sales_id,all_time_quantity_sold,quantity_sold,original_price,price,discount,discount_rate,list_price,price_usd,order_count,product_id,brand_id,category_id
54645,855.0,855.0,328900,267000,61900,19,328900,Null,Null,54645,18984,1804
54665,5783.0,5783.0,261000,217000,44000,17,261000,Null,Null,54665,18984,1815
122012,137.0,137.0,399000,399000,0,0,399000,Null,Null,122012,18984,1815
125781,10198.0,10198.0,199000,116000,83000,42,199000,Null,Null,125781,18641,1804
126000,5144.0,5144.0,590000,445000,145000,25,590000,Null,Null,126000,18641,1804
126697,2157.0,2157.0,209000,199000,10000,5,209000,Null,Null,126697,18641,1804
180912,1736.0,1736.0,595000,573000,22000,4,595000,Null,Null,180912,18984,1815
199828,1002.0,1002.0,734000,647000,87000,12,734000,Null,Null,199828,18984,1815
203734,101.0,101.0,432000,432000,0,0,432000,Null,Null,203734,18984,1815
208248,2048.0,2048.0,857000,728000,129000,15,857000,Null,Null,208248,18984,5264
233129,0.0,0.0,259000,259000,0,0,259000,Null,Null,233129,18984,1815
234751,52.0,52.0,200000,200000,0,0,200000,Null,Null,234751,50629,1815
249953,199.0,199.0,99000,99000,0,0,99000,Null,Null,249953,50629,1815
284609,1803.0,1803.0,235000,189000,46000,20,235000,Null,Null,284609,74674,1520
299431,12525.0,12525.0,272800,169000,103800,38,272800,Null,Null,299431,18984,1815
299461,8630.0,8630.0,390000,292000,98000,25,390000,Null,Null,299461,18984,1815
356188,5207.0,5207.0,63000,63000,0,0,63000,Null,Null,356188,18984,1837
359286,108.0,108.0,144840,142002,2838,2,144840,Null,Null,359286,18991,1815
359480,1422.0,1422.0,300000,227000,73000,24,300000,Null,Null,359480,18984,1815
359483,166.0,166.0,352000,352000,0,0,352000,Null,Null,359483,18984,1815
359484,3022.0,3022.0,138000,134000,4000,3,138000,Null,Null,359484,18984,25026
359492,314.0,314.0,298000,298000,0,0,298000,Null,Null,359492,18984,1805
359726,68.0,68.0,529000,529000,0,0,529000,Null,Null,359726,18984,1815
360660,947.0,947.0,499000,361000,138000,28,499000,Null,Null,360660,18984,1815
360738,2557.0,2557.0,548900,532000,16900,3,548900,Null,Null,360738,18984,1815
360759,101.0,101.0,649000,444000,205000,32,649000,Null,Null,360759,18984,1804
361277,746.0,746.0,265000,265000,0,0,265000,Null,Null,361277,19107,1815
361279,369.0,369.0,175000,175000,0,0,175000,Null,Null,361279,19107,5267
362117,10.0,10.0,1199000,1080000,119000,10,1199000,Null,Null,362117,18804,11935
365155,3.0,3.0,12999000,11699000,1300000,10,12999000,Null,Null,365155,18985,1804
376848,85.0,85.0,946000,946000,0,0,946000,Null,Null,376848,18984,1805
379462,6689.0,6689.0,357000,225000,132000,37,357000,Null,Null,379462,18792,1805
380792,2276.0,2276.0,308800,300000,8800,3,308800,Null,Null,380792,21273,1520
380795,3679.0,3679.0,308800,294000,14800,5,308800,Null,Null,380795,21273,1520
380857,178.0,178.0,99000,99000,0,0,99000,Null,Null,380857,21268,1520
381859,279.0,279.0,16000,14400,1600,10,16000,Null,Null,381859,21590,1601
382654,1121.0,1121.0,48000,43200,4800,10,48000,Null,Null,382654,21590,1583
383286,6798.0,6798.0,121000,114000,7000,6,121000,Null,Null,383286,21273,1520
385455,0.0,0.0,65000,65000,0,0,65000,Null,Null,385455,19107,1815
385469,2879.0,2879.0,76000,69000,7000,9,76000,Null,Null,385469,21261,1520
385477,7788.0,7788.0,304000,217000,87000,29,304000,Null,Null,385477,21261,1520
385568,2277.0,2277.0,69000,61000,8000,12,69000,Null,Null,385568,21261,1520
385574,5296.0,5296.0,300000,253000,47000,16,300000,Null,Null,385574,21261,1520
385582,4237.0,4237.0,276000,178000,98000,36,276000,Null,Null,385582,21261,1520
385614,2131.0,2131.0,70000,61000,9000,13,70000,Null,Null,385614,21261,1520
385615,4775.0,4775.0,280000,191000,89000,32,280000,Null,Null,385615,21261,1520
385654,8052.0,8052.0,77000,63000,14000,18,77000,Null,Null,385654,21261,1520
389145,708.0,708.0,164000,164000,0,0,164000,Null,Null,389145,18984,1838
389598,623.0,623.0,311500,311500,0,0,311500,Null,Null,389598,22095,1520
389628,101.0,101.0,65000,50000,15000,23,65000,Null,Null,389628,22095,2
389659,1585.0,1585.0,46489,46489,0,0,46489,Null,Null,389659,22095,1520
389688,157.0,157.0,210000,164890,45110,21,210000,Null,Null,389688,22095,1520
392967,22.0,22.0,125000,112000,13000,10,125000,Null,Null,392967,22653,1520
394686,442.0,442.0,285000,150000,135000,47,285000,Null,Null,394686,24921,1520
395428,5028.0,5028.0,425000,373000,52000,12,425000,Null,Null,395428,19018,1520
411327,688.0,688.0,310000,289000,21000,7,310000,Null,Null,411327,26689,1520
411663,304.0,304.0,1500000,1399000,101000,7,1500000,Null,Null,411663,26689,1520
411736,214.0,214.0,429000,429000,0,0,429000,Null,Null,411736,26689,3422
413638,172.0,172.0,415000,369000,46000,11,415000,Null,Null,413638,26689,1520
415517,161.0,161.0,650000,599000,51000,8,650000,Null,Null,415517,26689,11605
418556,1543.0,1543.0,570900,569000,1900,0,570900,Null,Null,418556,18984,1805
418574,96.0,96.0,199000,199000,0,0,199000,Null,Null,418574,18984,1804
418620,10.0,10.0,284000,284000,0,0,284000,Null,Null,418620,18984,1815
418636,157.0,157.0,759000,405000,354000,47,759000,Null,Null,418636,18984,1815
419018,9.0,9.0,1170000,1170000,0,0,1170000,Null,Null,419018,18984,1815
420412,4694.0,4694.0,137700,127000,10700,8,137700,Null,Null,420412,27918,1520
426104,8019.0,8019.0,201000,164000,37000,18,201000,Null,Null,426104,31580,1520
432950,146.0,146.0,89000,56000,33000,37,89000,Null,Null,432950,32909,11512
432953,766.0,766.0,99000,99000,0,0,99000,Null,Null,432953,32909,1520
434782,0.0,0.0,0,148000,70000,0,148000,Null,Null,434782,284599,0
435317,33.0,33.0,789000,789000,0,0,789000,Null,Null,435317,33203,8168
435390,98.0,98.0,880000,739000,141000,16,880000,Null,Null,435390,33203,1520
435416,1.0,1.0,4400000,4400000,0,0,4400000,Null,Null,435416,33203,8168
441648,934.0,934.0,70000,63000,7000,10,70000,Null,Null,441648,22653,1520
442348,5942.0,5942.0,1000000,828000,172000,17,1000000,Null,Null,442348,34398,1520
442901,14.0,14.0,4150000,3790000,360000,9,4150000,Null,Null,442901,27449,2
442980,279.0,279.0,149000,149000,0,0,149000,Null,Null,442980,21265,1520
444873,117.0,117.0,346000,299000,47000,14,346000,Null,Null,444873,40626,17170
447316,269.0,269.0,219000,197000,22000,10,219000,Null,Null,447316,18804,1634
447317,394.0,394.0,419000,409000,10000,2,419000,Null,Null,447317,18804,1634
447665,3414.0,3414.0,194000,173000,21000,11,194000,Null,Null,447665,21269,1520
447667,3063.0,3063.0,205000,175000,30000,15,205000,Null,Null,447667,21269,1520
448842,759.0,759.0,339000,309000,30000,9,339000,Null,Null,448842,18804,1520
451856,796.0,796.0,89400,76000,13400,15,89400,Null,Null,451856,41391,53190
453215,0.0,0.0,6900000,6900000,0,0,6900000,Null,Null,453215,27449,2
453218,0.0,0.0,21900000,21900000,0,0,21900000,Null,Null,453218,27449,2
453232,0.0,0.0,3500000,3500000,0,0,3500000,Null,Null,453232,27449,2
453704,1832.0,1832.0,190000,141000,49000,26,190000,Null,Null,453704,41660,13878
455847,111.0,111.0,322000,196000,126000,39,322000,Null,Null,455847,33652,3177
458326,1.0,1.0,5990000,5990000,0,0,5990000,Null,Null,458326,25502,914
458330,1.0,1.0,6885000,6885000,0,0,6885000,Null,Null,458330,25502,914
458422,0.0,0.0,5940000,5940000,0,0,5940000,Null,Null,458422,25502,914
458460,0.0,0.0,6200000,6200000,0,0,6200000,Null,Null,458460,25502,914
458756,0.0,0.0,5830000,5830000,0,0,5830000,Null,Null,458756,25502,5385
458769,0.0,0.0,5880000,5880000,0,0,5880000,Null,Null,458769,25502,914
458791,0.0,0.0,6200000,6200000,0,0,6200000,Null,Null,458791,25502,914
459036,0.0,0.0,7885000,7885000,0,0,7885000,Null,Null,459036,25502,914
459051,0.0,0.0,8110000,8110000,0,0,8110000,Null,Null,459051,25502,914
459067,0.0,0.0,7670000,7670000,0,0,7670000,Null,Null,459067,25502,914
460381,7280.0,7280.0,181000,159000,22000,12,181000,Null,Null,460381,21266,1520
460382,4490.0,4490.0,156600,151000,5600,4,156600,Null,Null,460382,21266,1520
460385,19475.0,19475.0,131400,129000,2400,2,131400,Null,Null,460385,21266,1520
460386,7624.0,7624.0,131400,128000,3400,3,131400,Null,Null,460386,21266,1520
460406,2170.0,2170.0,13000,13000,0,0,13000,Null,Null,460406,21266,1520
460467,257.0,257.0,139000,139000,0,0,139000,Null,Null,460467,21268,1520
460536,172.0,172.0,139000,139000,0,0,139000,Null,Null,460536,21269,1520
460539,11490.0,11490.0,229000,196000,33000,14,229000,Null,Null,460539,21269,1520
460591,359.0,359.0,297000,279000,18000,6,297000,Null,Null,460591,21265,1520
460595,191.0,191.0,82000,82000,0,0,82000,Null,Null,460595,21266,1520
460597,225.0,225.0,82000,82000,0,0,82000,Null,Null,460597,21266,1520
460758,2012.0,2012.0,92000,82000,10000,11,92000,Null,Null,460758,21273,1520
460761,2541.0,2541.0,150000,127000,23000,15,150000,Null,Null,460761,21273,1520
460762,5114.0,5114.0,76000,69000,7000,9,76000,Null,Null,460762,21273,1520
460765,10129.0,10129.0,127300,127000,300,0,127300,Null,Null,460765,21274,1520
460943,14144.0,14144.0,215000,165000,50000,23,215000,Null,Null,460943,41661,1627
466737,23105.0,23105.0,749000,439000,310000,41,749000,Null,Null,466737,5221825,1883
467866,3.0,3.0,13333333,13333333,0,0,13333333,Null,Null,467866,18984,4880
469253,261.0,261.0,749000,599000,150000,20,749000,Null,Null,469253,51059,11885
470417,34.0,34.0,369000,369000,0,0,369000,Null,Null,470417,47489,1520
470430,1342.0,1342.0,369000,369000,0,0,369000,Null,Null,470430,47489,3426
470441,1868.0,1868.0,570000,529000,41000,7,570000,Null,Null,470441,47489,3426
470571,529.0,529.0,495000,369000,126000,25,495000,Null,Null,470571,47489,3422
470616,41.0,41.0,255000,255000,0,0,255000,Null,Null,470616,47489,17170
470626,495.0,495.0,390000,270000,120000,31,390000,Null,Null,470626,47489,1520
472561,310.0,310.0,181000,130000,51000,28,181000,Null,Null,472561,47663,1520
472566,153.0,153.0,181000,130000,51000,28,181000,Null,Null,472566,47663,1520
477936,1402.0,1402.0,235000,198000,37000,16,235000,Null,Null,477936,79599,1883
481841,166.0,166.0,106125,106125,0,0,106125,Null,Null,481841,48201,1520
484026,0.0,0.0,6200000,6200000,0,0,6200000,Null,Null,484026,25502,914
484043,0.0,0.0,5800000,5800000,0,0,5800000,Null,Null,484043,25502,914
484309,0.0,0.0,5940000,5940000,0,0,5940000,Null,Null,484309,25502,914
484331,0.0,0.0,7100000,7100000,0,0,7100000,Null,Null,484331,25502,914
484352,0.0,0.0,8050000,8050000,0,0,8050000,Null,Null,484352,25502,914
484353,0.0,0.0,8300000,8300000,0,0,8300000,Null,Null,484353,25502,914
484370,0.0,0.0,7800000,7800000,0,0,7800000,Null,Null,484370,25502,914
484406,1.0,1.0,6800000,6800000,0,0,6800000,Null,Null,484406,25502,5385
484423,1.0,1.0,7500000,7500000,0,0,7500000,Null,Null,484423,25502,5385
484440,0.0,0.0,8800000,8800000,0,0,8800000,Null,Null,484440,25502,5385
485695,225.0,225.0,285000,285000,0,0,285000,Null,Null,485695,34379,3422
487524,470.0,470.0,198000,189000,9000,5,198000,Null,Null,487524,18802,1815
491312,50.0,50.0,21000,21000,0,0,21000,Null,Null,491312,48727,11605
496177,163.0,163.0,570000,570000,0,0,570000,Null,Null,496177,25422,1815
505915,319.0,319.0,429000,429000,0,0,429000,Null,Null,505915,26689,3422
508536,684.0,684.0,240000,218000,22000,9,240000,Null,Null,508536,243693,1815
511233,14.0,14.0,75000,55000,20000,27,75000,Null,Null,511233,50693,1520
511489,0.0,0.0,5900000,5900000,0,0,5900000,Null,Null,511489,25502,914
514927,638.0,638.0,759000,627000,132000,17,759000,Null,Null,514927,18984,1815
515545,1418.0,1418.0,446600,355000,91600,21,446600,Null,Null,515545,18984,1815
515550,115.0,115.0,449000,449000,0,0,449000,Null,Null,515550,18984,1836
515551,1591.0,1591.0,820000,608000,212000,26,820000,Null,Null,515551,18984,1815
520943,672.0,672.0,10000,10000,0,0,10000,Null,Null,520943,46335,1634
522730,56.0,56.0,450000,344000,106000,24,450000,Null,Null,522730,52207,11605
522736,348.0,348.0,380000,271000,109000,29,380000,Null,Null,522736,52207,8206
524217,333.0,333.0,180000,180000,0,0,180000,Null,Null,524217,18845,1815
525403,416.0,416.0,175000,124000,51000,29,175000,Null,Null,525403,47663,13878
525522,1318.0,1318.0,187000,141000,46000,25,187000,Null,Null,525522,47664,13878
525572,57.0,57.0,187000,141000,46000,25,187000,Null,Null,525572,47664,13878
526484,175.0,175.0,265000,245000,20000,8,265000,Null,Null,526484,52496,2154
529402,316.0,316.0,79000,79000,0,0,79000,Null,Null,529402,52977,1883
536498,185.0,185.0,480000,380000,100000,21,480000,Null,Null,536498,25229,1883
536965,194.0,194.0,199000,199000,0,0,199000,Null,Null,536965,18984,1804
537791,2.0,2.0,219000,219000,0,0,219000,Null,Null,537791,243693,1815
541546,100.0,100.0,98000,83300,14700,15,98000,Null,Null,541546,64152,1520
544425,1438.0,1438.0,375000,375000,0,0,375000,Null,Null,544425,47422,8170
549186,95.0,95.0,64000,64000,0,0,64000,Null,Null,549186,243693,1815
550442,6.0,6.0,255000,255000,0,0,255000,Null,Null,550442,18984,1804
550582,12540.0,12540.0,315000,275000,40000,13,315000,Null,Null,550582,19018,1520
553383,3380.0,3380.0,79000,69000,10000,13,79000,Null,Null,553383,74676,1520
553392,2641.0,2641.0,130000,99000,31000,24,130000,Null,Null,553392,74676,1520
554401,49.0,49.0,70000,49000,21000,30,70000,Null,Null,554401,243693,1815
554912,1978.0,1978.0,398000,398000,0,0,398000,Null,Null,554912,18984,3428
555019,15.0,15.0,876000,876000,0,0,876000,Null,Null,555019,18984,5267
556663,27.0,27.0,350000,350000,0,0,350000,Null,Null,556663,40699,23254
558335,0.0,0.0,129000,129000,0,0,129000,Null,Null,558335,79650,53190
558347,0.0,0.0,192000,192000,0,0,192000,Null,Null,558347,79650,53190
558353,1311.0,1311.0,305000,272000,33000,11,305000,Null,Null,558353,79650,53190
558569,177.0,177.0,439000,220000,219000,50,439000,Null,Null,558569,19588,53190
559949,3802.0,3802.0,235000,154300,80700,34,235000,Null,Null,559949,47415,1520
562183,919.0,919.0,175000,159000,16000,9,175000,Null,Null,562183,26689,1520
568277,289.0,289.0,300000,300000,0,0,300000,Null,Null,568277,85867,17162
568659,22077.0,22077.0,210000,205000,5000,2,210000,Null,Null,568659,64932,1601
568830,28395.0,28395.0,110000,90000,20000,18,110000,Null,Null,568830,86206,1583
573267,131.0,131.0,415000,389000,26000,6,415000,Null,Null,573267,108326,1520
575974,0.0,0.0,242000,224000,18000,7,242000,Null,Null,575974,19588,2020
576018,39.0,39.0,199000,199000,0,0,199000,Null,Null,576018,19588,1343
577147,269.0,269.0,360000,360000,0,0,360000,Null,Null,577147,859997,2
578912,72.0,72.0,195000,195000,0,0,195000,Null,Null,578912,41048,1883
578967,8316.0,8316.0,430000,367000,63000,15,430000,Null,Null,578967,41048,1883
579850,1941.0,1941.0,215000,159000,56000,26,215000,Null,Null,579850,41048,1984
579854,99.0,99.0,119000,119000,0,0,119000,Null,Null,579854,41048,1883
579928,4.0,4.0,142000,142000,0,0,142000,Null,Null,579928,41048,1984
579932,1077.0,1077.0,151000,112000,39000,26,151000,Null,Null,579932,41048,1883
579962,13.0,13.0,585000,585000,0,0,585000,Null,Null,579962,41048,1883
580040,229.0,229.0,320000,287000,33000,10,320000,Null,Null,580040,41048,1984
580507,747.0,747.0,65000,44000,21000,32,65000,Null,Null,580507,47663,1520
580508,1187.0,1187.0,65000,45000,20000,31,65000,Null,Null,580508,47663,1520
580515,273.0,273.0,65000,44000,21000,32,65000,Null,Null,580515,47663,1520
581470,1422.0,1422.0,145000,110000,35000,24,145000,Null,Null,581470,21265,1520
584803,0.0,0.0,27299000,27299000,0,0,27299000,Null,Null,584803,18984,4880
591967,526.0,526.0,125000,125000,0,0,125000,Null,Null,591967,111455,1815
595655,983.0,983.0,76000,76000,0,0,76000,Null,Null,595655,111461,1815
597580,137.0,137.0,299000,219000,80000,27,299000,Null,Null,597580,25422,53190
604233,0.0,0.0,2119000,2119000,0,0,2119000,Null,Null,604233,112278,914
604943,4101.0,4101.0,850000,800000,50000,6,850000,Null,Null,604943,218165,1805
630785,0.0,0.0,0,76000,3000,0,76000,Null,Null,630785,112887,0
630811,864.0,864.0,189000,163000,26000,14,189000,Null,Null,630811,112882,1520
631034,17776.0,17776.0,79000,68000,11000,14,79000,Null,Null,631034,22013,1583
631496,8850.0,8850.0,210000,170000,40000,19,210000,Null,Null,631496,22013,17170
631498,6084.0,6084.0,274000,222000,52000,19,274000,Null,Null,631498,22013,17170
631508,1164.0,1164.0,82000,70500,11500,14,82000,Null,Null,631508,112887,3426
631519,1390.0,1390.0,110000,95000,15000,14,110000,Null,Null,631519,112887,3426
631523,1703.0,1703.0,220000,178000,42000,19,220000,Null,Null,631523,22013,1520
631525,8454.0,8454.0,89000,76500,12500,14,89000,Null,Null,631525,22013,1520
631959,3801.0,3801.0,100000,66500,33500,34,100000,Null,Null,631959,112887,1520
631963,657.0,657.0,109000,93500,15500,14,109000,Null,Null,631963,112887,1520
632680,151652.0,151652.0,99000,85500,13500,14,99000,Null,Null,632680,112885,1613
632681,11689.0,11689.0,56000,50500,5500,10,56000,Null,Null,632681,112885,1520
637038,2132.0,2132.0,99000,85000,14000,14,99000,Null,Null,637038,18805,1815
638369,314.0,314.0,429000,429000,0,0,429000,Null,Null,638369,47489,3422
638371,219.0,219.0,250000,229000,21000,8,250000,Null,Null,638371,47489,3422
646304,90.0,90.0,365000,347000,18000,5,365000,Null,Null,646304,113778,1520
647148,0.0,0.0,1600000,1600000,0,0,1600000,Null,Null,647148,25229,1883
647768,431.0,431.0,799000,749000,50000,6,799000,Null,Null,647768,113854,2154
653804,1132.0,1132.0,50000,50000,0,0,50000,Null,Null,653804,46335,1634
653805,44.0,44.0,75000,75000,0,0,75000,Null,Null,653805,46335,1520
654609,1525.0,1525.0,409000,364000,45000,11,409000,Null,Null,654609,114329,11875
654647,3068.0,3068.0,129000,115000,14000,11,129000,Null,Null,654647,114329,1520
655484,244.0,244.0,170000,170000,0,0,170000,Null,Null,655484,19107,1815
686750,369.0,369.0,69000,69000,0,0,69000,Null,Null,686750,142848,1778
690673,168.0,168.0,39000,39000,0,0,39000,Null,Null,690673,143006,1634
691576,98.0,98.0,899000,830000,69000,8,899000,Null,Null,691576,18984,1838
693209,573.0,573.0,289000,289000,0,0,289000,Null,Null,693209,143086,1520
694380,332.0,332.0,120000,60000,60000,50,120000,Null,Null,694380,143130,8602
694387,1080.0,1080.0,90000,45000,45000,50,90000,Null,Null,694387,143130,1520
694391,1611.0,1611.0,195000,100000,95000,49,195000,Null,Null,694391,143130,1520
696344,144.0,144.0,229000,210000,19000,8,229000,Null,Null,696344,79650,53190
696349,2236.0,2236.0,269000,247000,22000,8,269000,Null,Null,696349,19018,53190
696495,1023.0,1023.0,329000,302000,27000,8,329000,Null,Null,696495,19018,53190
696521,2.0,2.0,399000,385000,14000,4,399000,Null,Null,696521,19018,1883
702134,231.0,231.0,1050000,1024000,26000,2,1050000,Null,Null,702134,18984,1815
709192,1493.0,1493.0,350000,336000,14000,4,350000,Null,Null,709192,243693,1815
714324,1.0,1.0,8000000,8000000,0,0,8000000,Null,Null,714324,25502,914
714327,0.0,0.0,5785000,5785000,0,0,5785000,Null,Null,714327,25502,914
715750,327.0,327.0,105000,105000,0,0,105000,Null,Null,715750,21253,3422
716377,0.0,0.0,7985000,7985000,0,0,7985000,Null,Null,716377,25502,914
717367,10.0,10.0,932000,726960,205040,22,932000,Null,Null,717367,26150,914
727022,28.0,28.0,4890000,3999000,891000,18,4890000,Null,Null,727022,144639,11935
727027,6.0,6.0,4890000,3999000,891000,18,4890000,Null,Null,727027,144639,11935
739341,172.0,172.0,179000,179000,0,0,179000,Null,Null,739341,21276,1520
739342,25.0,25.0,172000,172000,0,0,172000,Null,Null,739342,21276,1520
749588,4.0,4.0,48000,48000,0,0,48000,Null,Null,749588,145543,914
749594,0.0,0.0,48000,48000,0,0,48000,Null,Null,749594,145543,914
755572,7865.0,7865.0,156600,150000,6600,4,156600,Null,Null,755572,21266,1520
758879,785.0,785.0,49000,49000,0,0,49000,Null,Null,758879,21266,1520
766342,2224.0,2224.0,180000,179000,1000,1,180000,Null,Null,766342,218165,1815
767101,21554.0,21554.0,196000,109000,87000,44,196000,Null,Null,767101,21261,1630
781987,8253.0,8253.0,791000,487000,304000,38,791000,Null,Null,781987,48077,23362
783065,0.0,0.0,7200000,7200000,0,0,7200000,Null,Null,783065,48649,1634
796867,6635.0,6635.0,95000,80000,15000,16,95000,Null,Null,796867,21261,1520
801356,1887.0,1887.0,1045000,984000,61000,6,1045000,Null,Null,801356,26689,3426
802247,160.0,160.0,545000,299000,246000,45,545000,Null,Null,802247,148961,1883
827725,186.0,186.0,499000,199000,300000,60,499000,Null,Null,827725,31627,1883
844187,223.0,223.0,110000,110000,0,0,110000,Null,Null,844187,150229,914
855018,12616.0,12616.0,790000,650000,140000,18,790000,Null,Null,855018,18641,1804
855600,696.0,696.0,318900,318900,0,0,318900,Null,Null,855600,18641,1804
865648,16873.0,16873.0,190000,162000,28000,15,190000,Null,Null,865648,86206,3422
877310,0.0,0.0,0,180000,0,0,180000,Null,Null,877310,31580,0
877362,50.0,50.0,59000,59000,0,0,59000,Null,Null,877362,48727,1520
877460,2816.0,2816.0,180000,145000,35000,19,180000,Null,Null,877460,31580,3426
890513,0.0,0.0,18900000,18900000,0,0,18900000,Null,Null,890513,25502,914
890537,0.0,0.0,11870000,11870000,0,0,11870000,Null,Null,890537,25502,914
890575,0.0,0.0,7300000,7300000,0,0,7300000,Null,Null,890575,25502,914
890599,0.0,0.0,9980000,9980000,0,0,9980000,Null,Null,890599,25502,914
890605,0.0,0.0,9560000,9560000,0,0,9560000,Null,Null,890605,25502,914
890607,0.0,0.0,12390000,12390000,0,0,12390000,Null,Null,890607,25502,5385
890609,0.0,0.0,12390000,12390000,0,0,12390000,Null,Null,890609,25502,914
890615,0.0,0.0,7880000,7880000,0,0,7880000,Null,Null,890615,25502,914
890623,0.0,0.0,8930000,8930000,0,0,8930000,Null,Null,890623,25502,5385
890625,0.0,0.0,9560000,9560000,0,0,9560000,Null,Null,890625,25502,914
890627,0.0,0.0,9560000,9560000,0,0,9560000,Null,Null,890627,25502,914
890637,0.0,0.0,8720000,8720000,0,0,8720000,Null,Null,890637,25502,5385
892121,2302.0,2302.0,144000,137000,7000,5,144000,Null,Null,892121,19312,2153
892141,554.0,554.0,144000,135000,9000,6,144000,Null,Null,892141,19312,2153
895314,994.0,994.0,41900,41900,0,0,41900,Null,Null,895314,150004,4428
899654,89.0,89.0,210000,210000,0,0,210000,Null,Null,899654,150002,1815
902013,6162.0,6162.0,220000,179000,41000,19,220000,Null,Null,902013,25403,11605
902918,40.0,40.0,300000,199000,101000,34,300000,Null,Null,902918,4647777,914
904890,822.0,822.0,83000,83000,0,0,83000,Null,Null,904890,21867,8300
907522,3116.0,3116.0,485000,392000,93000,19,485000,Null,Null,907522,22393,1520
911333,660.0,660.0,75000,45000,30000,40,75000,Null,Null,911333,238407,1583
911351,2354.0,2354.0,80000,65000,15000,19,80000,Null,Null,911351,238407,3426
911355,853.0,853.0,80000,72000,8000,10,80000,Null,Null,911355,238407,2347
920500,32.0,32.0,699000,589000,110000,16,699000,Null,Null,920500,46363,914
927571,2516.0,2516.0,75000,71100,3900,5,75000,Null,Null,927571,829895,8172
932400,1.0,1.0,11569000,11569000,0,0,11569000,Null,Null,932400,18802,8067
933535,174.0,174.0,110000,110000,0,0,110000,Null,Null,933535,145037,2
949687,1929.0,1929.0,300000,220000,80000,27,300000,Null,Null,949687,152763,1883
975131,2205.0,2205.0,197000,136000,61000,31,197000,Null,Null,975131,21125,2225
977113,1034.0,1034.0,129000,125000,4000,3,129000,Null,Null,977113,153315,17186
980512,495.0,495.0,274778,274778,0,0,274778,Null,Null,980512,47422,1883
984740,312.0,312.0,397000,397000,0,0,397000,Null,Null,984740,20304,2136
1011253,233.0,233.0,478000,478000,0,0,478000,Null,Null,1011253,18984,1804
1012064,1.0,1.0,851000,851000,0,0,851000,Null,Null,1012064,46363,914
1016811,0.0,0.0,5060000,5060000,0,0,5060000,Null,Null,1016811,155090,2
1016813,0.0,0.0,4940000,4940000,0,0,4940000,Null,Null,1016813,155090,2
1021671,580.0,580.0,255000,255000,0,0,255000,Null,Null,1021671,114514,23216
1024190,486.0,486.0,1007000,549000,458000,45,1007000,Null,Null,1024190,48077,1883
1026342,305.0,305.0,1980000,1804000,176000,9,1980000,Null,Null,1026342,18984,1815
1027138,94.0,94.0,325000,325000,0,0,325000,Null,Null,1027138,151948,2
1038392,5.0,5.0,1253000,1253000,0,0,1253000,Null,Null,1038392,26150,914
1042578,0.0,0.0,3420000,3420000,0,0,3420000,Null,Null,1042578,155086,2
1042602,0.0,0.0,3534000,3534000,0,0,3534000,Null,Null,1042602,155086,17170
1042606,0.0,0.0,4284000,4284000,0,0,4284000,Null,Null,1042606,155086,53350
1042622,0.0,0.0,5220000,5220000,0,0,5220000,Null,Null,1042622,155086,17170
1042630,0.0,0.0,5076000,5076000,0,0,5076000,Null,Null,1042630,155086,53350
1042638,0.0,0.0,5220000,5220000,0,0,5220000,Null,Null,1042638,155086,17170
1042642,0.0,0.0,4860000,4860000,0,0,4860000,Null,Null,1042642,155086,17170
1042646,0.0,0.0,6600000,6600000,0,0,6600000,Null,Null,1042646,155086,17170
1042650,0.0,0.0,6528000,6528000,0,0,6528000,Null,Null,1042650,155086,53350
1042658,0.0,0.0,20000000,20000000,0,0,20000000,Null,Null,1042658,155086,17170
1042662,0.0,0.0,4500000,4500000,0,0,4500000,Null,Null,1042662,155086,2
1042666,1.0,1.0,4500000,4500000,0,0,4500000,Null,Null,1042666,155086,2
1042670,0.0,0.0,9300000,9300000,0,0,9300000,Null,Null,1042670,155086,1601
1042674,0.0,0.0,9300000,9300000,0,0,9300000,Null,Null,1042674,155086,2
1042678,0.0,0.0,20000000,20000000,0,0,20000000,Null,Null,1042678,155086,17170
1042756,0.0,0.0,3720000,3720000,0,0,3720000,Null,Null,1042756,155090,17170
1055224,15.0,15.0,220000,198000,22000,10,220000,Null,Null,1055224,111461,1815
1057882,2918.0,2918.0,500000,346000,154000,31,500000,Null,Null,1057882,50629,1815
1059892,9730.0,9730.0,330000,240000,90000,27,330000,Null,Null,1059892,50629,1815
1060082,6039.0,6039.0,380000,320000,60000,16,380000,Null,Null,1060082,50629,1815
1065940,0.0,0.0,40818000,40818000,0,0,40818000,Null,Null,1065940,41408,2266
1081764,3208.0,3208.0,255000,207000,48000,19,255000,Null,Null,1081764,22013,11605
1082080,943.0,943.0,79990,79990,0,0,79990,Null,Null,1082080,22095,1630
1082512,60.0,60.0,158000,158000,0,0,158000,Null,Null,1082512,25048,1520
1084776,1498.0,1498.0,373000,252000,121000,32,373000,Null,Null,1084776,21125,1883
1197177,404.0,404.0,45000,45000,0,0,45000,Null,Null,1197177,154167,1601
1218467,899.0,899.0,170000,170000,0,0,170000,Null,Null,1218467,143820,1520
1303927,1220.0,1220.0,644000,359000,285000,44,644000,Null,Null,1303927,48077,1883
1313875,4054.0,4054.0,91000,78500,12500,14,91000,Null,Null,1313875,112882,3422
1313877,2041.0,2041.0,91000,78500,12500,14,91000,Null,Null,1313877,112882,3422
1313881,1981.0,1981.0,104000,89500,14500,14,104000,Null,Null,1313881,112882,3422
1313885,3714.0,3714.0,119000,103000,16000,13,119000,Null,Null,1313885,112882,1520
1313887,5663.0,5663.0,95000,88500,6500,7,95000,Null,Null,1313887,112882,3422
1313889,3963.0,3963.0,122000,106000,16000,13,122000,Null,Null,1313889,112882,3422
1313893,697.0,697.0,57000,50500,6500,11,57000,Null,Null,1313893,156143,1520
1313903,1331.0,1331.0,300000,227000,73000,24,300000,Null,Null,1313903,156145,53350
1321077,930.0,930.0,253000,215000,38000,15,253000,Null,Null,1321077,238407,1520
1321913,260.0,260.0,300000,200000,100000,33,300000,Null,Null,1321913,50629,1815
1325569,171.0,171.0,65000,65000,0,0,65000,Null,Null,1325569,63747,1883
1347157,50878.0,50878.0,270000,145000,125000,46,270000,Null,Null,1347157,65071,1520
1362447,7061.0,7061.0,366000,352000,14000,4,366000,Null,Null,1362447,149699,1583
1366467,198.0,198.0,1820000,1648000,172000,9,1820000,Null,Null,1366467,18984,1815
1371931,0.0,0.0,7300000,7300000,0,0,7300000,Null,Null,1371931,156409,914
1373911,169.0,169.0,341000,341000,0,0,341000,Null,Null,1373911,19107,1815
1380213,0.0,0.0,6100000,6100000,0,0,6100000,Null,Null,1380213,156409,914
1380221,0.0,0.0,13300000,13300000,0,0,13300000,Null,Null,1380221,156409,914
1380271,0.0,0.0,6100000,6100000,0,0,6100000,Null,Null,1380271,156409,914
1382955,0.0,0.0,11550000,11550000,0,0,11550000,Null,Null,1382955,25502,914
1382967,0.0,0.0,9140000,9140000,0,0,9140000,Null,Null,1382967,25502,914
1382985,0.0,0.0,13290000,13290000,0,0,13290000,Null,Null,1382985,25502,914
1382989,0.0,0.0,13900000,13900000,0,0,13900000,Null,Null,1382989,25502,914
1383005,0.0,0.0,8610000,8610000,0,0,8610000,Null,Null,1383005,25502,914
1383013,0.0,0.0,11030000,11030000,0,0,11030000,Null,Null,1383013,25502,914
1383053,0.0,0.0,13130000,13130000,0,0,13130000,Null,Null,1383053,25502,914
1383079,0.0,0.0,9660000,9660000,0,0,9660000,Null,Null,1383079,25502,914
1383111,0.0,0.0,9580000,9580000,0,0,9580000,Null,Null,1383111,25502,914
1383117,0.0,0.0,14370000,14370000,0,0,14370000,Null,Null,1383117,25502,914
1383123,0.0,0.0,6780000,6780000,0,0,6780000,Null,Null,1383123,25502,914
1383125,0.0,0.0,9385000,9385000,0,0,9385000,Null,Null,1383125,25502,914
1385505,0.0,0.0,14985000,14985000,0,0,14985000,Null,Null,1385505,156409,914
1385507,0.0,0.0,13300000,13300000,0,0,13300000,Null,Null,1385507,156409,914
1398733,0.0,0.0,420000,319000,101000,24,420000,Null,Null,1398733,48077,1883
1399571,10735.0,10735.0,483000,289000,194000,40,483000,Null,Null,1399571,48077,1883
1400785,4109.0,4109.0,439000,398000,41000,9,439000,Null,Null,1400785,48077,1883
1403217,2411.0,2411.0,556000,288000,268000,48,556000,Null,Null,1403217,48077,1883
1409235,0.0,0.0,13340000,13340000,0,0,13340000,Null,Null,1409235,25502,914
1409243,0.0,0.0,11030000,11030000,0,0,11030000,Null,Null,1409243,25502,5385
1409245,0.0,0.0,25830000,25830000,0,0,25830000,Null,Null,1409245,25502,914
1409259,0.0,0.0,12080000,12080000,0,0,12080000,Null,Null,1409259,25502,5385
1409299,1.0,1.0,13100000,13100000,0,0,13100000,Null,Null,1409299,25502,914
1409301,0.0,0.0,10800000,10800000,0,0,10800000,Null,Null,1409301,25502,5385
1409303,0.0,0.0,10800000,10800000,0,0,10800000,Null,Null,1409303,25502,914
1409321,0.0,0.0,11985000,11985000,0,0,11985000,Null,Null,1409321,25502,914
1409349,0.0,0.0,10000000,10000000,0,0,10000000,Null,Null,1409349,25502,914
1409377,0.0,0.0,11340000,11340000,0,0,11340000,Null,Null,1409377,25502,914
1409379,0.0,0.0,11340000,11340000,0,0,11340000,Null,Null,1409379,25502,914
1409395,0.0,0.0,15230000,15230000,0,0,15230000,Null,Null,1409395,25502,914
1409405,0.0,0.0,14280000,14280000,0,0,14280000,Null,Null,1409405,25502,5385
1409407,0.0,0.0,9030000,9030000,0,0,9030000,Null,Null,1409407,25502,914
1453913,10845.0,10845.0,506000,278000,228000,45,506000,Null,Null,1453913,48077,1883
1453915,157.0,157.0,259000,259000,0,0,259000,Null,Null,1453915,48077,1936
1457747,520.0,520.0,173000,160000,13000,8,173000,Null,Null,1457747,18845,1815
1471675,1.0,1.0,78000,78000,0,0,78000,Null,Null,1471675,159283,23362
1508313,33.0,33.0,1350000,1350000,0,0,1350000,Null,Null,1508313,18641,1815
1511705,0.0,0.0,121000,121000,0,0,121000,Null,Null,1511705,48077,2685
1516999,455.0,455.0,73000,73000,0,0,73000,Null,Null,1516999,18845,1815
1517005,612.0,612.0,75000,75000,0,0,75000,Null,Null,1517005,18845,1815
1522661,2.0,2.0,500000,425000,75000,15,500000,Null,Null,1522661,4647777,914
1522665,3.0,3.0,500000,470000,30000,6,500000,Null,Null,1522665,4647777,914
1524445,96.0,96.0,685000,495000,190000,28,685000,Null,Null,1524445,160211,3422
1529987,747.0,747.0,54000,48000,6000,11,54000,Null,Null,1529987,156143,1520
1529993,851.0,851.0,54000,48000,6000,11,54000,Null,Null,1529993,156143,1520
1530003,378.0,378.0,54000,48000,6000,11,54000,Null,Null,1530003,156143,1520
1534441,0.0,0.0,4320000,4320000,0,0,4320000,Null,Null,1534441,155086,17170
1534469,0.0,0.0,4854000,4854000,0,0,4854000,Null,Null,1534469,155090,17170
1534471,0.0,0.0,7482000,7482000,0,0,7482000,Null,Null,1534471,155090,17170
1534479,0.0,0.0,3492000,3492000,0,0,3492000,Null,Null,1534479,155090,2
1537315,9272.0,9272.0,90000,84900,5100,6,90000,Null,Null,1537315,21261,1520
1570109,0.0,0.0,13462000,13462000,0,0,13462000,Null,Null,1570109,156529,12876
1575707,21100.0,21100.0,424000,219000,205000,48,424000,Null,Null,1575707,48077,1883
1581113,130.0,130.0,299000,299000,0,0,299000,Null,Null,1581113,161077,2
1581155,881.0,881.0,75000,65000,10000,13,75000,Null,Null,1581155,47663,1520
1600005,1555.0,1555.0,149000,118000,31000,21,149000,Null,Null,1600005,25422,1804
1600023,607.0,607.0,126000,108000,18000,14,126000,Null,Null,1600023,49242,8300
1600039,932.0,932.0,144000,111000,33000,23,144000,Null,Null,1600039,49242,8300
1600057,808.0,808.0,122000,102000,20000,16,122000,Null,Null,1600057,49242,8300
1600059,1076.0,1076.0,112000,96000,16000,14,112000,Null,Null,1600059,49242,8300
1601595,385.0,385.0,199000,180000,19000,10,199000,Null,Null,1601595,160941,13878
1601605,583.0,583.0,199000,180000,19000,10,199000,Null,Null,1601605,160941,13878
1601621,197.0,197.0,199000,179000,20000,10,199000,Null,Null,1601621,160941,13878
1628055,695.0,695.0,295000,269000,26000,9,295000,Null,Null,1628055,26689,17162
1628057,178.0,178.0,275000,247500,27500,10,275000,Null,Null,1628057,26689,17162
1629095,187.0,187.0,950000,760000,190000,20,950000,Null,Null,1629095,162169,1520
1634983,7244.0,7244.0,69000,59500,9500,14,69000,Null,Null,1634983,112887,11605
1651191,1345.0,1345.0,380000,260000,120000,32,380000,Null,Null,1651191,152763,23588
1657931,9462.0,9462.0,119000,83000,36000,30,119000,Null,Null,1657931,41048,1883
1659079,231.0,231.0,15000,15000,0,0,15000,Null,Null,1659079,48381,1601
1659083,13.0,13.0,6000,6000,0,0,6000,Null,Null,1659083,48381,1601
1662427,1020.0,1020.0,129000,125000,4000,3,129000,Null,Null,1662427,153315,1520
1672153,19160.0,19160.0,308000,210000,98000,32,308000,Null,Null,1672153,21261,1630
1672155,9731.0,9731.0,49000,42000,7000,14,49000,Null,Null,1672155,21261,1520
1672157,20292.0,20292.0,317000,207000,110000,35,317000,Null,Null,1672157,21261,1520
1672211,6076.0,6076.0,194000,159000,35000,18,194000,Null,Null,1672211,21261,1520
1679021,1073.0,1073.0,138000,116800,21200,15,138000,Null,Null,1679021,163213,1520
1679043,1376.0,1376.0,211000,209000,2000,1,211000,Null,Null,1679043,163213,1520
1679047,1745.0,1745.0,300000,209000,91000,30,300000,Null,Null,1679047,163213,1520
1679061,20.0,20.0,12000,6000,6000,50,12000,Null,Null,1679061,163213,1520
1679105,204.0,204.0,12000,6000,6000,50,12000,Null,Null,1679105,163213,8305
1679107,3195.0,3195.0,43000,37000,6000,14,43000,Null,Null,1679107,163213,8305
1679111,269.0,269.0,15000,7500,7500,50,15000,Null,Null,1679111,163213,8305
1679129,1997.0,1997.0,13500,12300,1200,9,13500,Null,Null,1679129,163213,1520
1679135,530.0,530.0,19000,9500,9500,50,19000,Null,Null,1679135,163213,1520
1680827,5.0,5.0,39000,39000,0,0,39000,Null,Null,1680827,111461,2759
1685827,11.0,11.0,16000,16000,0,0,16000,Null,Null,1685827,160841,914
1687621,3286.0,3286.0,26000,23000,3000,12,26000,Null,Null,1687621,164391,17186
1687623,2506.0,2506.0,26000,23000,3000,12,26000,Null,Null,1687623,164391,17186
1687627,3449.0,3449.0,63000,57000,6000,10,63000,Null,Null,1687627,164391,1520
1692091,0.0,0.0,8500000,8500000,0,0,8500000,Null,Null,1692091,25502,5385
1692093,0.0,0.0,7880000,7880000,0,0,7880000,Null,Null,1692093,25502,5385
1692095,0.0,0.0,7880000,7880000,0,0,7880000,Null,Null,1692095,25502,5385
1692107,0.0,0.0,7450000,7450000,0,0,7450000,Null,Null,1692107,25502,914
1692113,2.0,2.0,8300000,8300000,0,0,8300000,Null,Null,1692113,25502,914
1692129,0.0,0.0,7185000,7185000,0,0,7185000,Null,Null,1692129,25502,914
1692135,1.0,1.0,21485000,21485000,0,0,21485000,Null,Null,1692135,25502,914
1692139,0.0,0.0,7770000,7770000,0,0,7770000,Null,Null,1692139,25502,914
1692175,0.0,0.0,8700000,8700000,0,0,8700000,Null,Null,1692175,25502,914
1692191,0.0,0.0,16380000,16380000,0,0,16380000,Null,Null,1692191,25502,914
1692193,0.0,0.0,16380000,16380000,0,0,16380000,Null,Null,1692193,25502,914
1692213,0.0,0.0,9720000,9720000,0,0,9720000,Null,Null,1692213,25502,914
1692215,0.0,0.0,8190000,8190000,0,0,8190000,Null,Null,1692215,25502,914
1692217,0.0,0.0,10450000,10450000,0,0,10450000,Null,Null,1692217,25502,914
1692225,0.0,0.0,11760000,11760000,0,0,11760000,Null,Null,1692225,25502,914
1692237,0.0,0.0,9560000,9560000,0,0,9560000,Null,Null,1692237,25502,914
1692259,0.0,0.0,6930000,6930000,0,0,6930000,Null,Null,1692259,25502,914
1692263,0.0,0.0,8185000,8185000,0,0,8185000,Null,Null,1692263,25502,914
1692269,1.0,1.0,7980000,7980000,0,0,7980000,Null,Null,1692269,25502,914
1692271,0.0,0.0,11340000,11340000,0,0,11340000,Null,Null,1692271,25502,5385
1695633,0.0,0.0,12890000,12890000,0,0,12890000,Null,Null,1695633,164793,1815
1695651,0.0,0.0,12880000,12880000,0,0,12880000,Null,Null,1695651,164793,1815
1695753,657.0,657.0,294000,255000,39000,13,294000,Null,Null,1695753,19018,1520
1711465,1036.0,1036.0,400000,400000,0,0,400000,Null,Null,1711465,165285,1520
1717399,6.0,6.0,900000,900000,0,0,900000,Null,Null,1717399,31632,914
1753529,251.0,251.0,349000,244000,105000,30,349000,Null,Null,1753529,167567,8206
1754691,2242.0,2242.0,129000,129000,0,0,129000,Null,Null,1754691,166383,1520
1792035,0.0,0.0,1167000,910260,256740,22,1167000,Null,Null,1792035,26150,914
1819263,149.0,149.0,139000,139000,0,0,139000,Null,Null,1819263,243693,1815
1831663,0.0,0.0,13500000,13500000,0,0,13500000,Null,Null,1831663,52315,8064
1860317,513.0,513.0,150000,79000,71000,47,150000,Null,Null,1860317,167817,17170
1911371,103.0,103.0,299000,299000,0,0,299000,Null,Null,1911371,47489,17170
1918591,3882.0,3882.0,35000,29000,6000,17,35000,Null,Null,1918591,52977,53074
1918931,746.0,746.0,39000,29000,10000,26,39000,Null,Null,1918931,52977,1883
1928063,0.0,0.0,4679000,4679000,0,0,4679000,Null,Null,1928063,168731,1520
1930797,612.0,612.0,203500,203500,0,0,203500,Null,Null,1930797,168555,11512
1935009,2458.0,2458.0,790000,547000,243000,31,790000,Null,Null,1935009,17827,1804
1937707,1174.0,1174.0,77000,39900,37100,48,77000,Null,Null,1937707,168669,3710
1950673,558.0,558.0,350000,299000,51000,15,350000,Null,Null,1950673,155216,1520
1951095,3234.0,3234.0,149000,88000,61000,41,149000,Null,Null,1951095,111461,1520
1992301,181.0,181.0,550000,550000,0,0,550000,Null,Null,1992301,18802,1520
1993815,0.0,0.0,21000000,18900000,2100000,10,21000000,Null,Null,1993815,50331,1805
1995737,113.0,113.0,69000,45000,24000,35,69000,Null,Null,1995737,25422,1815
1998343,204.0,204.0,143000,115000,28000,20,143000,Null,Null,1998343,243693,1815
1999195,320.0,320.0,70000,69900,100,0,70000,Null,Null,1999195,243693,1815
2004139,217.0,217.0,36000,36000,0,0,36000,Null,Null,2004139,111461,1883
2010525,99.0,99.0,140000,136000,4000,3,140000,Null,Null,2010525,243693,1815
2024153,4.0,4.0,349000,164000,185000,53,349000,Null,Null,2024153,46679,914
2036201,152.0,152.0,33000,26000,7000,21,33000,Null,Null,2036201,174505,17186
2038117,0.0,0.0,65000,65000,0,0,65000,Null,Null,2038117,111461,2140
2039129,1.0,1.0,7040000,6266000,774000,11,7040000,Null,Null,2039129,145556,914
2039747,796.0,796.0,734000,543000,191000,26,734000,Null,Null,2039747,41048,1883
2042221,3476.0,3476.0,194000,157000,37000,19,194000,Null,Null,2042221,21261,1520
2042227,9003.0,9003.0,317000,215000,102000,32,317000,Null,Null,2042227,21261,1520
2054469,17.0,17.0,145000,145000,0,0,145000,Null,Null,2054469,243693,1815
2054629,165.0,165.0,118000,105000,13000,11,118000,Null,Null,2054629,243693,1815
2054633,11.0,11.0,260000,200000,60000,23,260000,Null,Null,2054633,243693,1815
2066611,5.0,5.0,242000,188000,54000,22,242000,Null,Null,2066611,243693,1815
2075159,3668.0,3668.0,118000,67000,51000,43,118000,Null,Null,2075159,159019,3426
2079711,21224.0,21224.0,127300,115000,12300,10,127300,Null,Null,2079711,21274,1520
2100355,52.0,52.0,39500,39500,0,0,39500,Null,Null,2100355,111461,53054
2119169,45.0,45.0,979000,490000,489000,50,979000,Null,Null,2119169,48077,23832
2119173,6108.0,6108.0,539000,280000,259000,48,539000,Null,Null,2119173,48077,1883
2123245,17062.0,17062.0,120000,95000,25000,21,120000,Null,Null,2123245,86206,1583
2127549,678.0,678.0,241000,139000,102000,42,241000,Null,Null,2127549,48077,6948
2130029,1457.0,1457.0,309000,265000,44000,14,309000,Null,Null,2130029,21273,1520
2151853,20086.0,20086.0,542000,279000,263000,49,542000,Null,Null,2151853,48077,3177
2153015,461.0,461.0,490000,344000,146000,30,490000,Null,Null,2153015,25422,1883
2153187,708.0,708.0,290000,205000,85000,29,290000,Null,Null,2153187,25422,53190
2153235,3392.0,3392.0,545000,297000,248000,46,545000,Null,Null,2153235,48077,1883
2159295,6.0,6.0,169000,169000,0,0,169000,Null,Null,2159295,152755,914
2161457,0.0,0.0,9500000,9500000,0,0,9500000,Null,Null,2161457,25502,914
2161569,0.0,0.0,9500000,9500000,0,0,9500000,Null,Null,2161569,25502,914
2161623,0.0,0.0,11500000,11500000,0,0,11500000,Null,Null,2161623,25502,914
2161693,0.0,0.0,8900000,8900000,0,0,8900000,Null,Null,2161693,25502,914
2172573,0.0,0.0,12900000,12900000,0,0,12900000,Null,Null,2172573,25502,914
2172623,0.0,0.0,12900000,12900000,0,0,12900000,Null,Null,2172623,25502,914
2184787,0.0,0.0,1049000,698500,350500,33,1049000,Null,Null,2184787,46363,914
2185531,0.0,0.0,7800000,7800000,0,0,7800000,Null,Null,2185531,25502,5385
2185583,0.0,0.0,7500000,7500000,0,0,7500000,Null,Null,2185583,25502,5385
2185689,0.0,0.0,6900000,6900000,0,0,6900000,Null,Null,2185689,25502,914
2186859,0.0,0.0,8250000,8250000,0,0,8250000,Null,Null,2186859,25502,914
2187189,2.0,2.0,6585000,6585000,0,0,6585000,Null,Null,2187189,25502,914
2191709,1.0,1.0,6000000,6000000,0,0,6000000,Null,Null,2191709,25502,914
2192131,0.0,0.0,7385000,7385000,0,0,7385000,Null,Null,2192131,25502,914
2192487,2.0,2.0,6385000,6385000,0,0,6385000,Null,Null,2192487,25502,914
2212607,0.0,0.0,11550000,11550000,0,0,11550000,Null,Null,2212607,25502,914
2212689,0.0,0.0,12600000,12600000,0,0,12600000,Null,Null,2212689,25502,914
2213019,1.0,1.0,6200000,6200000,0,0,6200000,Null,Null,2213019,25502,914
2226243,1843.0,1843.0,80000,49000,31000,39,80000,Null,Null,2226243,168669,3710
2241231,6.0,6.0,54100,54100,0,0,54100,Null,Null,2241231,111461,1883
2241703,4.0,4.0,5500000,5500000,0,0,5500000,Null,Null,2241703,181341,1520
2247209,391.0,391.0,180000,115000,65000,36,180000,Null,Null,2247209,169917,3422
2261289,0.0,0.0,5785000,5785000,0,0,5785000,Null,Null,2261289,25502,914
2274659,0.0,0.0,7500000,7500000,0,0,7500000,Null,Null,2274659,25502,914
2283707,0.0,0.0,7350000,7350000,0,0,7350000,Null,Null,2283707,25502,914
2284757,0.0,0.0,5870000,5870000,0,0,5870000,Null,Null,2284757,25502,914
2287655,0.0,0.0,10700000,10700000,0,0,10700000,Null,Null,2287655,25502,914
2288019,0.0,0.0,11950000,11950000,0,0,11950000,Null,Null,2288019,25502,914
2288229,0.0,0.0,11920000,11920000,0,0,11920000,Null,Null,2288229,25502,5385
2289935,0.0,0.0,6285000,6285000,0,0,6285000,Null,Null,2289935,25502,914
2300517,179.0,179.0,135000,135000,0,0,135000,Null,Null,2300517,253687,1520
2304273,0.0,0.0,9550000,9550000,0,0,9550000,Null,Null,2304273,25502,914
2304319,0.0,0.0,9550000,9550000,0,0,9550000,Null,Null,2304319,25502,914
2304617,0.0,0.0,8000000,8000000,0,0,8000000,Null,Null,2304617,25502,914
2320119,0.0,0.0,5800000,5800000,0,0,5800000,Null,Null,2320119,25502,914
2342847,0.0,0.0,6900000,6900000,0,0,6900000,Null,Null,2342847,25502,914
2360457,7.0,7.0,7499000,7499000,0,0,7499000,Null,Null,2360457,147856,1789
2362849,0.0,0.0,12250000,12250000,0,0,12250000,Null,Null,2362849,25502,914
2379419,627.0,627.0,129000,129000,0,0,129000,Null,Null,2379419,156901,1601
2386485,6.0,6.0,168000,118000,50000,30,168000,Null,Null,2386485,185177,1520
2386867,720.0,720.0,129000,129000,0,0,129000,Null,Null,2386867,156901,1601
2391311,337.0,337.0,62778,62778,0,0,62778,Null,Null,2391311,47422,1883
2397037,10339.0,10339.0,120000,108000,12000,10,120000,Null,Null,2397037,86206,1583
2401561,6.0,6.0,16000,16000,0,0,16000,Null,Null,2401561,111461,914
2405391,72.0,72.0,5590000,3990000,1600000,29,5590000,Null,Null,2405391,185211,1520
2406967,2251.0,2251.0,185000,158000,27000,15,185000,Null,Null,2406967,22013,1583
2414671,0.0,0.0,6185000,6185000,0,0,6185000,Null,Null,2414671,25502,914
2415669,0.0,0.0,8900000,8900000,0,0,8900000,Null,Null,2415669,25502,5385
2416225,0.0,0.0,5785000,5785000,0,0,5785000,Null,Null,2416225,25502,914
2425689,0.0,0.0,6785000,6785000,0,0,6785000,Null,Null,2425689,25502,914
2431465,0.0,0.0,11650000,11650000,0,0,11650000,Null,Null,2431465,27449,11935
2436707,0.0,0.0,11000000,11000000,0,0,11000000,Null,Null,2436707,47678,1520
2453915,0.0,0.0,6980000,6980000,0,0,6980000,Null,Null,2453915,25502,914
2462825,3494.0,3494.0,1170000,794000,376000,32,1170000,Null,Null,2462825,18984,3428
2469427,1013.0,1013.0,119000,119000,0,0,119000,Null,Null,2469427,182017,1520
2471133,0.0,0.0,6090000,6090000,0,0,6090000,Null,Null,2471133,25502,914
2504593,1.0,1.0,249000,117000,132000,53,249000,Null,Null,2504593,46679,914
2552361,0.0,0.0,6885000,6885000,0,0,6885000,Null,Null,2552361,25502,5385
2555151,0.0,0.0,6885000,6885000,0,0,6885000,Null,Null,2555151,25502,5385
2567811,392.0,392.0,115000,115000,0,0,115000,Null,Null,2567811,191181,1520
2571145,0.0,0.0,42000,42000,0,0,42000,Null,Null,2571145,111461,914
2573465,657.0,657.0,65000,65000,0,0,65000,Null,Null,2573465,191181,1520
2576995,122.0,122.0,525000,445000,80000,15,525000,Null,Null,2576995,50662,1520
2577355,1.0,1.0,12500000,10500000,2000000,16,12500000,Null,Null,2577355,47678,1520
2577737,2077.0,2077.0,148000,148000,0,0,148000,Null,Null,2577737,191181,11512
2579159,340.0,340.0,2105000,1723000,382000,18,2105000,Null,Null,2579159,33203,8168
2581505,0.0,0.0,7485000,7485000,0,0,7485000,Null,Null,2581505,25502,914
2592345,0.0,0.0,6585000,6585000,0,0,6585000,Null,Null,2592345,25502,914
2600719,149.0,149.0,1800000,1800000,0,0,1800000,Null,Null,2600719,191611,1815
2602231,0.0,0.0,8343000,8343000,0,0,8343000,Null,Null,2602231,184457,914
2602233,0.0,0.0,8613000,8613000,0,0,8613000,Null,Null,2602233,184457,914
2609295,117.0,117.0,704999,704999,0,0,704999,Null,Null,2609295,31929,2136
2609469,221.0,221.0,395000,395000,0,0,395000,Null,Null,2609469,47489,11605
2616909,153.0,153.0,389000,389000,0,0,389000,Null,Null,2616909,47489,11605
2617291,0.0,0.0,8050000,8050000,0,0,8050000,Null,Null,2617291,25502,914
2626717,527.0,527.0,299000,229000,70000,23,299000,Null,Null,2626717,186549,1601
2627631,137.0,137.0,44000,44000,0,0,44000,Null,Null,2627631,111461,2014
2639025,135.0,135.0,1800,1800,0,0,1800,Null,Null,2639025,111461,1815
2642517,21.0,21.0,699000,489000,210000,30,699000,Null,Null,2642517,46363,914
2643399,1.0,1.0,589000,589000,0,0,589000,Null,Null,2643399,46363,914
2650847,0.0,0.0,6000000,6000000,0,0,6000000,Null,Null,2650847,25502,914
2665867,755.0,755.0,169000,159000,10000,6,169000,Null,Null,2665867,48599,1601
2683159,0.0,0.0,6400000,6400000,0,0,6400000,Null,Null,2683159,25502,5385
2684495,0.0,0.0,13300000,13300000,0,0,13300000,Null,Null,2684495,25502,914
2695315,19.0,19.0,7190000,4390000,2800000,39,7190000,Null,Null,2695315,144376,1520
2695321,3.0,3.0,5890000,3590000,2300000,39,5890000,Null,Null,2695321,144376,2
2738475,18990.0,18990.0,128000,102000,26000,20,128000,Null,Null,2738475,48249,1520
2738479,5193.0,5193.0,95000,69000,26000,27,95000,Null,Null,2738479,48249,1520
2738497,8238.0,8238.0,143000,107000,36000,25,143000,Null,Null,2738497,48249,11605
2738595,778.0,778.0,139000,117000,22000,16,139000,Null,Null,2738595,49242,8300
2739235,1187.0,1187.0,2800000,1780000,1020000,36,2800000,Null,Null,2739235,51302,1883
2749331,0.0,0.0,8770000,8770000,0,0,8770000,Null,Null,2749331,510089,8227
2752195,149.0,149.0,199000,179000,20000,10,199000,Null,Null,2752195,47882,914
2762225,34.0,34.0,165000,165000,0,0,165000,Null,Null,2762225,47882,914
2775387,1772.0,1772.0,53600,53600,0,0,53600,Null,Null,2775387,22095,1520
2775397,1169.0,1169.0,51000,51000,0,0,51000,Null,Null,2775397,22095,1520
2775543,3.0,3.0,245000,218000,27000,11,245000,Null,Null,2775543,47882,914
2775643,422.0,422.0,115700,115700,0,0,115700,Null,Null,2775643,196109,1832
2789861,94.0,94.0,79000,79000,0,0,79000,Null,Null,2789861,33203,2
2789921,1760.0,1760.0,54000,54000,0,0,54000,Null,Null,2789921,64152,1520
2792001,41.0,41.0,155000,155000,0,0,155000,Null,Null,2792001,47882,914
2796179,0.0,0.0,9750000,9750000,0,0,9750000,Null,Null,2796179,25502,914
2796635,3.0,3.0,12200000,12200000,0,0,12200000,Null,Null,2796635,25502,914
2804501,24.0,24.0,249000,222000,27000,11,249000,Null,Null,2804501,47882,914
2808703,0.0,0.0,21485000,21485000,0,0,21485000,Null,Null,2808703,25502,914
2817699,13.0,13.0,295000,263000,32000,11,295000,Null,Null,2817699,47882,914
2821273,0.0,0.0,7800000,7800000,0,0,7800000,Null,Null,2821273,25502,914
2829433,82.0,82.0,114700,106000,8700,8,114700,Null,Null,2829433,192493,1815
2850277,0.0,0.0,7400000,7400000,0,0,7400000,Null,Null,2850277,25502,914
2850663,472.0,472.0,78000,78000,0,0,78000,Null,Null,2850663,197655,1815
2850711,0.0,0.0,6510000,6510000,0,0,6510000,Null,Null,2850711,25502,5385
2851671,0.0,0.0,6185000,6185000,0,0,6185000,Null,Null,2851671,25502,914
2853329,0.0,0.0,11185000,11185000,0,0,11185000,Null,Null,2853329,25502,914
2854757,202.0,202.0,229000,229000,0,0,229000,Null,Null,2854757,47882,914
2869891,24.0,24.0,54000,40000,14000,26,54000,Null,Null,2869891,111461,914
2873653,949.0,949.0,380000,250000,130000,34,380000,Null,Null,2873653,152763,23588
2888357,498.0,498.0,199000,179000,20000,10,199000,Null,Null,2888357,47882,914
2909849,42.0,42.0,2182600,1669000,513600,24,2182600,Null,Null,2909849,25229,1979
2982265,649.0,649.0,57000,39000,18000,32,57000,Null,Null,2982265,200595,1520
2984005,438.0,438.0,69000,69000,0,0,69000,Null,Null,2984005,199937,1520
2984031,83.0,83.0,9000,9000,0,0,9000,Null,Null,2984031,46335,1634
2986081,0.0,0.0,250000,250000,0,0,250000,Null,Null,2986081,47882,914
2986985,1.0,1.0,6120000,6120000,0,0,6120000,Null,Null,2986985,25502,914
2989999,889.0,889.0,145000,145000,0,0,145000,Null,Null,2989999,198843,1815
3015555,8.0,8.0,180000,115000,65000,36,180000,Null,Null,3015555,156141,11605
3045643,53.0,53.0,175000,175000,0,0,175000,Null,Null,3045643,111461,914
3046929,0.0,0.0,9060000,9060000,0,0,9060000,Null,Null,3046929,191261,914
3052215,0.0,0.0,23060000,15039000,8021000,35,23060000,Null,Null,3052215,191235,5385
3052217,0.0,0.0,30280000,19732000,10548000,35,30280000,Null,Null,3052217,191235,914
3055353,50.0,50.0,14900,14000,900,6,14900,Null,Null,3055353,111461,1815
3056161,0.0,0.0,6740000,6740000,0,0,6740000,Null,Null,3056161,191235,914
3074967,325.0,325.0,53800,53800,0,0,53800,Null,Null,3074967,199937,1520
3078073,1.0,1.0,4610000,4471700,138300,3,4610000,Null,Null,3078073,199801,1520
3078103,0.0,0.0,13160000,13160000,0,0,13160000,Null,Null,3078103,199801,1520
3078125,0.0,0.0,19988000,19988000,0,0,19988000,Null,Null,3078125,199801,1520
3085417,0.0,0.0,9285000,9285000,0,0,9285000,Null,Null,3085417,25502,914
3086603,411.0,411.0,250000,250000,0,0,250000,Null,Null,3086603,148559,1883
3087039,125.0,125.0,2840000,2840000,0,0,2840000,Null,Null,3087039,148559,1883
3102359,0.0,0.0,6500000,6500000,0,0,6500000,Null,Null,3102359,25502,914
3151953,12.0,12.0,6890000,5999000,891000,13,6890000,Null,Null,3151953,144639,1520
3179511,191.0,191.0,214500,214500,0,0,214500,Null,Null,3179511,207249,1520
3237483,51.0,51.0,300000,300000,0,0,300000,Null,Null,3237483,150002,1815
3258975,9.0,9.0,9000,9000,0,0,9000,Null,Null,3258975,111461,1815
3258989,835.0,835.0,21999,21999,0,0,21999,Null,Null,3258989,111461,23392
3265121,5480.0,5480.0,127300,127000,300,0,127300,Null,Null,3265121,21274,1520
3271467,23.0,23.0,1350000,750000,600000,44,1350000,Null,Null,3271467,202043,1520
3280529,781.0,781.0,57000,44000,13000,23,57000,Null,Null,3280529,200595,1520
3282871,19.0,19.0,395000,395000,0,0,395000,Null,Null,3282871,47489,1583
3283803,26.0,26.0,5700000,5700000,0,0,5700000,Null,Null,3283803,27449,11935
3285123,2.0,2.0,81000,81000,0,0,81000,Null,Null,3285123,111461,914
3288283,0.0,0.0,9990000,9990000,0,0,9990000,Null,Null,3288283,200337,17170
3310797,376.0,376.0,257000,219000,38000,15,257000,Null,Null,3310797,41403,2
3332269,484.0,484.0,690000,654000,36000,5,690000,Null,Null,3332269,26689,17170
3416201,1693.0,1693.0,2147000,2147000,0,0,2147000,Null,Null,3416201,156529,1815
3416855,0.0,0.0,8950000,8950000,0,0,8950000,Null,Null,3416855,193837,914
3416895,0.0,0.0,11500000,11500000,0,0,11500000,Null,Null,3416895,193837,914
3416931,0.0,0.0,5900000,5900000,0,0,5900000,Null,Null,3416931,193837,15250
3416939,0.0,0.0,12800000,12800000,0,0,12800000,Null,Null,3416939,193837,15250
3424667,817.0,817.0,2703000,2703000,0,0,2703000,Null,Null,3424667,156529,12876
3447969,2379.0,2379.0,69000,69000,0,0,69000,Null,Null,3447969,290001,1520
3480627,7279.0,7279.0,924000,475000,449000,49,924000,Null,Null,3480627,48077,1883
3490039,24.0,24.0,1044000,1044000,0,0,1044000,Null,Null,3490039,182293,53350
3490097,53.0,53.0,1145000,1145000,0,0,1145000,Null,Null,3490097,182293,3426
3490281,14.0,14.0,509000,509000,0,0,509000,Null,Null,3490281,182293,2347
3490669,2.0,2.0,48000,48000,0,0,48000,Null,Null,3490669,111461,2234
3491069,50.0,50.0,219000,179000,40000,18,219000,Null,Null,3491069,47882,914
3515227,11.0,11.0,19890,19890,0,0,19890,Null,Null,3515227,111461,2266
3518839,5.0,5.0,99000,99000,0,0,99000,Null,Null,3518839,111461,23484
3554627,760.0,760.0,159000,159000,0,0,159000,Null,Null,3554627,21269,1520
3554629,5322.0,5322.0,308700,275000,33700,11,308700,Null,Null,3554629,21269,1613
3554823,1.0,1.0,1400000,1400000,0,0,1400000,Null,Null,3554823,204731,914
3571519,169.0,169.0,375000,375000,0,0,375000,Null,Null,3571519,27464,1805
3606453,314.0,314.0,55000,55000,0,0,55000,Null,Null,3606453,111626,1815
3618787,0.0,0.0,7950000,7155000,795000,10,7950000,Null,Null,3618787,205847,2
3619561,9.0,9.0,22000000,18990000,3010000,14,22000000,Null,Null,3619561,21673,1805
3619821,945.0,945.0,257000,257000,0,0,257000,Null,Null,3619821,18804,1634
3623995,5.0,5.0,299000,299000,0,0,299000,Null,Null,3623995,184409,914
3648517,165.0,165.0,39000,39000,0,0,39000,Null,Null,3648517,111461,1804
3657611,90.0,90.0,389999,389999,0,0,389999,Null,Null,3657611,186747,1805
3658367,915.0,915.0,79000,79000,0,0,79000,Null,Null,3658367,144691,1520
3677753,3067.0,3067.0,2249000,1499000,750000,33,2249000,Null,Null,3677753,199495,1883
3677799,2564.0,2564.0,1669000,999000,670000,40,1669000,Null,Null,3677799,199495,1883
3680661,52.0,52.0,1990000,1890000,100000,5,1990000,Null,Null,3680661,207367,914
3722179,264.0,264.0,87000,58000,29000,33,87000,Null,Null,3722179,47664,17162
3722181,135.0,135.0,87000,58000,29000,33,87000,Null,Null,3722181,47664,17162
3722213,95.0,95.0,187000,141000,46000,25,187000,Null,Null,3722213,47664,13878
3723215,129.0,129.0,77655,77655,0,0,77655,Null,Null,3723215,111461,1520
3756877,0.0,0.0,6700000,6700000,0,0,6700000,Null,Null,3756877,27449,2
3756879,0.0,0.0,8400000,8400000,0,0,8400000,Null,Null,3756879,27449,2
3767899,4.0,4.0,81889,81889,0,0,81889,Null,Null,3767899,111461,2805
3808289,1.0,1.0,3570000,3570000,0,0,3570000,Null,Null,3808289,74999,17170
3813065,150.0,150.0,86000,86000,0,0,86000,Null,Null,3813065,197443,13878
3840463,2577.0,2577.0,150000,150000,0,0,150000,Null,Null,3840463,209879,1520
3855863,879.0,879.0,80000,80000,0,0,80000,Null,Null,3855863,143398,1883
3869627,663.0,663.0,159000,159000,0,0,159000,Null,Null,3869627,202437,1520
3898327,159.0,159.0,198000,179000,19000,10,198000,Null,Null,3898327,47882,914
3898387,72.0,72.0,198999,169000,29999,15,198999,Null,Null,3898387,47882,914
3899543,34.0,34.0,165000,165000,0,0,165000,Null,Null,3899543,47882,914
3915085,68.0,68.0,199000,179000,20000,10,199000,Null,Null,3915085,47882,914
3927949,456.0,456.0,490000,421000,69000,14,490000,Null,Null,3927949,19312,2153
3928213,510.0,510.0,76000,69920,6080,8,76000,Null,Null,3928213,211415,1622
3928217,514.0,514.0,109000,100280,8720,8,109000,Null,Null,3928217,211415,1622
3950335,16.0,16.0,335000,335000,0,0,335000,Null,Null,3950335,114328,13878
3950347,60.0,60.0,269000,173000,96000,36,269000,Null,Null,3950347,114328,17170
3953455,184.0,184.0,115280,115280,0,0,115280,Null,Null,3953455,111461,1815
3973363,5.0,5.0,19000,19000,0,0,19000,Null,Null,3973363,111461,914
3973375,89.0,89.0,79000,79000,0,0,79000,Null,Null,3973375,111461,914
4017899,478.0,478.0,259000,259000,0,0,259000,Null,Null,4017899,206003,1520
4043611,84.0,84.0,95000,95000,0,0,95000,Null,Null,4043611,47882,914
4048043,581.0,581.0,288000,288000,0,0,288000,Null,Null,4048043,18804,1789
4048581,95.0,95.0,559000,559000,0,0,559000,Null,Null,4048581,18804,8061
4059671,74.0,74.0,479000,459000,20000,4,479000,Null,Null,4059671,18804,8061
4064449,1.0,1.0,2150000,2150000,0,0,2150000,Null,Null,4064449,18804,8061
4065031,3.0,3.0,1850000,1850000,0,0,1850000,Null,Null,4065031,18804,8061
4065251,3.0,3.0,2040000,2040000,0,0,2040000,Null,Null,4065251,18804,8061
4065607,9.0,9.0,2350000,2350000,0,0,2350000,Null,Null,4065607,18804,8061
4115555,1.0,1.0,225000,225000,0,0,225000,Null,Null,4115555,411791,13878
4122353,0.0,0.0,4500000,4500000,0,0,4500000,Null,Null,4122353,185127,1520
4125015,6.0,6.0,285000,285000,0,0,285000,Null,Null,4125015,111461,1815
4142447,195.0,195.0,229000,229000,0,0,229000,Null,Null,4142447,47882,914
4252075,21.0,21.0,111900,99000,12900,12,111900,Null,Null,4252075,111461,5267
4265423,0.0,0.0,11116000,11116000,0,0,11116000,Null,Null,4265423,26150,914
4266203,1.0,1.0,10001000,5985000,4016000,40,10001000,Null,Null,4266203,26150,914
4266205,1.0,1.0,10001000,5985000,4016000,40,10001000,Null,Null,4266205,26150,914
4268915,34.0,34.0,11700,11700,0,0,11700,Null,Null,4268915,111461,1832
4279849,2119.0,2119.0,99000,97000,2000,2,99000,Null,Null,4279849,18984,1815
4312979,8072.0,8072.0,346500,240000,106500,31,346500,Null,Null,4312979,18984,1815
4340431,2856.0,2856.0,97800,97800,0,0,97800,Null,Null,4340431,216065,1815
4346331,2493.0,2493.0,450000,375000,75000,17,450000,Null,Null,4346331,50629,1815
4354111,518.0,518.0,150000,96000,54000,36,150000,Null,Null,4354111,148844,1520
4361879,2015.0,2015.0,610000,357000,253000,41,610000,Null,Null,4361879,212575,23290
4365021,100.0,100.0,150000,146000,4000,3,150000,Null,Null,4365021,111461,1883
4365045,133.0,133.0,23960,23960,0,0,23960,Null,Null,4365045,111461,1815
4370315,450.0,450.0,578000,233000,345000,60,578000,Null,Null,4370315,27396,1520
4370339,284.0,284.0,399000,271600,127400,32,399000,Null,Null,4370339,27396,1520
4407201,124.0,124.0,179000,179000,0,0,179000,Null,Null,4407201,47882,914
4423491,566.0,566.0,352800,310000,42800,12,352800,Null,Null,4423491,47803,1520
4423687,373.0,373.0,365400,293000,72400,20,365400,Null,Null,4423687,47803,1520
4424813,785.0,785.0,332000,332000,0,0,332000,Null,Null,4424813,47615,1520
4438819,232.0,232.0,49990,48000,1990,4,49990,Null,Null,4438819,111461,1815
4444147,766.0,766.0,52000,31000,21000,40,52000,Null,Null,4444147,110666,1520
4463195,0.0,0.0,12000000,12000000,0,0,12000000,Null,Null,4463195,217727,2
4465309,423.0,423.0,39000,37000,2000,5,39000,Null,Null,4465309,191669,1815
4473753,52.0,52.0,95000,95000,0,0,95000,Null,Null,4473753,111461,1883
4482101,133.0,133.0,13000,13000,0,0,13000,Null,Null,4482101,111461,1815
4482143,115.0,115.0,19500,18000,1500,8,19500,Null,Null,4482143,111461,1815
4482993,3259.0,3259.0,78000,72540,5460,7,78000,Null,Null,4482993,63747,1883
4494843,2432.0,2432.0,850000,553000,297000,35,850000,Null,Null,4494843,218061,5905
4525605,124.0,124.0,28000,28000,0,0,28000,Null,Null,4525605,111461,914
4526253,5.0,5.0,16000,16000,0,0,16000,Null,Null,4526253,505165,914
4526319,0.0,0.0,16000,16000,0,0,16000,Null,Null,4526319,505165,914
4526323,7.0,7.0,16000,16000,0,0,16000,Null,Null,4526323,505165,914
4526327,3.0,3.0,16000,16000,0,0,16000,Null,Null,4526327,111461,914
4526331,0.0,0.0,16000,16000,0,0,16000,Null,Null,4526331,111461,15250
4526339,0.0,0.0,16000,16000,0,0,16000,Null,Null,4526339,505165,15250
4526343,12.0,12.0,16000,16000,0,0,16000,Null,Null,4526343,505165,914
4526347,1.0,1.0,16000,16000,0,0,16000,Null,Null,4526347,505165,914
4526351,8.0,8.0,16000,16000,0,0,16000,Null,Null,4526351,505165,914
4526355,0.0,0.0,16000,16000,0,0,16000,Null,Null,4526355,505165,15250
4526359,16.0,16.0,16000,16000,0,0,16000,Null,Null,4526359,111461,914
4526363,18.0,18.0,16000,16000,0,0,16000,Null,Null,4526363,505165,914
4526367,3.0,3.0,16000,16000,0,0,16000,Null,Null,4526367,505165,914
4526371,3.0,3.0,16000,16000,0,0,16000,Null,Null,4526371,505165,914
4526375,0.0,0.0,16000,16000,0,0,16000,Null,Null,4526375,505165,15250
4526379,2.0,2.0,16000,16000,0,0,16000,Null,Null,4526379,505165,914
4526387,0.0,0.0,16000,16000,0,0,16000,Null,Null,4526387,111461,15250
4526391,22.0,22.0,16000,16000,0,0,16000,Null,Null,4526391,111461,914
4526395,15.0,15.0,16000,16000,0,0,16000,Null,Null,4526395,111461,15250
4526399,15.0,15.0,16000,16000,0,0,16000,Null,Null,4526399,111461,914
4526403,8.0,8.0,16000,16000,0,0,16000,Null,Null,4526403,505165,914
4526407,4.0,4.0,16000,16000,0,0,16000,Null,Null,4526407,505165,914
4526411,0.0,0.0,16000,16000,0,0,16000,Null,Null,4526411,111461,15250
4526415,13.0,13.0,16000,16000,0,0,16000,Null,Null,4526415,111461,914
4526423,0.0,0.0,16000,16000,0,0,16000,Null,Null,4526423,505165,914
4526427,4.0,4.0,16000,16000,0,0,16000,Null,Null,4526427,111461,914
4526431,10.0,10.0,16000,16000,0,0,16000,Null,Null,4526431,505165,914
4526435,5.0,5.0,25000,25000,0,0,25000,Null,Null,4526435,111461,914
4526439,0.0,0.0,16000,16000,0,0,16000,Null,Null,4526439,111461,15250
4526443,1.0,1.0,15000,15000,0,0,15000,Null,Null,4526443,111461,914
4526447,21.0,21.0,16000,16000,0,0,16000,Null,Null,4526447,111461,914
4526455,20.0,20.0,16000,16000,0,0,16000,Null,Null,4526455,111461,914
4539349,117.0,117.0,12910,12910,0,0,12910,Null,Null,4539349,111461,1815
4541091,0.0,0.0,7452000,6210000,1242000,17,7452000,Null,Null,4541091,174699,914
4546537,29.0,29.0,215000,215000,0,0,215000,Null,Null,4546537,111461,914
4581755,46.0,46.0,246199,246199,0,0,246199,Null,Null,4581755,193677,1883
4581757,520.0,520.0,303450,303450,0,0,303450,Null,Null,4581757,193677,1883
4586127,31.0,31.0,6000,6000,0,0,6000,Null,Null,4586127,111461,51698
4612027,399.0,399.0,95000,95000,0,0,95000,Null,Null,4612027,214305,1520
4613079,1.0,1.0,165000,165000,0,0,165000,Null,Null,4613079,47803,11897
4615573,7.0,7.0,141900,141900,0,0,141900,Null,Null,4615573,154319,15250
4615683,10.0,10.0,129000,129000,0,0,129000,Null,Null,4615683,154319,914
4621783,106.0,106.0,90000,90000,0,0,90000,Null,Null,4621783,111461,23588
4630783,7748.0,7748.0,506000,250000,256000,51,506000,Null,Null,4630783,48077,1883
4693945,53.0,53.0,7900,7900,0,0,7900,Null,Null,4693945,111461,1815
4719849,0.0,0.0,690000,690000,0,0,690000,Null,Null,4719849,46363,914
4723053,1596.0,1596.0,125000,125000,0,0,125000,Null,Null,4723053,197443,13878
4734883,1.0,1.0,61000,61000,0,0,61000,Null,Null,4734883,111461,914
4783285,307.0,307.0,1187000,972000,215000,18,1187000,Null,Null,4783285,18984,1815
4794275,195.0,195.0,25000,16000,9000,36,25000,Null,Null,4794275,111461,1815
4810215,29.0,29.0,25900,25900,0,0,25900,Null,Null,4810215,111461,1811
4889007,694.0,694.0,38700,38700,0,0,38700,Null,Null,4889007,150004,1804
4897521,26732.0,26732.0,250000,250000,0,0,250000,Null,Null,4897521,20215,1804
4898377,5.0,5.0,415000,352750,62250,15,415000,Null,Null,4898377,26150,914
4898383,2.0,2.0,415000,323700,91300,22,415000,Null,Null,4898383,26150,914
4898407,13.0,13.0,415000,352750,62250,15,415000,Null,Null,4898407,26150,914
4932177,0.0,0.0,15000,15000,0,0,15000,Null,Null,4932177,505165,15320
4932185,2.0,2.0,15000,15000,0,0,15000,Null,Null,4932185,505165,914
4932193,0.0,0.0,57000,57000,0,0,57000,Null,Null,4932193,111461,914
4932197,0.0,0.0,16500,16500,0,0,16500,Null,Null,4932197,505165,15320
4932203,0.0,0.0,47000,47000,0,0,47000,Null,Null,4932203,111461,914
4935951,302.0,302.0,150000,150000,0,0,150000,Null,Null,4935951,111461,53054
4939061,365.0,365.0,29000,29000,0,0,29000,Null,Null,4939061,111461,1883
4992159,264.0,264.0,17366,8683,8683,50,17366,Null,Null,4992159,111461,1815
4992325,432.0,432.0,340000,340000,0,0,340000,Null,Null,4992325,63747,1883
4994301,861.0,861.0,1700000,1150000,550000,32,1700000,Null,Null,4994301,51302,1883
4995493,1474.0,1474.0,2300000,1780000,520000,23,2300000,Null,Null,4995493,51302,1883
5008167,800.0,800.0,120000,120000,0,0,120000,Null,Null,5008167,206003,1520
5010551,1140.0,1140.0,132000,132000,0,0,132000,Null,Null,5010551,196829,1520
5043669,71.0,71.0,45000,37100,7900,18,45000,Null,Null,5043669,222917,2266
5050641,39.0,39.0,115000,115000,0,0,115000,Null,Null,5050641,111461,1815
5079403,4.0,4.0,9700,9700,0,0,9700,Null,Null,5079403,111461,1815
5096207,847.0,847.0,85000,80750,4250,5,85000,Null,Null,5096207,111461,1815
5112461,18.0,18.0,6450000,6450000,0,0,6450000,Null,Null,5112461,223557,1520
5127691,27.0,27.0,550000,550000,0,0,550000,Null,Null,5127691,223671,914
5136709,509.0,509.0,336000,209000,127000,38,336000,Null,Null,5136709,223749,1520
5146283,10.0,10.0,699000,639000,60000,9,699000,Null,Null,5146283,31627,1883
5161511,1.0,1.0,6600000,6000000,600000,9,6600000,Null,Null,5161511,27481,1520
5164377,0.0,0.0,18137000,7254800,10882200,60,18137000,Null,Null,5164377,26150,5385
5164387,89.0,89.0,492000,383760,108240,22,492000,Null,Null,5164387,26150,914
5199485,0.0,0.0,2539000,2539000,0,0,2539000,Null,Null,5199485,26150,914
5219177,11.0,11.0,6900,6900,0,0,6900,Null,Null,5219177,212461,1815
5325125,578.0,578.0,52000,52000,0,0,52000,Null,Null,5325125,48381,3422
5358057,1.0,1.0,198000,198000,0,0,198000,Null,Null,5358057,154319,15318
5369943,1.0,1.0,176000,176000,0,0,176000,Null,Null,5369943,154319,15318
5371673,37.0,37.0,240000,240000,0,0,240000,Null,Null,5371673,26675,1815
5409161,50.0,50.0,9700,9700,0,0,9700,Null,Null,5409161,111461,5566
5411961,36.0,36.0,14000,14000,0,0,14000,Null,Null,5411961,111461,1805
5417741,84.0,84.0,99000,99000,0,0,99000,Null,Null,5417741,48381,1520
5429807,159.0,159.0,50000,50000,0,0,50000,Null,Null,5429807,111461,53074
5438391,143.0,143.0,99000,79000,20000,20,99000,Null,Null,5438391,47882,914
5455343,8.0,8.0,95000,95000,0,0,95000,Null,Null,5455343,111461,27180
5469303,556.0,556.0,480000,400000,80000,17,480000,Null,Null,5469303,50629,1815
5478347,14.0,14.0,198000,198000,0,0,198000,Null,Null,5478347,154319,914
5504295,753.0,753.0,699000,430000,269000,38,699000,Null,Null,5504295,25422,1520
5511229,69.0,69.0,15900,15900,0,0,15900,Null,Null,5511229,111461,1815
5522507,26741.0,26741.0,120000,108000,12000,10,120000,Null,Null,5522507,86206,11605
5535533,91.0,91.0,788000,788000,0,0,788000,Null,Null,5535533,47803,1520
5560235,12052.0,12052.0,93000,85000,8000,9,93000,Null,Null,5560235,21261,1631
5730933,1213.0,1213.0,567000,499000,68000,12,567000,Null,Null,5730933,47803,1520
5736583,193.0,193.0,67900,67900,0,0,67900,Null,Null,5736583,111461,1883
5739193,43.0,43.0,59500,59500,0,0,59500,Null,Null,5739193,111461,1883
5744713,141.0,141.0,320000,320000,0,0,320000,Null,Null,5744713,47425,1520
5750803,506.0,506.0,529200,417000,112200,21,529200,Null,Null,5750803,47803,1520
5812981,77.0,77.0,697000,697000,0,0,697000,Null,Null,5812981,18984,4880
5852729,30.0,30.0,769900,769900,0,0,769900,Null,Null,5852729,111461,23540
5862639,57.0,57.0,73000,43000,30000,41,73000,Null,Null,5862639,243693,1815
5868813,5.0,5.0,6990000,6990000,0,0,6990000,Null,Null,5868813,229213,1795
5902347,964.0,964.0,99000,85000,14000,14,99000,Null,Null,5902347,112887,17170
5902685,52646.0,52646.0,68000,59000,9000,13,68000,Null,Null,5902685,112887,1583
5904663,1434.0,1434.0,190000,154000,36000,19,190000,Null,Null,5904663,243693,1815
5908851,10.0,10.0,624000,425000,199000,32,624000,Null,Null,5908851,243693,1815
5909195,38.0,38.0,8900,8900,0,0,8900,Null,Null,5909195,111461,1815
5911429,0.0,0.0,141000,129000,12000,9,141000,Null,Null,5911429,243693,1815
5911431,48.0,48.0,214000,199000,15000,7,214000,Null,Null,5911431,243693,1815
5913881,154.0,154.0,39000,39000,0,0,39000,Null,Null,5913881,19107,1837
5980477,977.0,977.0,129000,129000,0,0,129000,Null,Null,5980477,111461,23282
5980833,43.0,43.0,149000,149000,0,0,149000,Null,Null,5980833,243693,1815
5981267,2.0,2.0,209000,175000,34000,16,209000,Null,Null,5981267,243693,1815
5981431,553.0,553.0,187000,187000,0,0,187000,Null,Null,5981431,111461,23282
5984995,142.0,142.0,107000,107000,0,0,107000,Null,Null,5984995,243693,1815
5986195,53.0,53.0,139000,85000,54000,39,139000,Null,Null,5986195,243693,1815
5986499,260.0,260.0,142000,110000,32000,23,142000,Null,Null,5986499,243693,1815
5987217,122.0,122.0,260000,260000,0,0,260000,Null,Null,5987217,243693,1815
5995255,106.0,106.0,699000,699000,0,0,699000,Null,Null,5995255,25277,1815
6006483,281.0,281.0,80000,68000,12000,15,80000,Null,Null,6006483,243693,1815
6009539,261.0,261.0,139000,99000,40000,29,139000,Null,Null,6009539,243693,1815
6012693,117.0,117.0,125000,90000,35000,28,125000,Null,Null,6012693,243693,1815
6019221,1.0,1.0,860000,860000,0,0,860000,Null,Null,6019221,159441,914
6076917,307.0,307.0,200000,140000,60000,30,200000,Null,Null,6076917,243693,1815
6076977,1.0,1.0,264000,185000,79000,30,264000,Null,Null,6076977,243693,1815
6077793,174.0,174.0,164000,159000,5000,3,164000,Null,Null,6077793,230983,1883
6077797,152.0,152.0,369103,368103,1000,0,369103,Null,Null,6077797,230983,2154
6132643,6.0,6.0,550000,550000,0,0,550000,Null,Null,6132643,184409,914
6132751,9.0,9.0,420000,420000,0,0,420000,Null,Null,6132751,184409,914
6166327,2.0,2.0,119900,119900,0,0,119900,Null,Null,6166327,111461,5531
6167533,305.0,305.0,39000,39000,0,0,39000,Null,Null,6167533,191669,1815
6187133,125.0,125.0,18000,18000,0,0,18000,Null,Null,6187133,111461,914
6211215,147.0,147.0,99000,95000,4000,4,99000,Null,Null,6211215,166419,1815
6215373,0.0,0.0,5500000,4400000,1100000,20,5500000,Null,Null,6215373,231355,53350
6216897,5.0,5.0,89000,89000,0,0,89000,Null,Null,6216897,166419,1815
6256843,22.0,22.0,57499,57499,0,0,57499,Null,Null,6256843,111461,1883
6300477,650.0,650.0,36000,36000,0,0,36000,Null,Null,6300477,111461,2488
6306615,2.0,2.0,6050000,4840000,1210000,20,6050000,Null,Null,6306615,231355,17170
6330493,3.0,3.0,275000,275000,0,0,275000,Null,Null,6330493,154319,15318
6369373,2.0,2.0,11800000,9440000,2360000,20,11800000,Null,Null,6369373,231355,17170
6376015,421.0,421.0,136000,83000,53000,39,136000,Null,Null,6376015,243693,1815
6393939,8.0,8.0,126500,126500,0,0,126500,Null,Null,6393939,154319,15318
6418657,6.0,6.0,262900,262900,0,0,262900,Null,Null,6418657,154319,914
6418665,191.0,191.0,170000,170000,0,0,170000,Null,Null,6418665,111461,23258
6430923,2391.0,2391.0,57000,50500,6500,11,57000,Null,Null,6430923,156143,17162
6431175,1010.0,1010.0,1198000,799000,399000,33,1198000,Null,Null,6431175,18984,3428
6454421,2.0,2.0,9043000,6459000,2584000,29,9043000,Null,Null,6454421,26150,914
6478409,0.0,0.0,15954000,15954000,0,0,15954000,Null,Null,6478409,153444,1805
6478969,65.0,65.0,200000,200000,0,0,200000,Null,Null,6478969,148818,4451
6485679,211.0,211.0,73000,73000,0,0,73000,Null,Null,6485679,111461,53074
6509837,0.0,0.0,93777,93777,0,0,93777,Null,Null,6509837,243693,1815
6522905,440.0,440.0,159000,128000,31000,19,159000,Null,Null,6522905,231297,1520
6546701,214.0,214.0,12000,12000,0,0,12000,Null,Null,6546701,145037,1520
6583921,5760.0,5760.0,280000,155000,125000,45,280000,Null,Null,6583921,65071,13878
6597807,366.0,366.0,2999000,2999000,0,0,2999000,Null,Null,6597807,147856,1789
6668775,2.0,2.0,6800000,5440000,1360000,20,6800000,Null,Null,6668775,231355,17170
6675373,266.0,266.0,329000,294000,35000,11,329000,Null,Null,6675373,21279,1520
6706511,157.0,157.0,18000,9270,8730,49,18000,Null,Null,6706511,111461,1815
6710595,30.0,30.0,9000,9000,0,0,9000,Null,Null,6710595,111461,1883
6715491,2.0,2.0,154000,154000,0,0,154000,Null,Null,6715491,154319,15250
6719031,44.0,44.0,17900,17000,900,5,17900,Null,Null,6719031,111461,2153
6719715,35.0,35.0,17381,17381,0,0,17381,Null,Null,6719715,111461,2266
6731165,211.0,211.0,420400,357000,63400,15,420400,Null,Null,6731165,41391,1883
6738207,444.0,444.0,1280000,768000,512000,40,1280000,Null,Null,6738207,33203,8168
6761497,2054.0,2054.0,160000,133000,27000,17,160000,Null,Null,6761497,232723,1520
6764159,69.0,69.0,26000,26000,0,0,26000,Null,Null,6764159,111461,1815
6775663,119.0,119.0,81500,81500,0,0,81500,Null,Null,6775663,111461,1883
6804679,380.0,380.0,115000,100000,15000,13,115000,Null,Null,6804679,166773,1520
6816541,325.0,325.0,71000,71000,0,0,71000,Null,Null,6816541,111461,3515
6819967,30.0,30.0,3600000,3600000,0,0,3600000,Null,Null,6819967,237567,1520
6847217,35.0,35.0,48500,48500,0,0,48500,Null,Null,6847217,111461,53190
6851791,3.0,3.0,19500,19500,0,0,19500,Null,Null,6851791,111461,914
6880649,1478.0,1478.0,329000,294000,35000,11,329000,Null,Null,6880649,21279,17170
6884515,716.0,716.0,239000,185000,54000,23,239000,Null,Null,6884515,186549,1583
6919467,191.0,191.0,699000,699000,0,0,699000,Null,Null,6919467,25277,1815
6954533,915.0,915.0,393000,393000,0,0,393000,Null,Null,6954533,48945,1520
6971185,1686.0,1686.0,125000,125000,0,0,125000,Null,Null,6971185,209333,1520
6997447,4.0,4.0,235000,235000,0,0,235000,Null,Null,6997447,111461,914
6998089,42.0,42.0,3380000,3380000,0,0,3380000,Null,Null,6998089,239653,11893
7005355,1560.0,1560.0,69000,57000,12000,17,69000,Null,Null,7005355,186605,53190
7028945,45.0,45.0,199000,199000,0,0,199000,Null,Null,7028945,239943,914
7073667,36.0,36.0,124000,124000,0,0,124000,Null,Null,7073667,217777,1520
7090463,1479.0,1479.0,1400000,890000,510000,36,1400000,Null,Null,7090463,218165,1805
7099307,6846.0,6846.0,21000,21000,0,0,21000,Null,Null,7099307,111461,1883
7134179,27.0,27.0,9400000,7036000,2364000,25,9400000,Null,Null,7134179,242001,1520
7140249,367.0,367.0,69000,69000,0,0,69000,Null,Null,7140249,111461,1815
7159593,176.0,176.0,44000,44000,0,0,44000,Null,Null,7159593,111461,2154
7161919,0.0,0.0,139000,139000,0,0,139000,Null,Null,7161919,111461,914
7168697,2.0,2.0,10140000,8450000,1690000,17,10140000,Null,Null,7168697,174699,914
7168943,1.0,1.0,9410000,7057500,2352500,25,9410000,Null,Null,7168943,174699,914
7169023,0.0,0.0,8600000,6450000,2150000,25,8600000,Null,Null,7169023,174699,914
7169079,1.0,1.0,8600000,6450000,2150000,25,8600000,Null,Null,7169079,174699,914
7185317,0.0,0.0,10020000,8350000,1670000,17,10020000,Null,Null,7185317,174699,914
7191189,114.0,114.0,165000,165000,0,0,165000,Null,Null,7191189,159427,1520
7198079,84.0,84.0,286000,230000,56000,20,286000,Null,Null,7198079,243693,1815
7202353,136.0,136.0,690000,369000,321000,47,690000,Null,Null,7202353,79599,1883
7202377,2260.0,2260.0,660000,544000,116000,18,660000,Null,Null,7202377,79599,1883
7219673,0.0,0.0,11290000,11290000,0,0,11290000,Null,Null,7219673,239655,1805
7221847,4.0,4.0,795000,795000,0,0,795000,Null,Null,7221847,41048,1883
7222191,0.0,0.0,1050000,945000,105000,10,1050000,Null,Null,7222191,182293,17170
7222235,1.0,1.0,710000,710000,0,0,710000,Null,Null,7222235,182293,17170
7241323,762.0,762.0,8900,8900,0,0,8900,Null,Null,7241323,21253,1601
7252483,0.0,0.0,14000,14000,0,0,14000,Null,Null,7252483,111461,1815
7255881,2996.0,2996.0,453600,364000,89600,20,453600,Null,Null,7255881,47615,1520
7286185,712.0,712.0,200000,150000,50000,25,200000,Null,Null,7286185,50629,1815
7286397,2.0,2.0,9000,9000,0,0,9000,Null,Null,7286397,111461,1815
7287555,19.0,19.0,9000,9000,0,0,9000,Null,Null,7287555,111461,1815
7319063,4.0,4.0,399000,255000,144000,36,399000,Null,Null,7319063,182293,8206
7331189,808.0,808.0,165000,165000,0,0,165000,Null,Null,7331189,200189,1520
7351929,0.0,0.0,12800,12000,800,6,12800,Null,Null,7351929,111461,1520
7352431,3348.0,3348.0,330000,330000,0,0,330000,Null,Null,7352431,221187,1613
7353673,33.0,33.0,50000,50000,0,0,50000,Null,Null,7353673,111461,23048
7382033,0.0,0.0,4550000,4550000,0,0,4550000,Null,Null,7382033,199801,1520
7382055,0.0,0.0,8900000,8900000,0,0,8900000,Null,Null,7382055,199801,1520
7382105,0.0,0.0,7158000,7158000,0,0,7158000,Null,Null,7382105,199801,1520
7383977,0.0,0.0,3700000,3700000,0,0,3700000,Null,Null,7383977,199801,1520
7405805,271.0,271.0,38900,38900,0,0,38900,Null,Null,7405805,21653,1815
7447383,4.0,4.0,1990000,1990000,0,0,1990000,Null,Null,7447383,143976,1796
7458423,396.0,396.0,150000,149000,1000,1,150000,Null,Null,7458423,213319,1520
7466201,207.0,207.0,105000,105000,0,0,105000,Null,Null,7466201,244095,2
7493151,767.0,767.0,596000,329000,267000,45,596000,Null,Null,7493151,231297,1520
7529377,12.0,12.0,57100,57100,0,0,57100,Null,Null,7529377,111461,1811
7530909,10.0,10.0,16000,16000,0,0,16000,Null,Null,7530909,111461,914
7548593,4754.0,4754.0,850000,649000,201000,24,850000,Null,Null,7548593,246571,1520
7555917,93.0,93.0,275968,137984,137984,50,275968,Null,Null,7555917,143256,1815
7579903,32.0,32.0,25000,25000,0,0,25000,Null,Null,7579903,111461,1815
7585976,354.0,354.0,45000,29000,16000,36,45000,Null,Null,7585976,158915,23800
7588629,187.0,187.0,250000,187000,63000,25,250000,Null,Null,7588629,173547,8371
7589201,205.0,205.0,38000,38000,0,0,38000,Null,Null,7589201,156415,1883
7607094,0.0,0.0,49980000,49980000,0,0,49980000,Null,Null,7607094,111461,1883
7607112,0.0,0.0,40990000,40990000,0,0,40990000,Null,Null,7607112,111461,23058
7609680,1232.0,1232.0,51000,46920,4080,8,51000,Null,Null,7609680,211415,1520
7626419,41.0,41.0,115000,115000,0,0,115000,Null,Null,7626419,19107,1838
7635008,1178.0,1178.0,60000,58000,2000,3,60000,Null,Null,7635008,111461,1883
7644410,330.0,330.0,99000,99000,0,0,99000,Null,Null,7644410,111461,1815
7645661,566.0,566.0,455000,409000,46000,10,455000,Null,Null,7645661,26689,1520
7645854,96.0,96.0,129000,123000,6000,5,129000,Null,Null,7645854,111461,1815
7649390,27.0,27.0,199000,199000,0,0,199000,Null,Null,7649390,47882,914
7663929,159.0,159.0,159000,155000,4000,3,159000,Null,Null,7663929,47882,914
7690576,71.0,71.0,18088,18088,0,0,18088,Null,Null,7690576,111461,1815
7690641,2178.0,2178.0,74000,74000,0,0,74000,Null,Null,7690641,231973,1520
7699060,1017.0,1017.0,866000,429000,437000,50,866000,Null,Null,7699060,48077,2136
7699062,1984.0,1984.0,567000,289000,278000,49,567000,Null,Null,7699062,48077,1984
7699064,24.0,24.0,776000,449000,327000,42,776000,Null,Null,7699064,48077,1984
7699066,0.0,0.0,879000,439500,439500,50,879000,Null,Null,7699066,48077,1883
7718059,686.0,686.0,179000,179000,0,0,179000,Null,Null,7718059,196271,1815
7727580,88.0,88.0,8900,8900,0,0,8900,Null,Null,7727580,21253,1601
7730873,50.0,50.0,8900,8900,0,0,8900,Null,Null,7730873,21253,1601
7734288,453.0,453.0,240000,240000,0,0,240000,Null,Null,7734288,26675,1815
7736587,142.0,142.0,17150,17150,0,0,17150,Null,Null,7736587,111461,1815
7736645,21.0,21.0,18800,18800,0,0,18800,Null,Null,7736645,111461,1815
7740152,359.0,359.0,699000,699000,0,0,699000,Null,Null,7740152,25277,1815
7771288,19.0,19.0,15000,15000,0,0,15000,Null,Null,7771288,505165,914
7771401,10.0,10.0,15000,15000,0,0,15000,Null,Null,7771401,505165,914
7777247,4341.0,4341.0,295000,211000,84000,28,295000,Null,Null,7777247,238861,1520
7796951,2.0,2.0,120000,120000,0,0,120000,Null,Null,7796951,111461,914
7799222,944.0,944.0,45000,45000,0,0,45000,Null,Null,7799222,111461,914
7804969,348.0,348.0,48000,35000,13000,27,48000,Null,Null,7804969,111461,914
7806236,22.0,22.0,200000,200000,0,0,200000,Null,Null,7806236,111461,914
7810517,72.0,72.0,14900,14000,900,6,14900,Null,Null,7810517,111461,1815
7837104,4.0,4.0,130900,130900,0,0,130900,Null,Null,7837104,111461,15250
7837906,3.0,3.0,129000,129000,0,0,129000,Null,Null,7837906,111461,15250
7839826,0.0,0.0,4230000,3384000,846000,20,4230000,Null,Null,7839826,231355,8227
7855225,2.0,2.0,12500000,12500000,0,0,12500000,Null,Null,7855225,50331,7075
7857559,0.0,0.0,7980000,7102200,877800,11,7980000,Null,Null,7857559,205847,1520
7877925,1.0,1.0,129000,129000,0,0,129000,Null,Null,7877925,111461,5995
7922209,0.0,0.0,700000,700000,0,0,700000,Null,Null,7922209,144477,1979
7934954,33.0,33.0,16900,16900,0,0,16900,Null,Null,7934954,111461,1815
7937090,162.0,162.0,44000,43120,880,2,44000,Null,Null,7937090,111461,1815
7939102,58.0,58.0,45900,45900,0,0,45900,Null,Null,7939102,111461,1815
7967540,302.0,302.0,175000,175000,0,0,175000,Null,Null,7967540,21276,2
7967595,1171.0,1171.0,188000,176000,12000,6,188000,Null,Null,7967595,21278,1520
7973338,81.0,81.0,170000,170000,0,0,170000,Null,Null,7973338,111461,8602
7979047,532.0,532.0,45000,45000,0,0,45000,Null,Null,7979047,251107,11837
7980446,456.0,456.0,99000,99000,0,0,99000,Null,Null,7980446,251107,1520
7991329,2.0,2.0,38746,38746,0,0,38746,Null,Null,7991329,111461,53054
8004965,29.0,29.0,69000,69000,0,0,69000,Null,Null,8004965,21651,1815
8011746,1568.0,1568.0,219000,153000,66000,30,219000,Null,Null,8011746,206855,1520
8031566,453.0,453.0,34900,34900,0,0,34900,Null,Null,8031566,111461,6061
8046718,114.0,114.0,79000,75050,3950,5,79000,Null,Null,8046718,111461,1815
8057337,72.0,72.0,630000,500000,130000,21,630000,Null,Null,8057337,25229,1883
8057340,5500.0,5500.0,98280,86000,12280,12,98280,Null,Null,8057340,208105,1520
8059462,0.0,0.0,8050000,8050000,0,0,8050000,Null,Null,8059462,25502,914
8059464,2.0,2.0,6585000,6585000,0,0,6585000,Null,Null,8059464,25502,914
8059669,0.0,0.0,5760000,5760000,0,0,5760000,Null,Null,8059669,25502,914
8061505,1.0,1.0,5785000,5785000,0,0,5785000,Null,Null,8061505,25502,914
8061515,0.0,0.0,5785000,5785000,0,0,5785000,Null,Null,8061515,25502,914
8061517,0.0,0.0,5785000,5785000,0,0,5785000,Null,Null,8061517,25502,914
8061527,0.0,0.0,8450000,8450000,0,0,8450000,Null,Null,8061527,25502,914
8061529,0.0,0.0,9050000,9050000,0,0,9050000,Null,Null,8061529,25502,914
8061531,0.0,0.0,9050000,9050000,0,0,9050000,Null,Null,8061531,25502,914
8072407,21.0,21.0,19000,19000,0,0,19000,Null,Null,8072407,505165,914
8080856,0.0,0.0,74990000,74990000,0,0,74990000,Null,Null,8080856,250865,53074
8094477,305.0,305.0,29778,29778,0,0,29778,Null,Null,8094477,198965,1520
8094768,2935.0,2935.0,475000,439000,36000,8,475000,Null,Null,8094768,47489,1520
8100632,0.0,0.0,100000,100000,0,0,100000,Null,Null,8100632,111461,914
8100742,70.0,70.0,19000,19000,0,0,19000,Null,Null,8100742,111461,914
8109438,36.0,36.0,36000,36000,0,0,36000,Null,Null,8109438,111461,914
8122661,0.0,0.0,20250000,20250000,0,0,20250000,Null,Null,8122661,156529,1815
8130527,435.0,435.0,100000,100000,0,0,100000,Null,Null,8130527,47664,1520
8130816,44.0,44.0,79720,79720,0,0,79720,Null,Null,8130816,111461,1815
8141095,108.0,108.0,89000,63000,26000,29,89000,Null,Null,8141095,48077,23282
8142219,339.0,339.0,185000,170200,14800,8,185000,Null,Null,8142219,211415,1622
8142225,627.0,627.0,105000,105000,0,0,105000,Null,Null,8142225,211415,1622
8142283,1759.0,1759.0,100000,100000,0,0,100000,Null,Null,8142283,211415,1622
8142287,492.0,492.0,80000,73600,6400,8,80000,Null,Null,8142287,211415,1622
8142293,737.0,737.0,65000,65000,0,0,65000,Null,Null,8142293,211415,1622
8142299,1102.0,1102.0,52000,47840,4160,8,52000,Null,Null,8142299,211415,1622
8142301,1285.0,1285.0,52000,47840,4160,8,52000,Null,Null,8142301,211415,1622
8148263,33.0,33.0,19000,19000,0,0,19000,Null,Null,8148263,111461,1815
8159949,65.0,65.0,74900,74900,0,0,74900,Null,Null,8159949,19071,1829
8173313,126.0,126.0,39000,37000,2000,5,39000,Null,Null,8173313,191669,1815
8179317,15.0,15.0,230000,230000,0,0,230000,Null,Null,8179317,18804,23048
8190056,1177.0,1177.0,7000,1000,6000,86,7000,Null,Null,8190056,111461,1815
8209696,382.0,382.0,189000,189000,0,0,189000,Null,Null,8209696,21651,1804
8211876,45.0,45.0,42888,42888,0,0,42888,Null,Null,8211876,211415,2
8211888,434.0,434.0,40000,36800,3200,8,40000,Null,Null,8211888,211415,2
8211893,242.0,242.0,30000,27600,2400,8,30000,Null,Null,8211893,211415,1622
8211897,147.0,147.0,30000,27600,2400,8,30000,Null,Null,8211897,211415,1622
8262429,0.0,0.0,6400000,6400000,0,0,6400000,Null,Null,8262429,25502,914
8264001,0.0,0.0,8500000,8500000,0,0,8500000,Null,Null,8264001,25502,5385
8265511,4.0,4.0,21999,21999,0,0,21999,Null,Null,8265511,111461,53074
8265939,44.0,44.0,117998,58999,58999,50,117998,Null,Null,8265939,111461,4451
8266299,1.0,1.0,12485000,12485000,0,0,12485000,Null,Null,8266299,25502,914
8269203,13.0,13.0,48000,45600,2400,5,48000,Null,Null,8269203,111461,914
8273645,328.0,328.0,72000,52000,20000,28,72000,Null,Null,8273645,243693,1815
8275109,10.0,10.0,10959,10959,0,0,10959,Null,Null,8275109,111461,1815
8275298,54.0,54.0,49000,49000,0,0,49000,Null,Null,8275298,111461,1815
8277742,31.0,31.0,199000,199000,0,0,199000,Null,Null,8277742,47882,914
8281099,160.0,160.0,249000,249000,0,0,249000,Null,Null,8281099,243693,1815
8286521,249.0,249.0,31900,31900,0,0,31900,Null,Null,8286521,111461,1815
8290581,12.0,12.0,2500000,2200000,300000,12,2500000,Null,Null,8290581,173547,914
8290598,187.0,187.0,1190000,1190000,0,0,1190000,Null,Null,8290598,18641,7078
8292436,2.0,2.0,1400000,1150000,250000,18,1400000,Null,Null,8292436,173547,15250
8293587,20.0,20.0,2800000,2400000,400000,14,2800000,Null,Null,8293587,173547,914
8294726,621.0,621.0,148900,148900,0,0,148900,Null,Null,8294726,111461,28398
8294948,178.0,178.0,585000,560000,25000,4,585000,Null,Null,8294948,259827,11845
8295103,184.0,184.0,1350000,1200000,150000,11,1350000,Null,Null,8295103,173547,8371
8299504,543.0,543.0,389000,389000,0,0,389000,Null,Null,8299504,25277,1815
8307337,28.0,28.0,120000,120000,0,0,120000,Null,Null,8307337,111461,914
8309574,401.0,401.0,199000,160000,39000,20,199000,Null,Null,8309574,254629,1811
8315059,0.0,0.0,12100000,12100000,0,0,12100000,Null,Null,8315059,25502,914
8317419,0.0,0.0,13885000,13885000,0,0,13885000,Null,Null,8317419,25502,914
8321398,0.0,0.0,10500000,10500000,0,0,10500000,Null,Null,8321398,25502,914
8338052,87.0,87.0,1386000,538000,848000,61,1386000,Null,Null,8338052,145335,1520
8378707,25.0,25.0,9597,9597,0,0,9597,Null,Null,8378707,111461,1815
8378816,1228.0,1228.0,831600,574000,257600,31,831600,Null,Null,8378816,18792,1805
8389455,716.0,716.0,200000,173000,27000,14,200000,Null,Null,8389455,243693,1815
8389612,10.0,10.0,18000,18000,0,0,18000,Null,Null,8389612,111461,1815
8411901,0.0,0.0,9685000,9685000,0,0,9685000,Null,Null,8411901,25502,914
8420079,0.0,0.0,8170000,8170000,0,0,8170000,Null,Null,8420079,25502,914
8420780,0.0,0.0,7360000,7360000,0,0,7360000,Null,Null,8420780,25502,914
8421677,0.0,0.0,11600000,11600000,0,0,11600000,Null,Null,8421677,25502,5385
8432262,203.0,203.0,57500,57500,0,0,57500,Null,Null,8432262,200673,1815
8543542,52.0,52.0,19000,19000,0,0,19000,Null,Null,8543542,111461,28480
8557046,0.0,0.0,10400000,5850000,4550000,44,10400000,Null,Null,8557046,174699,914
8557065,0.0,0.0,9990000,6993000,2997000,30,9990000,Null,Null,8557065,174699,914
8557074,0.0,0.0,20410000,20410000,0,0,20410000,Null,Null,8557074,174699,914
8557106,0.0,0.0,9372000,7810000,1562000,17,9372000,Null,Null,8557106,174699,914
8557109,0.0,0.0,8600000,6020000,2580000,30,8600000,Null,Null,8557109,174699,914
8557163,0.0,0.0,9792000,8160000,1632000,17,9792000,Null,Null,8557163,174699,914
8557214,0.0,0.0,8440000,5908000,2532000,30,8440000,Null,Null,8557214,174699,914
8557329,0.0,0.0,8050000,6037500,2012500,25,8050000,Null,Null,8557329,174699,914
8557335,0.0,0.0,9420000,7850000,1570000,17,9420000,Null,Null,8557335,174699,914
8557379,0.0,0.0,8530000,5971000,2559000,30,8530000,Null,Null,8557379,174699,914
8562621,2.0,2.0,9000,9000,0,0,9000,Null,Null,8562621,111461,1815
8580865,80.0,80.0,196000,159000,37000,19,196000,Null,Null,8580865,4647777,914
8639764,259.0,259.0,98000,76000,22000,22,98000,Null,Null,8639764,269907,1520
8677130,41.0,41.0,390000,268000,122000,31,390000,Null,Null,8677130,183257,914
8699027,13.0,13.0,174080,121856,52224,30,174080,Null,Null,8699027,111461,1815
8729465,94.0,94.0,75000,75000,0,0,75000,Null,Null,8729465,207475,1520
8832017,1.0,1.0,138000,138000,0,0,138000,Null,Null,8832017,111461,914
8959289,16911.0,16911.0,185000,160000,25000,14,185000,Null,Null,8959289,112882,3422
9345089,1.0,1.0,798000,699000,99000,12,798000,Null,Null,9345089,4647777,914
9357400,101.0,101.0,111000,80000,31000,28,111000,Null,Null,9357400,243693,1815
9362951,3.0,3.0,144000,144000,0,0,144000,Null,Null,9362951,111461,914
9380922,0.0,0.0,6000,5000,1000,17,6000,Null,Null,9380922,111461,1815
9420648,29.0,29.0,100000,100000,0,0,100000,Null,Null,9420648,111461,914
9445321,40.0,40.0,280000,280000,0,0,280000,Null,Null,9445321,867937,914
9503237,7.0,7.0,89000,89000,0,0,89000,Null,Null,9503237,21651,1815
9503332,13.0,13.0,109000,106820,2180,2,109000,Null,Null,9503332,21651,1815
9666261,0.0,0.0,79000,79000,0,0,79000,Null,Null,9666261,111461,914
9724296,78.0,78.0,175000,159000,16000,9,175000,Null,Null,9724296,47882,914
9727420,1203.0,1203.0,250000,250000,0,0,250000,Null,Null,9727420,255877,914
9731589,3.0,3.0,299000,199000,100000,33,299000,Null,Null,9731589,183257,914
9732022,5.0,5.0,499000,444000,55000,11,499000,Null,Null,9732022,223295,914
9734335,297.0,297.0,300000,300000,0,0,300000,Null,Null,9734335,255877,914
9765544,3.0,3.0,300000,300000,0,0,300000,Null,Null,9765544,111461,914
9800871,1.0,1.0,470000,445000,25000,5,470000,Null,Null,9800871,260955,1520
9803803,136.0,136.0,92000,92000,0,0,92000,Null,Null,9803803,273971,8300
9803818,108.0,108.0,112000,112000,0,0,112000,Null,Null,9803818,273971,8300
9803853,1855.0,1855.0,126000,126000,0,0,126000,Null,Null,9803853,273971,8300
9843514,321.0,321.0,76000,76000,0,0,76000,Null,Null,9843514,111461,1815
9845886,0.0,0.0,5880000,5880000,0,0,5880000,Null,Null,9845886,260977,1520
9847959,3.0,3.0,4400000,4400000,0,0,4400000,Null,Null,9847959,33203,8170
9848276,0.0,0.0,2990000,2242500,747500,25,2990000,Null,Null,9848276,174699,914
9848322,3.0,3.0,6000000,5000000,1000000,17,6000000,Null,Null,9848322,174699,914
9848332,0.0,0.0,3260000,2445000,815000,25,3260000,Null,Null,9848332,174699,914
9848386,0.0,0.0,9180000,7650000,1530000,17,9180000,Null,Null,9848386,174699,914
9848439,0.0,0.0,10620000,8850000,1770000,17,10620000,Null,Null,9848439,174699,914
9848459,0.0,0.0,11700000,9750000,1950000,17,11700000,Null,Null,9848459,174699,914
9848489,0.0,0.0,8760000,7300000,1460000,17,8760000,Null,Null,9848489,174699,914
9848549,0.0,0.0,7750000,7750000,0,0,7750000,Null,Null,9848549,260977,1520
9849188,174.0,174.0,714178,714178,0,0,714178,Null,Null,9849188,33203,1520
9850680,2.0,2.0,1218000,770000,448000,37,1218000,Null,Null,9850680,26150,914
9850682,38.0,38.0,1218000,912000,306000,25,1218000,Null,Null,9850682,26150,914
9853280,2.0,2.0,92978,92978,0,0,92978,Null,Null,9853280,111461,1815
9856114,1317.0,1317.0,240000,240000,0,0,240000,Null,Null,9856114,274953,914
9856643,173.0,173.0,79000,79000,0,0,79000,Null,Null,9856643,48727,11605
9858637,5.0,5.0,49000,44000,5000,10,49000,Null,Null,9858637,111461,1520
9858922,1597.0,1597.0,550000,275000,275000,50,550000,Null,Null,9858922,143130,1520
9859265,4.0,4.0,209000,209000,0,0,209000,Null,Null,9859265,111461,914
9859519,8.0,8.0,220000,220000,0,0,220000,Null,Null,9859519,111461,914
9859682,2.0,2.0,209000,209000,0,0,209000,Null,Null,9859682,111461,914
9871807,43.0,43.0,180000,116999,63001,35,180000,Null,Null,9871807,111461,1815
9881903,360.0,360.0,599000,599000,0,0,599000,Null,Null,9881903,46363,914
9934373,122.0,122.0,46000,46000,0,0,46000,Null,Null,9934373,111461,1883
9946573,32.0,32.0,3520000,3520000,0,0,3520000,Null,Null,9946573,150399,1626
9947317,87.0,87.0,1500000,1300000,200000,13,1500000,Null,Null,9947317,173547,8371
9958090,129.0,129.0,580000,550000,30000,5,580000,Null,Null,9958090,227957,1520
9977547,7.0,7.0,9000,9000,0,0,9000,Null,Null,9977547,111461,1815
9982523,9.0,9.0,59800,59800,0,0,59800,Null,Null,9982523,111461,1815
9998972,430.0,430.0,240000,240000,0,0,240000,Null,Null,9998972,274953,914
10017915,121.0,121.0,129000,108000,21000,16,129000,Null,Null,10017915,167357,1520
10018298,363.0,363.0,129000,129000,0,0,129000,Null,Null,10018298,232159,53350
10032000,80.0,80.0,32000,32000,0,0,32000,Null,Null,10032000,111461,53190
10053537,3269.0,3269.0,240000,165000,75000,31,240000,Null,Null,10053537,245063,1520
10067222,301.0,301.0,980000,750000,230000,23,980000,Null,Null,10067222,173547,914
10071383,10357.0,10357.0,168500,151000,17500,10,168500,Null,Null,10071383,21266,1520
10072103,4737.0,4737.0,25500,25500,0,0,25500,Null,Null,10072103,277781,1520
10073363,52.0,52.0,550000,550000,0,0,550000,Null,Null,10073363,149789,1815
10082226,127.0,127.0,215000,215000,0,0,215000,Null,Null,10082226,239363,1520
10091481,1234.0,1234.0,115000,115000,0,0,115000,Null,Null,10091481,177831,1520
10099734,600.0,600.0,280000,209000,71000,25,280000,Null,Null,10099734,65418,8602
10102761,13.0,13.0,182000,182000,0,0,182000,Null,Null,10102761,111461,1883
10104116,431.0,431.0,149000,149000,0,0,149000,Null,Null,10104116,244095,1520
10105936,396.0,396.0,220000,220000,0,0,220000,Null,Null,10105936,244095,1520
10113725,160.0,160.0,84000,60000,24000,29,84000,Null,Null,10113725,243693,1815
10125428,13.0,13.0,260000,260000,0,0,260000,Null,Null,10125428,867937,914
10126332,822.0,822.0,790000,790000,0,0,790000,Null,Null,10126332,18641,7078
10167751,60.0,60.0,1150000,980000,170000,15,1150000,Null,Null,10167751,173547,914
10188853,10.0,10.0,322222,209000,113222,35,322222,Null,Null,10188853,173547,914
10197363,3539.0,3539.0,399000,315000,84000,21,399000,Null,Null,10197363,18984,1838
10198980,2065.0,2065.0,350000,235000,115000,33,350000,Null,Null,10198980,18984,1838
10224416,9.0,9.0,42000,42000,0,0,42000,Null,Null,10224416,111461,1804
10227148,2930.0,2930.0,275000,169000,106000,39,275000,Null,Null,10227148,48077,1883
10230857,0.0,0.0,36300000,36300000,0,0,36300000,Null,Null,10230857,279911,1883
10231007,9.0,9.0,466666,462000,4666,1,466666,Null,Null,10231007,173547,914
10271325,1391.0,1391.0,45000,43000,2000,4,45000,Null,Null,10271325,829895,1520
10278480,7933.0,7933.0,165000,134000,31000,19,165000,Null,Null,10278480,114333,1520
10278713,11096.0,11096.0,515000,428000,87000,17,515000,Null,Null,10278713,114333,1520
10298023,3288.0,3288.0,519000,265000,254000,49,519000,Null,Null,10298023,7378235,1520
10311125,3.0,3.0,1650000,969000,681000,41,1650000,Null,Null,10311125,4647777,914
10315892,4.0,4.0,880000,569000,311000,35,880000,Null,Null,10315892,4647777,15318
10370043,196.0,196.0,60000,48000,12000,20,60000,Null,Null,10370043,111461,1815
10372542,127.0,127.0,50000,50000,0,0,50000,Null,Null,10372542,111461,2140
10373727,206.0,206.0,175000,128000,47000,27,175000,Null,Null,10373727,47663,13878
10374089,5.0,5.0,782000,399000,383000,49,782000,Null,Null,10374089,4647777,914
10379606,0.0,0.0,10400000,7800000,2600000,25,10400000,Null,Null,10379606,174699,914
10379651,0.0,0.0,10980000,9150000,1830000,17,10980000,Null,Null,10379651,174699,914
10383995,9.0,9.0,98000,98000,0,0,98000,Null,Null,10383995,111461,914
10387861,42.0,42.0,494444,490000,4444,1,494444,Null,Null,10387861,173547,914
10390974,226.0,226.0,1800000,1800000,0,0,1800000,Null,Null,10390974,154910,1805
10394554,5.0,5.0,105000,105000,0,0,105000,Null,Null,10394554,154319,914
10404745,811.0,811.0,185000,158000,27000,15,185000,Null,Null,10404745,282185,1520
10404757,467.0,467.0,165000,158000,7000,4,165000,Null,Null,10404757,282185,1520
10404761,4401.0,4401.0,164400,155000,9400,6,164400,Null,Null,10404761,282185,1520
10420017,3.0,3.0,824000,824000,0,0,824000,Null,Null,10420017,111461,914
10440296,104.0,104.0,16000,16000,0,0,16000,Null,Null,10440296,111461,914
10499488,43.0,43.0,19900,19900,0,0,19900,Null,Null,10499488,111461,1815
10564675,0.0,0.0,6599000,6599000,0,0,6599000,Null,Null,10564675,154754,914
10565028,0.0,0.0,999000,999000,0,0,999000,Null,Null,10565028,200319,914
10574201,9.0,9.0,235000,105000,130000,55,235000,Null,Null,10574201,31626,1984
10579630,1274.0,1274.0,187000,187000,0,0,187000,Null,Null,10579630,280113,1520
10579885,2.0,2.0,189000,189000,0,0,189000,Null,Null,10579885,154319,914
10579891,2.0,2.0,210000,210000,0,0,210000,Null,Null,10579891,154319,914
10585748,2.0,2.0,16000,16000,0,0,16000,Null,Null,10585748,505165,914
10588582,181.0,181.0,29000,29000,0,0,29000,Null,Null,10588582,111461,914
10596252,1.0,1.0,57500,57500,0,0,57500,Null,Null,10596252,111461,3990
10597090,149.0,149.0,45000,45000,0,0,45000,Null,Null,10597090,111461,914
10597422,809.0,809.0,365000,185000,180000,49,365000,Null,Null,10597422,167567,1520
10606661,271.0,271.0,46900,46900,0,0,46900,Null,Null,10606661,111461,8519
10640012,42.0,42.0,39900,39900,0,0,39900,Null,Null,10640012,111461,1815
10640154,4082.0,4082.0,68000,59000,9000,13,68000,Null,Null,10640154,112887,1520
10643887,327.0,327.0,163000,163000,0,0,163000,Null,Null,10643887,111461,23010
10669241,57.0,57.0,181000,134000,47000,26,181000,Null,Null,10669241,47663,1520
10680458,875.0,875.0,106900,106900,0,0,106900,Null,Null,10680458,111461,1832
10680701,7.0,7.0,19000,19000,0,0,19000,Null,Null,10680701,111461,914
10683667,1.0,1.0,856000,642000,214000,25,856000,Null,Null,10683667,26150,914
10686385,22.0,22.0,159000,159000,0,0,159000,Null,Null,10686385,281343,914
10688621,5.0,5.0,190000,190000,0,0,190000,Null,Null,10688621,239943,914
10690670,184.0,184.0,5307000,4300000,1007000,19,5307000,Null,Null,10690670,18984,4880
10692528,615.0,615.0,200000,192000,8000,4,200000,Null,Null,10692528,111461,1883
10696659,32.0,32.0,258000,258000,0,0,258000,Null,Null,10696659,20271,1815
10712419,115.0,115.0,345000,215000,130000,38,345000,Null,Null,10712419,151702,3424
10724668,281.0,281.0,111900,102000,9900,9,111900,Null,Null,10724668,111461,1832
10734388,3712.0,3712.0,435000,404000,31000,7,435000,Null,Null,10734388,47489,2347
10750803,1.0,1.0,16000,16000,0,0,16000,Null,Null,10750803,111461,15250
10758843,2790.0,2790.0,110000,87000,23000,21,110000,Null,Null,10758843,232723,1520
10764788,188.0,188.0,8990,8990,0,0,8990,Null,Null,10764788,111461,1831
10768010,163.0,163.0,309000,309000,0,0,309000,Null,Null,10768010,41391,1883
10768023,0.0,0.0,9750000,6337500,3412500,35,9750000,Null,Null,10768023,25502,914
10768545,0.0,0.0,85000,85000,0,0,85000,Null,Null,10768545,41391,53190
10769671,16.0,16.0,245000,218000,27000,11,245000,Null,Null,10769671,47882,2
10773328,4.0,4.0,49000,49000,0,0,49000,Null,Null,10773328,111461,1815
10784603,1327.0,1327.0,189000,189000,0,0,189000,Null,Null,10784603,196271,1815
10787668,124.0,124.0,48000,48000,0,0,48000,Null,Null,10787668,111461,914
10788379,0.0,0.0,9785000,9785000,0,0,9785000,Null,Null,10788379,25502,914
10793468,690.0,690.0,29000,29000,0,0,29000,Null,Null,10793468,111461,1815
10795646,423.0,423.0,86000,73000,13000,15,86000,Null,Null,10795646,203901,1520
10795693,505.0,505.0,86000,73000,13000,15,86000,Null,Null,10795693,203901,3422
10795695,990.0,990.0,216000,183000,33000,15,216000,Null,Null,10795695,203901,3422
10806260,74.0,74.0,35000,35000,0,0,35000,Null,Null,10806260,111461,1815
10814223,302.0,302.0,32900,32900,0,0,32900,Null,Null,10814223,111461,23022
10848174,128.0,128.0,18000,9000,9000,50,18000,Null,Null,10848174,111461,1815
10858345,498.0,498.0,245000,245000,0,0,245000,Null,Null,10858345,219625,1520
10881983,21.0,21.0,150000,150000,0,0,150000,Null,Null,10881983,111461,1811
10920799,20.0,20.0,16000,16000,0,0,16000,Null,Null,10920799,111461,2
10933195,9.0,9.0,16000,16000,0,0,16000,Null,Null,10933195,505165,2
10933197,5.0,5.0,25000,25000,0,0,25000,Null,Null,10933197,111461,2
10933199,0.0,0.0,16000,16000,0,0,16000,Null,Null,10933199,505165,15250
10933201,0.0,0.0,61000,61000,0,0,61000,Null,Null,10933201,111461,15250
10933205,39.0,39.0,16000,16000,0,0,16000,Null,Null,10933205,505165,914
10933207,21.0,21.0,16000,16000,0,0,16000,Null,Null,10933207,505165,914
10933524,8.0,8.0,16000,16000,0,0,16000,Null,Null,10933524,505165,15250
10933526,4.0,4.0,16000,16000,0,0,16000,Null,Null,10933526,505165,2
10933528,33.0,33.0,16000,16000,0,0,16000,Null,Null,10933528,505165,2
10933530,8.0,8.0,16000,16000,0,0,16000,Null,Null,10933530,505165,2
10933534,34.0,34.0,16000,16000,0,0,16000,Null,Null,10933534,505165,2
10933536,14.0,14.0,16000,16000,0,0,16000,Null,Null,10933536,505165,2
10967548,0.0,0.0,5820000,5820000,0,0,5820000,Null,Null,10967548,287227,17170
11058658,11401.0,11401.0,54000,45000,9000,17,54000,Null,Null,11058658,288231,23026
11080342,0.0,0.0,6000000,6000000,0,0,6000000,Null,Null,11080342,260977,1520
11110653,20.0,20.0,2500000,2500000,0,0,2500000,Null,Null,11110653,18804,8061
11118835,902.0,902.0,590000,590000,0,0,590000,Null,Null,11118835,219625,1520
11122751,25.0,25.0,215000,215000,0,0,215000,Null,Null,11122751,111461,914
11122789,0.0,0.0,8500000,8500000,0,0,8500000,Null,Null,11122789,25502,914
11123060,0.0,0.0,8900000,8900000,0,0,8900000,Null,Null,11123060,25502,914
11126172,201.0,201.0,95000,95000,0,0,95000,Null,Null,11126172,111461,53188
11178957,55.0,55.0,5540000,4190000,1350000,24,5540000,Null,Null,11178957,185211,1520
11183003,2085.0,2085.0,220000,220000,0,0,220000,Null,Null,11183003,284315,1520
11188135,0.0,0.0,8050000,8050000,0,0,8050000,Null,Null,11188135,25502,914
11190477,0.0,0.0,8400000,8400000,0,0,8400000,Null,Null,11190477,25502,914
11193289,0.0,0.0,13485000,13485000,0,0,13485000,Null,Null,11193289,25502,914
11197614,38.0,38.0,950000,659000,291000,31,950000,Null,Null,11197614,182293,1520
11201518,0.0,0.0,13085000,13085000,0,0,13085000,Null,Null,11201518,25502,914
11203853,80.0,80.0,13992,13992,0,0,13992,Null,Null,11203853,111461,2363
11204743,50.0,50.0,479000,479000,0,0,479000,Null,Null,11204743,18792,1805
11212346,816.0,816.0,345000,345000,0,0,345000,Null,Null,11212346,19107,3428
11212886,58.0,58.0,698000,680000,18000,3,698000,Null,Null,11212886,145335,1520
11216859,141.0,141.0,46400,46400,0,0,46400,Null,Null,11216859,111461,1805
11217956,225.0,225.0,3050000,3050000,0,0,3050000,Null,Null,11217956,147856,1794
11220808,418.0,418.0,402000,247000,155000,39,402000,Null,Null,11220808,48077,1883
11224739,78.0,78.0,215000,179000,36000,17,215000,Null,Null,11224739,47882,2
11234555,38.0,38.0,40000,40000,0,0,40000,Null,Null,11234555,111461,1815
11251711,1.0,1.0,1900000,1900000,0,0,1900000,Null,Null,11251711,18804,8061
11251735,5.0,5.0,1360000,1360000,0,0,1360000,Null,Null,11251735,18804,8061
11251770,6.0,6.0,1165000,1165000,0,0,1165000,Null,Null,11251770,18804,8061
11251935,10.0,10.0,950000,950000,0,0,950000,Null,Null,11251935,18804,8061
11251937,31.0,31.0,1050000,1050000,0,0,1050000,Null,Null,11251937,18804,8061
11251951,154.0,154.0,750000,750000,0,0,750000,Null,Null,11251951,18804,8061
11254933,425.0,425.0,1700000,1700000,0,0,1700000,Null,Null,11254933,153733,17170
11254935,239.0,239.0,1850000,1757000,93000,5,1850000,Null,Null,11254935,153733,17170
11255835,8.0,8.0,35000,35000,0,0,35000,Null,Null,11255835,111461,914
11257847,308.0,308.0,45000,23000,22000,49,45000,Null,Null,11257847,111461,1815
11279807,16.0,16.0,43900,30000,13900,32,43900,Null,Null,11279807,111461,914
11314393,3.0,3.0,143000,143000,0,0,143000,Null,Null,11314393,167853,2
11336478,8.0,8.0,667000,667000,0,0,667000,Null,Null,11336478,26150,1778
11341623,280.0,280.0,86900,86900,0,0,86900,Null,Null,11341623,21437,2153
11364348,17.0,17.0,550000,550000,0,0,550000,Null,Null,11364348,223671,914
11368961,3595.0,3595.0,85000,79000,6000,7,85000,Null,Null,11368961,202071,1520
11374712,27.0,27.0,450000,450000,0,0,450000,Null,Null,11374712,111461,8061
11376644,12.0,12.0,730000,730000,0,0,730000,Null,Null,11376644,18804,8061
11395980,6.0,6.0,16000,16000,0,0,16000,Null,Null,11395980,505165,2
11395982,6.0,6.0,16000,16000,0,0,16000,Null,Null,11395982,505165,914
11395984,15.0,15.0,16000,16000,0,0,16000,Null,Null,11395984,505165,2
11395988,18.0,18.0,16000,16000,0,0,16000,Null,Null,11395988,505165,2
11395999,6.0,6.0,16000,16000,0,0,16000,Null,Null,11395999,505165,15250
11396001,9.0,9.0,16000,16000,0,0,16000,Null,Null,11396001,505165,2
11396003,0.0,0.0,16000,16000,0,0,16000,Null,Null,11396003,505165,2
11396007,5.0,5.0,16000,16000,0,0,16000,Null,Null,11396007,505165,2
11396009,18.0,18.0,16000,16000,0,0,16000,Null,Null,11396009,505165,2
11405375,5.0,5.0,16000,16000,0,0,16000,Null,Null,11405375,505165,2
11405377,15.0,15.0,16000,16000,0,0,16000,Null,Null,11405377,505165,914
11405379,2.0,2.0,16000,16000,0,0,16000,Null,Null,11405379,505165,15250
11405385,13.0,13.0,16000,16000,0,0,16000,Null,Null,11405385,505165,2
11405387,5.0,5.0,16000,16000,0,0,16000,Null,Null,11405387,505165,2
11405389,0.0,0.0,16000,16000,0,0,16000,Null,Null,11405389,505165,2
11405391,2.0,2.0,16000,16000,0,0,16000,Null,Null,11405391,505165,15250
11405393,1.0,1.0,16000,16000,0,0,16000,Null,Null,11405393,111461,2
11405397,7.0,7.0,16000,16000,0,0,16000,Null,Null,11405397,505165,2
11411915,1.0,1.0,198999,198999,0,0,198999,Null,Null,11411915,111461,914
11415485,28.0,28.0,940000,940000,0,0,940000,Null,Null,11415485,18804,8061
11417214,18.0,18.0,140000,140000,0,0,140000,Null,Null,11417214,111461,2
11420700,5.0,5.0,567000,289000,278000,49,567000,Null,Null,11420700,4647777,15318
11423555,3018.0,3018.0,140000,95000,45000,32,140000,Null,Null,11423555,143130,1520
11442101,20.0,20.0,16000,16000,0,0,16000,Null,Null,11442101,505165,15250
11442103,34.0,34.0,16000,16000,0,0,16000,Null,Null,11442103,505165,914
11442105,4.0,4.0,16000,16000,0,0,16000,Null,Null,11442105,505165,15250
11442107,17.0,17.0,16000,16000,0,0,16000,Null,Null,11442107,505165,2
11442111,0.0,0.0,16000,16000,0,0,16000,Null,Null,11442111,505165,2
11442113,7.0,7.0,16000,16000,0,0,16000,Null,Null,11442113,505165,2
11442119,9.0,9.0,16000,16000,0,0,16000,Null,Null,11442119,505165,2
11443614,231.0,231.0,389000,389000,0,0,389000,Null,Null,11443614,25277,1815
11478258,55.0,55.0,11540,11515,25,0,11540,Null,Null,11478258,111461,1815
11478540,3.0,3.0,8500,8000,500,6,8500,Null,Null,11478540,111461,1815
11479038,212.0,212.0,19500,19500,0,0,19500,Null,Null,11479038,111461,5566
11479289,37.0,37.0,72000,72000,0,0,72000,Null,Null,11479289,111393,5263
11487527,380.0,380.0,90000,62000,28000,31,90000,Null,Null,11487527,741117,2513
11488920,1878.0,1878.0,715000,399000,316000,44,715000,Null,Null,11488920,48077,2
11489258,68.0,68.0,160000,160000,0,0,160000,Null,Null,11489258,303503,1520
11509625,24.0,24.0,78900,72000,6900,9,78900,Null,Null,11509625,111461,1815
11522932,513.0,513.0,365000,365000,0,0,365000,Null,Null,11522932,151948,1520
11588613,362.0,362.0,140000,110000,30000,21,140000,Null,Null,11588613,307105,1520
11592793,0.0,0.0,41340,39000,2340,6,41340,Null,Null,11592793,111461,1815
11594328,111.0,111.0,80000,80000,0,0,80000,Null,Null,11594328,111461,1883
11616161,1407.0,1407.0,499000,390000,109000,22,499000,Null,Null,11616161,21279,17170
11642028,264.0,264.0,24330,19000,5330,22,24330,Null,Null,11642028,111461,2363
11696937,42.0,42.0,73000,73000,0,0,73000,Null,Null,11696937,111461,27128
11719645,545.0,545.0,1200000,1200000,0,0,1200000,Null,Null,11719645,18804,7078
11720616,123.0,123.0,89000,89000,0,0,89000,Null,Null,11720616,166419,1815
11721798,5.0,5.0,18000,18000,0,0,18000,Null,Null,11721798,111461,914
11722056,13.0,13.0,16000,16000,0,0,16000,Null,Null,11722056,111461,914
11772926,105.0,105.0,17950,17950,0,0,17950,Null,Null,11772926,111461,2173
11794382,556.0,556.0,244000,122000,122000,50,244000,Null,Null,11794382,111461,1815
11802138,93.0,93.0,765000,749700,15300,2,765000,Null,Null,11802138,17825,8061
11834620,239.0,239.0,116500,116500,0,0,116500,Null,Null,11834620,310505,1832
11856471,0.0,0.0,9090000,6363000,2727000,30,9090000,Null,Null,11856471,174699,2
11856537,0.0,0.0,14970000,10479000,4491000,30,14970000,Null,Null,11856537,174699,2
11859172,68.0,68.0,119000,119000,0,0,119000,Null,Null,11859172,243693,1815
11859404,67.0,67.0,850000,850000,0,0,850000,Null,Null,11859404,111461,23540
11860156,554.0,554.0,320000,227000,93000,29,320000,Null,Null,11860156,156043,1520
11868279,0.0,0.0,5800000,5800000,0,0,5800000,Null,Null,11868279,27449,1520
11868584,0.0,0.0,7000000,7000000,0,0,7000000,Null,Null,11868584,27449,1520
11872678,0.0,0.0,16000,16000,0,0,16000,Null,Null,11872678,111461,914
11873518,0.0,0.0,5785000,5785000,0,0,5785000,Null,Null,11873518,25502,2
11873590,0.0,0.0,9400000,6110000,3290000,35,9400000,Null,Null,11873590,25502,2
11874956,448.0,448.0,220000,194500,25500,12,220000,Null,Null,11874956,156043,1520
11892302,344.0,344.0,19000,19000,0,0,19000,Null,Null,11892302,111461,15250
11949005,2665.0,2665.0,160000,135000,25000,16,160000,Null,Null,11949005,202071,1520
11954438,1167.0,1167.0,63000,48000,15000,24,63000,Null,Null,11954438,238407,1520
11956889,1272.0,1272.0,57000,45000,12000,21,57000,Null,Null,11956889,238407,1520
11961980,224.0,224.0,158000,158000,0,0,158000,Null,Null,11961980,111441,1583
11980971,533.0,533.0,293000,250000,43000,15,293000,Null,Null,11980971,238407,1520
11981121,684.0,684.0,45000,38250,6750,15,45000,Null,Null,11981121,183795,1520
11981853,35.0,35.0,88000,88000,0,0,88000,Null,Null,11981853,21653,1815
11983208,93.0,93.0,5720,5720,0,0,5720,Null,Null,11983208,111461,1815
12028719,0.0,0.0,999000,999000,0,0,999000,Null,Null,12028719,200319,914
12053893,3573.0,3573.0,320000,215000,105000,33,320000,Null,Null,12053893,317315,17162
12054639,341.0,341.0,320000,185000,135000,42,320000,Null,Null,12054639,317315,1520
12056666,1235.0,1235.0,320000,235000,85000,27,320000,Null,Null,12056666,317315,1520
12058282,588.0,588.0,249000,229000,20000,8,249000,Null,Null,12058282,317315,1520
12063801,162.0,162.0,237000,185000,52000,22,237000,Null,Null,12063801,317315,1520
12075796,0.0,0.0,7000000,6230000,770000,11,7000000,Null,Null,12075796,111461,914
12078062,0.0,0.0,7000000,6230000,770000,11,7000000,Null,Null,12078062,111461,914
12081510,985.0,985.0,201000,170000,31000,15,201000,Null,Null,12081510,238407,17170
12082922,963.0,963.0,299000,255000,44000,15,299000,Null,Null,12082922,183013,1520
12084496,2236.0,2236.0,369000,260000,109000,30,369000,Null,Null,12084496,114328,1520
12084498,493.0,493.0,389000,265000,124000,32,389000,Null,Null,12084498,114328,1520
12084500,3.0,3.0,285000,285000,0,0,285000,Null,Null,12084500,114328,2347
12084520,202.0,202.0,429000,429000,0,0,429000,Null,Null,12084520,114328,3422
12084610,47.0,47.0,170000,170000,0,0,170000,Null,Null,12084610,114328,17170
12086125,2222.0,2222.0,699000,353000,346000,49,699000,Null,Null,12086125,63967,1634
12093567,1.0,1.0,540000,540000,0,0,540000,Null,Null,12093567,111461,914
12107932,62.0,62.0,2299000,1850000,449000,20,2299000,Null,Null,12107932,223635,2
12108674,0.0,0.0,6800000,6052000,748000,11,6800000,Null,Null,12108674,111461,914
12108993,0.0,0.0,6800000,6052000,748000,11,6800000,Null,Null,12108993,111461,914
12114014,24.0,24.0,99000,99000,0,0,99000,Null,Null,12114014,111461,1815
12115034,84.0,84.0,466000,396100,69900,15,466000,Null,Null,12115034,26150,914
12132947,364.0,364.0,42800,42800,0,0,42800,Null,Null,12132947,318945,1520
12197016,2.0,2.0,37800,37800,0,0,37800,Null,Null,12197016,111461,53074
12205956,1.0,1.0,129000,129000,0,0,129000,Null,Null,12205956,111461,1520
12213522,35.0,35.0,48850,49000,0,0,48850,Null,Null,12213522,111461,5995
12219979,456.0,456.0,363258,363258,0,0,363258,Null,Null,12219979,314543,1520
12242241,245.0,245.0,146160,125000,21160,14,146160,Null,Null,12242241,47803,11897
12259521,754.0,754.0,49000,49000,0,0,49000,Null,Null,12259521,111461,1883
12285786,0.0,0.0,6710000,6039000,671000,10,6710000,Null,Null,12285786,4647777,914
12285969,248.0,248.0,109000,109000,0,0,109000,Null,Null,12285969,142542,3422
12295881,0.0,0.0,3900000,3900000,0,0,3900000,Null,Null,12295881,27449,1520
12302036,17.0,17.0,199000,199000,0,0,199000,Null,Null,12302036,111461,1815
12306850,1.0,1.0,325000,325000,0,0,325000,Null,Null,12306850,111461,914
12327271,6.0,6.0,299000,299000,0,0,299000,Null,Null,12327271,867937,914
12348807,62.0,62.0,102000,102000,0,0,102000,Null,Null,12348807,111461,1815
12376546,3313.0,3313.0,630000,599000,31000,5,630000,Null,Null,12376546,202607,53350
12379801,4.0,4.0,1140000,889200,250800,22,1140000,Null,Null,12379801,26150,914
12385988,743.0,743.0,120000,120000,0,0,120000,Null,Null,12385988,111461,27180
12393910,15.0,15.0,1036000,725200,310800,30,1036000,Null,Null,12393910,26150,914
12433246,11.0,11.0,300000,300000,0,0,300000,Null,Null,12433246,867937,914
12478881,875.0,875.0,333000,244000,89000,27,333000,Null,Null,12478881,65255,13878
12480771,368.0,368.0,297900,297900,0,0,297900,Null,Null,12480771,111461,1805
12484014,604.0,604.0,1102000,1102000,0,0,1102000,Null,Null,12484014,259827,1520
12485554,1629.0,1629.0,221000,110500,110500,50,221000,Null,Null,12485554,111461,1815
12490431,618.0,618.0,75000,59000,16000,21,75000,Null,Null,12490431,284381,3426
12494815,4.0,4.0,684000,349000,335000,49,684000,Null,Null,12494815,4647777,15250
12529076,103.0,103.0,399000,395000,4000,1,399000,Null,Null,12529076,160941,2
12564759,11.0,11.0,61000,61000,0,0,61000,Null,Null,12564759,111461,914
12636680,117.0,117.0,82000,82000,0,0,82000,Null,Null,12636680,230165,2153
12670852,10.0,10.0,15000,7500,7500,50,15000,Null,Null,12670852,111461,1815
12717796,0.0,0.0,75998,37999,37999,50,75998,Null,Null,12717796,111461,1815
12721207,10.0,10.0,249000,249000,0,0,249000,Null,Null,12721207,111461,914
12735581,41.0,41.0,130000,130000,0,0,130000,Null,Null,12735581,281343,914
12736380,11.0,11.0,162900,162900,0,0,162900,Null,Null,12736380,111461,2140
12737657,113.0,113.0,90000,90000,0,0,90000,Null,Null,12737657,111461,8371
12739927,0.0,0.0,6325000,6325000,0,0,6325000,Null,Null,12739927,25502,2
12740757,3.0,3.0,199000,199000,0,0,199000,Null,Null,12740757,111461,1883
12745337,45.0,45.0,85000,85000,0,0,85000,Null,Null,12745337,34398,1520
12999254,1807.0,1807.0,570000,529000,41000,7,570000,Null,Null,12999254,47489,8227
13118385,0.0,0.0,6300000,6300000,0,0,6300000,Null,Null,13118385,25502,914
13119283,398.0,398.0,29000,26000,3000,10,29000,Null,Null,13119283,111461,1815
13119587,77.0,77.0,45000,45000,0,0,45000,Null,Null,13119587,111461,914
13121129,1.0,1.0,5785000,5785000,0,0,5785000,Null,Null,13121129,25502,914
13130236,0.0,0.0,6100000,6100000,0,0,6100000,Null,Null,13130236,25502,914
13131464,2.0,2.0,52000,52000,0,0,52000,Null,Null,13131464,111461,1805
13135024,34.0,34.0,19000,19000,0,0,19000,Null,Null,13135024,505165,2
13135026,5.0,5.0,15000,15000,0,0,15000,Null,Null,13135026,505165,15320
13135028,25.0,25.0,15000,15000,0,0,15000,Null,Null,13135028,505165,2
13135032,9.0,9.0,19000,19000,0,0,19000,Null,Null,13135032,505165,2
13135034,14.0,14.0,16500,16500,0,0,16500,Null,Null,13135034,505165,2
13135036,11.0,11.0,16500,16500,0,0,16500,Null,Null,13135036,111461,2
13135042,10.0,10.0,19000,19000,0,0,19000,Null,Null,13135042,505165,2
13135051,19.0,19.0,16500,16500,0,0,16500,Null,Null,13135051,505165,2
13158001,29.0,29.0,19999,19999,0,0,19999,Null,Null,13158001,111461,1883
13160471,15.0,15.0,7900,7900,0,0,7900,Null,Null,13160471,111461,1815
13161084,0.0,0.0,12500,12000,500,4,12500,Null,Null,13161084,111461,20174
13210794,0.0,0.0,7250000,7250000,0,0,7250000,Null,Null,13210794,25502,914
13214997,0.0,0.0,13885000,13885000,0,0,13885000,Null,Null,13214997,25502,914
13246142,3.0,3.0,239000,239000,0,0,239000,Null,Null,13246142,239943,914
13246837,362.0,362.0,35000,35000,0,0,35000,Null,Null,13246837,111461,914
13286988,302.0,302.0,79000,79000,0,0,79000,Null,Null,13286988,111461,5995
13288934,0.0,0.0,12185000,12185000,0,0,12185000,Null,Null,13288934,25502,914
13302555,5.0,5.0,960000,748800,211200,22,960000,Null,Null,13302555,26150,914
13304298,4.0,4.0,1036000,828000,208000,20,1036000,Null,Null,13304298,26150,914
13306917,0.0,0.0,8610000,8610000,0,0,8610000,Null,Null,13306917,25502,914
13309367,3.0,3.0,44000,44000,0,0,44000,Null,Null,13309367,111461,53190
13309785,1082.0,1082.0,550000,495000,55000,10,550000,Null,Null,13309785,206523,1520
13311411,0.0,0.0,10290000,10290000,0,0,10290000,Null,Null,13311411,25502,914
13311521,0.0,0.0,13200000,13200000,0,0,13200000,Null,Null,13311521,25502,914
13311584,0.0,0.0,9400000,9400000,0,0,9400000,Null,Null,13311584,25502,914
13322568,329.0,329.0,4900,4900,0,0,4900,Null,Null,13322568,111461,1883
13325863,8192.0,8192.0,185000,160000,25000,14,185000,Null,Null,13325863,112882,1520
13326088,0.0,0.0,89000,89000,0,0,89000,Null,Null,13326088,111461,914
13327053,0.0,0.0,6585000,6585000,0,0,6585000,Null,Null,13327053,25502,914
13327337,3.0,3.0,2591000,1295500,1295500,50,2591000,Null,Null,13327337,26150,914
13331596,7.0,7.0,1503000,1172340,330660,22,1503000,Null,Null,13331596,26150,914
13333477,6.0,6.0,1607000,1253460,353540,22,1607000,Null,Null,13333477,26150,914
13336189,39.0,39.0,9800,9000,800,8,9800,Null,Null,13336189,111461,1815
13380295,524.0,524.0,918000,918000,0,0,918000,Null,Null,13380295,145335,1520
13383743,14.0,14.0,6500000,5785000,715000,11,6500000,Null,Null,13383743,205847,1520
13403347,87.0,87.0,540000,540000,0,0,540000,Null,Null,13403347,243693,1815
13410632,0.0,0.0,220000,220000,0,0,220000,Null,Null,13410632,48249,11605
13415775,3941.0,3941.0,22000,18000,4000,18,22000,Null,Null,13415775,270981,17170
13415779,3499.0,3499.0,35000,30000,5000,14,35000,Null,Null,13415779,270981,1520
13415980,9345.0,9345.0,40000,40000,0,0,40000,Null,Null,13415980,257839,1520
13416097,3441.0,3441.0,120000,91100,28900,24,120000,Null,Null,13416097,270981,2
13417532,192.0,192.0,32000,32000,0,0,32000,Null,Null,13417532,111461,8371
13418741,162.0,162.0,32000,32000,0,0,32000,Null,Null,13418741,111461,1883
13422769,3.0,3.0,137000,137000,0,0,137000,Null,Null,13422769,111461,23052
13441106,0.0,0.0,6400000,6400000,0,0,6400000,Null,Null,13441106,25502,914
13441115,0.0,0.0,6400000,6400000,0,0,6400000,Null,Null,13441115,25502,914
13446270,49.0,49.0,726000,566280,159720,22,726000,Null,Null,13446270,26150,914
13446755,22.0,22.0,726000,566280,159720,22,726000,Null,Null,13446755,26150,914
13448587,29.0,29.0,648000,505440,142560,22,648000,Null,Null,13448587,26150,914
13449548,7.0,7.0,648000,505000,143000,22,648000,Null,Null,13449548,26150,914
13451491,42.0,42.0,79900,79900,0,0,79900,Null,Null,13451491,111461,23246
13452654,152.0,152.0,509000,509000,0,0,509000,Null,Null,13452654,150002,1815
13453293,2878.0,2878.0,50000,44000,6000,12,50000,Null,Null,13453293,270981,13878
13453545,74.0,74.0,1299000,769000,530000,41,1299000,Null,Null,13453545,18991,1804
13461202,3.0,3.0,752000,601600,150400,20,752000,Null,Null,13461202,26150,914
13462821,25.0,25.0,932000,726960,205040,22,932000,Null,Null,13462821,26150,914
13465032,17.0,17.0,856000,667680,188320,22,856000,Null,Null,13465032,26150,914
13465532,6.0,6.0,550000,550000,0,0,550000,Null,Null,13465532,111461,23392
13469075,0.0,0.0,5950000,5950000,0,0,5950000,Null,Null,13469075,25502,914
13493375,1.0,1.0,9500000,9500000,0,0,9500000,Null,Null,13493375,25502,914
13511836,0.0,0.0,6800000,6800000,0,0,6800000,Null,Null,13511836,303445,3424
13512147,0.0,0.0,12100000,12100000,0,0,12100000,Null,Null,13512147,25502,914
13514446,0.0,0.0,8000000,8000000,0,0,8000000,Null,Null,13514446,303445,3424
13522656,0.0,0.0,4820000,4820000,0,0,4820000,Null,Null,13522656,287227,1520
13556522,52.0,52.0,139000,99000,40000,29,139000,Null,Null,13556522,111461,2657
13561921,101.0,101.0,405000,239000,166000,41,405000,Null,Null,13561921,48077,2512
13563968,41.0,41.0,899000,789000,110000,12,899000,Null,Null,13563968,46363,914
13566978,400.0,400.0,1850000,1850000,0,0,1850000,Null,Null,13566978,153733,17170
13566981,311.0,311.0,1850000,1757000,93000,5,1850000,Null,Null,13566981,153733,17170
13573119,28.0,28.0,856000,667680,188320,22,856000,Null,Null,13573119,26150,914
13573178,28.0,28.0,856000,667680,188320,22,856000,Null,Null,13573178,26150,914
13576359,6.0,6.0,59900,59900,0,0,59900,Null,Null,13576359,111461,1815
13578986,173.0,173.0,289000,202000,87000,30,289000,Null,Null,13578986,167567,2347
13579822,0.0,0.0,0,17500000,0,0,17500000,Null,Null,13579822,276543,0
13580833,0.0,0.0,0,17620000,0,0,17620000,Null,Null,13580833,276543,0
13582155,0.0,0.0,0,17600000,0,0,17600000,Null,Null,13582155,276543,0
13586633,0.0,0.0,63000,63000,0,0,63000,Null,Null,13586633,111461,1815
13593048,0.0,0.0,8900000,8900000,0,0,8900000,Null,Null,13593048,356243,1520
13619700,47.0,47.0,570000,570000,0,0,570000,Null,Null,13619700,26150,914
13624971,43.0,43.0,380000,380000,0,0,380000,Null,Null,13624971,867937,914
13629677,36.0,36.0,777000,555000,222000,29,777000,Null,Null,13629677,26150,914
13632171,71.0,71.0,57000,49000,8000,14,57000,Null,Null,13632171,111461,1815
13672532,0.0,0.0,8440000,8440000,0,0,8440000,Null,Null,13672532,25502,914
13672616,116.0,116.0,81900,81900,0,0,81900,Null,Null,13672616,111461,1815
13725206,0.0,0.0,6632727,6301091,331636,5,6632727,Null,Null,13725206,27449,1520
13728683,859.0,859.0,249000,199000,50000,20,249000,Null,Null,13728683,362275,1520
13740690,44.0,44.0,90000,90000,0,0,90000,Null,Null,13740690,243693,1815
13745119,2991.0,2991.0,600000,600000,0,0,600000,Null,Null,13745119,243913,12876
13769001,0.0,0.0,6200000,6200000,0,0,6200000,Null,Null,13769001,25502,914
13769238,232.0,232.0,651000,651000,0,0,651000,Null,Null,13769238,47615,1520
13778069,5.0,5.0,6200000,6200000,0,0,6200000,Null,Null,13778069,27449,1520
13781306,105.0,105.0,135000,135000,0,0,135000,Null,Null,13781306,25422,1804
13781435,0.0,0.0,6830000,6830000,0,0,6830000,Null,Null,13781435,25502,914
13781449,0.0,0.0,8190000,8190000,0,0,8190000,Null,Null,13781449,25502,914
13781962,293.0,293.0,91900,91900,0,0,91900,Null,Null,13781962,111461,28688
13782255,0.0,0.0,11030000,11030000,0,0,11030000,Null,Null,13782255,25502,914
13794059,1.0,1.0,1140000,855000,285000,25,1140000,Null,Null,13794059,26150,914
13796867,1.0,1.0,3600000,3600000,0,0,3600000,Null,Null,13796867,354721,3426
13798652,22.0,22.0,149000,149000,0,0,149000,Null,Null,13798652,47882,2
13802665,5.0,5.0,15000,15000,0,0,15000,Null,Null,13802665,111461,1815
13806833,0.0,0.0,354000,354000,0,0,354000,Null,Null,13806833,111461,914
13808285,159.0,159.0,165000,165000,0,0,165000,Null,Null,13808285,243693,1815
13813062,0.0,0.0,4618500,4618500,0,0,4618500,Null,Null,13813062,27449,1520
13824600,5521.0,5521.0,89000,76000,13000,15,89000,Null,Null,13824600,199937,1520
13850161,308.0,308.0,181000,132000,49000,27,181000,Null,Null,13850161,47663,1520
13861338,12.0,12.0,169000,149000,20000,12,169000,Null,Null,13861338,284381,1583
13884156,0.0,0.0,237000,237000,0,0,237000,Null,Null,13884156,243693,1815
13885854,3.0,3.0,110000,110000,0,0,110000,Null,Null,13885854,111461,914
13888246,0.0,0.0,6800000,6800000,0,0,6800000,Null,Null,13888246,25502,914
13894957,17.0,17.0,726000,566280,159720,22,726000,Null,Null,13894957,26150,914
13901129,101.0,101.0,5900,5900,0,0,5900,Null,Null,13901129,111461,1815
13906331,12.0,12.0,33000,33000,0,0,33000,Null,Null,13906331,111461,1815
13917613,69.0,69.0,154500,154500,0,0,154500,Null,Null,13917613,111461,2234
13951782,6.0,6.0,105000,105000,0,0,105000,Null,Null,13951782,111461,914
13952791,995.0,995.0,105000,92500,12500,12,105000,Null,Null,13952791,199937,1520
13959440,0.0,0.0,7800000,7800000,0,0,7800000,Null,Null,13959440,25502,914
13977044,0.0,0.0,7800000,7800000,0,0,7800000,Null,Null,13977044,25502,914
14014436,0.0,0.0,6800000,6800000,0,0,6800000,Null,Null,14014436,25502,914
14019904,9.0,9.0,88000,88000,0,0,88000,Null,Null,14019904,111461,23352
14027426,0.0,0.0,7140000,7140000,0,0,7140000,Null,Null,14027426,25502,914
14033757,740.0,740.0,27000,27000,0,0,27000,Null,Null,14033757,287339,1815
14035390,25.0,25.0,120000,120000,0,0,120000,Null,Null,14035390,21672,914
14035850,5.0,5.0,164000,164000,0,0,164000,Null,Null,14035850,111461,914
14037500,930.0,930.0,339000,339000,0,0,339000,Null,Null,14037500,151948,1520
14037531,0.0,0.0,7900000,7900000,0,0,7900000,Null,Null,14037531,25502,914
14040250,2271.0,2271.0,220000,217500,2500,1,220000,Null,Null,14040250,199937,1520
14041401,0.0,0.0,10385000,10385000,0,0,10385000,Null,Null,14041401,25502,914
14043881,0.0,0.0,8250000,8250000,0,0,8250000,Null,Null,14043881,25502,914
14045003,0.0,0.0,8250000,8250000,0,0,8250000,Null,Null,14045003,25502,914
14047843,2.0,2.0,72000,72000,0,0,72000,Null,Null,14047843,111461,914
14051440,305.0,305.0,87000,87000,0,0,87000,Null,Null,14051440,34398,1520
14053043,1.0,1.0,13130000,13130000,0,0,13130000,Null,Null,14053043,25502,914
14053070,0.0,0.0,9240000,9240000,0,0,9240000,Null,Null,14053070,25502,914
14054459,0.0,0.0,9700000,9700000,0,0,9700000,Null,Null,14054459,25502,914
14055934,0.0,0.0,12300000,12300000,0,0,12300000,Null,Null,14055934,25502,914
14056344,0.0,0.0,8900000,8900000,0,0,8900000,Null,Null,14056344,25502,914
14059142,0.0,0.0,13500000,13500000,0,0,13500000,Null,Null,14059142,25502,914
14059194,0.0,0.0,13500000,13500000,0,0,13500000,Null,Null,14059194,25502,914
14061244,0.0,0.0,7350000,7350000,0,0,7350000,Null,Null,14061244,25502,914
14061292,0.0,0.0,7885000,7885000,0,0,7885000,Null,Null,14061292,25502,914
14069500,0.0,0.0,9685000,9685000,0,0,9685000,Null,Null,14069500,25502,914
14071739,216.0,216.0,15000,15000,0,0,15000,Null,Null,14071739,111461,1815
14074424,0.0,0.0,5960000,5960000,0,0,5960000,Null,Null,14074424,25502,5385
14075868,270.0,270.0,269000,269000,0,0,269000,Null,Null,14075868,111461,914
14076815,1.0,1.0,95000,95000,0,0,95000,Null,Null,14076815,111461,2
14080270,6.0,6.0,169000,169000,0,0,169000,Null,Null,14080270,274015,914
14088151,125.0,125.0,195000,195000,0,0,195000,Null,Null,14088151,111461,27180
14088456,46.0,46.0,108900,108900,0,0,108900,Null,Null,14088456,111461,5995
14098366,0.0,0.0,6850000,6850000,0,0,6850000,Null,Null,14098366,112278,914
14113600,0.0,0.0,9240000,9240000,0,0,9240000,Null,Null,14113600,25502,914
14114183,75.0,75.0,399000,290000,109000,27,399000,Null,Null,14114183,165897,1815
14114437,9019.0,9019.0,190000,171000,19000,10,190000,Null,Null,14114437,86206,3422
14115539,23627.0,23627.0,109000,90000,19000,17,109000,Null,Null,14115539,86206,11605
14115720,0.0,0.0,8180000,8180000,0,0,8180000,Null,Null,14115720,25502,5384
14116324,111.0,111.0,50000,48000,2000,4,50000,Null,Null,14116324,111461,1815
14136607,0.0,0.0,0,6100000,0,0,6100000,Null,Null,14136607,276543,0
14137659,0.0,0.0,0,6000000,0,0,6000000,Null,Null,14137659,276543,0
14141223,12.0,12.0,5000,5000,0,0,5000,Null,Null,14141223,111461,1815
14143240,0.0,0.0,3920000,3920000,0,0,3920000,Null,Null,14143240,291997,17170
14144738,30.0,30.0,65000,65000,0,0,65000,Null,Null,14144738,111461,914
14147871,0.0,0.0,3920000,3920000,0,0,3920000,Null,Null,14147871,291997,3424
14152302,0.0,0.0,0,6000000,0,0,6000000,Null,Null,14152302,276543,0
14152687,0.0,0.0,0,6100000,0,0,6100000,Null,Null,14152687,276543,0
14153015,0.0,0.0,0,6120000,0,0,6120000,Null,Null,14153015,276543,0
14158420,0.0,0.0,0,6100000,0,0,6100000,Null,Null,14158420,276543,0
14158969,0.0,0.0,0,6120000,0,0,6120000,Null,Null,14158969,276543,0
14161163,0.0,0.0,0,6120000,0,0,6120000,Null,Null,14161163,276543,0
14163243,0.0,0.0,0,6120000,0,0,6120000,Null,Null,14163243,276543,0
14164983,0.0,0.0,0,6120000,0,0,6120000,Null,Null,14164983,276543,0
14165254,0.0,0.0,0,6120000,0,0,6120000,Null,Null,14165254,276543,0
14165835,0.0,0.0,9044000,9044000,0,0,9044000,Null,Null,14165835,291997,8227
14180626,86.0,86.0,120000,109000,11000,9,120000,Null,Null,14180626,185083,1815
14198509,0.0,0.0,32000,32000,0,0,32000,Null,Null,14198509,111461,2
14234064,30.0,30.0,128000,122500,5500,4,128000,Null,Null,14234064,111461,1815
14253932,1.0,1.0,1536000,1536000,0,0,1536000,Null,Null,14253932,159441,2
14260991,15.0,15.0,398000,398000,0,0,398000,Null,Null,14260991,111461,914
14262916,1.0,1.0,4500000,3600000,900000,20,4500000,Null,Null,14262916,231355,17170
14265381,0.0,0.0,186000,186000,0,0,186000,Null,Null,14265381,111461,1883
14265753,37.0,37.0,107900,107900,0,0,107900,Null,Null,14265753,111461,21440
14267221,0.0,0.0,250000,250000,0,0,250000,Null,Null,14267221,111461,6305
14294271,293.0,293.0,390000,390000,0,0,390000,Null,Null,14294271,315335,5893
14301319,1.0,1.0,6785000,6785000,0,0,6785000,Null,Null,14301319,25502,2
14301323,0.0,0.0,12880000,8372000,4508000,35,12880000,Null,Null,14301323,25502,2
14311159,11.0,11.0,425000,425000,0,0,425000,Null,Null,14311159,111461,914
14327919,1282.0,1282.0,105000,91000,14000,13,105000,Null,Null,14327919,199937,1520
14328401,10.0,10.0,9500,9500,0,0,9500,Null,Null,14328401,111461,1815
14336296,962.0,962.0,156000,156000,0,0,156000,Null,Null,14336296,2297339,1520
14347772,51.0,51.0,500000,500000,0,0,500000,Null,Null,14347772,867937,914
14350763,7.0,7.0,22590000,19500000,3090000,14,22590000,Null,Null,14350763,21673,8067
14350791,14.0,14.0,20900000,18040000,2860000,14,20900000,Null,Null,14350791,21673,28860
14351823,0.0,0.0,9720000,9720000,0,0,9720000,Null,Null,14351823,25502,5385
14352546,0.0,0.0,21400000,21400000,0,0,21400000,Null,Null,14352546,25502,5385
14352708,0.0,0.0,11760000,11760000,0,0,11760000,Null,Null,14352708,25502,5385
14371622,0.0,0.0,7750000,7750000,0,0,7750000,Null,Null,14371622,25502,5385
14372287,0.0,0.0,8250000,8250000,0,0,8250000,Null,Null,14372287,25502,5385
14372621,0.0,0.0,7750000,7750000,0,0,7750000,Null,Null,14372621,25502,914
14376468,0.0,0.0,9500000,9500000,0,0,9500000,Null,Null,14376468,25502,5385
14376560,0.0,0.0,10985000,10985000,0,0,10985000,Null,Null,14376560,25502,5385
14377042,0.0,0.0,8170000,8170000,0,0,8170000,Null,Null,14377042,25502,5385
14379218,0.0,0.0,6885000,6885000,0,0,6885000,Null,Null,14379218,25502,5385
14379314,0.0,0.0,8185000,8185000,0,0,8185000,Null,Null,14379314,25502,914
14388300,0.0,0.0,6400000,6400000,0,0,6400000,Null,Null,14388300,25502,914
14388343,0.0,0.0,7400000,7400000,0,0,7400000,Null,Null,14388343,25502,914
14388580,0.0,0.0,7110000,7110000,0,0,7110000,Null,Null,14388580,25502,5385
14388590,120.0,120.0,63500,63500,0,0,63500,Null,Null,14388590,174069,1815
14409505,0.0,0.0,10785000,10785000,0,0,10785000,Null,Null,14409505,25502,914
14422618,719.0,719.0,230000,180000,50000,22,230000,Null,Null,14422618,110481,1520
14423069,116.0,116.0,180000,118000,62000,34,180000,Null,Null,14423069,110481,1520
14433172,1.0,1.0,648000,518400,129600,20,648000,Null,Null,14433172,26150,914
14437808,1.0,1.0,207000,207000,0,0,207000,Null,Null,14437808,111461,2
14439234,8.0,8.0,648000,505440,142560,22,648000,Null,Null,14439234,26150,914
14448351,539.0,539.0,45000,45000,0,0,45000,Null,Null,14448351,180597,11605
14448546,158.0,158.0,60900,60900,0,0,60900,Null,Null,14448546,111461,23184
14449810,129.0,129.0,429000,429000,0,0,429000,Null,Null,14449810,20304,2136
14453020,0.0,0.0,6450000,6450000,0,0,6450000,Null,Null,14453020,112278,914
14453081,9.0,9.0,199000,195000,4000,2,199000,Null,Null,14453081,111461,2266
14453485,40.0,40.0,9000,9000,0,0,9000,Null,Null,14453485,111461,2363
14462132,1607.0,1607.0,169000,169000,0,0,169000,Null,Null,14462132,20304,1984
14471583,314.0,314.0,365000,365000,0,0,365000,Null,Null,14471583,151948,1520
14473623,2.0,2.0,549000,549000,0,0,549000,Null,Null,14473623,167853,2
14473627,4.0,4.0,494000,494000,0,0,494000,Null,Null,14473627,167853,2
14487415,1.0,1.0,28900,28900,0,0,28900,Null,Null,14487415,111461,2363
14500140,135.0,135.0,33500,33500,0,0,33500,Null,Null,14500140,111461,1815
14503524,1.0,1.0,7000000,7000000,0,0,7000000,Null,Null,14503524,111461,914
14508445,0.0,0.0,4200000,4200000,0,0,4200000,Null,Null,14508445,65095,8061
14510106,1.0,1.0,6499000,6499000,0,0,6499000,Null,Null,14510106,145556,914
14510155,0.0,0.0,6499000,6499000,0,0,6499000,Null,Null,14510155,145556,914
14518392,0.0,0.0,37200000,37200000,0,0,37200000,Null,Null,14518392,370043,11858
14518742,0.0,0.0,5800000,5800000,0,0,5800000,Null,Null,14518742,111461,914
14520200,250.0,250.0,49900,49900,0,0,49900,Null,Null,14520200,21653,1804
14520705,0.0,0.0,6360000,6360000,0,0,6360000,Null,Null,14520705,25502,5385
14529455,1.0,1.0,439000,439000,0,0,439000,Null,Null,14529455,167853,2
14532392,383.0,383.0,1190000,785000,405000,34,1190000,Null,Null,14532392,33203,1520
14537493,0.0,0.0,28000000,28000000,0,0,28000000,Null,Null,14537493,153444,11516
14537503,0.0,0.0,27290000,27290000,0,0,27290000,Null,Null,14537503,153444,11516
14537564,6.0,6.0,1159000,1159000,0,0,1159000,Null,Null,14537564,18984,1815
14548339,13.0,13.0,87000,87000,0,0,87000,Null,Null,14548339,111461,5385
14564566,0.0,0.0,65999,65999,0,0,65999,Null,Null,14564566,111461,2154
14566971,0.0,0.0,12200000,12200000,0,0,12200000,Null,Null,14566971,153444,11516
14566975,1.0,1.0,13000000,13000000,0,0,13000000,Null,Null,14566975,153444,11516
14602160,442.0,442.0,74000,74000,0,0,74000,Null,Null,14602160,111461,5995
14605245,39.0,39.0,114790,114790,0,0,114790,Null,Null,14605245,111461,28736
14605484,179.0,179.0,459000,459000,0,0,459000,Null,Null,14605484,20304,2136
14608248,1.0,1.0,1400000,1400000,0,0,1400000,Null,Null,14608248,111461,914
14610009,679.0,679.0,69000,69000,0,0,69000,Null,Null,14610009,113125,2
14615267,9.0,9.0,166000,166000,0,0,166000,Null,Null,14615267,111461,1815
14615461,29.0,29.0,18900,18900,0,0,18900,Null,Null,14615461,111461,1815
14617774,4258.0,4258.0,1200000,1134000,66000,6,1200000,Null,Null,14617774,47489,1520
14626062,2.0,2.0,255000,255000,0,0,255000,Null,Null,14626062,111461,914
14632541,28.0,28.0,49000,49000,0,0,49000,Null,Null,14632541,111461,1883
14638710,127.0,127.0,290000,185000,105000,36,290000,Null,Null,14638710,111461,1634
14639274,451.0,451.0,209000,209000,0,0,209000,Null,Null,14639274,20304,1883
14639395,296.0,296.0,449000,449000,0,0,449000,Null,Null,14639395,20304,2136
14640240,14.0,14.0,45999,45999,0,0,45999,Null,Null,14640240,111461,1883
14640564,0.0,0.0,75000,75000,0,0,75000,Null,Null,14640564,111461,53074
14654460,0.0,0.0,8929000,8929000,0,0,8929000,Null,Null,14654460,145556,914
14654692,0.0,0.0,8929000,8929000,0,0,8929000,Null,Null,14654692,145556,914
14681200,184.0,184.0,320000,302000,18000,6,320000,Null,Null,14681200,48399,1520
14681534,1.0,1.0,43900,43900,0,0,43900,Null,Null,14681534,111461,2266
14682964,8.0,8.0,13680,13680,0,0,13680,Null,Null,14682964,111461,2
14694900,3052.0,3052.0,115920,111000,4920,4,115920,Null,Null,14694900,208105,13878
14702862,2.0,2.0,27000,27000,0,0,27000,Null,Null,14702862,111461,914
14706909,15.0,15.0,29000,29000,0,0,29000,Null,Null,14706909,111461,1815
14707534,547.0,547.0,68000,46000,22000,32,68000,Null,Null,14707534,199937,1583
14707617,372.0,372.0,73900,73900,0,0,73900,Null,Null,14707617,111461,1815
14708536,568.0,568.0,200000,200000,0,0,200000,Null,Null,14708536,370711,1520
14709478,59.0,59.0,259000,259000,0,0,259000,Null,Null,14709478,250531,2347
14721745,0.0,0.0,920000,469000,451000,49,920000,Null,Null,14721745,4647777,914
14758377,1033.0,1033.0,916000,370000,546000,60,916000,Null,Null,14758377,145335,1520
14759011,0.0,0.0,4540000,4540000,0,0,4540000,Null,Null,14759011,374249,1520
14759149,0.0,0.0,10500000,10500000,0,0,10500000,Null,Null,14759149,374249,1520
14759548,0.0,0.0,10500000,10500000,0,0,10500000,Null,Null,14759548,374249,1520
14760204,0.0,0.0,13800000,13800000,0,0,13800000,Null,Null,14760204,374249,1520
14760318,0.0,0.0,10500000,10500000,0,0,10500000,Null,Null,14760318,374249,1520
14760760,0.0,0.0,19000000,19000000,0,0,19000000,Null,Null,14760760,374249,1520
14761019,0.0,0.0,12250000,12250000,0,0,12250000,Null,Null,14761019,374249,1520
14762189,0.0,0.0,17736000,17736000,0,0,17736000,Null,Null,14762189,374249,1520
14762479,0.0,0.0,16500000,16500000,0,0,16500000,Null,Null,14762479,374249,1520
14764119,2969.0,2969.0,299000,269000,30000,10,299000,Null,Null,14764119,363961,3177
14774272,48.0,48.0,148400,148400,0,0,148400,Null,Null,14774272,111461,1815
14775214,301.0,301.0,99000,99000,0,0,99000,Null,Null,14775214,251107,1520
14777267,146.0,146.0,99000,99000,0,0,99000,Null,Null,14777267,251107,1520
14785089,0.0,0.0,24900000,24900000,0,0,24900000,Null,Null,14785089,162945,2
14790073,15.0,15.0,15000,15000,0,0,15000,Null,Null,14790073,111461,1815
14791322,5.0,5.0,1088000,848640,239360,22,1088000,Null,Null,14791322,26150,2
14813516,8.0,8.0,259000,259000,0,0,259000,Null,Null,14813516,111461,914
14815054,9.0,9.0,259000,259000,0,0,259000,Null,Null,14815054,111461,914
14838805,312.0,312.0,9000,9000,0,0,9000,Null,Null,14838805,111461,7064
14851010,2.0,2.0,220000,220000,0,0,220000,Null,Null,14851010,239943,914
14852160,50.0,50.0,1250000,1250000,0,0,1250000,Null,Null,14852160,153733,1520
14852877,546.0,546.0,7500,7500,0,0,7500,Null,Null,14852877,233085,1520
14867796,3.0,3.0,3852000,3852000,0,0,3852000,Null,Null,14867796,402287,1520
14874555,0.0,0.0,6650000,6650000,0,0,6650000,Null,Null,14874555,402287,1520
14884863,11.0,11.0,450000,410000,40000,9,450000,Null,Null,14884863,173547,914
14885390,61.0,61.0,349000,349000,0,0,349000,Null,Null,14885390,360443,914
14901432,1910.0,1910.0,1250000,999000,251000,20,1250000,Null,Null,14901432,33203,1520
14901584,181.0,181.0,1350000,1050000,300000,22,1350000,Null,Null,14901584,33203,1520
14902362,204.0,204.0,345000,345000,0,0,345000,Null,Null,14902362,282065,27180
14903311,5.0,5.0,69000,69000,0,0,69000,Null,Null,14903311,111461,914
14903396,3.0,3.0,69000,69000,0,0,69000,Null,Null,14903396,111461,914
14903787,29.0,29.0,388000,350000,38000,10,388000,Null,Null,14903787,173547,914
14904277,12.0,12.0,461000,420000,41000,9,461000,Null,Null,14904277,173547,914
14924192,454.0,454.0,249000,219000,30000,12,249000,Null,Null,14924192,317315,17162
14926740,244.0,244.0,400000,380000,20000,5,400000,Null,Null,14926740,173547,914
14948942,0.0,0.0,684000,349000,335000,49,684000,Null,Null,14948942,4647777,15318
14950297,12.0,12.0,58697,58697,0,0,58697,Null,Null,14950297,111461,2948
14958833,10.0,10.0,4150000,3550000,600000,14,4150000,Null,Null,14958833,402287,1520
14959490,12.0,12.0,69000,69000,0,0,69000,Null,Null,14959490,111461,914
14967278,0.0,0.0,4200000,4200000,0,0,4200000,Null,Null,14967278,321805,1520
14968172,0.0,0.0,8000000,8000000,0,0,8000000,Null,Null,14968172,321805,3424
14969639,0.0,0.0,9000000,9000000,0,0,9000000,Null,Null,14969639,321805,53350
14970237,1.0,1.0,4200000,4200000,0,0,4200000,Null,Null,14970237,321805,1601
14971891,148.0,148.0,400000,340000,60000,15,400000,Null,Null,14971891,173547,914
14972282,0.0,0.0,999000,669000,330000,33,999000,Null,Null,14972282,4647777,15318
14973443,0.0,0.0,1169700,1169700,0,0,1169700,Null,Null,14973443,111461,1883
14980091,0.0,0.0,6600000,6600000,0,0,6600000,Null,Null,14980091,321805,1601
14980530,4.0,4.0,8000000,8000000,0,0,8000000,Null,Null,14980530,321805,17170
14981747,1512.0,1512.0,300000,252000,48000,16,300000,Null,Null,14981747,277519,1883
14982347,0.0,0.0,7400000,7400000,0,0,7400000,Null,Null,14982347,321805,1601
14984394,18.0,18.0,500000,500000,0,0,500000,Null,Null,14984394,867937,914
14988097,3.0,3.0,8000000,8000000,0,0,8000000,Null,Null,14988097,321805,3424
14990597,1.0,1.0,3600000,3600000,0,0,3600000,Null,Null,14990597,321805,17170
14990980,0.0,0.0,7600000,7600000,0,0,7600000,Null,Null,14990980,321805,53350
14992132,0.0,0.0,4200000,4200000,0,0,4200000,Null,Null,14992132,321805,3424
14992380,17.0,17.0,149500,149500,0,0,149500,Null,Null,14992380,111461,914
14992443,0.0,0.0,5200000,5200000,0,0,5200000,Null,Null,14992443,321805,53350
15013997,33.0,33.0,179000,165000,14000,8,179000,Null,Null,15013997,21651,1815
15050073,5.0,5.0,300000,300000,0,0,300000,Null,Null,15050073,867937,914
15050146,2.0,2.0,8000000,8000000,0,0,8000000,Null,Null,15050146,303445,17170
15050278,0.0,0.0,11400000,11400000,0,0,11400000,Null,Null,15050278,303445,1601
15050908,2.0,2.0,979000,489000,490000,50,979000,Null,Null,15050908,46363,2
15050969,0.0,0.0,1445000,1445000,0,0,1445000,Null,Null,15050969,145556,15318
15052942,0.0,0.0,3400000,3400000,0,0,3400000,Null,Null,15052942,303445,1520
15062418,56.0,56.0,159000,159000,0,0,159000,Null,Null,15062418,281343,914
15063796,1280.0,1280.0,149778,149778,0,0,149778,Null,Null,15063796,370711,1520
15066578,80.0,80.0,135000,135000,0,0,135000,Null,Null,15066578,281343,914
15073639,2.0,2.0,108900,108900,0,0,108900,Null,Null,15073639,154319,914
15081704,9.0,9.0,108900,108900,0,0,108900,Null,Null,15081704,154319,914
15082345,22.0,22.0,29000,14500,14500,50,29000,Null,Null,15082345,111461,1815
15099154,1.0,1.0,1806000,1806000,0,0,1806000,Null,Null,15099154,145556,2
15099162,0.0,0.0,6020000,6020000,0,0,6020000,Null,Null,15099162,145556,15318
15099226,0.0,0.0,6020000,6020000,0,0,6020000,Null,Null,15099226,145556,2
15099462,4.0,4.0,69000,69000,0,0,69000,Null,Null,15099462,111461,914
15100573,3.0,3.0,126000,126000,0,0,126000,Null,Null,15100573,154319,15250
15134851,529.0,529.0,240000,240000,0,0,240000,Null,Null,15134851,275197,1520
15148097,114.0,114.0,36000,18540,17460,49,36000,Null,Null,15148097,111461,51698
15149797,2428.0,2428.0,148000,148000,0,0,148000,Null,Null,15149797,298405,1520
15164014,8.0,8.0,19999,19999,0,0,19999,Null,Null,15164014,111461,53074
15186378,23.0,23.0,365000,349000,16000,4,365000,Null,Null,15186378,18845,1815
15198025,20.0,20.0,19000,19000,0,0,19000,Null,Null,15198025,111461,914
15198599,241.0,241.0,28900,28900,0,0,28900,Null,Null,15198599,111461,1815
15230725,0.0,0.0,53229000,53229000,0,0,53229000,Null,Null,15230725,50368,1815
15231971,0.0,0.0,53229000,53229000,0,0,53229000,Null,Null,15231971,50368,1815
15236274,78.0,78.0,80000,80000,0,0,80000,Null,Null,15236274,326671,1811
15240484,90.0,90.0,36500,36500,0,0,36500,Null,Null,15240484,111461,1883
15248566,112.0,112.0,38500,38500,0,0,38500,Null,Null,15248566,111461,1815
15249707,47.0,47.0,58000,58000,0,0,58000,Null,Null,15249707,111461,23010
15251528,75.0,75.0,35750,31000,4750,13,35750,Null,Null,15251528,111461,1815
15252783,71.0,71.0,299000,222000,77000,26,299000,Null,Null,15252783,111461,1634
15254519,59.0,59.0,125000,125000,0,0,125000,Null,Null,15254519,281343,914
15261572,5.0,5.0,19000,19000,0,0,19000,Null,Null,15261572,111461,1815
15271823,0.0,0.0,39840000,39840000,0,0,39840000,Null,Null,15271823,217953,7079
15272198,0.0,0.0,51280000,51280000,0,0,51280000,Null,Null,15272198,217953,7079
15272449,0.0,0.0,47090000,47090000,0,0,47090000,Null,Null,15272449,217953,7079
15272853,0.0,0.0,16620000,16620000,0,0,16620000,Null,Null,15272853,217953,7079
15280632,60.0,60.0,71890,71890,0,0,71890,Null,Null,15280632,111461,28480
15308102,138.0,138.0,48000,48000,0,0,48000,Null,Null,15308102,111461,8371
15318167,81.0,81.0,300000,300000,0,0,300000,Null,Null,15318167,274015,914
15333263,1086.0,1086.0,229000,129000,100000,44,229000,Null,Null,15333263,230607,2337
15336035,0.0,0.0,50000000,50000000,0,0,50000000,Null,Null,15336035,303445,53350
15337011,0.0,0.0,9000000,9000000,0,0,9000000,Null,Null,15337011,303445,53350
15342107,311.0,311.0,139000,111000,28000,20,139000,Null,Null,15342107,111461,1634
15343778,632.0,632.0,249000,162000,87000,35,249000,Null,Null,15343778,230607,23258
15350332,2.0,2.0,3985000,3546650,438350,11,3985000,Null,Null,15350332,205847,1520
15363917,0.0,0.0,16599000,16599000,0,0,16599000,Null,Null,15363917,154754,5385
15366901,235.0,235.0,55000,55000,0,0,55000,Null,Null,15366901,41528,1815
15367297,216.0,216.0,69000,69000,0,0,69000,Null,Null,15367297,19107,1815
15377266,992.0,992.0,129000,99000,30000,23,129000,Null,Null,15377266,111461,2659
15387114,14.0,14.0,87000,87000,0,0,87000,Null,Null,15387114,407561,914
15389238,102.0,102.0,147489,147489,0,0,147489,Null,Null,15389238,111461,1815
15394294,0.0,0.0,6599000,6599000,0,0,6599000,Null,Null,15394294,154754,914
15399091,0.0,0.0,10599000,10599000,0,0,10599000,Null,Null,15399091,154754,914
15399374,0.0,0.0,9699000,9699000,0,0,9699000,Null,Null,15399374,154754,914
15399754,1.0,1.0,79000,79000,0,0,79000,Null,Null,15399754,111461,914
15399999,0.0,0.0,8599000,8599000,0,0,8599000,Null,Null,15399999,154754,5384
15402658,3.0,3.0,5890000,5890000,0,0,5890000,Null,Null,15402658,154754,914
15408068,0.0,0.0,6599000,6599000,0,0,6599000,Null,Null,15408068,154754,914
15415827,0.0,0.0,6497000,6497000,0,0,6497000,Null,Null,15415827,145556,15318
15416268,0.0,0.0,6497000,6497000,0,0,6497000,Null,Null,15416268,145556,914
15420585,0.0,0.0,17432000,17432000,0,0,17432000,Null,Null,15420585,145556,914
15428054,1280.0,1280.0,175000,175000,0,0,175000,Null,Null,15428054,111461,23362
15428103,2500.0,2500.0,69000,69000,0,0,69000,Null,Null,15428103,193489,1815
15428119,0.0,0.0,4500000,4500000,0,0,4500000,Null,Null,15428119,65095,8061
15432912,951.0,951.0,19000,19000,0,0,19000,Null,Null,15432912,111461,1815
15448334,17.0,17.0,60999,60999,0,0,60999,Null,Null,15448334,111461,914
15461573,630.0,630.0,65000,52000,13000,20,65000,Null,Null,15461573,47663,1520
15467874,8.0,8.0,100000,100000,0,0,100000,Null,Null,15467874,111461,914
15518054,3.0,3.0,685000,685000,0,0,685000,Null,Null,15518054,111461,1883
15519526,33.0,33.0,80000,80000,0,0,80000,Null,Null,15519526,111461,914
15520057,2322.0,2322.0,322000,262000,60000,19,322000,Null,Null,15520057,22013,53350
15533180,1.0,1.0,5900000,5900000,0,0,5900000,Null,Null,15533180,290029,15250
15595231,191.0,191.0,44000,44000,0,0,44000,Null,Null,15595231,111461,1805
15602620,80.0,80.0,297998,148999,148999,50,297998,Null,Null,15602620,149308,1815
15642165,237.0,237.0,11000,9000,2000,18,11000,Null,Null,15642165,111461,1815
15648384,0.0,0.0,19500000,19500000,0,0,19500000,Null,Null,15648384,153444,11516
15648391,0.0,0.0,23378000,23378000,0,0,23378000,Null,Null,15648391,153444,7079
15648577,0.0,0.0,23228000,23228000,0,0,23228000,Null,Null,15648577,153444,7079
15654151,72.0,72.0,145000,80000,65000,45,145000,Null,Null,15654151,31581,1601
15655090,402.0,402.0,105000,105000,0,0,105000,Null,Null,15655090,211415,1622
15655877,310.0,310.0,17000,15640,1360,8,17000,Null,Null,15655877,211415,1520
15655918,481.0,481.0,33000,30360,2640,8,33000,Null,Null,15655918,211415,1520
15655975,68.0,68.0,33000,30360,2640,8,33000,Null,Null,15655975,211415,1520
15662471,121.0,121.0,1373000,979000,394000,29,1373000,Null,Null,15662471,26150,914
15665489,1802.0,1802.0,360000,300000,60000,17,360000,Null,Null,15665489,50629,1815
15666493,695.0,695.0,210000,168000,42000,20,210000,Null,Null,15666493,277519,1883
15673134,62.0,62.0,17000,15640,1360,8,17000,Null,Null,15673134,211415,1520
15673601,0.0,0.0,12500000,12500000,0,0,12500000,Null,Null,15673601,111461,1815
15677446,128.0,128.0,164900,142000,22900,14,164900,Null,Null,15677446,196271,1804
15680124,33.0,33.0,9500,9500,0,0,9500,Null,Null,15680124,111461,1815
15682093,4.0,4.0,9170000,6550000,2620000,29,9170000,Null,Null,15682093,405211,914
15687536,2.0,2.0,283000,283000,0,0,283000,Null,Null,15687536,20271,1815
15703213,780.0,780.0,979000,340000,639000,65,979000,Null,Null,15703213,413961,1883
15795542,4229.0,4229.0,119700,102000,17700,15,119700,Null,Null,15795542,217777,13878
15800659,604.0,604.0,490000,457000,33000,7,490000,Null,Null,15800659,21278,1520
15823484,2969.0,2969.0,139000,113000,26000,19,139000,Null,Null,15823484,22013,53350
15823487,1532.0,1532.0,139000,113000,26000,19,139000,Null,Null,15823487,22013,53350
15834087,488.0,488.0,99000,99000,0,0,99000,Null,Null,15834087,111461,1883
15863570,768.0,768.0,340000,334000,6000,2,340000,Null,Null,15863570,370343,1520
15891213,0.0,0.0,1607000,964200,642800,40,1607000,Null,Null,15891213,26150,2
15931478,100.0,100.0,39000,39000,0,0,39000,Null,Null,15931478,111461,1520
15963721,2.0,2.0,75000,75000,0,0,75000,Null,Null,15963721,111461,914
15990126,0.0,0.0,7840000,7840000,0,0,7840000,Null,Null,15990126,291997,8227
15994212,0.0,0.0,5600000,5600000,0,0,5600000,Null,Null,15994212,291997,8227
15995900,0.0,0.0,5600000,5600000,0,0,5600000,Null,Null,15995900,291997,8227
16061455,57.0,57.0,205000,205000,0,0,205000,Null,Null,16061455,25403,1520
16102389,21.0,21.0,39900,39900,0,0,39900,Null,Null,16102389,111461,1815
16105112,17.0,17.0,32000,32000,0,0,32000,Null,Null,16105112,111461,1815
16107196,491.0,491.0,75000,75000,0,0,75000,Null,Null,16107196,111461,5995
16115767,249.0,249.0,25000,25000,0,0,25000,Null,Null,16115767,111461,1815
16117576,810.0,810.0,29000,29000,0,0,29000,Null,Null,16117576,111461,1815
16152589,193.0,193.0,2016000,851000,1165000,58,2016000,Null,Null,16152589,183319,1520
16165720,14.0,14.0,85000,85000,0,0,85000,Null,Null,16165720,111461,5995
16169716,369.0,369.0,210000,137000,73000,35,210000,Null,Null,16169716,212575,1883
16178393,16.0,16.0,84999,84999,0,0,84999,Null,Null,16178393,111461,5995
16192433,51.0,51.0,16000,16000,0,0,16000,Null,Null,16192433,111461,914
16196661,6.0,6.0,33837,33837,0,0,33837,Null,Null,16196661,111461,2266
16197174,11.0,11.0,4000000,3920000,80000,2,4000000,Null,Null,16197174,406479,1520
16197757,0.0,0.0,12900,12900,0,0,12900,Null,Null,16197757,111461,1520
16209014,2.0,2.0,79856,79856,0,0,79856,Null,Null,16209014,111461,914
16211637,24.0,24.0,93000,93000,0,0,93000,Null,Null,16211637,47876,13878
16214220,261.0,261.0,175000,128000,47000,27,175000,Null,Null,16214220,47663,13878
16214309,254.0,254.0,175000,128000,47000,27,175000,Null,Null,16214309,47663,13878
16214455,234.0,234.0,102000,102000,0,0,102000,Null,Null,16214455,111461,5995
16215062,1.0,1.0,919000,469000,450000,49,919000,Null,Null,16215062,4647777,914
16215104,413.0,413.0,175000,130000,45000,26,175000,Null,Null,16215104,47663,13878
16217009,286.0,286.0,33000,33000,0,0,33000,Null,Null,16217009,111461,1804
16217071,0.0,0.0,12000,12000,0,0,12000,Null,Null,16217071,111461,1815
16217285,73.0,73.0,31000,31000,0,0,31000,Null,Null,16217285,111461,2
16221622,0.0,0.0,919000,469000,450000,49,919000,Null,Null,16221622,4647777,15318
16228823,0.0,0.0,14000,14000,0,0,14000,Null,Null,16228823,111461,914
16240461,0.0,0.0,7365000,6629000,736000,10,7365000,Null,Null,16240461,4647777,15318
16240555,0.0,0.0,7365000,6629000,736000,10,7365000,Null,Null,16240555,4647777,914
16259104,706.0,706.0,95000,95000,0,0,95000,Null,Null,16259104,372895,1520
16262699,27.0,27.0,199900,199900,0,0,199900,Null,Null,16262699,111461,28688
16269937,467.0,467.0,64141,64141,0,0,64141,Null,Null,16269937,111461,53054
16284231,2.0,2.0,24970,24970,0,0,24970,Null,Null,16284231,111461,2363
16341786,356.0,356.0,542000,379400,162600,30,542000,Null,Null,16341786,48077,1883
16344389,2020.0,2020.0,330000,330000,0,0,330000,Null,Null,16344389,283249,1520
16362780,101.0,101.0,74000,74000,0,0,74000,Null,Null,16362780,111461,1883
16374973,889.0,889.0,33500,20500,13000,39,33500,Null,Null,16374973,111461,11605
16375528,225.0,225.0,89000,89000,0,0,89000,Null,Null,16375528,419037,2
16378194,234.0,234.0,18900,18900,0,0,18900,Null,Null,16378194,111461,3990
16381598,25.0,25.0,39000,39000,0,0,39000,Null,Null,16381598,111461,914
16443914,676.0,676.0,90000,90000,0,0,90000,Null,Null,16443914,372895,1520
16461612,16.0,16.0,3550000,3550000,0,0,3550000,Null,Null,16461612,316217,1520
16465563,128.0,128.0,310000,310000,0,0,310000,Null,Null,16465563,152806,914
16518032,18.0,18.0,730000,730000,0,0,730000,Null,Null,16518032,18804,8061
16518573,2094.0,2094.0,198000,198000,0,0,198000,Null,Null,16518573,372895,1520
16518729,2.0,2.0,850000,850000,0,0,850000,Null,Null,16518729,18804,8061
16519876,21.0,21.0,38900,38900,0,0,38900,Null,Null,16519876,111461,53190
16520424,0.0,0.0,800000,800000,0,0,800000,Null,Null,16520424,18804,8061
16520899,3.0,3.0,188999,188999,0,0,188999,Null,Null,16520899,111461,2
16521748,21.0,21.0,1150000,1150000,0,0,1150000,Null,Null,16521748,18804,8061
16523479,87.0,87.0,580000,580000,0,0,580000,Null,Null,16523479,18804,8061
16556700,3.0,3.0,14998,14998,0,0,14998,Null,Null,16556700,111461,1883
16560117,0.0,0.0,192000,192000,0,0,192000,Null,Null,16560117,111461,23416
16580604,0.0,0.0,16399,15000,1399,9,16399,Null,Null,16580604,111461,1815
16583472,0.0,0.0,15000000,15000000,0,0,15000000,Null,Null,16583472,111461,914
16605270,0.0,0.0,12869000,12869000,0,0,12869000,Null,Null,16605270,145556,914
16605533,0.0,0.0,12869000,12869000,0,0,12869000,Null,Null,16605533,145556,914
16625449,18068.0,18068.0,300000,210000,90000,30,300000,Null,Null,16625449,21273,1520
16632557,215.0,215.0,48000,47000,1000,2,48000,Null,Null,16632557,111461,1815
16632581,0.0,0.0,8400000,8400000,0,0,8400000,Null,Null,16632581,25502,914
16644938,2.0,2.0,1056000,739000,317000,30,1056000,Null,Null,16644938,4647777,914
16652528,6.0,6.0,55000,55000,0,0,55000,Null,Null,16652528,111461,914
16652917,1.0,1.0,13800000,13800000,0,0,13800000,Null,Null,16652917,25502,914
16654170,0.0,0.0,12700000,12700000,0,0,12700000,Null,Null,16654170,25502,914
16658610,1665.0,1665.0,125000,125000,0,0,125000,Null,Null,16658610,111461,1520
16755626,364.0,364.0,1500000,968000,532000,35,1500000,Null,Null,16755626,235541,1815
16760437,19.0,19.0,726000,459000,267000,37,726000,Null,Null,16760437,26150,2
16831194,18.0,18.0,168000,168000,0,0,168000,Null,Null,16831194,111461,914
16836617,48.0,48.0,22000,22000,0,0,22000,Null,Null,16836617,111461,2
16836622,7.0,7.0,620000,620000,0,0,620000,Null,Null,16836622,111461,914
16861361,484.0,484.0,31475,31475,0,0,31475,Null,Null,16861361,111461,3177
16863949,89.0,89.0,57000,57000,0,0,57000,Null,Null,16863949,111461,51698
16873913,0.0,0.0,5989000,5989000,0,0,5989000,Null,Null,16873913,145556,15318
16874169,0.0,0.0,5989000,5989000,0,0,5989000,Null,Null,16874169,145556,914
16926579,8.0,8.0,665000,339000,326000,49,665000,Null,Null,16926579,4647777,914
16928041,2113.0,2113.0,215000,215000,0,0,215000,Null,Null,16928041,245945,1520
16930607,73.0,73.0,28000,28000,0,0,28000,Null,Null,16930607,111461,1815
16931764,135.0,135.0,40800,40800,0,0,40800,Null,Null,16931764,111461,914
16934551,12.0,12.0,169000,169000,0,0,169000,Null,Null,16934551,660813,1634
16936308,0.0,0.0,6999000,6999000,0,0,6999000,Null,Null,16936308,154754,914
16980141,155.0,155.0,285000,240000,45000,16,285000,Null,Null,16980141,243693,1815
16991546,36.0,36.0,45598,22799,22799,50,45598,Null,Null,16991546,111461,1815
16999669,56.0,56.0,39600,39600,0,0,39600,Null,Null,16999669,111461,23042
17002696,846.0,846.0,147600,147600,0,0,147600,Null,Null,17002696,111461,1883
17010108,17.0,17.0,143000,143000,0,0,143000,Null,Null,17010108,111461,914
17010175,264.0,264.0,90000,69000,21000,23,90000,Null,Null,17010175,168669,3710
17031425,131.0,131.0,1730400,1462100,268300,16,1730400,Null,Null,17031425,152822,11856
17043131,5317.0,5317.0,236700,232000,4700,2,236700,Null,Null,17043131,27918,1520
17043134,1787.0,1787.0,263000,238000,25000,10,263000,Null,Null,17043134,27918,1520
17043141,2227.0,2227.0,252000,203000,49000,19,252000,Null,Null,17043141,27918,1520
17044822,0.0,0.0,50000000,50000000,0,0,50000000,Null,Null,17044822,111461,23576
17044891,0.0,0.0,50000000,50000000,0,0,50000000,Null,Null,17044891,111461,23576
17044894,0.0,0.0,60000000,60000000,0,0,60000000,Null,Null,17044894,111461,23576
17056968,116.0,116.0,79000,79000,0,0,79000,Null,Null,17056968,111461,1815
17385849,0.0,0.0,6900000,6900000,0,0,6900000,Null,Null,17385849,368631,15318
17385851,0.0,0.0,6300000,6300000,0,0,6300000,Null,Null,17385851,368631,2
17385864,0.0,0.0,8300000,8300000,0,0,8300000,Null,Null,17385864,368631,2
17385866,0.0,0.0,12000000,12000000,0,0,12000000,Null,Null,17385866,368631,15318
17385895,0.0,0.0,14500000,14500000,0,0,14500000,Null,Null,17385895,368631,2
17385933,0.0,0.0,7200000,7200000,0,0,7200000,Null,Null,17385933,368631,2
17385935,0.0,0.0,11000000,11000000,0,0,11000000,Null,Null,17385935,368631,15318
17385946,0.0,0.0,23500000,23500000,0,0,23500000,Null,Null,17385946,368631,15318
17388329,1.0,1.0,16800000,16800000,0,0,16800000,Null,Null,17388329,368631,2
17388736,0.0,0.0,7800000,7800000,0,0,7800000,Null,Null,17388736,368631,15318
17388763,0.0,0.0,9000000,9000000,0,0,9000000,Null,Null,17388763,368631,2
17422425,860.0,860.0,75000,75000,0,0,75000,Null,Null,17422425,111461,1815
17423771,11.0,11.0,70000,70000,0,0,70000,Null,Null,17423771,18804,1883
17453973,0.0,0.0,175000,175000,0,0,175000,Null,Null,17453973,111461,1815
17459648,0.0,0.0,7875000,7875000,0,0,7875000,Null,Null,17459648,111461,914
17460518,1467.0,1467.0,249000,224000,25000,10,249000,Null,Null,17460518,86206,17170
17469123,0.0,0.0,8330000,5950000,2380000,29,8330000,Null,Null,17469123,405211,914
17486835,26.0,26.0,85900,85900,0,0,85900,Null,Null,17486835,111461,914
17487178,273.0,273.0,345000,345000,0,0,345000,Null,Null,17487178,111461,27180
17504736,125.0,125.0,82000,82000,0,0,82000,Null,Null,17504736,21653,1815
17510084,12.0,12.0,349000,349000,0,0,349000,Null,Null,17510084,19788,1815
17531865,8.0,8.0,58767,58767,0,0,58767,Null,Null,17531865,111461,53074
17589085,201.0,201.0,295000,236000,59000,20,295000,Null,Null,17589085,277519,1883
17593518,180.0,180.0,1285000,749000,536000,42,1285000,Null,Null,17593518,48077,2225
17613452,304.0,304.0,348778,348778,0,0,348778,Null,Null,17613452,241131,1520
17615410,1.0,1.0,2248000,1799000,449000,20,2248000,Null,Null,17615410,4647777,914
17616528,6.0,6.0,89000,89000,0,0,89000,Null,Null,17616528,111461,914
17620708,10.0,10.0,7500,7500,0,0,7500,Null,Null,17620708,111461,1815
17629146,173.0,173.0,20000,20000,0,0,20000,Null,Null,17629146,111461,1815
17629257,16.0,16.0,15000,12000,3000,20,15000,Null,Null,17629257,111461,1815
17884235,3.0,3.0,4114285,2888000,1226285,30,4114285,Null,Null,17884235,405211,914
17884465,0.0,0.0,17996,8998,8998,50,17996,Null,Null,17884465,111461,1815
17898514,197.0,197.0,18000,18000,0,0,18000,Null,Null,17898514,111461,914
17903369,591.0,591.0,134900,134900,0,0,134900,Null,Null,17903369,111461,1815
17904053,401.0,401.0,350000,312000,38000,11,350000,Null,Null,17904053,111461,1634
17912240,402.0,402.0,55000,55000,0,0,55000,Null,Null,17912240,154845,3426
17913419,703.0,703.0,450000,450000,0,0,450000,Null,Null,17913419,412807,1804
17917676,0.0,0.0,0,7500000,0,0,7500000,Null,Null,17917676,258977,0
17918465,0.0,0.0,15900,15900,0,0,15900,Null,Null,17918465,111461,1815
17928719,3959.0,3959.0,95000,95000,0,0,95000,Null,Null,17928719,111461,1520
17929562,0.0,0.0,90250000,90250000,0,0,90250000,Null,Null,17929562,25697,2
17929564,0.0,0.0,80750000,80750000,0,0,80750000,Null,Null,17929564,25697,2
17929566,0.0,0.0,90250000,90250000,0,0,90250000,Null,Null,17929566,25697,2
17929568,0.0,0.0,90250000,90250000,0,0,90250000,Null,Null,17929568,25697,2
17937865,0.0,0.0,85500000,85500000,0,0,85500000,Null,Null,17937865,25697,2
17937930,0.0,0.0,33250000,33250000,0,0,33250000,Null,Null,17937930,25697,2
17938162,0.0,0.0,13300000,13300000,0,0,13300000,Null,Null,17938162,25697,2
17938182,0.0,0.0,19000000,19000000,0,0,19000000,Null,Null,17938182,25697,2
17938222,0.0,0.0,17100000,17100000,0,0,17100000,Null,Null,17938222,25697,2
17938224,0.0,0.0,19000000,19000000,0,0,19000000,Null,Null,17938224,25697,2
17938236,0.0,0.0,11400000,11400000,0,0,11400000,Null,Null,17938236,25697,2
17938248,0.0,0.0,23750000,23750000,0,0,23750000,Null,Null,17938248,25697,2
17938370,0.0,0.0,11400000,11400000,0,0,11400000,Null,Null,17938370,25697,2
17938398,0.0,0.0,11400000,11400000,0,0,11400000,Null,Null,17938398,25697,2
17938406,0.0,0.0,16150000,16150000,0,0,16150000,Null,Null,17938406,25697,2
17938424,0.0,0.0,13300000,13300000,0,0,13300000,Null,Null,17938424,25697,2
17938434,0.0,0.0,11400000,11400000,0,0,11400000,Null,Null,17938434,25697,2
17938609,0.0,0.0,14250000,14250000,0,0,14250000,Null,Null,17938609,25697,2
17938713,0.0,0.0,12000000,12000000,0,0,12000000,Null,Null,17938713,25697,2
17938748,0.0,0.0,11500000,11500000,0,0,11500000,Null,Null,17938748,25697,2
17939792,0.0,0.0,71250000,71250000,0,0,71250000,Null,Null,17939792,25697,2
17939802,0.0,0.0,76000000,76000000,0,0,76000000,Null,Null,17939802,25697,2
17939820,0.0,0.0,76000000,76000000,0,0,76000000,Null,Null,17939820,25697,2
17939822,0.0,0.0,61750000,61750000,0,0,61750000,Null,Null,17939822,25697,2
17939840,0.0,0.0,52250000,52250000,0,0,52250000,Null,Null,17939840,25697,2
17939842,0.0,0.0,52250000,52250000,0,0,52250000,Null,Null,17939842,25697,2
17939858,0.0,0.0,42750000,42750000,0,0,42750000,Null,Null,17939858,25697,2
17939886,0.0,0.0,42750000,42750000,0,0,42750000,Null,Null,17939886,25697,2
17939888,0.0,0.0,37050000,37050000,0,0,37050000,Null,Null,17939888,25697,2
17939900,0.0,0.0,80750000,80750000,0,0,80750000,Null,Null,17939900,25697,2
17939904,0.0,0.0,76000000,76000000,0,0,76000000,Null,Null,17939904,25697,2
17939906,0.0,0.0,27550000,27550000,0,0,27550000,Null,Null,17939906,25697,2
17939912,0.0,0.0,33250000,33250000,0,0,33250000,Null,Null,17939912,25697,2
17939914,0.0,0.0,37050000,37050000,0,0,37050000,Null,Null,17939914,25697,2
17939918,0.0,0.0,47500000,47500000,0,0,47500000,Null,Null,17939918,25697,2
17939920,0.0,0.0,27550000,27550000,0,0,27550000,Null,Null,17939920,25697,2
17939924,0.0,0.0,37050000,37050000,0,0,37050000,Null,Null,17939924,25697,2
17939926,0.0,0.0,37050000,37050000,0,0,37050000,Null,Null,17939926,25697,2
17939928,0.0,0.0,76000000,76000000,0,0,76000000,Null,Null,17939928,25697,2
17939936,0.0,0.0,19000000,19000000,0,0,19000000,Null,Null,17939936,25697,2
17939938,0.0,0.0,27550000,27550000,0,0,27550000,Null,Null,17939938,25697,2
17939940,0.0,0.0,37050000,37050000,0,0,37050000,Null,Null,17939940,25697,2
17939942,0.0,0.0,42750000,42750000,0,0,42750000,Null,Null,17939942,25697,2
17939944,0.0,0.0,37050000,37050000,0,0,37050000,Null,Null,17939944,25697,2
17939950,0.0,0.0,37050000,37050000,0,0,37050000,Null,Null,17939950,25697,2
17939954,0.0,0.0,34200000,34200000,0,0,34200000,Null,Null,17939954,25697,2
17939962,0.0,0.0,37050000,37050000,0,0,37050000,Null,Null,17939962,25697,2
17939964,0.0,0.0,33250000,33250000,0,0,33250000,Null,Null,17939964,25697,2
17939971,0.0,0.0,33250000,33250000,0,0,33250000,Null,Null,17939971,25697,2
17939975,0.0,0.0,61750000,61750000,0,0,61750000,Null,Null,17939975,25697,2
17939977,0.0,0.0,33250000,33250000,0,0,33250000,Null,Null,17939977,25697,2
17939981,0.0,0.0,27550000,27550000,0,0,27550000,Null,Null,17939981,25697,2
17939983,0.0,0.0,71250000,71250000,0,0,71250000,Null,Null,17939983,25697,2
17939984,0.0,0.0,23750000,23750000,0,0,23750000,Null,Null,17939984,25697,2
17939987,0.0,0.0,27550000,27550000,0,0,27550000,Null,Null,17939987,25697,2
17939989,0.0,0.0,71250000,71250000,0,0,71250000,Null,Null,17939989,25697,2
17939995,0.0,0.0,23750000,23750000,0,0,23750000,Null,Null,17939995,25697,2
17939999,0.0,0.0,23750000,23750000,0,0,23750000,Null,Null,17939999,25697,2
17940001,0.0,0.0,23750000,23750000,0,0,23750000,Null,Null,17940001,25697,2
17940003,0.0,0.0,19000000,19000000,0,0,19000000,Null,Null,17940003,25697,2
17940007,0.0,0.0,23750000,23750000,0,0,23750000,Null,Null,17940007,25697,2
17940011,0.0,0.0,17100000,17100000,0,0,17100000,Null,Null,17940011,25697,2
17940013,0.0,0.0,19000000,19000000,0,0,19000000,Null,Null,17940013,25697,2
17940017,0.0,0.0,17100000,17100000,0,0,17100000,Null,Null,17940017,25697,2
17940023,0.0,0.0,14725000,14725000,0,0,14725000,Null,Null,17940023,25697,2
17940025,0.0,0.0,17100000,17100000,0,0,17100000,Null,Null,17940025,25697,2
17940029,0.0,0.0,16150000,16150000,0,0,16150000,Null,Null,17940029,25697,2
17940031,0.0,0.0,19000000,19000000,0,0,19000000,Null,Null,17940031,25697,2
17940039,0.0,0.0,14250000,14250000,0,0,14250000,Null,Null,17940039,25697,2
17940056,0.0,0.0,17100000,17100000,0,0,17100000,Null,Null,17940056,25697,2
17940060,0.0,0.0,14250000,14250000,0,0,14250000,Null,Null,17940060,25697,2
17940062,0.0,0.0,64600000,64600000,0,0,64600000,Null,Null,17940062,25697,2
17940064,0.0,0.0,14250000,14250000,0,0,14250000,Null,Null,17940064,25697,2
17940066,0.0,0.0,76000000,76000000,0,0,76000000,Null,Null,17940066,25697,2
17940070,0.0,0.0,14250000,14250000,0,0,14250000,Null,Null,17940070,25697,2
17940074,0.0,0.0,71250000,71250000,0,0,71250000,Null,Null,17940074,25697,2
17940076,0.0,0.0,36100000,36100000,0,0,36100000,Null,Null,17940076,25697,2
17940080,0.0,0.0,56050000,56050000,0,0,56050000,Null,Null,17940080,25697,2
17940082,0.0,0.0,14250000,14250000,0,0,14250000,Null,Null,17940082,25697,2
17940084,0.0,0.0,12350000,12350000,0,0,12350000,Null,Null,17940084,25697,2
17940085,0.0,0.0,52250000,52250000,0,0,52250000,Null,Null,17940085,25697,2
17940088,0.0,0.0,33250000,33250000,0,0,33250000,Null,Null,17940088,25697,2
17940092,0.0,0.0,47500000,47500000,0,0,47500000,Null,Null,17940092,25697,2
17940094,0.0,0.0,11400000,11400000,0,0,11400000,Null,Null,17940094,25697,2
17940096,0.0,0.0,16150000,16150000,0,0,16150000,Null,Null,17940096,25697,2
17940098,0.0,0.0,14250000,14250000,0,0,14250000,Null,Null,17940098,25697,2
17940102,0.0,0.0,37050000,37050000,0,0,37050000,Null,Null,17940102,25697,2
17940106,0.0,0.0,23750000,23750000,0,0,23750000,Null,Null,17940106,25697,2
17940110,0.0,0.0,42750000,42750000,0,0,42750000,Null,Null,17940110,25697,2
17940112,0.0,0.0,64600000,64600000,0,0,64600000,Null,Null,17940112,25697,2
17940114,0.0,0.0,80750000,80750000,0,0,80750000,Null,Null,17940114,25697,2
17940118,0.0,0.0,14250000,14250000,0,0,14250000,Null,Null,17940118,25697,2
17940120,0.0,0.0,23750000,23750000,0,0,23750000,Null,Null,17940120,25697,2
17940124,0.0,0.0,36100000,36100000,0,0,36100000,Null,Null,17940124,25697,2
17940126,0.0,0.0,19000000,19000000,0,0,19000000,Null,Null,17940126,25697,2
17940128,0.0,0.0,14250000,14250000,0,0,14250000,Null,Null,17940128,25697,2
17940130,0.0,0.0,14250000,14250000,0,0,14250000,Null,Null,17940130,25697,2
17940134,0.0,0.0,61750000,61750000,0,0,61750000,Null,Null,17940134,25697,2
17940136,0.0,0.0,33250000,33250000,0,0,33250000,Null,Null,17940136,25697,2
17940138,0.0,0.0,42750000,42750000,0,0,42750000,Null,Null,17940138,25697,2
17940140,0.0,0.0,34200000,34200000,0,0,34200000,Null,Null,17940140,25697,2
17940142,0.0,0.0,14250000,14250000,0,0,14250000,Null,Null,17940142,25697,2
17940146,0.0,0.0,14250000,14250000,0,0,14250000,Null,Null,17940146,25697,2
17940148,0.0,0.0,34200000,34200000,0,0,34200000,Null,Null,17940148,25697,2
17940150,0.0,0.0,16150000,16150000,0,0,16150000,Null,Null,17940150,25697,2
17940152,0.0,0.0,16150000,16150000,0,0,16150000,Null,Null,17940152,25697,2
17940154,0.0,0.0,14250000,14250000,0,0,14250000,Null,Null,17940154,25697,2
17940158,0.0,0.0,27550000,27550000,0,0,27550000,Null,Null,17940158,25697,2
17940159,0.0,0.0,27550000,27550000,0,0,27550000,Null,Null,17940159,25697,2
17940161,0.0,0.0,14250000,14250000,0,0,14250000,Null,Null,17940161,25697,2
17940162,0.0,0.0,37050000,37050000,0,0,37050000,Null,Null,17940162,25697,2
17940166,0.0,0.0,61750000,61750000,0,0,61750000,Null,Null,17940166,25697,2
17940168,0.0,0.0,14250000,14250000,0,0,14250000,Null,Null,17940168,25697,2
17940170,0.0,0.0,27550000,27550000,0,0,27550000,Null,Null,17940170,25697,2
17940174,0.0,0.0,27550000,27550000,0,0,27550000,Null,Null,17940174,25697,2
17940178,0.0,0.0,23750000,23750000,0,0,23750000,Null,Null,17940178,25697,2
17940180,0.0,0.0,47500000,47500000,0,0,47500000,Null,Null,17940180,25697,2
17940182,0.0,0.0,61750000,61750000,0,0,61750000,Null,Null,17940182,25697,2
17940184,0.0,0.0,14250000,14250000,0,0,14250000,Null,Null,17940184,25697,2
17940188,0.0,0.0,23750000,23750000,0,0,23750000,Null,Null,17940188,25697,2
17940190,0.0,0.0,37050000,37050000,0,0,37050000,Null,Null,17940190,25697,2
17940192,0.0,0.0,13300000,13300000,0,0,13300000,Null,Null,17940192,25697,2
17940196,0.0,0.0,14250000,14250000,0,0,14250000,Null,Null,17940196,25697,2
17940198,0.0,0.0,61750000,61750000,0,0,61750000,Null,Null,17940198,25697,2
17940200,0.0,0.0,23750000,23750000,0,0,23750000,Null,Null,17940200,25697,2
17940206,0.0,0.0,19000000,19000000,0,0,19000000,Null,Null,17940206,25697,2
17940208,0.0,0.0,33250000,33250000,0,0,33250000,Null,Null,17940208,25697,2
17940210,0.0,0.0,13300000,13300000,0,0,13300000,Null,Null,17940210,25697,2
17940212,0.0,0.0,54150000,54150000,0,0,54150000,Null,Null,17940212,25697,2
17940214,0.0,0.0,19000000,19000000,0,0,19000000,Null,Null,17940214,25697,2
17940216,0.0,0.0,17100000,17100000,0,0,17100000,Null,Null,17940216,25697,2
17940218,0.0,0.0,14250000,14250000,0,0,14250000,Null,Null,17940218,25697,2
17940222,0.0,0.0,33250000,33250000,0,0,33250000,Null,Null,17940222,25697,2
17940226,0.0,0.0,12350000,12350000,0,0,12350000,Null,Null,17940226,25697,2
17940228,0.0,0.0,16150000,16150000,0,0,16150000,Null,Null,17940228,25697,2
17940230,0.0,0.0,13300000,13300000,0,0,13300000,Null,Null,17940230,25697,2
17940232,0.0,0.0,16150000,16150000,0,0,16150000,Null,Null,17940232,25697,2
17940236,0.0,0.0,16150000,16150000,0,0,16150000,Null,Null,17940236,25697,2
17940238,0.0,0.0,33250000,33250000,0,0,33250000,Null,Null,17940238,25697,2
17940240,0.0,0.0,14250000,14250000,0,0,14250000,Null,Null,17940240,25697,2
17940244,0.0,0.0,33250000,33250000,0,0,33250000,Null,Null,17940244,25697,2
17940246,0.0,0.0,14250000,14250000,0,0,14250000,Null,Null,17940246,25697,2
17940248,0.0,0.0,23750000,23750000,0,0,23750000,Null,Null,17940248,25697,2
17940254,0.0,0.0,33250000,33250000,0,0,33250000,Null,Null,17940254,25697,2
17940256,0.0,0.0,14250000,14250000,0,0,14250000,Null,Null,17940256,25697,2
17940262,0.0,0.0,33250000,33250000,0,0,33250000,Null,Null,17940262,25697,2
17940263,0.0,0.0,14250000,14250000,0,0,14250000,Null,Null,17940263,25697,2
17940268,0.0,0.0,27550000,27550000,0,0,27550000,Null,Null,17940268,25697,2
17940272,0.0,0.0,14250000,14250000,0,0,14250000,Null,Null,17940272,25697,2
17940278,0.0,0.0,12350000,12350000,0,0,12350000,Null,Null,17940278,25697,2
17940280,0.0,0.0,27550000,27550000,0,0,27550000,Null,Null,17940280,25697,2
17940282,0.0,0.0,12350000,12350000,0,0,12350000,Null,Null,17940282,25697,2
17940286,0.0,0.0,17100000,17100000,0,0,17100000,Null,Null,17940286,25697,2
17940292,0.0,0.0,11400000,11400000,0,0,11400000,Null,Null,17940292,25697,2
17940296,0.0,0.0,71250000,71250000,0,0,71250000,Null,Null,17940296,25697,2
17940302,0.0,0.0,19000000,19000000,0,0,19000000,Null,Null,17940302,25697,2
17940304,0.0,0.0,47500000,47500000,0,0,47500000,Null,Null,17940304,25697,2
17940306,0.0,0.0,11400000,11400000,0,0,11400000,Null,Null,17940306,25697,2
17940308,0.0,0.0,19000000,19000000,0,0,19000000,Null,Null,17940308,25697,2
17940310,0.0,0.0,12350000,12350000,0,0,12350000,Null,Null,17940310,25697,2
17940312,0.0,0.0,17100000,17100000,0,0,17100000,Null,Null,17940312,25697,2
17940316,0.0,0.0,47500000,47500000,0,0,47500000,Null,Null,17940316,25697,2
17940329,0.0,0.0,19000000,19000000,0,0,19000000,Null,Null,17940329,25697,2
17940331,0.0,0.0,23750000,23750000,0,0,23750000,Null,Null,17940331,25697,2
17940333,0.0,0.0,42750000,42750000,0,0,42750000,Null,Null,17940333,25697,2
17940337,0.0,0.0,17100000,17100000,0,0,17100000,Null,Null,17940337,25697,2
17940339,0.0,0.0,11400000,11400000,0,0,11400000,Null,Null,17940339,25697,2
17940343,0.0,0.0,27550000,27550000,0,0,27550000,Null,Null,17940343,25697,2
17940346,0.0,0.0,17100000,17100000,0,0,17100000,Null,Null,17940346,25697,2
17940348,0.0,0.0,18000000,18000000,0,0,18000000,Null,Null,17940348,25697,2
17940350,0.0,0.0,14250000,14250000,0,0,14250000,Null,Null,17940350,25697,2
17940354,0.0,0.0,37050000,37050000,0,0,37050000,Null,Null,17940354,25697,2
17940362,0.0,0.0,14725000,14725000,0,0,14725000,Null,Null,17940362,25697,2
17940364,0.0,0.0,12350000,12350000,0,0,12350000,Null,Null,17940364,25697,2
17940366,0.0,0.0,14250000,14250000,0,0,14250000,Null,Null,17940366,25697,2
17940368,0.0,0.0,16150000,16150000,0,0,16150000,Null,Null,17940368,25697,2
17940370,0.0,0.0,37050000,37050000,0,0,37050000,Null,Null,17940370,25697,2
17940374,0.0,0.0,14250000,14250000,0,0,14250000,Null,Null,17940374,25697,2
17940376,0.0,0.0,14250000,14250000,0,0,14250000,Null,Null,17940376,25697,2
17940378,0.0,0.0,11400000,11400000,0,0,11400000,Null,Null,17940378,25697,2
17940384,0.0,0.0,61750000,61750000,0,0,61750000,Null,Null,17940384,25697,2
17940386,0.0,0.0,11500000,11500000,0,0,11500000,Null,Null,17940386,25697,2
17940388,0.0,0.0,11400000,11400000,0,0,11400000,Null,Null,17940388,25697,2
17940390,0.0,0.0,23750000,23750000,0,0,23750000,Null,Null,17940390,25697,2
17940392,0.0,0.0,14250000,14250000,0,0,14250000,Null,Null,17940392,25697,2
17940394,0.0,0.0,14250000,14250000,0,0,14250000,Null,Null,17940394,25697,2
17940398,0.0,0.0,14250000,14250000,0,0,14250000,Null,Null,17940398,25697,2
17940400,0.0,0.0,33250000,33250000,0,0,33250000,Null,Null,17940400,25697,2
17940402,0.0,0.0,14250000,14250000,0,0,14250000,Null,Null,17940402,25697,2
17940404,0.0,0.0,11500000,11500000,0,0,11500000,Null,Null,17940404,25697,2
17940408,0.0,0.0,11400000,11400000,0,0,11400000,Null,Null,17940408,25697,2
17940410,0.0,0.0,47500000,47500000,0,0,47500000,Null,Null,17940410,25697,2
17940412,0.0,0.0,11400000,11400000,0,0,11400000,Null,Null,17940412,25697,2
17940414,0.0,0.0,12350000,12350000,0,0,12350000,Null,Null,17940414,25697,2
17940416,0.0,0.0,11400000,11400000,0,0,11400000,Null,Null,17940416,25697,2
17940418,0.0,0.0,14250000,14250000,0,0,14250000,Null,Null,17940418,25697,2
17940422,0.0,0.0,14250000,14250000,0,0,14250000,Null,Null,17940422,25697,2
17940426,0.0,0.0,37050000,37050000,0,0,37050000,Null,Null,17940426,25697,2
17940430,0.0,0.0,11400000,11400000,0,0,11400000,Null,Null,17940430,25697,2
17940434,0.0,0.0,14250000,14250000,0,0,14250000,Null,Null,17940434,25697,2
17940455,0.0,0.0,13300000,13300000,0,0,13300000,Null,Null,17940455,25697,2
17940480,0.0,0.0,12350000,12350000,0,0,12350000,Null,Null,17940480,25697,2
17940484,0.0,0.0,19000000,19000000,0,0,19000000,Null,Null,17940484,25697,2
17940488,0.0,0.0,11400000,11400000,0,0,11400000,Null,Null,17940488,25697,2
17940490,0.0,0.0,19950000,19950000,0,0,19950000,Null,Null,17940490,25697,2
17940492,0.0,0.0,17100000,17100000,0,0,17100000,Null,Null,17940492,25697,2
17940498,0.0,0.0,11400000,11400000,0,0,11400000,Null,Null,17940498,25697,2
17940500,0.0,0.0,11400000,11400000,0,0,11400000,Null,Null,17940500,25697,2
17940506,0.0,0.0,23750000,23750000,0,0,23750000,Null,Null,17940506,25697,2
17940508,0.0,0.0,16150000,16150000,0,0,16150000,Null,Null,17940508,25697,2
17940516,0.0,0.0,11400000,11400000,0,0,11400000,Null,Null,17940516,25697,2
17940518,0.0,0.0,12500000,12500000,0,0,12500000,Null,Null,17940518,25697,2
17940522,0.0,0.0,14250000,14250000,0,0,14250000,Null,Null,17940522,25697,2
17940530,0.0,0.0,17100000,17100000,0,0,17100000,Null,Null,17940530,25697,2
17940531,0.0,0.0,14250000,14250000,0,0,14250000,Null,Null,17940531,25697,2
17940539,0.0,0.0,14250000,14250000,0,0,14250000,Null,Null,17940539,25697,2
17940541,0.0,0.0,16150000,16150000,0,0,16150000,Null,Null,17940541,25697,2
17940549,0.0,0.0,18000000,18000000,0,0,18000000,Null,Null,17940549,25697,2
17940553,0.0,0.0,12350000,12350000,0,0,12350000,Null,Null,17940553,25697,2
17940555,0.0,0.0,14250000,14250000,0,0,14250000,Null,Null,17940555,25697,2
17940557,0.0,0.0,14250000,14250000,0,0,14250000,Null,Null,17940557,25697,2
17940563,0.0,0.0,11400000,11400000,0,0,11400000,Null,Null,17940563,25697,2
17940565,0.0,0.0,12350000,12350000,0,0,12350000,Null,Null,17940565,25697,2
17940573,0.0,0.0,14250000,14250000,0,0,14250000,Null,Null,17940573,25697,2
17940575,0.0,0.0,16150000,16150000,0,0,16150000,Null,Null,17940575,25697,2
17940577,0.0,0.0,19000000,19000000,0,0,19000000,Null,Null,17940577,25697,2
17940581,0.0,0.0,12000000,12000000,0,0,12000000,Null,Null,17940581,25697,2
17940583,0.0,0.0,12350000,12350000,0,0,12350000,Null,Null,17940583,25697,2
17940587,0.0,0.0,11400000,11400000,0,0,11400000,Null,Null,17940587,25697,2
17940590,0.0,0.0,11400000,11400000,0,0,11400000,Null,Null,17940590,25697,2
17940592,0.0,0.0,14250000,14250000,0,0,14250000,Null,Null,17940592,25697,2
17940594,0.0,0.0,11400000,11400000,0,0,11400000,Null,Null,17940594,25697,2
17940600,0.0,0.0,19000000,19000000,0,0,19000000,Null,Null,17940600,25697,2
17940602,0.0,0.0,80750000,80750000,0,0,80750000,Null,Null,17940602,25697,2
17940603,0.0,0.0,11400000,11400000,0,0,11400000,Null,Null,17940603,25697,2
17940605,0.0,0.0,16150000,16150000,0,0,16150000,Null,Null,17940605,25697,2
17940608,0.0,0.0,13300000,13300000,0,0,13300000,Null,Null,17940608,25697,2
17940610,0.0,0.0,19000000,19000000,0,0,19000000,Null,Null,17940610,25697,2
17940612,0.0,0.0,11400000,11400000,0,0,11400000,Null,Null,17940612,25697,2
17940614,0.0,0.0,12350000,12350000,0,0,12350000,Null,Null,17940614,25697,2
17940622,0.0,0.0,11875000,11875000,0,0,11875000,Null,Null,17940622,25697,2
17940624,0.0,0.0,64600000,64600000,0,0,64600000,Null,Null,17940624,25697,2
17940630,0.0,0.0,12500000,12500000,0,0,12500000,Null,Null,17940630,25697,2
17940632,0.0,0.0,17100000,17100000,0,0,17100000,Null,Null,17940632,25697,2
17940638,0.0,0.0,12350000,12350000,0,0,12350000,Null,Null,17940638,25697,2
17940642,0.0,0.0,15000000,15000000,0,0,15000000,Null,Null,17940642,25697,2
17940646,0.0,0.0,52250000,52250000,0,0,52250000,Null,Null,17940646,25697,2
17940648,0.0,0.0,16150000,16150000,0,0,16150000,Null,Null,17940648,25697,2
17940650,0.0,0.0,14250000,14250000,0,0,14250000,Null,Null,17940650,25697,2
17940656,0.0,0.0,11400000,11400000,0,0,11400000,Null,Null,17940656,25697,2
17940660,0.0,0.0,16150000,16150000,0,0,16150000,Null,Null,17940660,25697,2
17940664,0.0,0.0,14250000,14250000,0,0,14250000,Null,Null,17940664,25697,2
17940668,0.0,0.0,17000000,17000000,0,0,17000000,Null,Null,17940668,25697,2
17940672,0.0,0.0,12350000,12350000,0,0,12350000,Null,Null,17940672,25697,2
17940674,0.0,0.0,14250000,14250000,0,0,14250000,Null,Null,17940674,25697,2
17940676,0.0,0.0,12350000,12350000,0,0,12350000,Null,Null,17940676,25697,2
17940680,0.0,0.0,11400000,11400000,0,0,11400000,Null,Null,17940680,25697,2
17940681,0.0,0.0,14250000,14250000,0,0,14250000,Null,Null,17940681,25697,2
17940684,0.0,0.0,11500000,11500000,0,0,11500000,Null,Null,17940684,25697,2
17940686,0.0,0.0,14250000,14250000,0,0,14250000,Null,Null,17940686,25697,2
17940688,0.0,0.0,12350000,12350000,0,0,12350000,Null,Null,17940688,25697,2
17940690,0.0,0.0,14250000,14250000,0,0,14250000,Null,Null,17940690,25697,2
17940696,0.0,0.0,14250000,14250000,0,0,14250000,Null,Null,17940696,25697,2
17940700,0.0,0.0,14250000,14250000,0,0,14250000,Null,Null,17940700,25697,2
17940704,0.0,0.0,11400000,11400000,0,0,11400000,Null,Null,17940704,25697,2
17940710,0.0,0.0,11400000,11400000,0,0,11400000,Null,Null,17940710,25697,2
17940712,0.0,0.0,11400000,11400000,0,0,11400000,Null,Null,17940712,25697,2
17940714,0.0,0.0,11400000,11400000,0,0,11400000,Null,Null,17940714,25697,2
17940716,0.0,0.0,11400000,11400000,0,0,11400000,Null,Null,17940716,25697,2
17940718,0.0,0.0,11400000,11400000,0,0,11400000,Null,Null,17940718,25697,2
17940720,0.0,0.0,33250000,33250000,0,0,33250000,Null,Null,17940720,25697,2
17940724,0.0,0.0,14250000,14250000,0,0,14250000,Null,Null,17940724,25697,2
17940726,0.0,0.0,11500000,11500000,0,0,11500000,Null,Null,17940726,25697,2
17940730,0.0,0.0,11400000,11400000,0,0,11400000,Null,Null,17940730,25697,2
17940734,0.0,0.0,11400000,11400000,0,0,11400000,Null,Null,17940734,25697,2
17940740,0.0,0.0,16000000,16000000,0,0,16000000,Null,Null,17940740,25697,2
17940743,0.0,0.0,11400000,11400000,0,0,11400000,Null,Null,17940743,25697,2
17940745,0.0,0.0,27550000,27550000,0,0,27550000,Null,Null,17940745,25697,2
17940749,0.0,0.0,11400000,11400000,0,0,11400000,Null,Null,17940749,25697,2
17940753,0.0,0.0,11400000,11400000,0,0,11400000,Null,Null,17940753,25697,2
17940755,0.0,0.0,11400000,11400000,0,0,11400000,Null,Null,17940755,25697,2
17940756,0.0,0.0,23750000,23750000,0,0,23750000,Null,Null,17940756,25697,2
17940759,0.0,0.0,12500000,12500000,0,0,12500000,Null,Null,17940759,25697,2
17940773,0.0,0.0,11500000,11500000,0,0,11500000,Null,Null,17940773,25697,2
17940777,0.0,0.0,12500000,12500000,0,0,12500000,Null,Null,17940777,25697,2
17940781,0.0,0.0,23750000,23750000,0,0,23750000,Null,Null,17940781,25697,2
17940783,0.0,0.0,12500000,12500000,0,0,12500000,Null,Null,17940783,25697,2
17940785,0.0,0.0,11500000,11500000,0,0,11500000,Null,Null,17940785,25697,2
17940793,0.0,0.0,11500000,11500000,0,0,11500000,Null,Null,17940793,25697,2
17940801,0.0,0.0,12500000,12500000,0,0,12500000,Null,Null,17940801,25697,2
17940810,0.0,0.0,11500000,11500000,0,0,11500000,Null,Null,17940810,25697,2
17940813,0.0,0.0,12000000,12000000,0,0,12000000,Null,Null,17940813,25697,2
17940815,0.0,0.0,13300000,13300000,0,0,13300000,Null,Null,17940815,25697,2
17940833,0.0,0.0,11500000,11500000,0,0,11500000,Null,Null,17940833,25697,2
17940856,0.0,0.0,11500000,11500000,0,0,11500000,Null,Null,17940856,25697,2
17940859,0.0,0.0,11500000,11500000,0,0,11500000,Null,Null,17940859,25697,2
17940871,0.0,0.0,11500000,11500000,0,0,11500000,Null,Null,17940871,25697,2
17940894,0.0,0.0,11500000,11500000,0,0,11500000,Null,Null,17940894,25697,2
17940945,0.0,0.0,15500000,15500000,0,0,15500000,Null,Null,17940945,25697,2
17940949,0.0,0.0,11500000,11500000,0,0,11500000,Null,Null,17940949,25697,2
17940964,0.0,0.0,11500000,11500000,0,0,11500000,Null,Null,17940964,25697,2
17940966,0.0,0.0,11400000,11400000,0,0,11400000,Null,Null,17940966,25697,2
17941001,0.0,0.0,11400000,11400000,0,0,11400000,Null,Null,17941001,25697,2
17941034,0.0,0.0,11400000,11400000,0,0,11400000,Null,Null,17941034,25697,2
17941049,0.0,0.0,11400000,11400000,0,0,11400000,Null,Null,17941049,25697,2
17941075,0.0,0.0,11500000,11500000,0,0,11500000,Null,Null,17941075,25697,2
17941554,0.0,0.0,12500000,12500000,0,0,12500000,Null,Null,17941554,25697,2
17944973,0.0,0.0,15000000,15000000,0,0,15000000,Null,Null,17944973,111461,914
17946135,351.0,351.0,148000,148000,0,0,148000,Null,Null,17946135,111459,7078
17954885,838.0,838.0,380000,380000,0,0,380000,Null,Null,17954885,178003,1520
17967186,19.0,19.0,15000,15000,0,0,15000,Null,Null,17967186,111461,914
17967720,182.0,182.0,79000,79000,0,0,79000,Null,Null,17967720,111461,914
17974146,133.0,133.0,98500,98500,0,0,98500,Null,Null,17974146,111461,914
17974334,179.0,179.0,350000,350000,0,0,350000,Null,Null,17974334,111461,23634
18008048,3.0,3.0,190000,190000,0,0,190000,Null,Null,18008048,111461,914
19049500,173.0,173.0,139000,139000,0,0,139000,Null,Null,19049500,111461,1520
19252282,73.0,73.0,169000,169000,0,0,169000,Null,Null,19252282,111461,914
19252286,10.0,10.0,121000,121000,0,0,121000,Null,Null,19252286,111461,914
19266484,1.0,1.0,12590000,12590000,0,0,12590000,Null,Null,19266484,114527,1815
19275615,103.0,103.0,64500,64500,0,0,64500,Null,Null,19275615,111461,914
19283978,0.0,0.0,7690000,7690000,0,0,7690000,Null,Null,19283978,25502,914
19289811,0.0,0.0,7000000,7000000,0,0,7000000,Null,Null,19289811,25502,914
19290620,8.0,8.0,6900,6900,0,0,6900,Null,Null,19290620,111461,1815
19291095,109.0,109.0,68000,68000,0,0,68000,Null,Null,19291095,111461,8371
19292327,0.0,0.0,8785000,8785000,0,0,8785000,Null,Null,19292327,25502,914
19293743,0.0,0.0,8050000,8050000,0,0,8050000,Null,Null,19293743,25502,914
19296423,0.0,0.0,9100000,9100000,0,0,9100000,Null,Null,19296423,25502,5385
19304545,0.0,0.0,6485000,6485000,0,0,6485000,Null,Null,19304545,25502,5385
19336345,3003.0,3003.0,28000,28000,0,0,28000,Null,Null,19336345,111461,1815
19339428,529.0,529.0,89900,89900,0,0,89900,Null,Null,19339428,111461,1815
19348723,819.0,819.0,179000,169000,10000,6,179000,Null,Null,19348723,177811,1520
19349211,0.0,0.0,5885000,5885000,0,0,5885000,Null,Null,19349211,25502,5385
19354652,0.0,0.0,5885000,5885000,0,0,5885000,Null,Null,19354652,25502,914
19365415,53.0,53.0,127808,89465,38343,30,127808,Null,Null,19365415,111461,1815
19365924,0.0,0.0,7800000,7800000,0,0,7800000,Null,Null,19365924,25502,5385
19382008,37.0,37.0,64000,15000,49000,77,64000,Null,Null,19382008,111461,914
19383338,14.0,14.0,32000,12000,20000,63,32000,Null,Null,19383338,111461,914
19383872,74.0,74.0,35000,35000,0,0,35000,Null,Null,19383872,111461,914
19383901,18.0,18.0,22000,22000,0,0,22000,Null,Null,19383901,21588,1601
19387730,0.0,0.0,8585000,8585000,0,0,8585000,Null,Null,19387730,25502,5385
19389826,1.0,1.0,6600000,6600000,0,0,6600000,Null,Null,19389826,25502,914
19392372,234.0,234.0,429000,429000,0,0,429000,Null,Null,19392372,20304,2136
19393538,0.0,0.0,9485000,9485000,0,0,9485000,Null,Null,19393538,25502,914
19402005,0.0,0.0,19500000,19500000,0,0,19500000,Null,Null,19402005,25502,914
19402085,0.0,0.0,19500000,19500000,0,0,19500000,Null,Null,19402085,25502,914
19402234,0.0,0.0,19500000,19500000,0,0,19500000,Null,Null,19402234,25502,5385
19402768,0.0,0.0,12600000,12600000,0,0,12600000,Null,Null,19402768,25502,914
19406836,37.0,37.0,450000,239999,210001,47,450000,Null,Null,19406836,111461,27180
19408981,0.0,0.0,3520000,3520000,0,0,3520000,Null,Null,19408981,374249,1520
19409169,0.0,0.0,16500000,16500000,0,0,16500000,Null,Null,19409169,374249,1520
19410534,0.0,0.0,11500000,11500000,0,0,11500000,Null,Null,19410534,25697,2
19410879,0.0,0.0,14500000,14500000,0,0,14500000,Null,Null,19410879,25697,2
19410977,0.0,0.0,11500000,11500000,0,0,11500000,Null,Null,19410977,25697,2
19412218,0.0,0.0,11500000,11500000,0,0,11500000,Null,Null,19412218,25697,2
19412401,0.0,0.0,11500000,11500000,0,0,11500000,Null,Null,19412401,25697,2
19416866,4.0,4.0,90000,88200,1800,2,90000,Null,Null,19416866,111461,914
19418786,12.0,12.0,126000,126000,0,0,126000,Null,Null,19418786,154319,914
19419738,5391.0,5391.0,104000,104000,0,0,104000,Null,Null,19419738,27464,20182
19420227,0.0,0.0,8200000,8200000,0,0,8200000,Null,Null,19420227,25502,5385
19447584,0.0,0.0,10080000,10080000,0,0,10080000,Null,Null,19447584,25502,914
19448191,0.0,0.0,36750000,36750000,0,0,36750000,Null,Null,19448191,25502,5385
19462097,0.0,0.0,97000,97000,0,0,97000,Null,Null,19462097,111461,1883
19558098,178.0,178.0,65000,45000,20000,31,65000,Null,Null,19558098,47663,1520
19563949,443.0,443.0,175000,124000,51000,29,175000,Null,Null,19563949,47663,13878
19584471,10.0,10.0,75000,75000,0,0,75000,Null,Null,19584471,111461,23282
19590256,0.0,0.0,6090000,6090000,0,0,6090000,Null,Null,19590256,25502,914
19600451,62.0,62.0,64900,64900,0,0,64900,Null,Null,19600451,111461,8371
19600797,0.0,0.0,9580000,9580000,0,0,9580000,Null,Null,19600797,25502,5385
19605323,112.0,112.0,42500,42500,0,0,42500,Null,Null,19605323,111461,1520
19615374,0.0,0.0,320000,320000,0,0,320000,Null,Null,19615374,111461,15250
19616866,3640.0,3640.0,120000,120000,0,0,120000,Null,Null,19616866,50807,11835
19618682,1.0,1.0,798000,399000,399000,50,798000,Null,Null,19618682,111461,15250
19621888,21.0,21.0,150000,115000,35000,23,150000,Null,Null,19621888,50807,1520
19640804,201.0,201.0,460000,460000,0,0,460000,Null,Null,19640804,25422,8170
19646731,120.0,120.0,153000,153000,0,0,153000,Null,Null,19646731,197443,13878
19656684,264.0,264.0,199000,193000,6000,3,199000,Null,Null,19656684,260259,1805
19686022,0.0,0.0,10820000,10820000,0,0,10820000,Null,Null,19686022,25502,5385
19686267,11.0,11.0,263000,263000,0,0,263000,Null,Null,19686267,154319,914
19686516,0.0,0.0,5880000,5880000,0,0,5880000,Null,Null,19686516,25502,5385
19686809,0.0,0.0,12500000,12500000,0,0,12500000,Null,Null,19686809,25502,914
19700055,0.0,0.0,6885000,6885000,0,0,6885000,Null,Null,19700055,25502,914
19705375,1.0,1.0,45000,45000,0,0,45000,Null,Null,19705375,364731,2
19718948,0.0,0.0,6440000,6440000,0,0,6440000,Null,Null,19718948,25502,914
19719366,449.0,449.0,150000,101000,49000,33,150000,Null,Null,19719366,420823,23394
19722532,3.0,3.0,6100000,6100000,0,0,6100000,Null,Null,19722532,25502,914
19728842,0.0,0.0,6800000,6800000,0,0,6800000,Null,Null,19728842,25502,5385
19729152,0.0,0.0,6150000,6150000,0,0,6150000,Null,Null,19729152,25502,5385
19729575,0.0,0.0,6200000,6200000,0,0,6200000,Null,Null,19729575,25502,914
19729672,0.0,0.0,6600000,6600000,0,0,6600000,Null,Null,19729672,25502,914
19730704,315.0,315.0,35000,35000,0,0,35000,Null,Null,19730704,111461,1815
19731188,0.0,0.0,5785000,5785000,0,0,5785000,Null,Null,19731188,25502,914
19731300,0.0,0.0,10985000,10985000,0,0,10985000,Null,Null,19731300,25502,914
19731302,0.0,0.0,8950000,8950000,0,0,8950000,Null,Null,19731302,25502,914
19731324,0.0,0.0,6550000,6550000,0,0,6550000,Null,Null,19731324,25502,5385
19748880,492.0,492.0,149000,149000,0,0,149000,Null,Null,19748880,445011,1520
19750235,0.0,0.0,14310000,14310000,0,0,14310000,Null,Null,19750235,26274,7079
19761182,0.0,0.0,546000,546000,0,0,546000,Null,Null,19761182,111461,15318
19764447,98.0,98.0,199000,199000,0,0,199000,Null,Null,19764447,111461,914
19769587,0.0,0.0,13485000,13485000,0,0,13485000,Null,Null,19769587,25502,914
19771312,5.0,5.0,80000,80000,0,0,80000,Null,Null,19771312,111461,27128
19772753,62.0,62.0,89000,89000,0,0,89000,Null,Null,19772753,21651,1815
19789782,0.0,0.0,6300000,6300000,0,0,6300000,Null,Null,19789782,25502,914
19791650,0.0,0.0,12750000,12750000,0,0,12750000,Null,Null,19791650,25502,914
19793402,0.0,0.0,11060000,11060000,0,0,11060000,Null,Null,19793402,25502,914
19796012,39.0,39.0,11000,11000,0,0,11000,Null,Null,19796012,111461,2363
19803125,110.0,110.0,2500000,2125000,375000,15,2500000,Null,Null,19803125,33203,1520
19805004,341.0,341.0,2700000,2099000,601000,22,2700000,Null,Null,19805004,33203,1520
19807132,145.0,145.0,4400000,3575000,825000,19,4400000,Null,Null,19807132,33203,8170
19807265,0.0,0.0,8585000,8585000,0,0,8585000,Null,Null,19807265,25502,914
19807780,318.0,318.0,179000,141000,38000,21,179000,Null,Null,19807780,230607,23258
19809576,146.0,146.0,3520000,2999000,521000,15,3520000,Null,Null,19809576,33203,1520
19821434,552.0,552.0,104000,86000,18000,17,104000,Null,Null,19821434,243693,1815
19822394,0.0,0.0,9240000,9240000,0,0,9240000,Null,Null,19822394,25502,914
19823408,249.0,249.0,320000,185000,135000,42,320000,Null,Null,19823408,317315,17162
19823687,65.0,65.0,119000,119000,0,0,119000,Null,Null,19823687,27464,1815
19830413,182.0,182.0,105000,89000,16000,15,105000,Null,Null,19830413,111461,1815
19831422,0.0,0.0,10710000,10710000,0,0,10710000,Null,Null,19831422,25502,914
19831629,0.0,0.0,5985000,5985000,0,0,5985000,Null,Null,19831629,25502,914
19840068,1155.0,1155.0,89000,81000,8000,9,89000,Null,Null,19840068,408443,1815
19842992,115.0,115.0,330000,330000,0,0,330000,Null,Null,19842992,194403,1520
19843591,28.0,28.0,59000,59000,0,0,59000,Null,Null,19843591,111461,914
19853979,285.0,285.0,300000,222000,78000,26,300000,Null,Null,19853979,420823,23394
19859421,0.0,0.0,92928000,58080000,34848000,38,92928000,Null,Null,19859421,296157,1883
19883880,1.0,1.0,8000000,8000000,0,0,8000000,Null,Null,19883880,25502,914
19892687,0.0,0.0,11500000,11500000,0,0,11500000,Null,Null,19892687,25697,2
19901285,1.0,1.0,5985000,5985000,0,0,5985000,Null,Null,19901285,25502,914
19901328,4.0,4.0,49000,49000,0,0,49000,Null,Null,19901328,111461,1815
19901547,0.0,0.0,6300000,6300000,0,0,6300000,Null,Null,19901547,25502,914
19901553,250.0,250.0,850000,699000,151000,18,850000,Null,Null,19901553,218061,5905
19902207,21.0,21.0,159500,159500,0,0,159500,Null,Null,19902207,111461,914
19911204,93.0,93.0,35340,35340,0,0,35340,Null,Null,19911204,428977,23622
19915088,6.0,6.0,3426000,3426000,0,0,3426000,Null,Null,19915088,40901,17170
19919918,0.0,0.0,13000000,6890000,6110000,47,13000000,Null,Null,19919918,111461,914
19923728,274.0,274.0,59000,59000,0,0,59000,Null,Null,19923728,111461,1815
19929615,52.0,52.0,205000,205000,0,0,205000,Null,Null,19929615,111461,914
19929974,494.0,494.0,69000,69000,0,0,69000,Null,Null,19929974,111461,1883
19961243,0.0,0.0,6450000,6450000,0,0,6450000,Null,Null,19961243,112278,2
19986711,0.0,0.0,10800000,10800000,0,0,10800000,Null,Null,19986711,25502,914
19986794,0.0,0.0,7800000,7800000,0,0,7800000,Null,Null,19986794,199801,1520
19986822,0.0,0.0,11185000,11185000,0,0,11185000,Null,Null,19986822,25502,914
19989837,71.0,71.0,105000,105000,0,0,105000,Null,Null,19989837,111461,1815
19991668,0.0,0.0,8785000,8785000,0,0,8785000,Null,Null,19991668,25502,914
19992088,1424.0,1424.0,149000,134000,15000,10,149000,Null,Null,19992088,408443,1815
20007641,24.0,24.0,1190000,1190000,0,0,1190000,Null,Null,20007641,110996,26652
20023596,230.0,230.0,200000,200000,0,0,200000,Null,Null,20023596,111461,1883
20025317,0.0,0.0,13085000,13085000,0,0,13085000,Null,Null,20025317,25502,5385
20025334,51.0,51.0,370000,240000,130000,35,370000,Null,Null,20025334,111461,23052
20026595,94.0,94.0,450000,315000,135000,30,450000,Null,Null,20026595,111461,23052
20028074,38.0,38.0,269000,269000,0,0,269000,Null,Null,20028074,111461,1815
20033756,334.0,334.0,55000,32000,23000,42,55000,Null,Null,20033756,111461,1883
20036138,11.0,11.0,75000,75000,0,0,75000,Null,Null,20036138,18804,2153
20062509,1.0,1.0,184000,184000,0,0,184000,Null,Null,20062509,111461,914
20062564,5.0,5.0,4158330,3499000,659330,16,4158330,Null,Null,20062564,204875,1520
20062764,0.0,0.0,5400000,5400000,0,0,5400000,Null,Null,20062764,354721,1601
20063575,0.0,0.0,8400000,8400000,0,0,8400000,Null,Null,20063575,354721,1601
20065765,0.0,0.0,162500,162500,0,0,162500,Null,Null,20065765,111461,914
20096623,12.0,12.0,99000,99000,0,0,99000,Null,Null,20096623,111461,3175
20103667,1389.0,1389.0,16500,16500,0,0,16500,Null,Null,20103667,111461,1883
20105896,267.0,267.0,119900,119900,0,0,119900,Null,Null,20105896,111461,1815
20105932,11.0,11.0,15000,15000,0,0,15000,Null,Null,20105932,111461,914
20106048,11.0,11.0,15000,15000,0,0,15000,Null,Null,20106048,111461,914
20125278,0.0,0.0,21000000,21000000,0,0,21000000,Null,Null,20125278,354721,1601
20131404,302.0,302.0,16000,16000,0,0,16000,Null,Null,20131404,111461,914
20140675,0.0,0.0,12490000,12490000,0,0,12490000,Null,Null,20140675,307531,8205
20162525,1.0,1.0,4600000,4600000,0,0,4600000,Null,Null,20162525,354721,17170
20174019,1.0,1.0,275000,275000,0,0,275000,Null,Null,20174019,111461,15250
20174991,0.0,0.0,8400000,8400000,0,0,8400000,Null,Null,20174991,354721,17170
20199779,1.0,1.0,13490000,13490000,0,0,13490000,Null,Null,20199779,307531,8205
20203823,363.0,363.0,53900,53900,0,0,53900,Null,Null,20203823,111461,1815
20206058,257.0,257.0,160000,160000,0,0,160000,Null,Null,20206058,111461,1815
20206698,961.0,961.0,1041600,868000,173600,17,1041600,Null,Null,20206698,149913,914
20225162,142.0,142.0,175000,168000,7000,4,175000,Null,Null,20225162,41528,1815
20239110,660.0,660.0,891600,743000,148600,17,891600,Null,Null,20239110,149913,914
20239367,14.0,14.0,69000,69000,0,0,69000,Null,Null,20239367,111461,914
20241871,1.0,1.0,16500000,16500000,0,0,16500000,Null,Null,20241871,148551,1815
20241967,7.0,7.0,843000,843000,0,0,843000,Null,Null,20241967,149913,914
20246503,0.0,0.0,36500000,36500000,0,0,36500000,Null,Null,20246503,111461,23576
20264820,12.0,12.0,159000,153000,6000,4,159000,Null,Null,20264820,111461,1815
20265046,7.0,7.0,157000,151000,6000,4,157000,Null,Null,20265046,111461,1815
20276096,0.0,0.0,11985000,11985000,0,0,11985000,Null,Null,20276096,25502,914
20276214,0.0,0.0,10900000,10900000,0,0,10900000,Null,Null,20276214,25502,914
20278010,0.0,0.0,11000000,11000000,0,0,11000000,Null,Null,20278010,25502,914
20280497,5.0,5.0,125500,125500,0,0,125500,Null,Null,20280497,427581,914
20280649,22.0,22.0,240000,240000,0,0,240000,Null,Null,20280649,427581,2
20280764,90.0,90.0,120000,120000,0,0,120000,Null,Null,20280764,427581,2
20280829,56.0,56.0,120000,120000,0,0,120000,Null,Null,20280829,427581,2
20280968,164.0,164.0,14200,14200,0,0,14200,Null,Null,20280968,427581,2
20281401,1.0,1.0,220000,220000,0,0,220000,Null,Null,20281401,427581,2
20281408,8.0,8.0,15250,15250,0,0,15250,Null,Null,20281408,427581,2
20281421,86.0,86.0,160000,160000,0,0,160000,Null,Null,20281421,20271,1804
20281483,0.0,0.0,6985000,6985000,0,0,6985000,Null,Null,20281483,25502,914
20281560,0.0,0.0,8985000,8985000,0,0,8985000,Null,Null,20281560,25502,914
20281613,0.0,0.0,8085000,8085000,0,0,8085000,Null,Null,20281613,25502,914
20281795,0.0,0.0,6985000,6985000,0,0,6985000,Null,Null,20281795,25502,914
20283002,0.0,0.0,10585000,10585000,0,0,10585000,Null,Null,20283002,25502,914
20283127,0.0,0.0,9685000,9685000,0,0,9685000,Null,Null,20283127,25502,914
20283417,0.0,0.0,7800000,7800000,0,0,7800000,Null,Null,20283417,25502,914
20284128,0.0,0.0,16200000,16200000,0,0,16200000,Null,Null,20284128,25502,914
20284130,22.0,22.0,64000,37000,27000,42,64000,Null,Null,20284130,111461,914
20285491,4.0,4.0,39900,39900,0,0,39900,Null,Null,20285491,111461,914
20315732,0.0,0.0,0,285000,115000,0,285000,Null,Null,20315732,198975,0
20332810,2077.0,2077.0,59000,59000,0,0,59000,Null,Null,20332810,111461,23304
20333028,3496.0,3496.0,125000,125000,0,0,125000,Null,Null,20333028,179125,1520
20337531,0.0,0.0,650000,650000,0,0,650000,Null,Null,20337531,444709,2
20350849,2.0,2.0,242000,242000,0,0,242000,Null,Null,20350849,154319,914
20350967,0.0,0.0,189000,189000,0,0,189000,Null,Null,20350967,111461,23022
20363893,79.0,79.0,350000,350000,0,0,350000,Null,Null,20363893,47422,8170
20368843,6.0,6.0,466000,344000,122000,26,466000,Null,Null,20368843,26150,914
20392298,6.0,6.0,104500,104500,0,0,104500,Null,Null,20392298,111461,914
20414538,3.0,3.0,650000,650000,0,0,650000,Null,Null,20414538,444709,2
20420201,0.0,0.0,900000,900000,0,0,900000,Null,Null,20420201,444709,2
20421319,118.0,118.0,374000,374000,0,0,374000,Null,Null,20421319,300267,23048
20422266,3827.0,3827.0,436000,226000,210000,48,436000,Null,Null,20422266,48077,1883
20423335,0.0,0.0,750000,750000,0,0,750000,Null,Null,20423335,444709,2
20431911,2.0,2.0,249000,249000,0,0,249000,Null,Null,20431911,152755,914
20445026,0.0,0.0,700000,700000,0,0,700000,Null,Null,20445026,111461,23588
20476542,62.0,62.0,34500,34500,0,0,34500,Null,Null,20476542,111461,23622
20484673,804.0,804.0,295000,295000,0,0,295000,Null,Null,20484673,278107,1883
20495992,226.0,226.0,550000,299000,251000,46,550000,Null,Null,20495992,19312,1815
20528052,128.0,128.0,139000,139000,0,0,139000,Null,Null,20528052,111461,2153
20541866,41167.0,41167.0,59000,51000,8000,14,59000,Null,Null,20541866,112885,1520
20547175,42.0,42.0,26000,26000,0,0,26000,Null,Null,20547175,407561,914
20551462,44.0,44.0,28900,28000,900,3,28900,Null,Null,20551462,111461,1815
20552385,51.0,51.0,120000,120000,0,0,120000,Null,Null,20552385,111461,1815
20560396,371.0,371.0,99000,69000,30000,30,99000,Null,Null,20560396,111461,11803
20575902,316.0,316.0,120000,99000,21000,18,120000,Null,Null,20575902,111461,1815
20580153,321.0,321.0,599000,599000,0,0,599000,Null,Null,20580153,53557,23394
20583699,5.0,5.0,120000,120000,0,0,120000,Null,Null,20583699,111461,2
20583833,16.0,16.0,80000,80000,0,0,80000,Null,Null,20583833,111461,2
20583900,10.0,10.0,81000,81000,0,0,81000,Null,Null,20583900,111461,2
20584648,4.0,4.0,390000,390000,0,0,390000,Null,Null,20584648,444709,2
20600692,191.0,191.0,33700,33700,0,0,33700,Null,Null,20600692,111461,1815
20615119,632.0,632.0,79000,79000,0,0,79000,Null,Null,20615119,111461,2153
20616267,49.0,49.0,59000,53000,6000,10,59000,Null,Null,20616267,111461,914
20634384,113.0,113.0,49900,49900,0,0,49900,Null,Null,20634384,111461,2154
20634620,4.0,4.0,299000,299000,0,0,299000,Null,Null,20634620,111461,23540
20640806,339.0,339.0,58698,58698,0,0,58698,Null,Null,20640806,111461,7064
20640851,0.0,0.0,14970000,10479000,4491000,30,14970000,Null,Null,20640851,174699,914
20646244,1214.0,1214.0,98000,98000,0,0,98000,Null,Null,20646244,111461,2234
20647351,7.0,7.0,9000,9000,0,0,9000,Null,Null,20647351,111461,1815
20649902,179.0,179.0,680000,389000,291000,43,680000,Null,Null,20649902,430445,3422
20651476,5.0,5.0,49900,49900,0,0,49900,Null,Null,20651476,111461,53074
20680323,0.0,0.0,217000,217000,0,0,217000,Null,Null,20680323,111461,914
20680352,7.0,7.0,44900,44900,0,0,44900,Null,Null,20680352,111461,23010
20693734,0.0,0.0,61171000,61171000,0,0,61171000,Null,Null,20693734,111461,53074
20694316,0.0,0.0,74184000,74184000,0,0,74184000,Null,Null,20694316,111461,53074
20699577,1.0,1.0,7598,3799,3799,50,7598,Null,Null,20699577,111461,1815
20699862,0.0,0.0,70840000,70840000,0,0,70840000,Null,Null,20699862,111461,53074
20701571,1257.0,1257.0,160000,150000,10000,6,160000,Null,Null,20701571,182139,1520
20709218,8.0,8.0,1170000,819000,351000,30,1170000,Null,Null,20709218,4647777,914
20711189,63.0,63.0,199000,199000,0,0,199000,Null,Null,20711189,111461,11858
20724782,25.0,25.0,459900,459900,0,0,459900,Null,Null,20724782,111461,914
20760539,1.0,1.0,9343000,8409000,934000,10,9343000,Null,Null,20760539,4647777,15318
20808738,1686.0,1686.0,155000,114000,41000,26,155000,Null,Null,20808738,50807,1520
20819500,1063.0,1063.0,165000,139000,26000,16,165000,Null,Null,20819500,50807,1520
20833143,28.0,28.0,78900,77322,1578,2,78900,Null,Null,20833143,111461,1815
20864973,1.0,1.0,245000,245000,0,0,245000,Null,Null,20864973,455513,914
20866305,592.0,592.0,89000,89000,0,0,89000,Null,Null,20866305,455955,1520
20867549,5.0,5.0,8000,8000,0,0,8000,Null,Null,20867549,111461,1520
20869738,3095.0,3095.0,360000,296000,64000,18,360000,Null,Null,20869738,21273,1520
20877417,193.0,193.0,128900,125000,3900,3,128900,Null,Null,20877417,111461,1815
20879460,0.0,0.0,3000000,3000000,0,0,3000000,Null,Null,20879460,111461,914
20932785,1.0,1.0,210000,210000,0,0,210000,Null,Null,20932785,455513,2
20934436,4.0,4.0,259000,259000,0,0,259000,Null,Null,20934436,21651,1815
20959852,0.0,0.0,714000,714000,0,0,714000,Null,Null,20959852,455513,2
21012114,2.0,2.0,210000,210000,0,0,210000,Null,Null,21012114,154319,914
21024823,1340.0,1340.0,75000,59000,16000,21,75000,Null,Null,21024823,225363,1520
21031854,10.0,10.0,444000,436000,8000,2,444000,Null,Null,21031854,86206,1520
21031868,5.0,5.0,741000,519000,222000,30,741000,Null,Null,21031868,4647777,914
21031935,10.0,10.0,77000,61000,16000,21,77000,Null,Null,21031935,111461,914
21032603,125.0,125.0,495000,449000,46000,9,495000,Null,Null,21032603,202607,1601
21032645,3095.0,3095.0,150000,150000,0,0,150000,Null,Null,21032645,202607,1597
21058847,78.0,78.0,105000,105000,0,0,105000,Null,Null,21058847,281343,914
21061146,387.0,387.0,60000,60000,0,0,60000,Null,Null,21061146,111461,23362
21078501,130.0,130.0,89900,89900,0,0,89900,Null,Null,21078501,111461,1815
21078746,1573.0,1573.0,349000,289000,60000,17,349000,Null,Null,21078746,363961,3177
21082435,4.0,4.0,94000,75000,19000,20,94000,Null,Null,21082435,111461,914
21121611,4.0,4.0,58000,58000,0,0,58000,Null,Null,21121611,407561,914
21145122,91.0,91.0,329000,316000,13000,4,329000,Null,Null,21145122,111461,1815
21155024,2826.0,2826.0,190000,190000,0,0,190000,Null,Null,21155024,284315,1520
21162121,79.0,79.0,437900,427000,10900,2,437900,Null,Null,21162121,111461,1815
21167516,0.0,0.0,7500,7500,0,0,7500,Null,Null,21167516,111461,1815
21167684,0.0,0.0,7000,7000,0,0,7000,Null,Null,21167684,111461,1815
21182189,12.0,12.0,6000,6000,0,0,6000,Null,Null,21182189,48381,1601
21183089,36.0,36.0,165000,165000,0,0,165000,Null,Null,21183089,111461,53074
21184688,0.0,0.0,14400000,14400000,0,0,14400000,Null,Null,21184688,193837,914
21189199,1.0,1.0,77000,72000,5000,6,77000,Null,Null,21189199,243693,1815
21189613,2.0,2.0,6000,6000,0,0,6000,Null,Null,21189613,48381,1601
21201795,124.0,124.0,36900,36900,0,0,36900,Null,Null,21201795,111461,1883
21226990,0.0,0.0,12500000,12500000,0,0,12500000,Null,Null,21226990,193837,914
21229521,218.0,218.0,125000,125000,0,0,125000,Null,Null,21229521,111461,23258
21238585,333.0,333.0,45000,45000,0,0,45000,Null,Null,21238585,111461,53074
21259297,52.0,52.0,56000,56000,0,0,56000,Null,Null,21259297,111461,914
21264038,270.0,270.0,245000,245000,0,0,245000,Null,Null,21264038,111461,1815
21268314,0.0,0.0,42000,42000,0,0,42000,Null,Null,21268314,111461,53190
21269844,1.0,1.0,49100,49100,0,0,49100,Null,Null,21269844,111461,1815
21277006,4.0,4.0,18000,18000,0,0,18000,Null,Null,21277006,111461,914
21277167,8.0,8.0,18000,18000,0,0,18000,Null,Null,21277167,111461,914
21297952,166.0,166.0,700000,455500,244500,35,700000,Null,Null,21297952,48621,1811
21298805,0.0,0.0,105000,48000,57000,54,105000,Null,Null,21298805,111461,5995
21301419,1703.0,1703.0,150000,150000,0,0,150000,Null,Null,21301419,111461,23034
21315976,70.0,70.0,350000,350000,0,0,350000,Null,Null,21315976,111461,1815
21316309,569.0,569.0,131000,131000,0,0,131000,Null,Null,21316309,19107,1838
21317020,14.0,14.0,2265000,2265000,0,0,2265000,Null,Null,21317020,18804,8061
21325248,121.0,121.0,89000,89000,0,0,89000,Null,Null,21325248,111461,1815
21325869,214.0,214.0,87000,87000,0,0,87000,Null,Null,21325869,111461,1815
21373904,2627.0,2627.0,19000,19000,0,0,19000,Null,Null,21373904,111461,1883
21411205,10.0,10.0,450000,450000,0,0,450000,Null,Null,21411205,111461,914
21415129,73.0,73.0,189476,94738,94738,50,189476,Null,Null,21415129,111461,1883
21423173,0.0,0.0,473000,400000,73000,15,473000,Null,Null,21423173,111461,914
21428940,59.0,59.0,589000,589000,0,0,589000,Null,Null,21428940,46363,914
21431466,1.0,1.0,5090000,5090000,0,0,5090000,Null,Null,21431466,258315,1520
21433575,13.0,13.0,3005000,2343000,662000,22,3005000,Null,Null,21433575,26150,914
21440096,21.0,21.0,75000,75000,0,0,75000,Null,Null,21440096,111461,1815
21441057,4358.0,4358.0,283000,223000,60000,21,283000,Null,Null,21441057,41048,1883
21442616,232.0,232.0,14012,14012,0,0,14012,Null,Null,21442616,111461,1815
21444023,590.0,590.0,209000,209000,0,0,209000,Null,Null,21444023,21688,2
21465183,13.0,13.0,1650000,1650000,0,0,1650000,Null,Null,21465183,18804,8061
21466336,893.0,893.0,53500,53500,0,0,53500,Null,Null,21466336,111461,2337
21471019,6.0,6.0,55000,55000,0,0,55000,Null,Null,21471019,111461,914
21473238,186.0,186.0,6900,6900,0,0,6900,Null,Null,21473238,111461,1815
21481196,812.0,812.0,99000,99000,0,0,99000,Null,Null,21481196,21253,1583
21482254,154.0,154.0,679000,378900,300100,44,679000,Null,Null,21482254,111461,1883
21483373,149.0,149.0,65990,65990,0,0,65990,Null,Null,21483373,111461,51698
21495761,0.0,0.0,48949000,48949000,0,0,48949000,Null,Null,21495761,400077,20492
21558490,8.0,8.0,95000,95000,0,0,95000,Null,Null,21558490,111461,23276
21561796,4.0,4.0,250000,195000,55000,22,250000,Null,Null,21561796,111461,1815
21569900,693.0,693.0,150000,150000,0,0,150000,Null,Null,21569900,111461,1815
21572053,126.0,126.0,198990,197000,1990,1,198990,Null,Null,21572053,111461,1815
21575193,0.0,0.0,14000000,14000000,0,0,14000000,Null,Null,21575193,47678,1520
21582013,1788.0,1788.0,45000,39900,5100,11,45000,Null,Null,21582013,111461,1883
21582385,4.0,4.0,18000,18000,0,0,18000,Null,Null,21582385,111461,914
21602618,283.0,283.0,250000,245000,5000,2,250000,Null,Null,21602618,25403,1520
21610437,0.0,0.0,10500000,10500000,0,0,10500000,Null,Null,21610437,374249,1520
21610779,0.0,0.0,14980000,14980000,0,0,14980000,Null,Null,21610779,374249,1520
21612915,1.0,1.0,83499,83499,0,0,83499,Null,Null,21612915,111461,1883
21615417,0.0,0.0,5584000,5584000,0,0,5584000,Null,Null,21615417,374249,1520
21635350,0.0,0.0,6380000,6380000,0,0,6380000,Null,Null,21635350,374249,1520
21652972,10.0,10.0,3490000,3450000,40000,1,3490000,Null,Null,21652972,144639,2
21671531,0.0,0.0,5584000,5584000,0,0,5584000,Null,Null,21671531,374249,1520
21677521,0.0,0.0,5584000,5584000,0,0,5584000,Null,Null,21677521,374249,1520
21682896,250.0,250.0,45000,39900,5100,11,45000,Null,Null,21682896,111461,1883
21685227,7.0,7.0,159000,159000,0,0,159000,Null,Null,21685227,111461,914
21709416,0.0,0.0,4430000,4430000,0,0,4430000,Null,Null,21709416,374249,1520
21709809,0.0,0.0,4430000,4430000,0,0,4430000,Null,Null,21709809,374249,1520
21710122,0.0,0.0,4430000,4430000,0,0,4430000,Null,Null,21710122,374249,1520
21710547,4.0,4.0,8999,8999,0,0,8999,Null,Null,21710547,111461,1815
21711000,0.0,0.0,4590000,4590000,0,0,4590000,Null,Null,21711000,374249,1520
21711615,0.0,0.0,7950000,7950000,0,0,7950000,Null,Null,21711615,193837,15936
21711839,0.0,0.0,4430000,4430000,0,0,4430000,Null,Null,21711839,374249,1520
21712042,0.0,0.0,4560000,4560000,0,0,4560000,Null,Null,21712042,374249,1520
21712999,0.0,0.0,8000000,8000000,0,0,8000000,Null,Null,21712999,193837,914
21714159,0.0,0.0,10550000,10550000,0,0,10550000,Null,Null,21714159,193837,914
21714366,0.0,0.0,3520000,3520000,0,0,3520000,Null,Null,21714366,374249,1520
21714990,0.0,0.0,4100000,4100000,0,0,4100000,Null,Null,21714990,374249,1520
21752340,230.0,230.0,330000,330000,0,0,330000,Null,Null,21752340,178501,914
21754311,1223.0,1223.0,45000,45000,0,0,45000,Null,Null,21754311,111461,914
21761398,59.0,59.0,24000,24000,0,0,24000,Null,Null,21761398,111461,15936
21762475,21.0,21.0,39900,39900,0,0,39900,Null,Null,21762475,111461,1815
21782438,4.0,4.0,28900,28900,0,0,28900,Null,Null,21782438,111461,2514
21857291,49.0,49.0,258900,258900,0,0,258900,Null,Null,21857291,111461,1815
21903327,316.0,316.0,11900,11662,238,2,11900,Null,Null,21903327,111461,1815
21922020,461.0,461.0,119000,98000,21000,18,119000,Null,Null,21922020,111461,8519
21940408,0.0,0.0,789000,789000,0,0,789000,Null,Null,21940408,455513,2
21981889,0.0,0.0,170000,170000,0,0,170000,Null,Null,21981889,455513,2
22011133,411.0,411.0,230000,230000,0,0,230000,Null,Null,22011133,111461,1883
22028042,75.0,75.0,39000,30900,8100,21,39000,Null,Null,22028042,111461,1815
22028097,6.0,6.0,243000,243000,0,0,243000,Null,Null,22028097,111461,914
22029756,15.0,15.0,99000,99000,0,0,99000,Null,Null,22029756,111461,914
22030584,49.0,49.0,154800,154800,0,0,154800,Null,Null,22030584,111461,1815
22041847,16.0,16.0,25000,24000,1000,4,25000,Null,Null,22041847,111461,1520
22052319,2109.0,2109.0,81000,66000,15000,19,81000,Null,Null,22052319,112886,1583
22052322,1934.0,1934.0,81000,66000,15000,19,81000,Null,Null,22052322,112886,1583
22052329,1540.0,1540.0,76000,62000,14000,18,76000,Null,Null,22052329,112886,1583
22072676,79.0,79.0,75000,75000,0,0,75000,Null,Null,22072676,111461,1815
22081857,3.0,3.0,4000000,4000000,0,0,4000000,Null,Null,22081857,463255,1583
22081865,1242.0,1242.0,40000,40000,0,0,40000,Null,Null,22081865,111461,1883
22103020,640.0,640.0,350000,285000,65000,19,350000,Null,Null,22103020,469887,1520
22105532,40.0,40.0,17900,17900,0,0,17900,Null,Null,22105532,111461,1815
22167361,1.0,1.0,13990000,12590000,1400000,10,13990000,Null,Null,22167361,18985,2
22170321,286.0,286.0,83490,83490,0,0,83490,Null,Null,22170321,111461,2173
22194407,7.0,7.0,784000,549000,235000,30,784000,Null,Null,22194407,4647777,914
22253697,1111.0,1111.0,88000,78000,10000,11,88000,Null,Null,22253697,21272,1520
22254079,4852.0,4852.0,396000,318000,78000,20,396000,Null,Null,22254079,27918,1520
22254660,23773.0,23773.0,396000,286000,110000,28,396000,Null,Null,22254660,27918,1520
22256619,12.0,12.0,5900,1000,4900,83,5900,Null,Null,22256619,111461,2363
22272066,0.0,0.0,11100000,9250000,1850000,17,11100000,Null,Null,22272066,174699,2
22364421,9.0,9.0,3426000,3426000,0,0,3426000,Null,Null,22364421,40901,1520
22367910,5.0,5.0,54400,54400,0,0,54400,Null,Null,22367910,111461,23394
22369398,167.0,167.0,105000,95000,10000,10,105000,Null,Null,22369398,183795,1520
22372768,15119.0,15119.0,529000,487000,42000,8,529000,Null,Null,22372768,523789,1883
22372854,326.0,326.0,790000,690000,100000,13,790000,Null,Null,22372854,243693,1815
22380700,186.0,186.0,129000,129000,0,0,129000,Null,Null,22380700,155308,1815
22383687,218.0,218.0,721000,721000,0,0,721000,Null,Null,22383687,256611,26652
22413302,27.0,27.0,212267,148587,63680,30,212267,Null,Null,22413302,111461,1815
22436030,15.0,15.0,139000,139000,0,0,139000,Null,Null,22436030,21651,1815
22436063,1750.0,1750.0,25780,25780,0,0,25780,Null,Null,22436063,18776,1815
22437111,53.0,53.0,39000,39000,0,0,39000,Null,Null,22437111,111461,8371
22493519,14.0,14.0,25000,25000,0,0,25000,Null,Null,22493519,364731,2
22507317,3.0,3.0,210000,210000,0,0,210000,Null,Null,22507317,455513,2
22507620,5.0,5.0,210000,210000,0,0,210000,Null,Null,22507620,455513,2
22507696,6.0,6.0,210000,210000,0,0,210000,Null,Null,22507696,455513,2
22556367,174.0,174.0,95000,95000,0,0,95000,Null,Null,22556367,281343,914
22613503,82.0,82.0,120000,120000,0,0,120000,Null,Null,22613503,111461,1815
22616518,1.0,1.0,230000,230000,0,0,230000,Null,Null,22616518,455513,2
22617279,5.0,5.0,200000,200000,0,0,200000,Null,Null,22617279,455513,2
22625465,8.0,8.0,58000,58000,0,0,58000,Null,Null,22625465,111461,914
22631108,1.0,1.0,23900,23000,900,4,23900,Null,Null,22631108,111461,1883
22633043,151.0,151.0,165000,161700,3300,2,165000,Null,Null,22633043,155308,1815
22653543,319.0,319.0,320000,314000,6000,2,320000,Null,Null,22653543,48399,1520
22671307,31.0,31.0,2500,2500,0,0,2500,Null,Null,22671307,111461,2685
22754662,0.0,0.0,38400000,38400000,0,0,38400000,Null,Null,22754662,144845,53190
22777778,185.0,185.0,440000,440000,0,0,440000,Null,Null,22777778,111461,2849
22778027,314.0,314.0,199000,199000,0,0,199000,Null,Null,22778027,111461,1883
22822546,89.0,89.0,27000,27000,0,0,27000,Null,Null,22822546,111461,1634
22878295,1081.0,1081.0,2000,2000,0,0,2000,Null,Null,22878295,111461,5450
22881214,4.0,4.0,172000,172000,0,0,172000,Null,Null,22881214,455513,2
22900556,0.0,0.0,18000000,18000000,0,0,18000000,Null,Null,22900556,254129,1815
22911430,6.0,6.0,230000,230000,0,0,230000,Null,Null,22911430,455513,2
22935173,0.0,0.0,230000,230000,0,0,230000,Null,Null,22935173,455513,2
22935301,2.0,2.0,200000,200000,0,0,200000,Null,Null,22935301,455513,15250
22949739,23.0,23.0,27000,27000,0,0,27000,Null,Null,22949739,111461,53074
22976410,79.0,79.0,25000,25000,0,0,25000,Null,Null,22976410,111461,914
22983097,1386.0,1386.0,150000,147000,3000,2,150000,Null,Null,22983097,182139,1520
23006566,209.0,209.0,110000,94100,15900,14,110000,Null,Null,23006566,200189,1520
23018695,0.0,0.0,431000,431000,0,0,431000,Null,Null,23018695,111461,914
23026129,0.0,0.0,6000,6000,0,0,6000,Null,Null,23026129,111461,2
23062716,77.0,77.0,279000,279000,0,0,279000,Null,Null,23062716,111461,914
23068220,35.0,35.0,455000,455000,0,0,455000,Null,Null,23068220,41048,1883
23085024,31.0,31.0,16500,16500,0,0,16500,Null,Null,23085024,505165,914
23099028,25.0,25.0,13600,13600,0,0,13600,Null,Null,23099028,111461,914
23108268,10.0,10.0,3850000,3850000,0,0,3850000,Null,Null,23108268,234023,1520
23108953,24.0,24.0,4750000,4750000,0,0,4750000,Null,Null,23108953,234023,1520
23118896,9.0,9.0,3600000,3600000,0,0,3600000,Null,Null,23118896,234023,1520
23124694,19.0,19.0,3850000,3850000,0,0,3850000,Null,Null,23124694,234023,1520
23142193,2.0,2.0,2100000,2100000,0,0,2100000,Null,Null,23142193,18804,8061
23213391,46.0,46.0,113000,113000,0,0,113000,Null,Null,23213391,111461,27180
23220930,29.0,29.0,62000,62000,0,0,62000,Null,Null,23220930,111461,914
23270570,3.0,3.0,18050,18050,0,0,18050,Null,Null,23270570,111461,3710
23286510,223.0,223.0,149000,149000,0,0,149000,Null,Null,23286510,281769,914
23290894,20.0,20.0,43980,43980,0,0,43980,Null,Null,23290894,111461,23244
23361189,35.0,35.0,159000,155820,3180,2,159000,Null,Null,23361189,111467,1815
23395335,2.0,2.0,3500000,3500000,0,0,3500000,Null,Null,23395335,464951,8227
23396414,0.0,0.0,40860000,40860000,0,0,40860000,Null,Null,23396414,279957,11858
23403954,52.0,52.0,120000,101299,18701,16,120000,Null,Null,23403954,111461,2784
23411884,2.0,2.0,17800,17800,0,0,17800,Null,Null,23411884,111461,914
23413777,18.0,18.0,13600,13600,0,0,13600,Null,Null,23413777,111461,914
23420871,10.0,10.0,76000,76000,0,0,76000,Null,Null,23420871,364731,2
23425756,283.0,283.0,74500,74500,0,0,74500,Null,Null,23425756,111461,914
23432505,79.0,79.0,62000,62000,0,0,62000,Null,Null,23432505,111461,23394
23442433,2.0,2.0,270630,270630,0,0,270630,Null,Null,23442433,111461,7078
23442757,8.0,8.0,269000,269000,0,0,269000,Null,Null,23442757,111461,1883
23445358,331.0,331.0,24990,24990,0,0,24990,Null,Null,23445358,111461,53054
23447625,650.0,650.0,115000,115000,0,0,115000,Null,Null,23447625,354595,17162
23462368,97.0,97.0,379000,379000,0,0,379000,Null,Null,23462368,25422,1634
23476097,0.0,0.0,52800,52800,0,0,52800,Null,Null,23476097,111461,5995
23476288,664.0,664.0,132000,132000,0,0,132000,Null,Null,23476288,361507,2971
23481564,434.0,434.0,125000,125000,0,0,125000,Null,Null,23481564,19071,3428
23485049,496.0,496.0,300000,300000,0,0,300000,Null,Null,23485049,484879,1520
23490593,154.0,154.0,259000,259000,0,0,259000,Null,Null,23490593,18984,1815
23515481,114.0,114.0,49000,49000,0,0,49000,Null,Null,23515481,21653,1815
23518127,132.0,132.0,288000,269000,19000,7,288000,Null,Null,23518127,19246,1838
23536038,503.0,503.0,279000,205000,74000,27,279000,Null,Null,23536038,230607,23258
23542112,90.0,90.0,169000,85000,84000,50,169000,Null,Null,23542112,21651,1815
23622337,6.0,6.0,57899,57899,0,0,57899,Null,Null,23622337,111461,914
23697531,456.0,456.0,36000,29000,7000,19,36000,Null,Null,23697531,111461,1815
23790776,424.0,424.0,99880,99880,0,0,99880,Null,Null,23790776,111461,1815
23792190,158.0,158.0,43500,43500,0,0,43500,Null,Null,23792190,111461,1883
23803910,18.0,18.0,99000,35000,64000,65,99000,Null,Null,23803910,111461,914
23821425,340.0,340.0,78000,78000,0,0,78000,Null,Null,23821425,111461,1883
23865953,214.0,214.0,275000,275000,0,0,275000,Null,Null,23865953,18804,8061
23872577,0.0,0.0,23000,18000,5000,22,23000,Null,Null,23872577,111461,15250
23880517,28.0,28.0,99000,98000,1000,1,99000,Null,Null,23880517,160941,13878
23896098,247.0,247.0,229745,229745,0,0,229745,Null,Null,23896098,487213,1520
23986597,1060.0,1060.0,60000,57000,3000,5,60000,Null,Null,23986597,454391,1520
23991110,62.0,62.0,150000,98000,52000,35,150000,Null,Null,23991110,111461,23026
24006018,101.0,101.0,113999,113999,0,0,113999,Null,Null,24006018,21651,1815
24015648,1.0,1.0,330000,330000,0,0,330000,Null,Null,24015648,455513,2
24048219,4.0,4.0,200000,200000,0,0,200000,Null,Null,24048219,455513,2
24053893,2.0,2.0,250000,250000,0,0,250000,Null,Null,24053893,455513,2
24065366,2.0,2.0,789000,789000,0,0,789000,Null,Null,24065366,455513,2
24070454,2.0,2.0,200000,200000,0,0,200000,Null,Null,24070454,455513,2
24072618,1.0,1.0,714000,714000,0,0,714000,Null,Null,24072618,455513,2
24156710,1418.0,1418.0,6990,6640,350,5,6990,Null,Null,24156710,111461,1883
24161391,820.0,820.0,300000,300000,0,0,300000,Null,Null,24161391,484879,1520
24163146,462.0,462.0,199000,153000,46000,23,199000,Null,Null,24163146,230607,23258
24189343,143.0,143.0,179000,179000,0,0,179000,Null,Null,24189343,111461,1815
24244446,374.0,374.0,379000,379000,0,0,379000,Null,Null,24244446,161077,2
24246161,131.0,131.0,630000,630000,0,0,630000,Null,Null,24246161,488997,1520
24246233,1076.0,1076.0,350000,350000,0,0,350000,Null,Null,24246233,248445,1520
24260927,1231.0,1231.0,239000,239000,0,0,239000,Null,Null,24260927,211603,1520
24312036,1055.0,1055.0,331000,229000,102000,31,331000,Null,Null,24312036,321545,1520
24319638,4.0,4.0,49000,49000,0,0,49000,Null,Null,24319638,111461,1815
24341840,572.0,572.0,150000,150000,0,0,150000,Null,Null,24341840,155524,8305
24356473,314.0,314.0,89000,89000,0,0,89000,Null,Null,24356473,363961,3177
24405272,81.0,81.0,139000,139000,0,0,139000,Null,Null,24405272,111461,1634
24417530,2.0,2.0,149000,149000,0,0,149000,Null,Null,24417530,111461,23346
24499189,13.0,13.0,255000,255000,0,0,255000,Null,Null,24499189,47424,1520
24538083,0.0,0.0,15500000,15500000,0,0,15500000,Null,Null,24538083,443441,26652
24544397,0.0,0.0,21500000,21500000,0,0,21500000,Null,Null,24544397,111461,15318
24545394,3.0,3.0,76000,76000,0,0,76000,Null,Null,24545394,111461,914
24598534,93.0,93.0,729000,725000,4000,1,729000,Null,Null,24598534,18804,1520
24607822,0.0,0.0,720000,720000,0,0,720000,Null,Null,24607822,47424,1520
24628107,8.0,8.0,209000,209000,0,0,209000,Null,Null,24628107,111461,914
24645791,10.0,10.0,294000,294000,0,0,294000,Null,Null,24645791,111461,914
24650581,327.0,327.0,199000,199000,0,0,199000,Null,Null,24650581,48202,1520
24685119,752.0,752.0,140778,140778,0,0,140778,Null,Null,24685119,370711,1520
24699546,3037.0,3037.0,166600,151000,15600,9,166600,Null,Null,24699546,27918,1520
24736246,0.0,0.0,4320000,4320000,0,0,4320000,Null,Null,24736246,493321,3422
24736489,0.0,0.0,7500000,7500000,0,0,7500000,Null,Null,24736489,111461,914
24736593,0.0,0.0,6000000,6000000,0,0,6000000,Null,Null,24736593,111461,914
24752546,328.0,328.0,148000,148000,0,0,148000,Null,Null,24752546,21274,1520
24765434,0.0,0.0,4800000,4800000,0,0,4800000,Null,Null,24765434,406413,1520
24786824,321.0,321.0,500000,420000,80000,16,500000,Null,Null,24786824,150297,1520
24788762,0.0,0.0,0,10900000,0,0,10900000,Null,Null,24788762,276543,0
24791816,0.0,0.0,40500000,40500000,0,0,40500000,Null,Null,24791816,111461,23576
24865067,292.0,292.0,184000,164000,20000,11,184000,Null,Null,24865067,255043,1815
24900393,6.0,6.0,95000,95000,0,0,95000,Null,Null,24900393,111461,1883
24910578,3503.0,3503.0,290000,140000,150000,52,290000,Null,Null,24910578,148534,1520
24929679,521.0,521.0,150000,99000,51000,34,150000,Null,Null,24929679,111461,1804
24969676,43.0,43.0,5000,2500,2500,50,5000,Null,Null,24969676,111461,1883
24981803,103.0,103.0,120000,99000,21000,18,120000,Null,Null,24981803,185083,1815
24989322,289.0,289.0,90000,90000,0,0,90000,Null,Null,24989322,495507,1520
24997365,197.0,197.0,45000,45000,0,0,45000,Null,Null,24997365,21653,1815
25037627,0.0,0.0,4050000,4050000,0,0,4050000,Null,Null,25037627,401041,1520
25051899,723.0,723.0,189000,189000,0,0,189000,Null,Null,25051899,204301,2
25055074,2.0,2.0,279800,279800,0,0,279800,Null,Null,25055074,111461,23622
25058248,77.0,77.0,20000,16000,4000,20,20000,Null,Null,25058248,111461,914
25058705,93.0,93.0,87000,69000,18000,21,87000,Null,Null,25058705,111461,914
25059503,152.0,152.0,83000,35000,48000,58,83000,Null,Null,25059503,111461,914
25074016,320.0,320.0,210000,199000,11000,5,210000,Null,Null,25074016,202607,1520
25074045,134.0,134.0,530000,265000,265000,50,530000,Null,Null,25074045,202607,1520
25106346,422.0,422.0,128900,121000,7900,6,128900,Null,Null,25106346,111461,28688
25108019,3415.0,3415.0,69000,59500,9500,14,69000,Null,Null,25108019,112887,3426
25108217,25444.0,25444.0,68000,59000,9000,13,68000,Null,Null,25108217,112887,1583
25123004,941.0,941.0,300000,189000,111000,37,300000,Null,Null,25123004,255877,914
25126056,279.0,279.0,15000,15000,0,0,15000,Null,Null,25126056,111461,1520
25129473,8.0,8.0,130000,130000,0,0,130000,Null,Null,25129473,111461,914
25140473,0.0,0.0,450000,450000,0,0,450000,Null,Null,25140473,111461,6305
25169432,14.0,14.0,57489,57489,0,0,57489,Null,Null,25169432,111461,914
25186758,0.0,0.0,148000,148000,0,0,148000,Null,Null,25186758,111461,23126
25246033,1106.0,1106.0,950000,902000,48000,5,950000,Null,Null,25246033,259783,1883
25248696,259.0,259.0,32800,32800,0,0,32800,Null,Null,25248696,111461,28674
25250318,66.0,66.0,46000,46000,0,0,46000,Null,Null,25250318,111461,914
25278409,296.0,296.0,120000,120000,0,0,120000,Null,Null,25278409,111461,2337
25312799,1.0,1.0,470000,470000,0,0,470000,Null,Null,25312799,455513,2
25313692,1.0,1.0,340000,340000,0,0,340000,Null,Null,25313692,455513,2
25314039,1.0,1.0,473000,473000,0,0,473000,Null,Null,25314039,455513,2
25315070,1.0,1.0,470000,470000,0,0,470000,Null,Null,25315070,455513,2
25324694,0.0,0.0,15000,10000,5000,33,15000,Null,Null,25324694,111461,1815
25325318,20.0,20.0,16900,16900,0,0,16900,Null,Null,25325318,111461,1815
25402439,13.0,13.0,8888000,7799000,1089000,12,8888000,Null,Null,25402439,498605,1520
25402949,6.0,6.0,6600000,6600000,0,0,6600000,Null,Null,25402949,498605,1520
25408070,174.0,174.0,31000,31000,0,0,31000,Null,Null,25408070,111461,914
25412653,13.0,13.0,27700,27700,0,0,27700,Null,Null,25412653,111461,23036
25421013,828.0,828.0,660000,464000,196000,30,660000,Null,Null,25421013,41048,1883
25421029,1.0,1.0,399000,399000,0,0,399000,Null,Null,25421029,41048,2136
25433064,2.0,2.0,4600000,4600000,0,0,4600000,Null,Null,25433064,499169,3424
25433066,9.0,9.0,3800000,3800000,0,0,3800000,Null,Null,25433066,499169,17170
25434784,0.0,0.0,6500000,6500000,0,0,6500000,Null,Null,25434784,499169,17170
25434788,0.0,0.0,13000000,13000000,0,0,13000000,Null,Null,25434788,499169,17170
25440933,595.0,595.0,200000,99000,101000,51,200000,Null,Null,25440933,148534,1607
25444067,3036.0,3036.0,290000,140000,150000,52,290000,Null,Null,25444067,148534,2
25446047,0.0,0.0,7098000,6389000,709000,10,7098000,Null,Null,25446047,4647777,914
25554844,1303.0,1303.0,29000,29000,0,0,29000,Null,Null,25554844,111461,1815
25560712,0.0,0.0,12000000,12000000,0,0,12000000,Null,Null,25560712,499169,3424
25561272,0.0,0.0,14000000,14000000,0,0,14000000,Null,Null,25561272,499169,1601
25598451,0.0,0.0,5500000,5500000,0,0,5500000,Null,Null,25598451,499169,53350
25599163,1.0,1.0,4500000,4500000,0,0,4500000,Null,Null,25599163,499169,17170
25599322,1.0,1.0,5500000,5500000,0,0,5500000,Null,Null,25599322,499169,1601
25656707,380.0,380.0,27000,27000,0,0,27000,Null,Null,25656707,111461,1815
25690698,201.0,201.0,50000,47500,2500,5,50000,Null,Null,25690698,111461,2140
25692340,352.0,352.0,108000,108000,0,0,108000,Null,Null,25692340,111461,1815
25704809,1985.0,1985.0,535000,385000,150000,28,535000,Null,Null,25704809,47489,3422
25730586,8.0,8.0,4300000,4300000,0,0,4300000,Null,Null,25730586,499169,17170
25736448,1.0,1.0,5000000,5000000,0,0,5000000,Null,Null,25736448,499169,1520
25738219,206.0,206.0,396000,265000,131000,33,396000,Null,Null,25738219,113716,1583
25739052,0.0,0.0,130000,89000,41000,32,130000,Null,Null,25739052,19071,2
25749035,757.0,757.0,68200,68200,0,0,68200,Null,Null,25749035,361507,4429
25758447,1.0,1.0,258811,258811,0,0,258811,Null,Null,25758447,47882,914
25813758,0.0,0.0,5785000,5785000,0,0,5785000,Null,Null,25813758,25502,914
25814208,0.0,0.0,7385000,7385000,0,0,7385000,Null,Null,25814208,25502,914
25815077,0.0,0.0,7750000,7750000,0,0,7750000,Null,Null,25815077,25502,914
25815151,0.0,0.0,8100000,8100000,0,0,8100000,Null,Null,25815151,25502,914
25861909,263.0,263.0,460000,460000,0,0,460000,Null,Null,25861909,314409,1520
25904808,375.0,375.0,20000,20000,0,0,20000,Null,Null,25904808,111461,8202
25917926,1195.0,1195.0,307000,269000,38000,12,307000,Null,Null,25917926,502135,1520
25917928,1164.0,1164.0,390000,335000,55000,14,390000,Null,Null,25917928,502135,3426
25917930,1528.0,1528.0,147000,129000,18000,12,147000,Null,Null,25917930,502135,3426
25917932,1161.0,1161.0,307000,259000,48000,16,307000,Null,Null,25917932,502135,3426
25917934,90.0,90.0,124000,123000,1000,1,124000,Null,Null,25917934,502135,1520
25917935,878.0,878.0,190000,169000,21000,11,190000,Null,Null,25917935,502135,1520
25922008,0.0,0.0,10020000,8350000,1670000,17,10020000,Null,Null,25922008,174699,914
25922080,72.0,72.0,116000,99000,17000,15,116000,Null,Null,25922080,111461,914
25922110,2.0,2.0,343422,343422,0,0,343422,Null,Null,25922110,111461,1832
25925129,38.0,38.0,10000,10000,0,0,10000,Null,Null,25925129,111461,1520
25925799,36.0,36.0,189000,159000,30000,16,189000,Null,Null,25925799,47882,914
25935733,29.0,29.0,695000,695000,0,0,695000,Null,Null,25935733,74559,914
25946133,206.0,206.0,360000,360000,0,0,360000,Null,Null,25946133,111461,23394
25949745,0.0,0.0,5690000,5600000,90000,2,5690000,Null,Null,25949745,147856,28856
25960921,0.0,0.0,10685000,10685000,0,0,10685000,Null,Null,25960921,25502,5385
25962286,61.0,61.0,109000,109000,0,0,109000,Null,Null,25962286,111461,914
25962563,23.0,23.0,88500,88500,0,0,88500,Null,Null,25962563,111461,914
25962704,0.0,0.0,990000,990000,0,0,990000,Null,Null,25962704,111461,1883
25964603,0.0,0.0,6785000,6785000,0,0,6785000,Null,Null,25964603,25502,914
25964607,0.0,0.0,6100000,6100000,0,0,6100000,Null,Null,25964607,25502,914
26022296,0.0,0.0,6000,6000,0,0,6000,Null,Null,26022296,48381,1601
26029929,603.0,603.0,25000,24500,500,2,25000,Null,Null,26029929,111461,1815
26033870,28.0,28.0,218000,218000,0,0,218000,Null,Null,26033870,111461,23010
26062595,122.0,122.0,120000,120000,0,0,120000,Null,Null,26062595,111461,914
26064289,21.0,21.0,3524000,2517000,1007000,29,3524000,Null,Null,26064289,26150,914
26074393,24.0,24.0,105000,105000,0,0,105000,Null,Null,26074393,111461,914
26075426,147.0,147.0,98500,98500,0,0,98500,Null,Null,26075426,111461,914
26080685,185.0,185.0,330000,330000,0,0,330000,Null,Null,26080685,111461,27180
26086452,0.0,0.0,52433000,39324000,13109000,25,52433000,Null,Null,26086452,183111,23376
26093257,261.0,261.0,69900,69900,0,0,69900,Null,Null,26093257,111461,5531
26096771,1253.0,1253.0,215000,215000,0,0,215000,Null,Null,26096771,254393,1520
26113983,114.0,114.0,95000,84100,10900,11,95000,Null,Null,26113983,200189,1520
26115341,40.0,40.0,170000,170000,0,0,170000,Null,Null,26115341,200189,1520
26115522,23.0,23.0,270000,270000,0,0,270000,Null,Null,26115522,200189,1520
26119079,97.0,97.0,877000,804000,73000,8,877000,Null,Null,26119079,18984,1815
26143398,221.0,221.0,70000,28000,42000,60,70000,Null,Null,26143398,111461,914
26149459,21.0,21.0,110000,110000,0,0,110000,Null,Null,26149459,111461,1883
26165963,319.0,319.0,124000,124000,0,0,124000,Null,Null,26165963,150002,2
26219795,83.0,83.0,139900,139900,0,0,139900,Null,Null,26219795,111393,1815
26230723,20.0,20.0,99000,99000,0,0,99000,Null,Null,26230723,270875,914
26286896,21.0,21.0,273000,273000,0,0,273000,Null,Null,26286896,111461,23588
26289535,27.0,27.0,84000,84000,0,0,84000,Null,Null,26289535,111461,5995
26297899,330.0,330.0,65000,57330,7670,12,65000,Null,Null,26297899,21653,1815
26299369,2.0,2.0,3900000,3900000,0,0,3900000,Null,Null,26299369,506629,17170
26299371,3.0,3.0,3900000,3900000,0,0,3900000,Null,Null,26299371,506629,17170
26299373,0.0,0.0,4100000,4100000,0,0,4100000,Null,Null,26299373,506629,2
26299415,0.0,0.0,4700000,4700000,0,0,4700000,Null,Null,26299415,506629,2
26299417,0.0,0.0,8700000,8700000,0,0,8700000,Null,Null,26299417,506629,2
26299425,0.0,0.0,18600000,18600000,0,0,18600000,Null,Null,26299425,506629,1601
26299433,0.0,0.0,10500000,10500000,0,0,10500000,Null,Null,26299433,506629,53350
26299569,21.0,21.0,280000,187000,93000,33,280000,Null,Null,26299569,111461,914
26312778,13.0,13.0,139000,139000,0,0,139000,Null,Null,26312778,21651,1815
26318814,14.0,14.0,100000,100000,0,0,100000,Null,Null,26318814,111461,914
26334551,2350.0,2350.0,180000,180000,0,0,180000,Null,Null,26334551,252399,23352
26339567,363.0,363.0,279000,279000,0,0,279000,Null,Null,26339567,25422,8170
26341625,231.0,231.0,91900,91900,0,0,91900,Null,Null,26341625,111461,4593
26348659,429.0,429.0,79000,70000,9000,11,79000,Null,Null,26348659,226401,1811
26348819,357.0,357.0,159000,159000,0,0,159000,Null,Null,26348819,111461,53190
26353146,16.0,16.0,118000,118000,0,0,118000,Null,Null,26353146,111461,914
26353267,1.0,1.0,69000,9000,60000,87,69000,Null,Null,26353267,111461,1815
26376922,5.0,5.0,3490000,3490000,0,0,3490000,Null,Null,26376922,150399,1626
26436884,53.0,53.0,67000,67000,0,0,67000,Null,Null,26436884,111461,914
26470086,199.0,199.0,73000,73000,0,0,73000,Null,Null,26470086,111461,1883
26470607,69.0,69.0,116000,89000,27000,23,116000,Null,Null,26470607,32909,1583
26491413,948.0,948.0,6990,6990,0,0,6990,Null,Null,26491413,111461,1883
26495168,1.0,1.0,4700000,4700000,0,0,4700000,Null,Null,26495168,506629,1520
26498455,0.0,0.0,20000000,20000000,0,0,20000000,Null,Null,26498455,506629,53350
26500302,0.0,0.0,18000000,18000000,0,0,18000000,Null,Null,26500302,506629,17170
26501921,40.0,40.0,189000,189000,0,0,189000,Null,Null,26501921,34398,1520
26525072,65.0,65.0,9900,9000,900,9,9900,Null,Null,26525072,408443,1815
26612966,2.0,2.0,1141000,799000,342000,30,1141000,Null,Null,26612966,4647777,914
26659222,201.0,201.0,29998,14999,14999,50,29998,Null,Null,26659222,111461,1815
26666015,19.0,19.0,7899,1000,6899,87,7899,Null,Null,26666015,111461,2363
26670490,3403.0,3403.0,242000,223000,19000,8,242000,Null,Null,26670490,523789,23258
26672005,0.0,0.0,14998,7499,7499,50,14998,Null,Null,26672005,111461,1815
26682634,66.0,66.0,125000,125000,0,0,125000,Null,Null,26682634,111461,914
26708402,148.0,148.0,43464,43464,0,0,43464,Null,Null,26708402,111461,8519
26709162,7674.0,7674.0,617600,460000,157600,26,617600,Null,Null,26709162,21273,1520
27068546,2385.0,2385.0,260000,160000,100000,38,260000,Null,Null,27068546,456351,1883
27183143,25.0,25.0,157000,157000,0,0,157000,Null,Null,27183143,111461,914
27532125,9.0,9.0,139000,139000,0,0,139000,Null,Null,27532125,111461,914
27599925,57.0,57.0,98000,98000,0,0,98000,Null,Null,27599925,111461,2
27636964,337.0,337.0,319000,319000,0,0,319000,Null,Null,27636964,510791,1520
27733472,1.0,1.0,375000,375000,0,0,375000,Null,Null,27733472,111461,914
27783890,791.0,791.0,550000,550000,0,0,550000,Null,Null,27783890,511405,1520
27813965,562.0,562.0,492000,383760,108240,22,492000,Null,Null,27813965,26150,914
27830160,6.0,6.0,109000,109000,0,0,109000,Null,Null,27830160,111461,15236
27850201,0.0,0.0,40000000,40000000,0,0,40000000,Null,Null,27850201,112888,11516
27854716,0.0,0.0,39000000,39000000,0,0,39000000,Null,Null,27854716,112888,11516
27859460,0.0,0.0,12000000,12000000,0,0,12000000,Null,Null,27859460,111461,914
27863025,0.0,0.0,14500,14000,500,3,14500,Null,Null,27863025,195495,1815
27872058,58.0,58.0,126000,126000,0,0,126000,Null,Null,27872058,111461,914
27888124,0.0,0.0,9000000,9000000,0,0,9000000,Null,Null,27888124,111461,914
27928235,0.0,0.0,7000000,7000000,0,0,7000000,Null,Null,27928235,111461,15318
28031120,17.0,17.0,13600,13600,0,0,13600,Null,Null,28031120,111461,914
28036776,53.0,53.0,15700,15700,0,0,15700,Null,Null,28036776,111461,914
28080769,0.0,0.0,48999,48999,0,0,48999,Null,Null,28080769,111461,914
28117010,58.0,58.0,17000,17000,0,0,17000,Null,Null,28117010,111461,1622
28271064,380.0,380.0,157500,138000,19500,12,157500,Null,Null,28271064,48381,53350
28517939,675.0,675.0,329000,326500,2500,1,329000,Null,Null,28517939,368347,1520
28548487,5.0,5.0,55000,55000,0,0,55000,Null,Null,28548487,111461,914
28603570,4.0,4.0,112000,112000,0,0,112000,Null,Null,28603570,407561,914
28619438,1377.0,1377.0,1500000,1150000,350000,23,1500000,Null,Null,28619438,51302,1883
28725732,91.0,91.0,1164378,1164378,0,0,1164378,Null,Null,28725732,33203,1520
28730935,19.0,19.0,178728,89364,89364,50,178728,Null,Null,28730935,163707,1815
28736624,135.0,135.0,15400,15400,0,0,15400,Null,Null,28736624,111461,1815
28747839,0.0,0.0,137000,137000,0,0,137000,Null,Null,28747839,111461,914
28921808,1.0,1.0,6443000,5799000,644000,10,6443000,Null,Null,28921808,4647777,914
28923163,0.0,0.0,6443000,5799000,644000,10,6443000,Null,Null,28923163,4647777,914
28937832,307.0,307.0,2400000,2400000,0,0,2400000,Null,Null,28937832,191611,1815
28950501,99.0,99.0,122800,122800,0,0,122800,Null,Null,28950501,111461,1815
28974222,34.0,34.0,270000,234000,36000,13,270000,Null,Null,28974222,143353,1815
29130514,0.0,0.0,10000000,10000000,0,0,10000000,Null,Null,29130514,111461,15318
29130544,0.0,0.0,8000000,8000000,0,0,8000000,Null,Null,29130544,111461,914
29138169,0.0,0.0,11000000,11000000,0,0,11000000,Null,Null,29138169,111461,914
29138413,197.0,197.0,35000,35000,0,0,35000,Null,Null,29138413,111461,914
29138431,128.0,128.0,49000,49000,0,0,49000,Null,Null,29138431,111461,914
29187427,0.0,0.0,55000000,47840000,7160000,13,55000000,Null,Null,29187427,111461,23576
29205762,36.0,36.0,250000,250000,0,0,250000,Null,Null,29205762,427581,914
29253667,24.0,24.0,1000,1000,0,0,1000,Null,Null,29253667,111461,2514
29440849,0.0,0.0,1650000,1650000,0,0,1650000,Null,Null,29440849,522685,8061
29446449,0.0,0.0,1850000,1850000,0,0,1850000,Null,Null,29446449,111461,8061
29452939,314.0,314.0,60000,60000,0,0,60000,Null,Null,29452939,111461,1815
29496874,1.0,1.0,16800000,16800000,0,0,16800000,Null,Null,29496874,50331,28860
29569060,2454.0,2454.0,500000,450000,50000,10,500000,Null,Null,29569060,202607,1520
29569089,3737.0,3737.0,500000,450000,50000,10,500000,Null,Null,29569089,202607,17170
29569359,2741.0,2741.0,260000,247000,13000,5,260000,Null,Null,29569359,202607,1520
29569376,5588.0,5588.0,160000,152000,8000,5,160000,Null,Null,29569376,202607,17170
29575776,178.0,178.0,22900,22900,0,0,22900,Null,Null,29575776,111461,1815
29655357,178.0,178.0,84000,84000,0,0,84000,Null,Null,29655357,111461,1815
29810162,0.0,0.0,6000000,6000000,0,0,6000000,Null,Null,29810162,111461,15318
29905257,46.0,46.0,3900,3900,0,0,3900,Null,Null,29905257,111461,2
29918892,115.0,115.0,279000,279000,0,0,279000,Null,Null,29918892,111461,1815
29931445,133.0,133.0,3290000,3290000,0,0,3290000,Null,Null,29931445,169013,1795
29950661,426.0,426.0,140000,73000,67000,48,140000,Null,Null,29950661,111461,1815
29976424,0.0,0.0,40000000,40000000,0,0,40000000,Null,Null,29976424,111461,23576
30009861,0.0,0.0,3600000,3600000,0,0,3600000,Null,Null,30009861,520917,1520
30019556,140.0,140.0,140000,140000,0,0,140000,Null,Null,30019556,111461,914
30028457,1.0,1.0,66000,66000,0,0,66000,Null,Null,30028457,111461,27180
30034533,4.0,4.0,189000,189000,0,0,189000,Null,Null,30034533,111461,914
30153875,9.0,9.0,900000,900000,0,0,900000,Null,Null,30153875,111461,914
30160763,0.0,0.0,14500000,14500000,0,0,14500000,Null,Null,30160763,514097,11516
30162771,0.0,0.0,17500000,17500000,0,0,17500000,Null,Null,30162771,514097,11516
30691895,311.0,311.0,45000,35099,9901,22,45000,Null,Null,30691895,111461,1883
30708425,4.0,4.0,89000,70000,19000,21,89000,Null,Null,30708425,111461,914
30709407,56.0,56.0,590000,385000,205000,35,590000,Null,Null,30709407,145567,1804
30735966,590.0,590.0,390000,390000,0,0,390000,Null,Null,30735966,111461,2
30744379,38.0,38.0,93000,93000,0,0,93000,Null,Null,30744379,111461,1805
30793204,13.0,13.0,5800000,5800000,0,0,5800000,Null,Null,30793204,522525,1520
30794085,887.0,887.0,595000,564000,31000,5,595000,Null,Null,30794085,26689,1520
30863042,0.0,0.0,45000,45000,0,0,45000,Null,Null,30863042,111461,2
30984937,52.0,52.0,65000,65000,0,0,65000,Null,Null,30984937,111461,1805
31043523,133.0,133.0,90000,90000,0,0,90000,Null,Null,31043523,111461,914
31134692,51.0,51.0,16000,16000,0,0,16000,Null,Null,31134692,505165,914
31139613,0.0,0.0,13085000,13085000,0,0,13085000,Null,Null,31139613,25502,5385
31139636,47.0,47.0,1373000,979000,394000,29,1373000,Null,Null,31139636,26150,914
31140594,20.0,20.0,93000,93000,0,0,93000,Null,Null,31140594,111461,27128
31141484,92.0,92.0,297998,148999,148999,50,297998,Null,Null,31141484,149308,1815
31142653,0.0,0.0,6185000,6185000,0,0,6185000,Null,Null,31142653,25502,914
31170775,1.0,1.0,13660000,13660000,0,0,13660000,Null,Null,31170775,217953,7079
31174410,333.0,333.0,125000,125000,0,0,125000,Null,Null,31174410,150002,1815
31206755,1250.0,1250.0,48900,48900,0,0,48900,Null,Null,31206755,21437,2153
31208141,6.0,6.0,244000,217000,27000,11,244000,Null,Null,31208141,47882,914
31234266,299.0,299.0,7000,7000,0,0,7000,Null,Null,31234266,111461,1815
31246606,1.0,1.0,4800000,4800000,0,0,4800000,Null,Null,31246606,527433,1520
31261844,181.0,181.0,445000,436100,8900,2,445000,Null,Null,31261844,19788,1789
31267145,69.0,69.0,129000,129000,0,0,129000,Null,Null,31267145,111461,23362
31276345,1062.0,1062.0,163000,163000,0,0,163000,Null,Null,31276345,516689,1883
31278833,11.0,11.0,54999,54999,0,0,54999,Null,Null,31278833,111461,1978
31323826,71.0,71.0,280000,280000,0,0,280000,Null,Null,31323826,111461,914
31328433,49.0,49.0,1100000,902000,198000,18,1100000,Null,Null,31328433,524163,1520
31469069,44.0,44.0,1500000,1470000,30000,2,1500000,Null,Null,31469069,25697,8061
31473727,0.0,0.0,24000,24000,0,0,24000,Null,Null,31473727,111461,1883
31494236,12.0,12.0,295000,265000,30000,10,295000,Null,Null,31494236,332519,1583
31496052,3.0,3.0,10500000,10500000,0,0,10500000,Null,Null,31496052,53189,2
31496195,3.0,3.0,7000000,7000000,0,0,7000000,Null,Null,31496195,53189,2
31520324,317.0,317.0,170000,170000,0,0,170000,Null,Null,31520324,111461,1815
31520438,54.0,54.0,190500,183000,7500,4,190500,Null,Null,31520438,111461,1815
31522402,8.0,8.0,5000000,5000000,0,0,5000000,Null,Null,31522402,111461,8170
31523672,46.0,46.0,99000,99000,0,0,99000,Null,Null,31523672,111461,1815
31525270,42.0,42.0,92000,92000,0,0,92000,Null,Null,31525270,163707,1815
31525316,165.0,165.0,120000,120000,0,0,120000,Null,Null,31525316,111461,914
31534085,112.0,112.0,952,952,0,0,952,Null,Null,31534085,111461,23112
31541799,946.0,946.0,689000,644700,44300,6,689000,Null,Null,31541799,304627,2020
31547651,3.0,3.0,199000,119000,80000,40,199000,Null,Null,31547651,25422,1815
31553765,43.0,43.0,268000,268000,0,0,268000,Null,Null,31553765,25422,8170
31596898,0.0,0.0,14990000,14990000,0,0,14990000,Null,Null,31596898,114527,1815
31597175,0.0,0.0,21490000,21490000,0,0,21490000,Null,Null,31597175,114527,1815
31602057,325.0,325.0,29000,29000,0,0,29000,Null,Null,31602057,111461,1804
31603015,45.0,45.0,89999,89999,0,0,89999,Null,Null,31603015,111461,27214
31604663,3.0,3.0,49000,39000,10000,20,49000,Null,Null,31604663,111461,914
31613571,10.0,10.0,115000,115000,0,0,115000,Null,Null,31613571,111461,914
31637622,69.0,69.0,460000,460000,0,0,460000,Null,Null,31637622,200189,1520
31639146,105.0,105.0,11000,10890,110,1,11000,Null,Null,31639146,111461,1520
31660209,14.0,14.0,199000,199000,0,0,199000,Null,Null,31660209,111461,914
31691167,301.0,301.0,78000,78000,0,0,78000,Null,Null,31691167,152786,1520
31693679,0.0,0.0,3520000,3520000,0,0,3520000,Null,Null,31693679,374249,1520
31694305,0.0,0.0,4100000,4100000,0,0,4100000,Null,Null,31694305,374249,1520
31698416,127.0,127.0,94500,94500,0,0,94500,Null,Null,31698416,111461,3515
31742557,2.0,2.0,10000,9900,100,1,10000,Null,Null,31742557,111461,1520
31820638,89.0,89.0,290000,290000,0,0,290000,Null,Null,31820638,18804,1789
31824414,1079.0,1079.0,530000,530000,0,0,530000,Null,Null,31824414,145656,1520
31827991,175.0,175.0,9000,9000,0,0,9000,Null,Null,31827991,111461,1520
31855083,20.0,20.0,14000,14000,0,0,14000,Null,Null,31855083,111461,11935
31874925,10207.0,10207.0,154000,154000,0,0,154000,Null,Null,31874925,209135,1520
31890803,98.0,98.0,54000,33000,21000,39,54000,Null,Null,31890803,153086,1815
31892171,177.0,177.0,350000,255000,95000,27,350000,Null,Null,31892171,469887,53350
31894793,188.0,188.0,350000,235000,115000,33,350000,Null,Null,31894793,469887,3426
31919393,65.0,65.0,279000,279000,0,0,279000,Null,Null,31919393,530597,1520
31938830,0.0,0.0,29200000,29200000,0,0,29200000,Null,Null,31938830,111461,15318
32004018,1753.0,1753.0,90000,90000,0,0,90000,Null,Null,32004018,111461,23416
32021496,86.0,86.0,167000,144000,23000,14,167000,Null,Null,32021496,26718,2154
32072094,1453.0,1453.0,150000,150000,0,0,150000,Null,Null,32072094,454787,1883
32075144,1276.0,1276.0,49000,49000,0,0,49000,Null,Null,32075144,244095,1520
32082294,396.0,396.0,49000,49000,0,0,49000,Null,Null,32082294,244095,1520
32085989,26.0,26.0,390000,200000,190000,49,390000,Null,Null,32085989,4647777,914
32102981,149.0,149.0,249000,249000,0,0,249000,Null,Null,32102981,151165,1520
32116011,1.0,1.0,49000,49000,0,0,49000,Null,Null,32116011,111461,914
32117943,0.0,0.0,249000,249000,0,0,249000,Null,Null,32117943,111461,11858
32137264,28.0,28.0,410000,209000,201000,49,410000,Null,Null,32137264,4647777,914
32178075,1510.0,1510.0,700000,389000,311000,44,700000,Null,Null,32178075,110935,1883
32178088,65.0,65.0,450000,324000,126000,28,450000,Null,Null,32178088,110935,1883
32178095,17.0,17.0,715000,381000,334000,47,715000,Null,Null,32178095,110935,1883
32178097,68.0,68.0,585000,344000,241000,41,585000,Null,Null,32178097,110935,1883
32178099,29.0,29.0,565000,399000,166000,29,565000,Null,Null,32178099,110935,2136
32200288,16.0,16.0,1182000,985000,197000,17,1182000,Null,Null,32200288,149913,914
32208871,47.0,47.0,30900,30900,0,0,30900,Null,Null,32208871,111461,1815
32215287,75.0,75.0,105000,105000,0,0,105000,Null,Null,32215287,111461,914
32216099,2.0,2.0,1190000,1190000,0,0,1190000,Null,Null,32216099,111461,914
32236260,432.0,432.0,160000,103000,57000,36,160000,Null,Null,32236260,150215,1520
32237380,482.0,482.0,354000,268000,86000,24,354000,Null,Null,32237380,150215,1520
32243650,51.0,51.0,237000,237000,0,0,237000,Null,Null,32243650,475619,1520
32250536,2.0,2.0,69000,69000,0,0,69000,Null,Null,32250536,111461,1815
32291496,60.0,60.0,115500,115500,0,0,115500,Null,Null,32291496,149256,1815
32314207,12.0,12.0,376000,376000,0,0,376000,Null,Null,32314207,239943,914
32328782,2232.0,2232.0,69000,69000,0,0,69000,Null,Null,32328782,155734,23304
32329916,0.0,0.0,385000,385000,0,0,385000,Null,Null,32329916,239943,914
32364679,3.0,3.0,12500000,12500000,0,0,12500000,Null,Null,32364679,144779,1805
32366521,8.0,8.0,358000,358000,0,0,358000,Null,Null,32366521,239943,914
32370923,0.0,0.0,80000,80000,0,0,80000,Null,Null,32370923,111461,1815
32395267,164.0,164.0,150000,135000,15000,10,150000,Null,Null,32395267,207367,1883
32397707,7.0,7.0,240001,240001,0,0,240001,Null,Null,32397707,111461,914
32399542,1215.0,1215.0,45220,45220,0,0,45220,Null,Null,32399542,111461,1815
32400627,386.0,386.0,85000,85000,0,0,85000,Null,Null,32400627,111461,1815
32403859,220.0,220.0,165000,151800,13200,8,165000,Null,Null,32403859,111461,1520
32426848,74.0,74.0,60000,60000,0,0,60000,Null,Null,32426848,427581,914
32591390,183.0,183.0,75000,75000,0,0,75000,Null,Null,32591390,111461,12908
32592433,31.0,31.0,104000,104000,0,0,104000,Null,Null,32592433,111461,914
32602842,28.0,28.0,10300000,10300000,0,0,10300000,Null,Null,32602842,228187,1520
32629467,17.0,17.0,14800000,14800000,0,0,14800000,Null,Null,32629467,228187,1520
32676547,9.0,9.0,105000,105000,0,0,105000,Null,Null,32676547,111461,914
32691470,59.0,59.0,299000,280000,19000,6,299000,Null,Null,32691470,111461,1815
32692753,52.0,52.0,179998,89999,89999,50,179998,Null,Null,32692753,163707,1815
32721809,34.0,34.0,744000,314000,430000,58,744000,Null,Null,32721809,200189,1520
32739847,6.0,6.0,195000,195000,0,0,195000,Null,Null,32739847,111461,914
32741111,0.0,0.0,10000000,10000000,0,0,10000000,Null,Null,32741111,111461,1520
32786017,3.0,3.0,50000,15000,35000,70,50000,Null,Null,32786017,111461,2
32786030,8.0,8.0,30000,17000,13000,43,30000,Null,Null,32786030,111461,2
32855709,273.0,273.0,159000,159000,0,0,159000,Null,Null,32855709,111461,1815
32858950,72.0,72.0,28900,28900,0,0,28900,Null,Null,32858950,150004,1804
32861823,9.0,9.0,149000,149000,0,0,149000,Null,Null,32861823,111461,1883
32894839,39.0,39.0,169000,169000,0,0,169000,Null,Null,32894839,111461,914
32895306,595.0,595.0,149000,149000,0,0,149000,Null,Null,32895306,111461,23246
32908535,18.0,18.0,14500,14500,0,0,14500,Null,Null,32908535,407561,914
32912338,0.0,0.0,75000,75000,0,0,75000,Null,Null,32912338,111461,15320
32923672,19.0,19.0,1500000,1470000,30000,2,1500000,Null,Null,32923672,25697,8061
32924508,161.0,161.0,95000,95000,0,0,95000,Null,Null,32924508,50655,23642
32924732,352.0,352.0,450000,360000,90000,20,450000,Null,Null,32924732,18804,7078
32926026,474.0,474.0,100000,90000,10000,10,100000,Null,Null,32926026,18804,2153
32928434,0.0,0.0,13900000,13900000,0,0,13900000,Null,Null,32928434,156409,914
32928436,0.0,0.0,13900000,13900000,0,0,13900000,Null,Null,32928436,156409,2
32928459,0.0,0.0,15800000,15800000,0,0,15800000,Null,Null,32928459,156409,914
32929170,3.0,3.0,116390,113000,3390,3,116390,Null,Null,32929170,111461,1815
32933095,1320.0,1320.0,118900,118900,0,0,118900,Null,Null,32933095,111461,1832
32933371,183.0,183.0,130000,130000,0,0,130000,Null,Null,32933371,111459,7078
32973402,508.0,508.0,187180,181000,6180,3,187180,Null,Null,32973402,312329,1815
32975790,2574.0,2574.0,165000,140250,24750,15,165000,Null,Null,32975790,542605,1520
32983594,13.0,13.0,59000,59000,0,0,59000,Null,Null,32983594,111461,914
32987921,0.0,0.0,3387000,3387000,0,0,3387000,Null,Null,32987921,26150,5384
32989055,100.0,100.0,100000,100000,0,0,100000,Null,Null,32989055,111461,28434
33033766,44.0,44.0,15000,15000,0,0,15000,Null,Null,33033766,111461,914
33035622,0.0,0.0,36999,36999,0,0,36999,Null,Null,33035622,111461,1815
33067171,33.0,33.0,92900,92900,0,0,92900,Null,Null,33067171,111461,5995
33092083,9.0,9.0,200000,200000,0,0,200000,Null,Null,33092083,111461,914
33142561,34.0,34.0,27900,27900,0,0,27900,Null,Null,33142561,21653,1815
33145799,171.0,171.0,69000,69000,0,0,69000,Null,Null,33145799,111461,914
33146789,33.0,33.0,26900,26900,0,0,26900,Null,Null,33146789,111461,2
33209563,0.0,0.0,6227000,6227000,0,0,6227000,Null,Null,33209563,527379,8227
33260915,0.0,0.0,39000000,39000000,0,0,39000000,Null,Null,33260915,111461,1520
33262088,12.0,12.0,10000,10000,0,0,10000,Null,Null,33262088,111461,49722
33288809,41.0,41.0,99000,99000,0,0,99000,Null,Null,33288809,47882,914
33342185,99.0,99.0,15000,15000,0,0,15000,Null,Null,33342185,111461,1815
33360472,28.0,28.0,81685,57180,24505,30,81685,Null,Null,33360472,111461,1815
33364342,15.0,15.0,64000,64000,0,0,64000,Null,Null,33364342,111461,23244
33388482,6.0,6.0,250000,232000,18000,7,250000,Null,Null,33388482,111461,1805
33404972,31.0,31.0,55000,55000,0,0,55000,Null,Null,33404972,111461,1883
33414955,274.0,274.0,199000,199000,0,0,199000,Null,Null,33414955,25422,1634
33440476,3.0,3.0,12897,12897,0,0,12897,Null,Null,33440476,111461,1815
33494720,4039.0,4039.0,590000,336000,254000,43,590000,Null,Null,33494720,110935,1520
33517811,89.0,89.0,299000,280000,19000,6,299000,Null,Null,33517811,111461,1815
33573544,40.0,40.0,14500000,14500000,0,0,14500000,Null,Null,33573544,191611,28694
33593566,689.0,689.0,11990,11390,600,5,11990,Null,Null,33593566,193677,1883
33606794,82.0,82.0,584000,584000,0,0,584000,Null,Null,33606794,182293,17170
33606875,65.0,65.0,409000,409000,0,0,409000,Null,Null,33606875,182293,1583
33630695,202.0,202.0,34900,29000,5900,17,34900,Null,Null,33630695,111461,8371
33650861,4.0,4.0,540000,540000,0,0,540000,Null,Null,33650861,111461,914
33678807,2.0,2.0,688999,688999,0,0,688999,Null,Null,33678807,111461,53074
33735317,285.0,285.0,69500,39000,30500,44,69500,Null,Null,33735317,21256,2
33735434,143.0,143.0,59000,39000,20000,34,59000,Null,Null,33735434,21256,2
33735438,408.0,408.0,109000,69000,40000,37,109000,Null,Null,33735438,21256,1520
33735497,281.0,281.0,152000,79000,73000,48,152000,Null,Null,33735497,21256,13878
33739373,123.0,123.0,41900,41900,0,0,41900,Null,Null,33739373,111461,1804
33761260,3286.0,3286.0,50000,35000,15000,30,50000,Null,Null,33761260,202071,1520
33785195,21937.0,21937.0,115000,104000,11000,10,115000,Null,Null,33785195,86206,1520
33786496,170.0,170.0,44700,44700,0,0,44700,Null,Null,33786496,111461,1813
34082222,91.0,91.0,13000,13000,0,0,13000,Null,Null,34082222,193677,1883
34097669,1647.0,1647.0,300000,159000,141000,47,300000,Null,Null,34097669,518605,1520
34170488,34.0,34.0,72000,72000,0,0,72000,Null,Null,34170488,111461,1883
34171666,238.0,238.0,39000,39000,0,0,39000,Null,Null,34171666,111461,1883
34187687,1863.0,1863.0,160000,155000,5000,3,160000,Null,Null,34187687,202607,1520
34206620,256.0,256.0,22000,22000,0,0,22000,Null,Null,34206620,111461,1520
34230976,194.0,194.0,389000,239000,150000,39,389000,Null,Null,34230976,111461,1883
34264306,0.0,0.0,11500000,11500000,0,0,11500000,Null,Null,34264306,25406,1520
34278190,137.0,137.0,200000,135000,65000,33,200000,Null,Null,34278190,197443,13878
34315213,611.0,611.0,28000,28000,0,0,28000,Null,Null,34315213,143006,1634
34315215,1060.0,1060.0,85000,70000,15000,18,85000,Null,Null,34315215,198557,1520
34320020,498.0,498.0,106000,88000,18000,17,106000,Null,Null,34320020,198557,1520
34320557,11.0,11.0,49000,49000,0,0,49000,Null,Null,34320557,111461,1883
34339077,359.0,359.0,95000,95000,0,0,95000,Null,Null,34339077,111461,1815
34339386,310.0,310.0,49000,49000,0,0,49000,Null,Null,34339386,111461,1815
34345425,3190.0,3190.0,350000,189000,161000,46,350000,Null,Null,34345425,281361,1601
34346450,1965.0,1965.0,221000,189000,32000,14,221000,Null,Null,34346450,21269,1520
34397223,0.0,0.0,20200000,20200000,0,0,20200000,Null,Null,34397223,539119,28862
34426526,4.0,4.0,8900000,8900000,0,0,8900000,Null,Null,34426526,111461,1520
34465040,16.0,16.0,4750000,3950000,800000,17,4750000,Null,Null,34465040,402287,1520
34480145,843.0,843.0,152600,103005,49595,33,152600,Null,Null,34480145,155505,1520
34480244,0.0,0.0,3560000,3560000,0,0,3560000,Null,Null,34480244,532949,1520
34481816,0.0,0.0,4150000,4150000,0,0,4150000,Null,Null,34481816,27398,1520
34502530,369.0,369.0,15000,15000,0,0,15000,Null,Null,34502530,111461,53074
34520643,152.0,152.0,53525,53525,0,0,53525,Null,Null,34520643,111461,28674
34530934,100.0,100.0,159000,159000,0,0,159000,Null,Null,34530934,111461,1815
34557311,1017.0,1017.0,114000,114000,0,0,114000,Null,Null,34557311,193811,1815
34561757,0.0,0.0,36000000,36000000,0,0,36000000,Null,Null,34561757,153444,2
34571103,29.0,29.0,769000,730550,38450,5,769000,Null,Null,34571103,152306,1815
34590854,0.0,0.0,39427080,39427080,0,0,39427080,Null,Null,34590854,111461,53074
34646156,44.0,44.0,79900,79900,0,0,79900,Null,Null,34646156,111461,1815
34676509,122.0,122.0,78000,78000,0,0,78000,Null,Null,34676509,111461,914
34725660,25.0,25.0,43000,43000,0,0,43000,Null,Null,34725660,407561,2
34743171,48.0,48.0,37000,37000,0,0,37000,Null,Null,34743171,364731,2
34743855,1.0,1.0,14950,14950,0,0,14950,Null,Null,34743855,364731,1815
34790708,243.0,243.0,35000,35000,0,0,35000,Null,Null,34790708,473565,1815
34816875,17.0,17.0,25000,25000,0,0,25000,Null,Null,34816875,111461,23022
34818286,5784.0,5784.0,35000,35000,0,0,35000,Null,Null,34818286,111461,23040
34863343,37.0,37.0,380000,380000,0,0,380000,Null,Null,34863343,111461,20492
34928735,2.0,2.0,8000,8000,0,0,8000,Null,Null,34928735,111461,1520
35019646,451.0,451.0,53000,53000,0,0,53000,Null,Null,35019646,48381,1601
35031098,1968.0,1968.0,123000,96000,27000,22,123000,Null,Null,35031098,154733,1520
35031109,721.0,721.0,167000,134000,33000,20,167000,Null,Null,35031109,154733,1520
35058677,1031.0,1031.0,85000,84000,1000,1,85000,Null,Null,35058677,18804,1883
35068214,394.0,394.0,39000,39000,0,0,39000,Null,Null,35068214,18804,2153
35109382,31.0,31.0,249000,249000,0,0,249000,Null,Null,35109382,47882,914
35129212,4.0,4.0,268000,268000,0,0,268000,Null,Null,35129212,111461,2948
35130073,180.0,180.0,89000,89000,0,0,89000,Null,Null,35130073,111461,5384
35133365,105.0,105.0,8000,8000,0,0,8000,Null,Null,35133365,270875,11803
35147291,0.0,0.0,3368000,3368000,0,0,3368000,Null,Null,35147291,26150,914
35149874,141.0,141.0,490000,249000,241000,49,490000,Null,Null,35149874,150433,2
35176701,0.0,0.0,50000000,50000000,0,0,50000000,Null,Null,35176701,111461,23576
35177210,12.0,12.0,80000,80000,0,0,80000,Null,Null,35177210,111461,914
35216213,305.0,305.0,299000,199000,100000,33,299000,Null,Null,35216213,25422,1520
35226725,2046.0,2046.0,279000,279000,0,0,279000,Null,Null,35226725,469887,3426
35228487,225.0,225.0,850000,90000,760000,89,850000,Null,Null,35228487,535885,2
35228509,252.0,252.0,850000,90000,760000,89,850000,Null,Null,35228509,535885,2
35231333,145.0,145.0,20000,20000,0,0,20000,Null,Null,35231333,111461,1520
35233450,57.0,57.0,2218800,1849000,369800,17,2218800,Null,Null,35233450,149913,914
35236494,0.0,0.0,192000,192000,0,0,192000,Null,Null,35236494,455513,15318
35239920,138.0,138.0,699000,400000,299000,43,699000,Null,Null,35239920,25422,1520
35246303,1.0,1.0,3960000,3960000,0,0,3960000,Null,Null,35246303,557687,5893
35247508,0.0,0.0,38996,38996,0,0,38996,Null,Null,35247508,111461,1883
35251483,270.0,270.0,90500,55000,35500,39,90500,Null,Null,35251483,153086,1815
35273810,1.0,1.0,35000,35000,0,0,35000,Null,Null,35273810,111461,53074
35278834,16.0,16.0,195900,190000,5900,3,195900,Null,Null,35278834,216347,1805
35292559,193.0,193.0,189000,189000,0,0,189000,Null,Null,35292559,216347,1805
35319126,19.0,19.0,202560,141792,60768,30,202560,Null,Null,35319126,111461,53190
35326987,151.0,151.0,100000,100000,0,0,100000,Null,Null,35326987,41083,2
35327436,0.0,0.0,49000000,36000000,13000000,27,49000000,Null,Null,35327436,111461,23576
35347363,32.0,32.0,37900,37900,0,0,37900,Null,Null,35347363,111461,1815
35367209,1634.0,1634.0,32000,32000,0,0,32000,Null,Null,35367209,111461,23416
35373097,144.0,144.0,78000,67000,11000,14,78000,Null,Null,35373097,226401,1811
35381289,53.0,53.0,49000,29000,20000,41,49000,Null,Null,35381289,625265,1815
35393100,0.0,0.0,19699,19699,0,0,19699,Null,Null,35393100,111461,914
35409127,0.0,0.0,32900000,32900000,0,0,32900000,Null,Null,35409127,111461,914
35409804,154.0,154.0,69000,49000,20000,29,69000,Null,Null,35409804,111461,1815
35409952,177.0,177.0,69000,49000,20000,29,69000,Null,Null,35409952,625265,1815
35412981,995.0,995.0,349000,349000,0,0,349000,Null,Null,35412981,525257,1815
35420153,904.0,904.0,75000,72000,3000,4,75000,Null,Null,35420153,21651,1815
35422376,135.0,135.0,53000,53000,0,0,53000,Null,Null,35422376,111461,5995
35431989,518.0,518.0,282000,282000,0,0,282000,Null,Null,35431989,111461,51698
35435245,1059.0,1059.0,9000,9000,0,0,9000,Null,Null,35435245,111461,23416
35449842,1201.0,1201.0,53000,53000,0,0,53000,Null,Null,35449842,475005,1883
35468224,42.0,42.0,4790000,4690000,100000,2,4790000,Null,Null,35468224,145090,1520
35485216,50.0,50.0,599000,439000,160000,27,599000,Null,Null,35485216,46363,914
35498389,1.0,1.0,221000,221000,0,0,221000,Null,Null,35498389,455513,2
35498867,1.0,1.0,310000,310000,0,0,310000,Null,Null,35498867,455513,2
35499439,2.0,2.0,331000,331000,0,0,331000,Null,Null,35499439,455513,2
35500035,2.0,2.0,210000,210000,0,0,210000,Null,Null,35500035,455513,2
35546760,0.0,0.0,38000000,38000000,0,0,38000000,Null,Null,35546760,111461,23576
35547557,0.0,0.0,12000,12000,0,0,12000,Null,Null,35547557,111461,2685
35578333,199.0,199.0,70395,70395,0,0,70395,Null,Null,35578333,111461,8170
35612137,297.0,297.0,189000,189000,0,0,189000,Null,Null,35612137,211343,1520
35675448,68.0,68.0,318000,159000,159000,50,318000,Null,Null,35675448,111461,15236
35723054,10.0,10.0,73900,73900,0,0,73900,Null,Null,35723054,111461,1815
35725725,45.0,45.0,98000,98000,0,0,98000,Null,Null,35725725,111461,914
35726089,64.0,64.0,979000,979000,0,0,979000,Null,Null,35726089,18641,1811
35726289,7.0,7.0,131000,131000,0,0,131000,Null,Null,35726289,111461,914
35728242,1.0,1.0,3960000,3960000,0,0,3960000,Null,Null,35728242,557687,17170
35728834,2.0,2.0,3960000,3960000,0,0,3960000,Null,Null,35728834,557687,17170
35734248,83.0,83.0,89000,89000,0,0,89000,Null,Null,35734248,111461,914
35734897,792.0,792.0,39000,39000,0,0,39000,Null,Null,35734897,111461,23432
35742412,8.0,8.0,98000,98000,0,0,98000,Null,Null,35742412,111461,914
35759353,0.0,0.0,3395,2954,441,13,3395,Null,Null,35759353,111461,2685
35761444,22513.0,22513.0,320200,262000,58200,18,320200,Null,Null,35761444,48247,1520
35864868,1498.0,1498.0,1100000,788000,312000,28,1100000,Null,Null,35864868,50629,1815
35865613,148.0,148.0,30000,30000,0,0,30000,Null,Null,35865613,111461,914
35875732,40.0,40.0,36100,36100,0,0,36100,Null,Null,35875732,111461,53054
35876754,33.0,33.0,40900,40900,0,0,40900,Null,Null,35876754,111461,53190
35905855,79.0,79.0,539000,299000,240000,45,539000,Null,Null,35905855,48077,1883
35905857,2291.0,2291.0,572000,328000,244000,43,572000,Null,Null,35905857,48077,1984
35905859,2354.0,2354.0,109000,57000,52000,48,109000,Null,Null,35905859,48077,2234
35906107,20.0,20.0,24999,24999,0,0,24999,Null,Null,35906107,111461,1815
35911581,148.0,148.0,65000,65000,0,0,65000,Null,Null,35911581,111461,1520
35911681,14.0,14.0,39000,39000,0,0,39000,Null,Null,35911681,252345,914
35921478,15.0,15.0,69000,59000,10000,14,69000,Null,Null,35921478,111461,1520
35925601,7.0,7.0,98000,98000,0,0,98000,Null,Null,35925601,281343,914
35928141,994.0,994.0,61000,61000,0,0,61000,Null,Null,35928141,111461,2337
35932511,0.0,0.0,11200000,11200000,0,0,11200000,Null,Null,35932511,50307,7079
35951535,165.0,165.0,185030,185030,0,0,185030,Null,Null,35951535,111461,1815
35964933,3.0,3.0,186000,186000,0,0,186000,Null,Null,35964933,143771,17170
36007224,67.0,67.0,160000,160000,0,0,160000,Null,Null,36007224,18805,1815
36014644,121.0,121.0,29900,29900,0,0,29900,Null,Null,36014644,111461,8371
36016686,15.0,15.0,39000,39000,0,0,39000,Null,Null,36016686,252345,914
36020537,27.0,27.0,8000,6000,2000,25,8000,Null,Null,36020537,111461,1520
36022562,720.0,720.0,148000,148000,0,0,148000,Null,Null,36022562,111461,1520
36033608,1157.0,1157.0,23000,23000,0,0,23000,Null,Null,36033608,111461,1883
36044824,100.0,100.0,68000,68000,0,0,68000,Null,Null,36044824,111461,27128
36086833,0.0,0.0,43205500,43205500,0,0,43205500,Null,Null,36086833,111461,2
36106566,154.0,154.0,82900,82900,0,0,82900,Null,Null,36106566,111461,1883
36158810,2947.0,2947.0,320000,179000,141000,44,320000,Null,Null,36158810,562001,1520
36158812,1579.0,1579.0,170000,115000,55000,32,170000,Null,Null,36158812,562001,1520
36185438,0.0,0.0,75000,75000,0,0,75000,Null,Null,36185438,111461,23416
36189854,261.0,261.0,65000,65000,0,0,65000,Null,Null,36189854,111461,23416
36258899,0.0,0.0,86000000,86000000,0,0,86000000,Null,Null,36258899,111461,2
36300228,197.0,197.0,21400,21400,0,0,21400,Null,Null,36300228,111461,2337
36335290,3.0,3.0,153000,153000,0,0,153000,Null,Null,36335290,111461,914
36358718,14.0,14.0,85000,85000,0,0,85000,Null,Null,36358718,281343,914
36372643,19.0,19.0,85000,42000,43000,51,85000,Null,Null,36372643,111461,914
36387115,98.0,98.0,9500000,9500000,0,0,9500000,Null,Null,36387115,433227,1520
36389487,23.0,23.0,7500000,7500000,0,0,7500000,Null,Null,36389487,433227,1520
36390548,99.0,99.0,174000,165000,9000,5,174000,Null,Null,36390548,149308,1815
36394298,58.0,58.0,35000,35000,0,0,35000,Null,Null,36394298,111461,914
36434633,0.0,0.0,7000000,7000000,0,0,7000000,Null,Null,36434633,25502,914
36435091,0.0,0.0,8585000,8585000,0,0,8585000,Null,Null,36435091,25502,914
36452514,204.0,204.0,43900,43900,0,0,43900,Null,Null,36452514,111461,1883
36461825,746.0,746.0,299000,224250,74750,25,299000,Null,Null,36461825,111461,1883
36560504,127.0,127.0,290000,169000,121000,42,290000,Null,Null,36560504,48077,23282
36568964,45.0,45.0,67999,67999,0,0,67999,Null,Null,36568964,111461,2805
36640450,3.0,3.0,120000,120000,0,0,120000,Null,Null,36640450,111461,914
36663703,0.0,0.0,149999000,149999000,0,0,149999000,Null,Null,36663703,566411,23450
36676655,1393.0,1393.0,209000,209000,0,0,209000,Null,Null,36676655,541293,1634
36678762,389.0,389.0,132000,116000,16000,12,132000,Null,Null,36678762,49242,8300
36681117,0.0,0.0,39374000,39374000,0,0,39374000,Null,Null,36681117,548965,23576
36710007,1953.0,1953.0,89000,89000,0,0,89000,Null,Null,36710007,111461,1815
36715411,257.0,257.0,139000,99000,40000,29,139000,Null,Null,36715411,111461,1811
36729773,510.0,510.0,39000,39000,0,0,39000,Null,Null,36729773,111461,1815
36737874,338.0,338.0,49000,49000,0,0,49000,Null,Null,36737874,111461,23416
36767757,517.0,517.0,300000,294000,6000,2,300000,Null,Null,36767757,296041,1520
36778572,33.0,33.0,599000,379000,220000,37,599000,Null,Null,36778572,25422,1815
36789400,151.0,151.0,180000,131000,49000,27,180000,Null,Null,36789400,111461,1520
36795162,356.0,356.0,520000,489000,31000,6,520000,Null,Null,36795162,150297,1520
36826466,105.0,105.0,22800,22800,0,0,22800,Null,Null,36826466,111461,914
36832530,30.0,30.0,133500,133500,0,0,133500,Null,Null,36832530,111461,914
36852423,1.0,1.0,769000,769000,0,0,769000,Null,Null,36852423,46363,914
36852943,44.0,44.0,149000,149000,0,0,149000,Null,Null,36852943,281343,914
36867849,54.0,54.0,15000,15000,0,0,15000,Null,Null,36867849,152755,914
36873509,266.0,266.0,179000,179000,0,0,179000,Null,Null,36873509,451383,53074
36892969,1.0,1.0,190000,190000,0,0,190000,Null,Null,36892969,239943,914
36935892,49.0,49.0,15000,15000,0,0,15000,Null,Null,36935892,111461,1883
36966404,9.0,9.0,31460,31460,0,0,31460,Null,Null,36966404,111461,1520
36987686,2515.0,2515.0,320000,210000,110000,34,320000,Null,Null,36987686,568489,1520
37012811,603.0,603.0,249000,249000,0,0,249000,Null,Null,37012811,281769,914
37016060,23.0,23.0,59000,59000,0,0,59000,Null,Null,37016060,111461,914
37035103,41.0,41.0,29000,29000,0,0,29000,Null,Null,37035103,885693,914
37037928,1.0,1.0,80000,80000,0,0,80000,Null,Null,37037928,111461,914
37064296,63.0,63.0,31600000,31600000,0,0,31600000,Null,Null,37064296,433227,1520
37112646,13.0,13.0,75000,75000,0,0,75000,Null,Null,37112646,281343,914
37127687,81.0,81.0,2387000,2387000,0,0,2387000,Null,Null,37127687,290791,2806
37128307,1.0,1.0,9000,9000,0,0,9000,Null,Null,37128307,111461,1520
37132249,6.0,6.0,386000,386000,0,0,386000,Null,Null,37132249,239943,914
37133635,817.0,817.0,35000,35000,0,0,35000,Null,Null,37133635,111461,914
37139753,285.0,285.0,44000,44000,0,0,44000,Null,Null,37139753,111461,914
37141416,205.0,205.0,790000,758400,31600,4,790000,Null,Null,37141416,560095,1520
37142413,2.0,2.0,238500,238500,0,0,238500,Null,Null,37142413,111461,15250
37153816,207.0,207.0,790000,758400,31600,4,790000,Null,Null,37153816,560095,1520
37156749,109.0,109.0,59000,59000,0,0,59000,Null,Null,37156749,111461,914
37164065,340.0,340.0,17800,17800,0,0,17800,Null,Null,37164065,111461,53074
37169839,8.0,8.0,34000,34000,0,0,34000,Null,Null,37169839,111461,914
37170284,30.0,30.0,184000,184000,0,0,184000,Null,Null,37170284,111461,914
37289936,14.0,14.0,5490000,5490000,0,0,5490000,Null,Null,37289936,112735,1795
37293036,15.0,15.0,10000,10000,0,0,10000,Null,Null,37293036,111461,1520
37317513,98.0,98.0,19900,19900,0,0,19900,Null,Null,37317513,111461,53074
37432011,310.0,310.0,720000,720000,0,0,720000,Null,Null,37432011,252693,1601
37495650,3156.0,3156.0,447000,410000,37000,8,447000,Null,Null,37495650,523789,1883
37538624,5.0,5.0,9000,5000,4000,44,9000,Null,Null,37538624,111461,11935
37539434,82.0,82.0,6200000,5704000,496000,8,6200000,Null,Null,37539434,111461,1520
37539437,0.0,0.0,3500000,3500000,0,0,3500000,Null,Null,37539437,111461,1520
37545731,1501.0,1501.0,115000,115000,0,0,115000,Null,Null,37545731,372895,1520
37547304,197.0,197.0,75000,75000,0,0,75000,Null,Null,37547304,111461,1815
37552451,102.0,102.0,99000,99000,0,0,99000,Null,Null,37552451,111625,1815
37554539,13.0,13.0,539000,460000,79000,15,539000,Null,Null,37554539,111457,1803
37617303,0.0,0.0,9000,9000,0,0,9000,Null,Null,37617303,111461,1815
37647451,50.0,50.0,120000,120000,0,0,120000,Null,Null,37647451,111461,2136
37655545,742.0,742.0,140000,140000,0,0,140000,Null,Null,37655545,111461,1815
37669933,0.0,0.0,109000,109000,0,0,109000,Null,Null,37669933,407561,914
37688735,1.0,1.0,83000,83000,0,0,83000,Null,Null,37688735,111461,1883
37730520,496.0,496.0,219000,149000,70000,32,219000,Null,Null,37730520,230607,2337
37744809,35.0,35.0,98000,98000,0,0,98000,Null,Null,37744809,111461,914
37745695,133.0,133.0,199000,199000,0,0,199000,Null,Null,37745695,446513,1583
37750855,40.0,40.0,130133,91093,39040,30,130133,Null,Null,37750855,111461,1815
37769268,258.0,258.0,48000,35000,13000,27,48000,Null,Null,37769268,111461,914
37792470,736.0,736.0,93900,93900,0,0,93900,Null,Null,37792470,111461,1815
37792856,143.0,143.0,190000,190000,0,0,190000,Null,Null,37792856,111461,1815
37807764,26.0,26.0,87000,87000,0,0,87000,Null,Null,37807764,111461,914
37821553,0.0,0.0,50000000,50000000,0,0,50000000,Null,Null,37821553,278035,1883
37822613,21.0,21.0,79000,79000,0,0,79000,Null,Null,37822613,111461,1815
37869185,276.0,276.0,200000,135000,65000,33,200000,Null,Null,37869185,111461,1520
37932200,77.0,77.0,4100000,3850000,250000,6,4100000,Null,Null,37932200,27481,1520
37941602,0.0,0.0,15560000,15560000,0,0,15560000,Null,Null,37941602,218151,2
37952738,11.0,11.0,31999,31999,0,0,31999,Null,Null,37952738,111461,53074
37971642,74.0,74.0,146499,146499,0,0,146499,Null,Null,37971642,21651,1815
37972250,0.0,0.0,53404000,39324000,14080000,26,53404000,Null,Null,37972250,183111,23376
38015885,0.0,0.0,12300000,12300000,0,0,12300000,Null,Null,38015885,228187,1520
38068697,1.0,1.0,44999,44999,0,0,44999,Null,Null,38068697,111461,914
38075697,48.0,48.0,24900,15000,9900,40,24900,Null,Null,38075697,111461,11935
38114299,344.0,344.0,64000,64000,0,0,64000,Null,Null,38114299,111461,23258
38121241,52.0,52.0,299000,299000,0,0,299000,Null,Null,38121241,867937,914
38130207,94.0,94.0,65000,65000,0,0,65000,Null,Null,38130207,111461,914
38132660,53.0,53.0,98000,98000,0,0,98000,Null,Null,38132660,111461,914
38138637,327.0,327.0,199000,166000,33000,17,199000,Null,Null,38138637,63894,1634
38158144,0.0,0.0,87000000,87000000,0,0,87000000,Null,Null,38158144,111461,23576
38158449,0.0,0.0,58000000,58000000,0,0,58000000,Null,Null,38158449,111461,23642
38160387,0.0,0.0,65000000,65000000,0,0,65000000,Null,Null,38160387,111461,23634
38160616,34.0,34.0,246000,125897,120103,49,246000,Null,Null,38160616,111461,1815
38161107,0.0,0.0,90000000,90000000,0,0,90000000,Null,Null,38161107,111461,23576
38162019,0.0,0.0,75460000,75460000,0,0,75460000,Null,Null,38162019,111461,23634
38164788,110.0,110.0,185000,185000,0,0,185000,Null,Null,38164788,223635,1520
38246297,156.0,156.0,49000,49000,0,0,49000,Null,Null,38246297,155376,3422
38304453,10.0,10.0,194900,194900,0,0,194900,Null,Null,38304453,111461,53190
38309582,26.0,26.0,649000,636020,12980,2,649000,Null,Null,38309582,111461,8061
38309801,523.0,523.0,84000,81000,3000,4,84000,Null,Null,38309801,18804,2153
38330867,1.0,1.0,14000,7000,7000,50,14000,Null,Null,38330867,111461,1520
38357087,0.0,0.0,10000000,10000000,0,0,10000000,Null,Null,38357087,111461,11935
38363022,2617.0,2617.0,39000,39000,0,0,39000,Null,Null,38363022,111461,1815
38372056,811.0,811.0,155000,99000,56000,36,155000,Null,Null,38372056,307105,1520
38384795,1633.0,1633.0,105000,105000,0,0,105000,Null,Null,38384795,354595,17162
38407102,21.0,21.0,239000,239000,0,0,239000,Null,Null,38407102,18805,1815
38418037,247.0,247.0,35934,17967,17967,50,35934,Null,Null,38418037,111461,1815
38454302,3.0,3.0,1399000,1399000,0,0,1399000,Null,Null,38454302,46363,914
38538673,20.0,20.0,105000,67000,38000,36,105000,Null,Null,38538673,111461,914
38566281,4.0,4.0,109000,47000,62000,57,109000,Null,Null,38566281,111461,914
38604387,964.0,964.0,175000,175000,0,0,175000,Null,Null,38604387,209879,1520
38605512,10.0,10.0,98000,62000,36000,37,98000,Null,Null,38605512,111461,914
38607972,52.0,52.0,349000,349000,0,0,349000,Null,Null,38607972,867937,914
38615374,66.0,66.0,298000,298000,0,0,298000,Null,Null,38615374,867937,914
38638609,4.0,4.0,68000,68000,0,0,68000,Null,Null,38638609,111461,914
38645201,93.0,93.0,59000,59000,0,0,59000,Null,Null,38645201,111461,914
38666598,1706.0,1706.0,40000,40000,0,0,40000,Null,Null,38666598,111461,3177
38735034,598.0,598.0,275000,275000,0,0,275000,Null,Null,38735034,274063,1520
38746132,36.0,36.0,69000,69000,0,0,69000,Null,Null,38746132,111461,914
38838832,1616.0,1616.0,265000,217000,48000,18,265000,Null,Null,38838832,21269,1520
38935033,3.0,3.0,3500000,3500000,0,0,3500000,Null,Null,38935033,538513,1634
38997194,940.0,940.0,25996,12998,12998,50,25996,Null,Null,38997194,111461,1815
39000984,36.0,36.0,175000,175000,0,0,175000,Null,Null,39000984,111461,914
39292323,155.0,155.0,115000,115000,0,0,115000,Null,Null,39292323,111461,23282
39292737,343.0,343.0,1190000,990000,200000,17,1190000,Null,Null,39292737,282263,1520
39293798,0.0,0.0,99000,99000,0,0,99000,Null,Null,39293798,111461,914
39297868,2020.0,2020.0,165000,125000,40000,24,165000,Null,Null,39297868,183795,1520
39300814,11.0,11.0,116000,74000,42000,36,116000,Null,Null,39300814,111461,1634
39301439,1210.0,1210.0,299000,169000,130000,43,299000,Null,Null,39301439,245945,1520
39319398,30.0,30.0,159000,141000,18000,11,159000,Null,Null,39319398,111461,1815
39328696,30.0,30.0,300000,195000,105000,35,300000,Null,Null,39328696,205035,1520
39334371,3234.0,3234.0,530000,355000,175000,33,530000,Null,Null,39334371,205035,1520
39336189,1.0,1.0,9000,7000,2000,22,9000,Null,Null,39336189,111461,1520
39361700,31.0,31.0,25000,25000,0,0,25000,Null,Null,39361700,111461,2
39374845,48.0,48.0,6000,6000,0,0,6000,Null,Null,39374845,111461,11935
39514946,10085.0,10085.0,140000,104000,36000,26,140000,Null,Null,39514946,257507,1520
39607755,847.0,847.0,650000,650000,0,0,650000,Null,Null,39607755,514213,1520
39996898,0.0,0.0,38496000,38496000,0,0,38496000,Null,Null,39996898,548965,23576
40008318,0.0,0.0,41246000,41246000,0,0,41246000,Null,Null,40008318,548965,23576
40043602,64.0,64.0,109000,109000,0,0,109000,Null,Null,40043602,111461,914
40170132,0.0,0.0,3500000,3500000,0,0,3500000,Null,Null,40170132,111461,11935
40362325,51.0,51.0,44000,44000,0,0,44000,Null,Null,40362325,111461,3177
40364238,7.0,7.0,164000,164000,0,0,164000,Null,Null,40364238,111461,914
40365257,74.0,74.0,65000,52900,12100,19,65000,Null,Null,40365257,111461,914
40369312,50.0,50.0,164000,164000,0,0,164000,Null,Null,40369312,111461,914
40398326,95.0,95.0,58000,58000,0,0,58000,Null,Null,40398326,111461,914
40403870,144.0,144.0,53796,53796,0,0,53796,Null,Null,40403870,111461,914
40412767,9.0,9.0,856000,684800,171200,20,856000,Null,Null,40412767,26150,914
40418108,38.0,38.0,25000,24000,1000,4,25000,Null,Null,40418108,111461,8193
40431026,1.0,1.0,68999,68999,0,0,68999,Null,Null,40431026,111461,914
40500000,0.0,0.0,800000,800000,0,0,800000,Null,Null,40500000,111461,1883
40639597,382.0,382.0,2999000,2999000,0,0,2999000,Null,Null,40639597,147856,1789
40717161,12.0,12.0,286160,243000,43160,15,286160,Null,Null,40717161,111461,1883
40737046,0.0,0.0,40000000,40000000,0,0,40000000,Null,Null,40737046,111461,23576
40737659,36.0,36.0,141440,99008,42432,30,141440,Null,Null,40737659,193811,1815
40742815,2.0,2.0,9000,9000,0,0,9000,Null,Null,40742815,111461,8197
40752584,945.0,945.0,25000,25000,0,0,25000,Null,Null,40752584,111461,23416
40754102,84.0,84.0,1590000,1590000,0,0,1590000,Null,Null,40754102,282065,27180
40842141,61.0,61.0,100000,62000,38000,38,100000,Null,Null,40842141,111461,914
40844122,0.0,0.0,38000000,38000000,0,0,38000000,Null,Null,40844122,111461,23576
40848461,0.0,0.0,39000000,39000000,0,0,39000000,Null,Null,40848461,111461,23576
40850439,2.0,2.0,69000,69000,0,0,69000,Null,Null,40850439,111461,914
40871895,269.0,269.0,185000,165000,20000,11,185000,Null,Null,40871895,269907,1520
40875024,66.0,66.0,2500000,2500000,0,0,2500000,Null,Null,40875024,160667,1815
40886072,309.0,309.0,360000,360000,0,0,360000,Null,Null,40886072,111461,1883
40888300,57.0,57.0,519000,519000,0,0,519000,Null,Null,40888300,248191,1520
40932568,59.0,59.0,59000,59000,0,0,59000,Null,Null,40932568,111461,1815
40935824,132.0,132.0,199000,199000,0,0,199000,Null,Null,40935824,21268,1520
40935834,278.0,278.0,205000,205000,0,0,205000,Null,Null,40935834,21268,1520
40964844,118.0,118.0,84000,84000,0,0,84000,Null,Null,40964844,111461,914
40965833,59.0,59.0,120000,120000,0,0,120000,Null,Null,40965833,111461,49722
40969313,9.0,9.0,42000,42000,0,0,42000,Null,Null,40969313,364731,2
40980657,5.0,5.0,43000,43000,0,0,43000,Null,Null,40980657,111461,914
41062678,14.0,14.0,630000,319000,311000,49,630000,Null,Null,41062678,4647777,914
41075957,83.0,83.0,1960,1960,0,0,1960,Null,Null,41075957,111461,2805
41107522,0.0,0.0,8200000,8036000,164000,2,8200000,Null,Null,41107522,514213,1520
41162985,741.0,741.0,169000,161000,8000,5,169000,Null,Null,41162985,86206,13878
41163769,3089.0,3089.0,198000,167000,31000,16,198000,Null,Null,41163769,86206,1520
41163955,2650.0,2650.0,198000,175000,23000,12,198000,Null,Null,41163955,86206,1520
41168623,0.0,0.0,4800000,3415000,1385000,29,4800000,Null,Null,41168623,550041,1520
41172859,260.0,260.0,125000,112000,13000,10,125000,Null,Null,41172859,22653,1520
41173407,1.0,1.0,3829000,3829000,0,0,3829000,Null,Null,41173407,18804,2
41181459,48.0,48.0,79000,79000,0,0,79000,Null,Null,41181459,111461,914
41182035,62.0,62.0,54000,54000,0,0,54000,Null,Null,41182035,111461,914
41218197,11.0,11.0,65000,65000,0,0,65000,Null,Null,41218197,111461,914
41225938,1.0,1.0,680000,349000,331000,49,680000,Null,Null,41225938,4647777,914
41227454,2020.0,2020.0,75000,75000,0,0,75000,Null,Null,41227454,40699,2337
41228196,3032.0,3032.0,298000,249000,49000,16,298000,Null,Null,41228196,111461,8171
41257928,1.0,1.0,70000,70000,0,0,70000,Null,Null,41257928,111461,914
41258260,148.0,148.0,69000,49000,20000,29,69000,Null,Null,41258260,625265,1815
41263241,484.0,484.0,607000,446405,160595,26,607000,Null,Null,41263241,145339,1520
41272836,1.0,1.0,98000,98000,0,0,98000,Null,Null,41272836,111461,914
41273282,25.0,25.0,69000,69000,0,0,69000,Null,Null,41273282,111461,8371
41273444,7.0,7.0,87000,87000,0,0,87000,Null,Null,41273444,111461,914
41299268,167.0,167.0,693000,499000,194000,28,693000,Null,Null,41299268,145339,1520
41304599,13.0,13.0,279000,279000,0,0,279000,Null,Null,41304599,867937,914
41318362,5544.0,5544.0,379000,366000,13000,3,379000,Null,Null,41318362,25422,21388
41318920,1020.0,1020.0,139000,95000,44000,32,139000,Null,Null,41318920,230607,23052
41332433,648.0,648.0,75000,75000,0,0,75000,Null,Null,41332433,230537,23010
41349312,4.0,4.0,164900,164900,0,0,164900,Null,Null,41349312,111461,2140
41354143,59.0,59.0,34900,18000,16900,48,34900,Null,Null,41354143,111461,914
41370491,124.0,124.0,59000,59000,0,0,59000,Null,Null,41370491,21437,2153
41371053,301.0,301.0,42000,42000,0,0,42000,Null,Null,41371053,111461,20492
41371714,93.0,93.0,25000,25000,0,0,25000,Null,Null,41371714,111461,914
41376529,1.0,1.0,11890000,11890000,0,0,11890000,Null,Null,41376529,74643,1815
41380390,6.0,6.0,4400000,4312000,88000,2,4400000,Null,Null,41380390,514213,1520
41390475,8.0,8.0,5800000,5800000,0,0,5800000,Null,Null,41390475,17856,11937
41418337,17.0,17.0,43000,43000,0,0,43000,Null,Null,41418337,111461,914
41430891,3.0,3.0,110000,110000,0,0,110000,Null,Null,41430891,111461,2154
41488128,10.0,10.0,710000,500000,210000,30,710000,Null,Null,41488128,4647777,914
41523006,398.0,398.0,249278,249278,0,0,249278,Null,Null,41523006,370711,1520
41529852,0.0,0.0,6940000,6250000,690000,10,6940000,Null,Null,41529852,4647777,914
41556614,126.0,126.0,34000,34000,0,0,34000,Null,Null,41556614,111461,914
41563695,324.0,324.0,39000,39000,0,0,39000,Null,Null,41563695,111461,914
41570913,27.0,27.0,87000,87000,0,0,87000,Null,Null,41570913,111461,914
41622977,0.0,0.0,299000,299000,0,0,299000,Null,Null,41622977,475611,1634
41683346,2.0,2.0,10990000,10990000,0,0,10990000,Null,Null,41683346,111461,1520
41799459,301.0,301.0,360000,328000,32000,9,360000,Null,Null,41799459,17826,1815
41863423,74.0,74.0,35000,35000,0,0,35000,Null,Null,41863423,111461,20174
41873601,86.0,86.0,148800,143000,5800,4,148800,Null,Null,41873601,111461,1815
41885554,5.0,5.0,87000,87000,0,0,87000,Null,Null,41885554,111461,914
41886085,3497.0,3497.0,40000,40000,0,0,40000,Null,Null,41886085,111461,1883
42049436,6.0,6.0,35000,18000,17000,49,35000,Null,Null,42049436,111461,914
42081833,0.0,0.0,14900,14900,0,0,14900,Null,Null,42081833,111461,1815
42111898,163.0,163.0,336000,328000,8000,2,336000,Null,Null,42111898,111461,1815
42190787,25.0,25.0,45000,29999,15001,33,45000,Null,Null,42190787,111461,3177
42194457,119.0,119.0,68000,68000,0,0,68000,Null,Null,42194457,111461,914
42194820,43.0,43.0,56000,56000,0,0,56000,Null,Null,42194820,111461,914
42241386,1460.0,1460.0,55000,55000,0,0,55000,Null,Null,42241386,111461,23282
42245405,85.0,85.0,130000,130000,0,0,130000,Null,Null,42245405,111461,914
42253908,0.0,0.0,8330000,5950000,2380000,29,8330000,Null,Null,42253908,405211,914
42270992,1546.0,1546.0,499000,329000,170000,34,499000,Null,Null,42270992,363961,1883
42285046,822.0,822.0,493000,448000,45000,9,493000,Null,Null,42285046,298633,1520
42333095,13.0,13.0,490000,480200,9800,2,490000,Null,Null,42333095,19788,8061
42335313,980.0,980.0,39000,39000,0,0,39000,Null,Null,42335313,480737,1520
42351003,13.0,13.0,55000,55000,0,0,55000,Null,Null,42351003,111461,914
42362390,63.0,63.0,138000,138000,0,0,138000,Null,Null,42362390,63894,1520
42403330,697.0,697.0,780000,780000,0,0,780000,Null,Null,42403330,613285,1520
42469714,77.0,77.0,120000,120000,0,0,120000,Null,Null,42469714,111461,1815
42491736,1426.0,1426.0,180000,137000,43000,24,180000,Null,Null,42491736,212647,1883
42515494,0.0,0.0,55000000,55000000,0,0,55000000,Null,Null,42515494,111461,23576
42523386,30.0,30.0,16500000,16500000,0,0,16500000,Null,Null,42523386,433227,1520
42539701,0.0,0.0,199000,199000,0,0,199000,Null,Null,42539701,111461,3177
42543279,0.0,0.0,12000000,10680000,1320000,11,12000000,Null,Null,42543279,402287,1520
42559192,34.0,34.0,355000,355000,0,0,355000,Null,Null,42559192,114328,1583
42562497,3.0,3.0,5590000,4790000,800000,14,5590000,Null,Null,42562497,402287,1520
42564424,113.0,113.0,1100000,1100000,0,0,1100000,Null,Null,42564424,154910,2324
42566443,5.0,5.0,9750000,8350000,1400000,14,9750000,Null,Null,42566443,402287,1520
42598916,44.0,44.0,350000,350000,0,0,350000,Null,Null,42598916,510303,1634
42648299,3.0,3.0,139900,139900,0,0,139900,Null,Null,42648299,111461,1815
42673891,93.0,93.0,55000,44900,10100,18,55000,Null,Null,42673891,180597,11605
42677397,4.0,4.0,3450000,3450000,0,0,3450000,Null,Null,42677397,33203,1520
42684015,2.0,2.0,230000,230000,0,0,230000,Null,Null,42684015,111461,914
42687026,0.0,0.0,47000000,47000000,0,0,47000000,Null,Null,42687026,111461,23576
42687370,409.0,409.0,275000,252500,22500,8,275000,Null,Null,42687370,199937,1520
42688426,1.0,1.0,70000,70000,0,0,70000,Null,Null,42688426,111461,914
42700970,31.0,31.0,53699,53699,0,0,53699,Null,Null,42700970,111461,914
42718737,127.0,127.0,59000,59000,0,0,59000,Null,Null,42718737,111461,23246
42750480,6.0,6.0,138000,138000,0,0,138000,Null,Null,42750480,111461,914
42759652,549.0,549.0,129000,85000,44000,34,129000,Null,Null,42759652,230607,23052
42769233,508.0,508.0,85000,85000,0,0,85000,Null,Null,42769233,111461,53190
42785265,360.0,360.0,589000,589000,0,0,589000,Null,Null,42785265,469887,53350
42786475,8.0,8.0,720000,369000,351000,49,720000,Null,Null,42786475,4647777,914
42788270,26.0,26.0,189000,189000,0,0,189000,Null,Null,42788270,4647777,914
42839971,30.0,30.0,219000,219000,0,0,219000,Null,Null,42839971,111461,8225
42843090,878.0,878.0,185000,165000,20000,11,185000,Null,Null,42843090,479473,17170
42843107,1.0,1.0,69000,69000,0,0,69000,Null,Null,42843107,111461,1883
42845326,19.0,19.0,45000,36000,9000,20,45000,Null,Null,42845326,143607,1520
42870297,3.0,3.0,7200000,6293000,907000,13,7200000,Null,Null,42870297,614435,1520
42889999,2468.0,2468.0,125000,106250,18750,15,125000,Null,Null,42889999,542605,1520
42895880,132.0,132.0,739000,739000,0,0,739000,Null,Null,42895880,508845,53350
42926109,0.0,0.0,8330000,5950000,2380000,29,8330000,Null,Null,42926109,405211,914
42964762,0.0,0.0,75600000,75600000,0,0,75600000,Null,Null,42964762,111461,11935
42965924,0.0,0.0,99000000,99000000,0,0,99000000,Null,Null,42965924,111461,11935
42967157,0.0,0.0,74300000,74300000,0,0,74300000,Null,Null,42967157,111461,11935
42969422,353.0,353.0,9900,9900,0,0,9900,Null,Null,42969422,616653,8602
42969465,0.0,0.0,43200000,43200000,0,0,43200000,Null,Null,42969465,111461,11935
42993648,137.0,137.0,273000,273000,0,0,273000,Null,Null,42993648,221169,2347
42999445,366.0,366.0,550000,498000,52000,9,550000,Null,Null,42999445,155701,1520
43040205,42.0,42.0,15000,15000,0,0,15000,Null,Null,43040205,7372899,914
43043389,59.0,59.0,40000,40000,0,0,40000,Null,Null,43043389,111461,914
43043620,10.0,10.0,326700,326700,0,0,326700,Null,Null,43043620,111461,914
43043840,29.0,29.0,30000,8000,22000,73,30000,Null,Null,43043840,111461,914
43112975,189.0,189.0,35000,35000,0,0,35000,Null,Null,43112975,111461,8193
43117919,397.0,397.0,148000,148000,0,0,148000,Null,Null,43117919,21274,8217
43151467,3.0,3.0,65000,65000,0,0,65000,Null,Null,43151467,111461,914
43163776,2678.0,2678.0,470000,350000,120000,26,470000,Null,Null,43163776,407749,1520
43177346,1593.0,1593.0,450000,350000,100000,22,450000,Null,Null,43177346,407749,1520
43180753,0.0,0.0,71510000,71510000,0,0,71510000,Null,Null,43180753,111461,2340
43181017,9.0,9.0,190000,190000,0,0,190000,Null,Null,43181017,111461,914
43181626,7.0,7.0,180000,180000,0,0,180000,Null,Null,43181626,111461,914
43330912,513.0,513.0,549000,389000,160000,29,549000,Null,Null,43330912,363961,1883
43331726,12.0,12.0,142000,142000,0,0,142000,Null,Null,43331726,111461,914
43333370,17.0,17.0,19200,9000,10200,53,19200,Null,Null,43333370,48567,1883
43334206,3.0,3.0,6999,6999,0,0,6999,Null,Null,43334206,111461,1815
43341166,6772.0,6772.0,268000,220000,48000,18,268000,Null,Null,43341166,86206,1520
43363450,0.0,0.0,22900000,22900000,0,0,22900000,Null,Null,43363450,182449,11516
43368719,0.0,0.0,24590000,24590000,0,0,24590000,Null,Null,43368719,182449,8064
43395521,10.0,10.0,67000,67000,0,0,67000,Null,Null,43395521,174069,1820
43399070,95.0,95.0,150000,149000,1000,1,150000,Null,Null,43399070,192489,1815
43406932,41.0,41.0,150000,149000,1000,1,150000,Null,Null,43406932,192489,1815
43605340,428.0,428.0,135000,135000,0,0,135000,Null,Null,43605340,111461,23778
43667965,25.0,25.0,306000,272000,34000,11,306000,Null,Null,43667965,47882,914
43689370,532.0,532.0,1077300,974000,103300,10,1077300,Null,Null,43689370,217131,1520
43695247,28.0,28.0,329000,329000,0,0,329000,Null,Null,43695247,111461,914
43714620,5.0,5.0,495000,495000,0,0,495000,Null,Null,43714620,111461,914
43723351,19.0,19.0,472000,472000,0,0,472000,Null,Null,43723351,111461,914
43750579,0.0,0.0,6500000,6500000,0,0,6500000,Null,Null,43750579,111461,914
43750622,0.0,0.0,11000000,11000000,0,0,11000000,Null,Null,43750622,111461,914
43753597,0.0,0.0,279000,279000,0,0,279000,Null,Null,43753597,111461,914
43754492,1109.0,1109.0,105000,105000,0,0,105000,Null,Null,43754492,294273,1520
43761442,100.0,100.0,109000,109000,0,0,109000,Null,Null,43761442,111461,1832
43763060,272.0,272.0,211000,211000,0,0,211000,Null,Null,43763060,294273,11753
43794566,65.0,65.0,3700000,3367000,333000,9,3700000,Null,Null,43794566,111461,1520
43801385,0.0,0.0,5459000,5459000,0,0,5459000,Null,Null,43801385,111461,1520
43808661,1231.0,1231.0,180000,180000,0,0,180000,Null,Null,43808661,236503,23362
43811301,0.0,0.0,5459000,5459000,0,0,5459000,Null,Null,43811301,111461,11935
43813148,0.0,0.0,63090000,63090000,0,0,63090000,Null,Null,43813148,111461,1520
43815348,31.0,31.0,31399,31399,0,0,31399,Null,Null,43815348,111461,914
43815550,0.0,0.0,56600000,56600000,0,0,56600000,Null,Null,43815550,111461,1520
43818051,19.0,19.0,413000,413000,0,0,413000,Null,Null,43818051,111461,914
43827108,238.0,238.0,179500,179500,0,0,179500,Null,Null,43827108,47803,11897
43834469,63.0,63.0,105000,105000,0,0,105000,Null,Null,43834469,111461,914
43838366,9.0,9.0,39000,39000,0,0,39000,Null,Null,43838366,252345,914
43857691,0.0,0.0,60000,60000,0,0,60000,Null,Null,43857691,111461,23362
43859841,193.0,193.0,360758,360758,0,0,360758,Null,Null,43859841,149699,1583
43880302,908.0,908.0,249000,162000,87000,35,249000,Null,Null,43880302,230607,23258
43891180,173.0,173.0,2650000,2650000,0,0,2650000,Null,Null,43891180,18641,1815
43924153,32.0,32.0,5690000,5690000,0,0,5690000,Null,Null,43924153,147856,1789
44022756,3.0,3.0,19000,5000,14000,74,19000,Null,Null,44022756,111461,1520
44028128,126.0,126.0,209000,179000,30000,14,209000,Null,Null,44028128,47882,914
44040813,82.0,82.0,99500,99500,0,0,99500,Null,Null,44040813,111461,914
44043706,33.0,33.0,109000,109000,0,0,109000,Null,Null,44043706,111461,914
44045342,174.0,174.0,55000,53000,2000,4,55000,Null,Null,44045342,111461,23258
44045501,160.0,160.0,80000,80000,0,0,80000,Null,Null,44045501,111461,914
44056396,83.0,83.0,97000,85000,12000,12,97000,Null,Null,44056396,111461,20492
44063562,134.0,134.0,920000,920000,0,0,920000,Null,Null,44063562,284315,1520
44088845,1.0,1.0,4750000,4750000,0,0,4750000,Null,Null,44088845,46007,3424
44102624,705.0,705.0,169000,109000,60000,36,169000,Null,Null,44102624,230607,23052
44104533,170.0,170.0,158000,158000,0,0,158000,Null,Null,44104533,197443,13878
44106824,189.0,189.0,45000,45000,0,0,45000,Null,Null,44106824,21437,2153
44107220,2841.0,2841.0,2900000,2600000,300000,10,2900000,Null,Null,44107220,18804,1626
44114466,16.0,16.0,80000,80000,0,0,80000,Null,Null,44114466,427581,914
44120270,50.0,50.0,273998,136999,136999,50,273998,Null,Null,44120270,111461,1883
44123568,0.0,0.0,71000,71000,0,0,71000,Null,Null,44123568,111461,914
44138399,7.0,7.0,380000,380000,0,0,380000,Null,Null,44138399,5244477,1520
44140593,511.0,511.0,315000,229000,86000,27,315000,Null,Null,44140593,508909,1601
44143396,1.0,1.0,3950000,3950000,0,0,3950000,Null,Null,44143396,111461,11935
44179654,0.0,0.0,5100000,5100000,0,0,5100000,Null,Null,44179654,624383,1520
44180436,82.0,82.0,3628000,2591250,1036750,29,3628000,Null,Null,44180436,26150,914
44180454,25.0,25.0,3628000,2591250,1036750,29,3628000,Null,Null,44180454,26150,914
44180496,0.0,0.0,5830000,5830000,0,0,5830000,Null,Null,44180496,204731,914
44220932,5.0,5.0,39000,39000,0,0,39000,Null,Null,44220932,252345,914
44232101,3035.0,3035.0,690000,513000,177000,26,690000,Null,Null,44232101,50629,1815
44237915,36.0,36.0,130000,65000,65000,50,130000,Null,Null,44237915,111461,914
44297321,13.0,13.0,580650,580650,0,0,580650,Null,Null,44297321,111670,2020
44301944,2054.0,2054.0,102000,84000,18000,18,102000,Null,Null,44301944,198555,1520
44350764,5.0,5.0,34900,34900,0,0,34900,Null,Null,44350764,111461,2363
44463370,0.0,0.0,10000000,10000000,0,0,10000000,Null,Null,44463370,111461,914
44603799,325.0,325.0,250000,250000,0,0,250000,Null,Null,44603799,274953,914
44666420,500.0,500.0,99000,53000,46000,46,99000,Null,Null,44666420,626103,1520
44713810,37.0,37.0,25000,5000,20000,80,25000,Null,Null,44713810,111461,8371
44713817,15.0,15.0,199000,199000,0,0,199000,Null,Null,44713817,111461,914
44810580,128.0,128.0,516000,516000,0,0,516000,Null,Null,44810580,248191,1520
44812107,0.0,0.0,29000000,29000000,0,0,29000000,Null,Null,44812107,180545,28860
44816582,15.0,15.0,296000,296000,0,0,296000,Null,Null,44816582,111461,914
44822929,277.0,277.0,300000,215000,85000,28,300000,Null,Null,44822929,245945,1883
44861533,389.0,389.0,179000,179000,0,0,179000,Null,Null,44861533,557311,53350
44866261,66.0,66.0,87000,87000,0,0,87000,Null,Null,44866261,111461,914
44866428,29.0,29.0,52000,52000,0,0,52000,Null,Null,44866428,111461,914
44874943,42.0,42.0,69000,69000,0,0,69000,Null,Null,44874943,111461,914
44875312,29.0,29.0,55000,55000,0,0,55000,Null,Null,44875312,111461,2337
44878245,1291.0,1291.0,165000,165000,0,0,165000,Null,Null,44878245,4424515,1520
44887786,0.0,0.0,0,39000,21000,0,39000,Null,Null,44887786,111461,0
44891215,182.0,182.0,119000,69000,50000,42,119000,Null,Null,44891215,625265,1815
44894873,787.0,787.0,79000,72000,7000,9,79000,Null,Null,44894873,111461,1811
44931440,0.0,0.0,16500000,16500000,0,0,16500000,Null,Null,44931440,499169,53350
44931604,0.0,0.0,16500000,16500000,0,0,16500000,Null,Null,44931604,499169,1520
44935549,1129.0,1129.0,45000,45000,0,0,45000,Null,Null,44935549,505803,3426
44954579,8.0,8.0,273000,273000,0,0,273000,Null,Null,44954579,406837,1815
44965989,349.0,349.0,630000,630000,0,0,630000,Null,Null,44965989,177927,1805
44985664,0.0,0.0,20000000,20000000,0,0,20000000,Null,Null,44985664,463255,1601
45024004,18.0,18.0,16000,16000,0,0,16000,Null,Null,45024004,111461,914
45024052,2.0,2.0,14500000,14500000,0,0,14500000,Null,Null,45024052,225619,1520
45034238,2.0,2.0,600000,369000,231000,39,600000,Null,Null,45034238,4647777,914
45059353,72.0,72.0,62000,62000,0,0,62000,Null,Null,45059353,111461,1883
45099529,12.0,12.0,15000,15000,0,0,15000,Null,Null,45099529,111461,914
45099775,1.0,1.0,299000,152490,146510,49,299000,Null,Null,45099775,594779,914
45150482,5.0,5.0,75000,75000,0,0,75000,Null,Null,45150482,111461,914
45150752,1119.0,1119.0,58000,56100,1900,3,58000,Null,Null,45150752,829895,1520
45163095,328.0,328.0,288900,288900,0,0,288900,Null,Null,45163095,524561,1805
45169903,3.0,3.0,180000,180000,0,0,180000,Null,Null,45169903,111461,914
45170460,2.0,2.0,25599,25599,0,0,25599,Null,Null,45170460,111461,914
45188593,0.0,0.0,120000,120000,0,0,120000,Null,Null,45188593,111461,1883
45188661,26.0,26.0,29998,14999,14999,50,29998,Null,Null,45188661,111461,1815
45210345,3.0,3.0,81000,81000,0,0,81000,Null,Null,45210345,111461,23622
45243616,425.0,425.0,19000,19000,0,0,19000,Null,Null,45243616,280167,1607
45290088,30.0,30.0,29000,29000,0,0,29000,Null,Null,45290088,111461,914
45290334,0.0,0.0,47999,47999,0,0,47999,Null,Null,45290334,111461,914
45300792,1551.0,1551.0,52900,52900,0,0,52900,Null,Null,45300792,111461,2140
45305306,0.0,0.0,18499,18499,0,0,18499,Null,Null,45305306,111461,914
45305538,1.0,1.0,12000,12000,0,0,12000,Null,Null,45305538,111461,914
45307813,459.0,459.0,9000,9000,0,0,9000,Null,Null,45307813,111461,914
45308515,23.0,23.0,9000,9000,0,0,9000,Null,Null,45308515,111461,914
45311431,8.0,8.0,456000,456000,0,0,456000,Null,Null,45311431,152806,914
45319677,4180.0,4180.0,51000,39000,12000,24,51000,Null,Null,45319677,21261,1520
45319679,3668.0,3668.0,51000,39000,12000,24,51000,Null,Null,45319679,21261,1520
45404047,402.0,402.0,125000,125000,0,0,125000,Null,Null,45404047,173743,1883
45411715,4.0,4.0,259000,259000,0,0,259000,Null,Null,45411715,111461,1883
45423872,62.0,62.0,14000,14000,0,0,14000,Null,Null,45423872,111461,914
45424318,150.0,150.0,400000,360000,40000,10,400000,Null,Null,45424318,173547,914
45430075,6.0,6.0,418000,380000,38000,9,418000,Null,Null,45430075,173547,914
45430294,0.0,0.0,91744000,91744000,0,0,91744000,Null,Null,45430294,143398,53074
45443981,1233.0,1233.0,6990,6990,0,0,6990,Null,Null,45443981,111461,1883
45449971,31.0,31.0,418000,380000,38000,9,418000,Null,Null,45449971,173547,914
45457124,3.0,3.0,352000,320000,32000,9,352000,Null,Null,45457124,173547,15250
45460873,0.0,0.0,10000000,10000000,0,0,10000000,Null,Null,45460873,111461,914
45462483,0.0,0.0,15000000,15000000,0,0,15000000,Null,Null,45462483,111461,914
45464404,209.0,209.0,52900,52900,0,0,52900,Null,Null,45464404,111461,2657
45489328,165.0,165.0,189000,189000,0,0,189000,Null,Null,45489328,64922,1883
45533795,0.0,0.0,247000,125970,121030,49,247000,Null,Null,45533795,594779,914
45543135,168.0,168.0,150000,143000,7000,5,150000,Null,Null,45543135,202607,2
45559087,21.0,21.0,68900,68900,0,0,68900,Null,Null,45559087,64152,1520
45579046,327.0,327.0,850000,518000,332000,39,850000,Null,Null,45579046,153086,1815
45599406,0.0,0.0,10900000,10900000,0,0,10900000,Null,Null,45599406,53189,1520
45608364,313.0,313.0,214800,214800,0,0,214800,Null,Null,45608364,111461,1815
45608421,762.0,762.0,151900,151900,0,0,151900,Null,Null,45608421,111461,1815
45608451,16.0,16.0,155500,149000,6500,4,155500,Null,Null,45608451,111461,1815
45613055,1.0,1.0,266000,135660,130340,49,266000,Null,Null,45613055,594779,914
45640394,0.0,0.0,72000000,72000000,0,0,72000000,Null,Null,45640394,111461,1883
45653577,17.0,17.0,59000,31000,28000,47,59000,Null,Null,45653577,111461,914
45691952,5.0,5.0,79000,79000,0,0,79000,Null,Null,45691952,111461,1883
45762361,0.0,0.0,39950000,39950000,0,0,39950000,Null,Null,45762361,635623,23450
45782342,0.0,0.0,49950000,49950000,0,0,49950000,Null,Null,45782342,635623,23450
45798744,77.0,77.0,2699000,2159200,539800,20,2699000,Null,Null,45798744,19034,1815
45816165,0.0,0.0,12000,12000,0,0,12000,Null,Null,45816165,111461,8371
45816615,19.0,19.0,35000,35000,0,0,35000,Null,Null,45816615,111461,8371
45824954,0.0,0.0,598000,598000,0,0,598000,Null,Null,45824954,111461,23622
45838861,751.0,751.0,29000,29000,0,0,29000,Null,Null,45838861,53740,1520
45839454,57.0,57.0,85000,85000,0,0,85000,Null,Null,45839454,111461,3710
45845517,30.0,30.0,150000,20000,130000,87,150000,Null,Null,45845517,111461,8371
45850777,93.0,93.0,399000,355000,44000,11,399000,Null,Null,45850777,223295,914
45869183,36.0,36.0,45000,36000,9000,20,45000,Null,Null,45869183,111461,914
45900941,70.0,70.0,520000,416000,104000,20,520000,Null,Null,45900941,52207,1520
45972422,46.0,46.0,39000,39000,0,0,39000,Null,Null,45972422,111461,914
46021671,408.0,408.0,47998,47998,0,0,47998,Null,Null,46021671,111461,914
46054347,41.0,41.0,150000,150000,0,0,150000,Null,Null,46054347,111461,914
46060478,3935.0,3935.0,180000,180000,0,0,180000,Null,Null,46060478,562001,1520
46063760,1.0,1.0,7500000,7500000,0,0,7500000,Null,Null,46063760,200779,1520
46104321,1.0,1.0,1770000,1239000,531000,30,1770000,Null,Null,46104321,4647777,914
46104500,7.0,7.0,29000,29000,0,0,29000,Null,Null,46104500,407561,914
46107481,1907.0,1907.0,139000,139000,0,0,139000,Null,Null,46107481,618755,1805
46160069,71.0,71.0,155000,155000,0,0,155000,Null,Null,46160069,281343,914
46178425,31.0,31.0,18000,18000,0,0,18000,Null,Null,46178425,111461,1622
46179013,4897.0,4897.0,950000,549000,401000,42,950000,Null,Null,46179013,631569,1520
46193718,193.0,193.0,35000,33000,2000,6,35000,Null,Null,46193718,111461,1815
46202190,23.0,23.0,39000,39000,0,0,39000,Null,Null,46202190,111461,23032
46202826,40.0,40.0,274000,274000,0,0,274000,Null,Null,46202826,111461,914
46208141,633.0,633.0,70000,70000,0,0,70000,Null,Null,46208141,111461,23246
46231498,125.0,125.0,35000,35000,0,0,35000,Null,Null,46231498,111461,1815
46234981,200.0,200.0,95000,95000,0,0,95000,Null,Null,46234981,235091,1520
46235970,0.0,0.0,7900000,7900000,0,0,7900000,Null,Null,46235970,193837,914
46237036,0.0,0.0,9950000,9950000,0,0,9950000,Null,Null,46237036,193837,15320
46237134,0.0,0.0,7750000,7750000,0,0,7750000,Null,Null,46237134,193837,15250
46239356,1005.0,1005.0,4990,4990,0,0,4990,Null,Null,46239356,111461,1883
46242432,163.0,163.0,87000,87000,0,0,87000,Null,Null,46242432,111461,914
46242612,52.0,52.0,60000,60000,0,0,60000,Null,Null,46242612,111461,914
46248529,186.0,186.0,225000,225000,0,0,225000,Null,Null,46248529,111461,23282
46260797,14.0,14.0,98000,98000,0,0,98000,Null,Null,46260797,111461,914
46286958,78.0,78.0,65000,65000,0,0,65000,Null,Null,46286958,111461,914
46289675,199.0,199.0,49000,49000,0,0,49000,Null,Null,46289675,111461,914
46317393,0.0,0.0,5660000,5660000,0,0,5660000,Null,Null,46317393,155090,1520
46350367,0.0,0.0,45160000,45160000,0,0,45160000,Null,Null,46350367,111461,23104
46356002,5.0,5.0,120000,120000,0,0,120000,Null,Null,46356002,111461,914
46401202,40.0,40.0,164000,164000,0,0,164000,Null,Null,46401202,111461,914
46448999,16.0,16.0,790000,397700,392300,50,790000,Null,Null,46448999,111461,4381
46471451,310.0,310.0,40000,40000,0,0,40000,Null,Null,46471451,111461,1815
46472956,52.0,52.0,134000,134000,0,0,134000,Null,Null,46472956,111461,1815
46553547,79.0,79.0,75000,75000,0,0,75000,Null,Null,46553547,111461,15318
46610987,239.0,239.0,165000,140250,24750,15,165000,Null,Null,46610987,542605,1520
46630415,39.0,39.0,32000,32000,0,0,32000,Null,Null,46630415,111461,914
46644605,614.0,614.0,175000,175000,0,0,175000,Null,Null,46644605,4424515,1520
46646792,7.0,7.0,19200,19200,0,0,19200,Null,Null,46646792,111461,1883
46689426,181.0,181.0,89000,89000,0,0,89000,Null,Null,46689426,111461,1815
46718209,312.0,312.0,89000,89000,0,0,89000,Null,Null,46718209,65417,1520
46730252,0.0,0.0,8880,8880,0,0,8880,Null,Null,46730252,111461,20174
46730852,4.0,4.0,860000,439000,421000,49,860000,Null,Null,46730852,4647777,914
46745436,83.0,83.0,45000,45000,0,0,45000,Null,Null,46745436,111461,914
46748561,693.0,693.0,824000,427000,397000,48,824000,Null,Null,46748561,48077,23362
46771295,151.0,151.0,660000,660000,0,0,660000,Null,Null,46771295,660533,1520
46773011,96.0,96.0,149000,149000,0,0,149000,Null,Null,46773011,178883,1520
46778967,820.0,820.0,141000,141000,0,0,141000,Null,Null,46778967,64152,1520
46784751,3.0,3.0,5600000,5600000,0,0,5600000,Null,Null,46784751,660715,1520
46822212,439.0,439.0,55000,42000,13000,24,55000,Null,Null,46822212,637535,8200
46824399,21.0,21.0,309000,309000,0,0,309000,Null,Null,46824399,111461,1815
46905791,0.0,0.0,15000,15000,0,0,15000,Null,Null,46905791,111461,2
46906018,16.0,16.0,50000,50000,0,0,50000,Null,Null,46906018,111461,914
46980003,409.0,409.0,189000,171000,18000,10,189000,Null,Null,46980003,111461,1520
47081914,1384.0,1384.0,99000,89000,10000,10,99000,Null,Null,47081914,408443,1815
47101179,39.0,39.0,110000,110000,0,0,110000,Null,Null,47101179,111461,914
47113839,230.0,230.0,99000,88000,11000,11,99000,Null,Null,47113839,456351,914
47149569,2886.0,2886.0,330000,240000,90000,27,330000,Null,Null,47149569,221187,1520
47163069,5.0,5.0,44000,44000,0,0,44000,Null,Null,47163069,111461,1883
47166386,32.0,32.0,25000,19999,5001,20,25000,Null,Null,47166386,200673,1815
47171098,226.0,226.0,125000,125000,0,0,125000,Null,Null,47171098,111461,914
47181006,0.0,0.0,5000000,5000000,0,0,5000000,Null,Null,47181006,569135,1520
47197271,68.0,68.0,199000,156000,43000,22,199000,Null,Null,47197271,63894,1634
47221108,23.0,23.0,790000,439000,351000,44,790000,Null,Null,47221108,173547,914
47221386,81.0,81.0,1599000,890000,709000,44,1599000,Null,Null,47221386,18776,1815
47238933,0.0,0.0,8000000,5999000,2001000,25,8000000,Null,Null,47238933,4647777,15318
47243118,91.0,91.0,36000,29000,7000,19,36000,Null,Null,47243118,111461,1815
47252045,129.0,129.0,35000,35000,0,0,35000,Null,Null,47252045,111461,914
47264079,198.0,198.0,98000,98000,0,0,98000,Null,Null,47264079,111461,1815
47270547,190.0,190.0,45000,45000,0,0,45000,Null,Null,47270547,625265,1815
47271184,0.0,0.0,3500000,3500000,0,0,3500000,Null,Null,47271184,663447,53350
47271214,137.0,137.0,45000,45000,0,0,45000,Null,Null,47271214,625265,1815
47271217,92.0,92.0,519000,519000,0,0,519000,Null,Null,47271217,21651,1815
47271614,309.0,309.0,38000,38000,0,0,38000,Null,Null,47271614,111461,1815
47272512,166.0,166.0,45000,45000,0,0,45000,Null,Null,47272512,625265,1815
47282611,61.0,61.0,45000,45000,0,0,45000,Null,Null,47282611,625265,1815
47292697,1.0,1.0,2000000,2000000,0,0,2000000,Null,Null,47292697,111461,8061
47314489,7.0,7.0,77000,77000,0,0,77000,Null,Null,47314489,111461,914
47321729,14898.0,14898.0,749000,553000,196000,26,749000,Null,Null,47321729,25422,28454
47323146,122.0,122.0,150000,150000,0,0,150000,Null,Null,47323146,111461,5531
47453026,39.0,39.0,850000,90000,760000,89,850000,Null,Null,47453026,535885,1815
47461891,6.0,6.0,170000,170000,0,0,170000,Null,Null,47461891,18804,1883
47462861,13.0,13.0,160000,160000,0,0,160000,Null,Null,47462861,18804,2153
47470738,2254.0,2254.0,159000,95500,63500,40,159000,Null,Null,47470738,500047,1815
47499875,176.0,176.0,88000,88000,0,0,88000,Null,Null,47499875,235091,1520
47500338,421.0,421.0,88000,88000,0,0,88000,Null,Null,47500338,235091,1520
47570875,0.0,0.0,17661000,17661000,0,0,17661000,Null,Null,47570875,111461,914
47576824,0.0,0.0,11571000,11571000,0,0,11571000,Null,Null,47576824,111461,914
47868985,0.0,0.0,3650000,3650000,0,0,3650000,Null,Null,47868985,18804,1520
47961612,1180.0,1180.0,40000,40000,0,0,40000,Null,Null,47961612,454251,17186
47990067,305.0,305.0,367800,367800,0,0,367800,Null,Null,47990067,111461,23362
48010771,0.0,0.0,6369000,6369000,0,0,6369000,Null,Null,48010771,4647777,15318
48018778,13.0,13.0,13000,13000,0,0,13000,Null,Null,48018778,111461,2
48018782,3.0,3.0,19000,19000,0,0,19000,Null,Null,48018782,111461,914
48018784,31.0,31.0,17000,17000,0,0,17000,Null,Null,48018784,111461,2
48018786,17.0,17.0,19000,19000,0,0,19000,Null,Null,48018786,111461,2
48018788,12.0,12.0,19000,19000,0,0,19000,Null,Null,48018788,111461,2
48018790,0.0,0.0,19000,19000,0,0,19000,Null,Null,48018790,111461,2
48018792,5.0,5.0,19000,19000,0,0,19000,Null,Null,48018792,111461,2
48018794,6.0,6.0,19000,19000,0,0,19000,Null,Null,48018794,111461,2
48033915,1.0,1.0,74697,74697,0,0,74697,Null,Null,48033915,111461,1520
48038508,17.0,17.0,15000,15000,0,0,15000,Null,Null,48038508,111461,2
48038524,8.0,8.0,19000,19000,0,0,19000,Null,Null,48038524,111461,2
48038530,22.0,22.0,13000,13000,0,0,13000,Null,Null,48038530,111461,2
48038532,0.0,0.0,19000,19000,0,0,19000,Null,Null,48038532,111461,2
48045630,3448.0,3448.0,100000,80000,20000,20,100000,Null,Null,48045630,18804,1883
48054936,57.0,57.0,20000,11000,9000,45,20000,Null,Null,48054936,111461,1520
48055150,1540.0,1540.0,186000,93000,93000,50,186000,Null,Null,48055150,111461,3877
48069394,2.0,2.0,20300000,20300000,0,0,20300000,Null,Null,48069394,191611,1815
48085908,792.0,792.0,399000,399000,0,0,399000,Null,Null,48085908,183251,1520
48087407,779.0,779.0,159000,85000,74000,47,159000,Null,Null,48087407,314675,1829
48094891,251.0,251.0,55000,55000,0,0,55000,Null,Null,48094891,111461,23042
48116746,15.0,15.0,19000,19000,0,0,19000,Null,Null,48116746,505165,2
48116750,10.0,10.0,19000,19000,0,0,19000,Null,Null,48116750,505165,2
48116754,7.0,7.0,19000,19000,0,0,19000,Null,Null,48116754,505165,2
48116774,27.0,27.0,42000,42000,0,0,42000,Null,Null,48116774,505165,2
48116782,7.0,7.0,35000,35000,0,0,35000,Null,Null,48116782,505165,2
48116784,12.0,12.0,19000,19000,0,0,19000,Null,Null,48116784,505165,2
48116786,8.0,8.0,19000,19000,0,0,19000,Null,Null,48116786,505165,2
48116792,5.0,5.0,19000,19000,0,0,19000,Null,Null,48116792,505165,2
48116808,21.0,21.0,19000,19000,0,0,19000,Null,Null,48116808,505165,2
48116823,11.0,11.0,19000,19000,0,0,19000,Null,Null,48116823,505165,2
48150602,0.0,0.0,45000,45000,0,0,45000,Null,Null,48150602,407561,15318
48152865,0.0,0.0,300000,300000,0,0,300000,Null,Null,48152865,111461,914
48158857,18.0,18.0,135000,135000,0,0,135000,Null,Null,48158857,111461,23048
48175833,458.0,458.0,250000,175000,75000,30,250000,Null,Null,48175833,111461,1883
48175867,296.0,296.0,150000,108000,42000,28,150000,Null,Null,48175867,111461,23588
48185325,127.0,127.0,21800,21800,0,0,21800,Null,Null,48185325,111461,23184
48203210,4.0,4.0,12000,12000,0,0,12000,Null,Null,48203210,111461,914
48209944,2115.0,2115.0,250000,165000,85000,34,250000,Null,Null,48209944,562001,1520
48223376,295.0,295.0,375000,280000,95000,25,375000,Null,Null,48223376,173547,914
48228472,12.0,12.0,214000,214000,0,0,214000,Null,Null,48228472,47882,914
48279791,15.0,15.0,120000,120000,0,0,120000,Null,Null,48279791,427581,914
48287959,255.0,255.0,190000,160000,30000,16,190000,Null,Null,48287959,111461,6305
48290415,53.0,53.0,300000,229000,71000,24,300000,Null,Null,48290415,221169,3422
48291658,1072.0,1072.0,204000,176000,28000,14,204000,Null,Null,48291658,112882,1520
48291660,825.0,825.0,204000,176000,28000,14,204000,Null,Null,48291660,112882,1520
48309156,0.0,0.0,15000,15000,0,0,15000,Null,Null,48309156,111461,914
48324874,7.0,7.0,6390000,6390000,0,0,6390000,Null,Null,48324874,183625,28856
48373983,2150.0,2150.0,55000,40000,15000,27,55000,Null,Null,48373983,186605,53190
48435277,4.0,4.0,56000,56000,0,0,56000,Null,Null,48435277,407561,914
48453934,0.0,0.0,5780000,5780000,0,0,5780000,Null,Null,48453934,204731,914
48459143,12.0,12.0,10000,3000,7000,70,10000,Null,Null,48459143,111461,1520
48464389,293.0,293.0,1105000,850000,255000,23,1105000,Null,Null,48464389,243693,1815
48468641,5.0,5.0,270000,270000,0,0,270000,Null,Null,48468641,427581,914
48483174,33.0,33.0,51514,25757,25757,50,51514,Null,Null,48483174,524255,1815
48488492,36.0,36.0,139520,97664,41856,30,139520,Null,Null,48488492,111461,1883
48493605,1070.0,1070.0,1300000,908000,392000,30,1300000,Null,Null,48493605,50629,2
48510374,2343.0,2343.0,200000,129000,71000,36,200000,Null,Null,48510374,218129,1883
48515812,390.0,390.0,115000,115000,0,0,115000,Null,Null,48515812,4433917,1520
48539295,6.0,6.0,366000,366000,0,0,366000,Null,Null,48539295,223295,914
48579668,472.0,472.0,331000,331000,0,0,331000,Null,Null,48579668,22095,1520
48592030,0.0,0.0,8700,8000,700,8,8700,Null,Null,48592030,111461,1815
48594883,11.0,11.0,329000,329000,0,0,329000,Null,Null,48594883,25422,53190
48606990,28.0,28.0,249000,219000,30000,12,249000,Null,Null,48606990,48599,1601
48622915,346.0,346.0,69000,62000,7000,10,69000,Null,Null,48622915,111461,27128
48627056,4131.0,4131.0,1050000,565000,485000,46,1050000,Null,Null,48627056,631569,1520
48649439,3.0,3.0,258500,258500,0,0,258500,Null,Null,48649439,111461,914
48653783,2.0,2.0,55000,55000,0,0,55000,Null,Null,48653783,50637,1883
48658720,35.0,35.0,75000,75000,0,0,75000,Null,Null,48658720,111461,914
48677365,1265.0,1265.0,31300,30000,1300,4,31300,Null,Null,48677365,111461,914
48696084,1.0,1.0,9900,9702,198,2,9900,Null,Null,48696084,111461,1815
48698479,560.0,560.0,130000,130000,0,0,130000,Null,Null,48698479,288231,23026
48716779,71.0,71.0,76800,76800,0,0,76800,Null,Null,48716779,288231,23026
48716910,1314.0,1314.0,95000,79000,16000,17,95000,Null,Null,48716910,288231,23026
48717416,1749.0,1749.0,68000,39000,29000,43,68000,Null,Null,48717416,288231,23026
48721852,302.0,302.0,135000,128250,6750,5,135000,Null,Null,48721852,111461,1634
48722108,1472.0,1472.0,68000,39000,29000,43,68000,Null,Null,48722108,288231,1883
48722252,2352.0,2352.0,68000,39000,29000,43,68000,Null,Null,48722252,288231,23026
48736618,35.0,35.0,76800,76800,0,0,76800,Null,Null,48736618,288231,1883
48737587,16.0,16.0,76800,76800,0,0,76800,Null,Null,48737587,288231,23026
48739244,2147.0,2147.0,95000,86000,9000,9,95000,Null,Null,48739244,288231,1883
48749290,25.0,25.0,119000,119000,0,0,119000,Null,Null,48749290,25422,2784
48758410,0.0,0.0,0,39000,0,0,39000,Null,Null,48758410,111461,0
48813894,796.0,796.0,92000,72000,20000,22,92000,Null,Null,48813894,47794,1520
48837733,14.0,14.0,183000,183000,0,0,183000,Null,Null,48837733,19107,1815
48838267,2.0,2.0,319000,239000,80000,25,319000,Null,Null,48838267,111461,914
48877909,101.0,101.0,379000,379000,0,0,379000,Null,Null,48877909,111461,1815
48881541,692.0,692.0,65000,65000,0,0,65000,Null,Null,48881541,257717,1520
48952072,3.0,3.0,87000,63000,24000,28,87000,Null,Null,48952072,111461,914
48961510,204.0,204.0,169000,169000,0,0,169000,Null,Null,48961510,111461,53074
48961747,620.0,620.0,74668,74668,0,0,74668,Null,Null,48961747,370711,1520
48967336,8.0,8.0,42000,42000,0,0,42000,Null,Null,48967336,364731,2
48967928,75.0,75.0,44000,44000,0,0,44000,Null,Null,48967928,111461,1815
48972911,16.0,16.0,442000,442000,0,0,442000,Null,Null,48972911,63894,1634
49008665,21.0,21.0,89000,89000,0,0,89000,Null,Null,49008665,281343,914
49047291,343.0,343.0,300000,300000,0,0,300000,Null,Null,49047291,274953,914
49116420,174.0,174.0,159000,115000,44000,28,159000,Null,Null,49116420,212647,1883
49129618,5.0,5.0,342000,284999,57001,17,342000,Null,Null,49129618,111461,23388
49172910,21.0,21.0,30000,30000,0,0,30000,Null,Null,49172910,111461,914
49217739,405.0,405.0,125000,125000,0,0,125000,Null,Null,49217739,179125,1520
49269026,27.0,27.0,70000,70000,0,0,70000,Null,Null,49269026,111461,1815
49274496,103.0,103.0,87716,43858,43858,50,87716,Null,Null,49274496,111461,1815
49278874,235.0,235.0,49000,29000,20000,41,49000,Null,Null,49278874,111461,1815
49288586,42.0,42.0,161500,161500,0,0,161500,Null,Null,49288586,47803,1520
49294599,448.0,448.0,245700,227000,18700,8,245700,Null,Null,49294599,244351,1520
49317741,0.0,0.0,4400000,4400000,0,0,4400000,Null,Null,49317741,321805,3424
49324242,335.0,335.0,360000,360000,0,0,360000,Null,Null,49324242,191907,1520
49360034,0.0,0.0,12000000,12000000,0,0,12000000,Null,Null,49360034,321805,3424
49363183,0.0,0.0,12000000,12000000,0,0,12000000,Null,Null,49363183,321805,17170
49366597,0.0,0.0,16000000,16000000,0,0,16000000,Null,Null,49366597,321805,1601
49366971,0.0,0.0,14000000,14000000,0,0,14000000,Null,Null,49366971,321805,53350
49369104,0.0,0.0,22000000,22000000,0,0,22000000,Null,Null,49369104,321805,1601
49378093,9.0,9.0,398000,398000,0,0,398000,Null,Null,49378093,167099,23304
49454962,93.0,93.0,349000,349000,0,0,349000,Null,Null,49454962,167099,23304
49461539,0.0,0.0,14000000,14000000,0,0,14000000,Null,Null,49461539,694875,3424
49463450,0.0,0.0,16000000,16000000,0,0,16000000,Null,Null,49463450,694875,17170
49464611,0.0,0.0,18000000,18000000,0,0,18000000,Null,Null,49464611,694875,17170
49465707,0.0,0.0,10000000,10000000,0,0,10000000,Null,Null,49465707,321805,1601
49465854,0.0,0.0,18000000,18000000,0,0,18000000,Null,Null,49465854,694875,53350
49466044,0.0,0.0,20000000,20000000,0,0,20000000,Null,Null,49466044,694875,53350
49466169,0.0,0.0,16000000,16000000,0,0,16000000,Null,Null,49466169,694875,3424
49466367,0.0,0.0,22000000,22000000,0,0,22000000,Null,Null,49466367,694875,53350
49472598,6.0,6.0,105000,105000,0,0,105000,Null,Null,49472598,111461,2
49480883,809.0,809.0,600000,499000,101000,17,600000,Null,Null,49480883,18804,1634
49482501,8.0,8.0,4590000,3990000,600000,13,4590000,Null,Null,49482501,402287,1520
49498981,790.0,790.0,139000,139000,0,0,139000,Null,Null,49498981,111461,1804
49503235,17.0,17.0,240000,240000,0,0,240000,Null,Null,49503235,111461,914
49545472,0.0,0.0,3800000,3800000,0,0,3800000,Null,Null,49545472,354721,1520
49546877,0.0,0.0,3400000,3400000,0,0,3400000,Null,Null,49546877,354721,17170
49546892,16.0,16.0,138900,138900,0,0,138900,Null,Null,49546892,111461,8070
49549551,1.0,1.0,3400000,3400000,0,0,3400000,Null,Null,49549551,354721,17170
49554373,135.0,135.0,695000,695000,0,0,695000,Null,Null,49554373,167099,3990
49558613,122.0,122.0,89000,89000,0,0,89000,Null,Null,49558613,111461,1815
49591425,0.0,0.0,4100000,4040000,60000,1,4100000,Null,Null,49591425,199801,1520
49593440,4.0,4.0,7158000,7099000,59000,1,7158000,Null,Null,49593440,199801,1520
49593802,0.0,0.0,8900000,8900000,0,0,8900000,Null,Null,49593802,199801,1520
49593987,2.0,2.0,4550000,4550000,0,0,4550000,Null,Null,49593987,199801,1520
49625458,28.0,28.0,95900,95900,0,0,95900,Null,Null,49625458,111461,51698
49629830,26.0,26.0,57600,57600,0,0,57600,Null,Null,49629830,111461,914
49631712,10.0,10.0,860000,599000,261000,30,860000,Null,Null,49631712,4647777,914
49646879,5.0,5.0,27000,27000,0,0,27000,Null,Null,49646879,111461,914
49651098,37.0,37.0,38000,38000,0,0,38000,Null,Null,49651098,111461,8371
49651363,2.0,2.0,39000,39000,0,0,39000,Null,Null,49651363,111461,914
49651917,39.0,39.0,7600,7600,0,0,7600,Null,Null,49651917,111461,1815
49656429,63.0,63.0,29900,29900,0,0,29900,Null,Null,49656429,111461,2805
49656686,648.0,648.0,32000,25600,6400,20,32000,Null,Null,49656686,542605,1612
49658272,54.0,54.0,109000,109000,0,0,109000,Null,Null,49658272,21651,1815
49664329,1.0,1.0,3800000,3800000,0,0,3800000,Null,Null,49664329,538513,1634
49722402,12.0,12.0,105000,105000,0,0,105000,Null,Null,49722402,111461,2
49733064,6.0,6.0,105000,105000,0,0,105000,Null,Null,49733064,111461,2
49736973,47.0,47.0,116000,116000,0,0,116000,Null,Null,49736973,111461,2
49737224,18.0,18.0,95000,95000,0,0,95000,Null,Null,49737224,111461,2
49745304,21.0,21.0,4610000,4579000,31000,1,4610000,Null,Null,49745304,199801,1520
49776006,5.0,5.0,1570000,1099000,471000,30,1570000,Null,Null,49776006,4647777,914
49860301,4.0,4.0,12000,12000,0,0,12000,Null,Null,49860301,111461,1815
49870397,0.0,0.0,9600000,9600000,0,0,9600000,Null,Null,49870397,156409,914
49882760,0.0,0.0,6700000,6700000,0,0,6700000,Null,Null,49882760,156409,914
49883492,0.0,0.0,15785000,15785000,0,0,15785000,Null,Null,49883492,156409,914
49884973,747.0,747.0,149000,149000,0,0,149000,Null,Null,49884973,661081,1804
49892585,0.0,0.0,6700000,6700000,0,0,6700000,Null,Null,49892585,156409,914
49904088,427.0,427.0,387000,387000,0,0,387000,Null,Null,49904088,153516,1520
49906255,105.0,105.0,110000,77000,33000,30,110000,Null,Null,49906255,111461,27128
49924896,639.0,639.0,89000,39000,50000,56,89000,Null,Null,49924896,500047,1815
49938338,0.0,0.0,4200000,4200000,0,0,4200000,Null,Null,49938338,354721,17170
49950511,108.0,108.0,30000,9000,21000,70,30000,Null,Null,49950511,111461,914
50017132,53.0,53.0,8796,8796,0,0,8796,Null,Null,50017132,111461,1520
50045215,16.0,16.0,16000,16000,0,0,16000,Null,Null,50045215,111461,914
50083853,722.0,722.0,62000,62000,0,0,62000,Null,Null,50083853,111461,1520
50086424,0.0,0.0,97999000,97999000,0,0,97999000,Null,Null,50086424,104279,23710
50096810,149.0,149.0,920000,859000,61000,7,920000,Null,Null,50096810,26689,1601
50098102,2962.0,2962.0,550000,357000,193000,35,550000,Null,Null,50098102,456351,23622
50206492,901.0,901.0,37000,37000,0,0,37000,Null,Null,50206492,111461,23416
50248318,7.0,7.0,150000,150000,0,0,150000,Null,Null,50248318,111461,15236
50248705,27.0,27.0,150000,150000,0,0,150000,Null,Null,50248705,111461,914
50251626,0.0,0.0,5700000,5700000,0,0,5700000,Null,Null,50251626,209651,1520
50252560,2.0,2.0,3496000,3496000,0,0,3496000,Null,Null,50252560,259989,53350
50252568,20.0,20.0,550000,550000,0,0,550000,Null,Null,50252568,185315,1883
50253691,422.0,422.0,170000,170000,0,0,170000,Null,Null,50253691,372895,1520
50253867,50.0,50.0,60000,56000,4000,7,60000,Null,Null,50253867,549763,1815
50254577,6.0,6.0,424000,424000,0,0,424000,Null,Null,50254577,185315,1883
50255494,0.0,0.0,5700000,5700000,0,0,5700000,Null,Null,50255494,209651,1520
50261956,169.0,169.0,149000,149000,0,0,149000,Null,Null,50261956,618755,1805
50272433,457.0,457.0,69000,69000,0,0,69000,Null,Null,50272433,111461,23246
50276839,3.0,3.0,250000,250000,0,0,250000,Null,Null,50276839,111461,914
50308042,106.0,106.0,890000,890000,0,0,890000,Null,Null,50308042,183013,1520
50324146,1.0,1.0,80000,80000,0,0,80000,Null,Null,50324146,111461,23282
50324186,0.0,0.0,120000,120000,0,0,120000,Null,Null,50324186,111461,23282
50326501,4202.0,4202.0,190000,190000,0,0,190000,Null,Null,50326501,47663,1520
50326939,978.0,978.0,1150000,1039000,111000,10,1150000,Null,Null,50326939,26689,17170
50329601,530.0,530.0,305000,305000,0,0,305000,Null,Null,50329601,623493,1520
50329771,524.0,524.0,305000,245000,60000,20,305000,Null,Null,50329771,623493,1520
50334606,321.0,321.0,305000,305000,0,0,305000,Null,Null,50334606,623493,1520
50353183,47.0,47.0,34900,34900,0,0,34900,Null,Null,50353183,111461,8371
50359715,4.0,4.0,145000,145000,0,0,145000,Null,Null,50359715,111461,914
50377449,14.0,14.0,1032000,407000,625000,61,1032000,Null,Null,50377449,183013,1520
50385570,1.0,1.0,285000,285000,0,0,285000,Null,Null,50385570,111461,914
50392724,579.0,579.0,59000,49001,9999,17,59000,Null,Null,50392724,111461,1815
50409477,201.0,201.0,140000,140000,0,0,140000,Null,Null,50409477,257333,2
50421638,0.0,0.0,295000,279000,16000,5,295000,Null,Null,50421638,111461,1815
50423005,0.0,0.0,66970000,66970000,0,0,66970000,Null,Null,50423005,400077,20492
50424465,599.0,599.0,82000,82000,0,0,82000,Null,Null,50424465,111461,1815
50427353,55.0,55.0,17000,17000,0,0,17000,Null,Null,50427353,111461,1815
50436590,271.0,271.0,169000,169000,0,0,169000,Null,Null,50436590,186751,4428
50463111,0.0,0.0,98000000,98000000,0,0,98000000,Null,Null,50463111,104279,23710
50481348,7.0,7.0,187000,187000,0,0,187000,Null,Null,50481348,167853,914
50485162,196.0,196.0,84900,84900,0,0,84900,Null,Null,50485162,111461,20492
50488596,162.0,162.0,65000,65000,0,0,65000,Null,Null,50488596,701913,1520
50508330,239.0,239.0,89000,89000,0,0,89000,Null,Null,50508330,111461,1815
50612149,95.0,95.0,707000,707000,0,0,707000,Null,Null,50612149,274777,1520
50618604,1173.0,1173.0,178000,178000,0,0,178000,Null,Null,50618604,64152,1520
50699261,1896.0,1896.0,525000,445000,80000,15,525000,Null,Null,50699261,50662,1520
50699277,304.0,304.0,365000,275000,90000,25,365000,Null,Null,50699277,50662,3424
50699284,3967.0,3967.0,525000,445000,80000,15,525000,Null,Null,50699284,50662,1520
50700390,28.0,28.0,299000,299000,0,0,299000,Null,Null,50700390,50662,1520
50700392,398.0,398.0,425000,404000,21000,5,425000,Null,Null,50700392,50662,2347
50700756,189.0,189.0,315000,315000,0,0,315000,Null,Null,50700756,111461,23588
50702128,3.0,3.0,3600000,3600000,0,0,3600000,Null,Null,50702128,564361,3426
50703568,156.0,156.0,417000,417000,0,0,417000,Null,Null,50703568,151948,1520
50711344,3.0,3.0,49000,49000,0,0,49000,Null,Null,50711344,111461,914
50736325,530.0,530.0,249000,249000,0,0,249000,Null,Null,50736325,275197,1520
50740242,823.0,823.0,180000,90000,90000,50,180000,Null,Null,50740242,197767,23136
50744048,148.0,148.0,310000,175000,135000,44,310000,Null,Null,50744048,185083,1815
50779213,188.0,188.0,650000,620000,30000,5,650000,Null,Null,50779213,491887,1520
50819884,9.0,9.0,90000,90000,0,0,90000,Null,Null,50819884,111461,53074
50889283,1697.0,1697.0,35000,35000,0,0,35000,Null,Null,50889283,180597,11605
50891667,146.0,146.0,39000,38220,780,2,39000,Null,Null,50891667,111461,1815
50926033,715.0,715.0,240000,126000,114000,48,240000,Null,Null,50926033,217777,1520
50937043,54.0,54.0,34800,35000,0,0,34800,Null,Null,50937043,111461,1815
50952469,414.0,414.0,25000,25000,0,0,25000,Null,Null,50952469,111461,1883
50952934,8.0,8.0,24899,24899,0,0,24899,Null,Null,50952934,111461,1883
51029511,0.0,0.0,269000,269000,0,0,269000,Null,Null,51029511,111461,914
51041232,0.0,0.0,9357143,6550000,2807143,30,9357143,Null,Null,51041232,405211,2
51041243,0.0,0.0,18357143,12850000,5507143,30,18357143,Null,Null,51041243,405211,2
51041247,0.0,0.0,18357143,12850000,5507143,30,18357143,Null,Null,51041247,405211,2
51041249,1.0,1.0,9642857,6750000,2892857,30,9642857,Null,Null,51041249,405211,2
51041250,0.0,0.0,9785714,6850000,2935714,30,9785714,Null,Null,51041250,405211,2
51041253,2.0,2.0,8500000,5950000,2550000,30,8500000,Null,Null,51041253,405211,2
51041255,0.0,0.0,7500000,7500000,0,0,7500000,Null,Null,51041255,405211,2
51041261,0.0,0.0,5971429,5971429,0,0,5971429,Null,Null,51041261,405211,2
51041285,0.0,0.0,12214286,12214286,0,0,12214286,Null,Null,51041285,405211,2
51041306,2.0,2.0,5657143,5657143,0,0,5657143,Null,Null,51041306,405211,2
51041308,2.0,2.0,7542857,7542857,0,0,7542857,Null,Null,51041308,405211,2
51043232,0.0,0.0,12168000,12168000,0,0,12168000,Null,Null,51043232,25697,2
51043720,0.0,0.0,15876000,15876000,0,0,15876000,Null,Null,51043720,25697,2
51044093,0.0,0.0,12168000,12168000,0,0,12168000,Null,Null,51044093,25697,2
51044103,0.0,0.0,12168000,12168000,0,0,12168000,Null,Null,51044103,25697,2
51044106,0.0,0.0,15876000,15876000,0,0,15876000,Null,Null,51044106,25697,2
51044450,0.0,0.0,12168000,12168000,0,0,12168000,Null,Null,51044450,25697,2
51044454,0.0,0.0,21168000,21168000,0,0,21168000,Null,Null,51044454,25697,2
51044868,239.0,239.0,180000,180000,0,0,180000,Null,Null,51044868,161949,27128
51048821,847.0,847.0,319000,319000,0,0,319000,Null,Null,51048821,469887,5893
51053503,60.0,60.0,96000,96000,0,0,96000,Null,Null,51053503,407561,2
51053523,56.0,56.0,29000,29000,0,0,29000,Null,Null,51053523,407561,2
51059393,1003.0,1003.0,33000,33000,0,0,33000,Null,Null,51059393,111461,1804
51066185,72.0,72.0,180000,135000,45000,25,180000,Null,Null,51066185,111461,1634
51092786,39.0,39.0,63790,63790,0,0,63790,Null,Null,51092786,111461,1815
51104756,101.0,101.0,74900,74900,0,0,74900,Null,Null,51104756,111461,914
51105287,1711.0,1711.0,40000,33000,7000,18,40000,Null,Null,51105287,277519,23340
51112392,0.0,0.0,2000,2000,0,0,2000,Null,Null,51112392,111461,23042
51120056,13.0,13.0,90000,90000,0,0,90000,Null,Null,51120056,111461,2
51144810,412.0,412.0,37000,37000,0,0,37000,Null,Null,51144810,111461,1883
51197258,4.0,4.0,48000,44000,4000,8,48000,Null,Null,51197258,243693,2
51200117,4.0,4.0,6000,6000,0,0,6000,Null,Null,51200117,111461,1520
51251538,62.0,62.0,82000,82000,0,0,82000,Null,Null,51251538,111461,1815
51265505,36.0,36.0,179000,161100,17900,10,179000,Null,Null,51265505,111461,2225
51283879,0.0,0.0,3850000,3850000,0,0,3850000,Null,Null,51283879,287227,1583
51283992,0.0,0.0,3850000,3850000,0,0,3850000,Null,Null,51283992,287227,53350
51284435,5.0,5.0,4290000,4290000,0,0,4290000,Null,Null,51284435,402993,1597
51284951,7.0,7.0,315000,280000,35000,11,315000,Null,Null,51284951,223295,914
51287418,1377.0,1377.0,246000,205000,41000,17,246000,Null,Null,51287418,74674,1520
51288340,5.0,5.0,33000,33000,0,0,33000,Null,Null,51288340,111461,2685
51289122,0.0,0.0,330000,330000,0,0,330000,Null,Null,51289122,111461,914
51291153,118.0,118.0,99000,89100,9900,10,99000,Null,Null,51291153,21651,1815
51296786,715.0,715.0,300000,159000,141000,47,300000,Null,Null,51296786,518605,1520
51312055,0.0,0.0,3630000,3630000,0,0,3630000,Null,Null,51312055,402993,2347
51319753,354.0,354.0,113000,113000,0,0,113000,Null,Null,51319753,111461,20492
51341756,6.0,6.0,50000,50000,0,0,50000,Null,Null,51341756,111461,914
51355202,134.0,134.0,150000,99000,51000,34,150000,Null,Null,51355202,111461,27180
51356529,20.0,20.0,99000,99000,0,0,99000,Null,Null,51356529,111461,914
51367916,0.0,0.0,56000,56000,0,0,56000,Null,Null,51367916,407561,2
51368456,1179.0,1179.0,120000,98000,22000,18,120000,Null,Null,51368456,277519,1883
51370884,1.0,1.0,131000,131000,0,0,131000,Null,Null,51370884,111461,914
51371292,74.0,74.0,109000,109000,0,0,109000,Null,Null,51371292,111461,2805
51371445,16.0,16.0,29000,29000,0,0,29000,Null,Null,51371445,407561,914
51373821,100.0,100.0,205000,205000,0,0,205000,Null,Null,51373821,193677,1883
51374700,110.0,110.0,178000,178000,0,0,178000,Null,Null,51374700,193677,2488
51420955,19.0,19.0,1115000,1115000,0,0,1115000,Null,Null,51420955,182293,53350
51437547,3.0,3.0,75000,75000,0,0,75000,Null,Null,51437547,111461,23282
51442066,159.0,159.0,89000,89000,0,0,89000,Null,Null,51442066,111461,1815
51461307,96.0,96.0,189000,189000,0,0,189000,Null,Null,51461307,111461,4428
51461310,52.0,52.0,189000,189000,0,0,189000,Null,Null,51461310,111461,1804
51470988,10971.0,10971.0,120000,70000,50000,42,120000,Null,Null,51470988,110935,8305
51472857,163.0,163.0,149000,149000,0,0,149000,Null,Null,51472857,197767,6305
51475007,63.0,63.0,75000,75000,0,0,75000,Null,Null,51475007,111461,914
51476716,2715.0,2715.0,300000,220000,80000,27,300000,Null,Null,51476716,277519,1883
51477227,16.0,16.0,79000,79000,0,0,79000,Null,Null,51477227,111461,914
51510460,670.0,670.0,32700,32700,0,0,32700,Null,Null,51510460,111461,28738
51511060,0.0,0.0,35000000,35000000,0,0,35000000,Null,Null,51511060,180151,11516
51518044,1.0,1.0,10000000,10000000,0,0,10000000,Null,Null,51518044,156409,914
51527713,0.0,0.0,12000000,12000000,0,0,12000000,Null,Null,51527713,156409,914
51529136,0.0,0.0,7900000,7900000,0,0,7900000,Null,Null,51529136,156409,914
51530502,2.0,2.0,390000,390000,0,0,390000,Null,Null,51530502,111461,23634
51531127,0.0,0.0,6700000,6700000,0,0,6700000,Null,Null,51531127,156409,914
51531432,12.0,12.0,65999,65999,0,0,65999,Null,Null,51531432,111461,914
51532159,0.0,0.0,6100000,6100000,0,0,6100000,Null,Null,51532159,156409,914
51532357,0.0,0.0,6300000,6300000,0,0,6300000,Null,Null,51532357,156409,914
51540051,12880.0,12880.0,715000,499000,216000,30,715000,Null,Null,51540051,160211,1520
51540377,2062.0,2062.0,285000,219000,66000,23,285000,Null,Null,51540377,160211,3422
51542236,1500.0,1500.0,455000,349000,106000,23,455000,Null,Null,51542236,160211,3422
51542411,5027.0,5027.0,575000,419000,156000,27,575000,Null,Null,51542411,160211,3422
51542699,4824.0,4824.0,575000,419000,156000,27,575000,Null,Null,51542699,160211,1520
51549505,38.0,38.0,195000,195000,0,0,195000,Null,Null,51549505,111461,3990
51554420,1388.0,1388.0,375000,279000,96000,26,375000,Null,Null,51554420,160211,1520
51554889,114.0,114.0,49000,44000,5000,10,49000,Null,Null,51554889,63747,53074
51559883,10627.0,10627.0,1000000,649000,351000,35,1000000,Null,Null,51559883,160211,3422
51567178,0.0,0.0,286000,286000,0,0,286000,Null,Null,51567178,111461,53190
51593115,4581.0,4581.0,19000,19000,0,0,19000,Null,Null,51593115,111461,1815
51626343,1.0,1.0,35000,35000,0,0,35000,Null,Null,51626343,111461,914
51626369,153.0,153.0,369000,307000,62000,17,369000,Null,Null,51626369,63894,1634
51640190,349.0,349.0,488000,488000,0,0,488000,Null,Null,51640190,111461,5264
51654599,20.0,20.0,25000,25000,0,0,25000,Null,Null,51654599,505165,914
51654851,740.0,740.0,72000,72000,0,0,72000,Null,Null,51654851,111461,18876
51655274,9.0,9.0,46000,46000,0,0,46000,Null,Null,51655274,111461,23416
51658113,0.0,0.0,5000,5000,0,0,5000,Null,Null,51658113,50034,8305
51661295,604.0,604.0,295000,295000,0,0,295000,Null,Null,51661295,707789,1520
51662145,235.0,235.0,20897,20897,0,0,20897,Null,Null,51662145,111461,53074
51690162,0.0,0.0,18900000,18900000,0,0,18900000,Null,Null,51690162,180151,11518
51690476,0.0,0.0,27000000,27000000,0,0,27000000,Null,Null,51690476,180151,11516
51690521,0.0,0.0,152000000,152000000,0,0,152000000,Null,Null,51690521,720689,1883
51693122,0.0,0.0,140000000,140000000,0,0,140000000,Null,Null,51693122,720689,1883
51693127,0.0,0.0,29009000,29009000,0,0,29009000,Null,Null,51693127,275769,15236
51696125,1658.0,1658.0,190000,138000,52000,27,190000,Null,Null,51696125,47663,1520
51700010,0.0,0.0,24523000,24523000,0,0,24523000,Null,Null,51700010,275769,15236
51705676,0.0,0.0,12000000,12000000,0,0,12000000,Null,Null,51705676,156409,914
51706763,0.0,0.0,7900000,7900000,0,0,7900000,Null,Null,51706763,156409,914
51707972,0.0,0.0,6100000,6100000,0,0,6100000,Null,Null,51707972,156409,914
51709690,0.0,0.0,12500000,12500000,0,0,12500000,Null,Null,51709690,156409,914
51715125,0.0,0.0,9600000,9600000,0,0,9600000,Null,Null,51715125,156409,914
51715452,0.0,0.0,8500000,8500000,0,0,8500000,Null,Null,51715452,156409,914
51715617,0.0,0.0,9600000,9600000,0,0,9600000,Null,Null,51715617,156409,914
51715779,0.0,0.0,6700000,6700000,0,0,6700000,Null,Null,51715779,156409,5385
51718870,17.0,17.0,115600,108000,7600,7,115600,Null,Null,51718870,111461,1815
51720183,0.0,0.0,14500000,14500000,0,0,14500000,Null,Null,51720183,156409,914
51720517,0.0,0.0,9700000,9700000,0,0,9700000,Null,Null,51720517,156409,914
51720975,0.0,0.0,8500000,8500000,0,0,8500000,Null,Null,51720975,156409,5385
51721048,0.0,0.0,6100000,6100000,0,0,6100000,Null,Null,51721048,156409,914
51721220,0.0,0.0,10800000,10800000,0,0,10800000,Null,Null,51721220,156409,914
51721867,0.0,0.0,6700000,6700000,0,0,6700000,Null,Null,51721867,156409,914
51721965,0.0,0.0,8500000,8500000,0,0,8500000,Null,Null,51721965,156409,914
51722190,0.0,0.0,10900000,10900000,0,0,10900000,Null,Null,51722190,156409,914
51722309,0.0,0.0,14500000,14500000,0,0,14500000,Null,Null,51722309,156409,914
51722344,0.0,0.0,9100000,9100000,0,0,9100000,Null,Null,51722344,156409,914
51722475,0.0,0.0,13300000,13300000,0,0,13300000,Null,Null,51722475,156409,914
51722590,0.0,0.0,6100000,6100000,0,0,6100000,Null,Null,51722590,156409,914
51722820,0.0,0.0,9700000,9700000,0,0,9700000,Null,Null,51722820,156409,5385
51722866,0.0,0.0,6700000,6700000,0,0,6700000,Null,Null,51722866,156409,914
51722919,0.0,0.0,13300000,13300000,0,0,13300000,Null,Null,51722919,156409,5385
51724421,0.0,0.0,8200000,8200000,0,0,8200000,Null,Null,51724421,156409,914
51724426,0.0,0.0,9600000,9600000,0,0,9600000,Null,Null,51724426,156409,914
51724430,0.0,0.0,13300000,13300000,0,0,13300000,Null,Null,51724430,156409,5385
51724437,0.0,0.0,9600000,9600000,0,0,9600000,Null,Null,51724437,156409,914
51724439,0.0,0.0,13900000,13900000,0,0,13900000,Null,Null,51724439,156409,914
51725142,0.0,0.0,130000000,130000000,0,0,130000000,Null,Null,51725142,720689,1883
51732092,0.0,0.0,6700000,6700000,0,0,6700000,Null,Null,51732092,156409,914
51843424,4.0,4.0,86000,86000,0,0,86000,Null,Null,51843424,111461,2234
51852428,0.0,0.0,79000,79000,0,0,79000,Null,Null,51852428,111461,23622
51852604,4.0,4.0,35000,35000,0,0,35000,Null,Null,51852604,505165,2
51852905,10.0,10.0,35000,35000,0,0,35000,Null,Null,51852905,505165,914
51852914,7.0,7.0,35000,35000,0,0,35000,Null,Null,51852914,505165,914
51852970,6.0,6.0,35000,35000,0,0,35000,Null,Null,51852970,505165,914
51898349,2.0,2.0,6980000,6980000,0,0,6980000,Null,Null,51898349,209651,1520
51913046,0.0,0.0,9000,9000,0,0,9000,Null,Null,51913046,111461,1815
51913317,20.0,20.0,9000,9000,0,0,9000,Null,Null,51913317,111461,1815
51915247,143.0,143.0,25197,25197,0,0,25197,Null,Null,51915247,111461,1883
51932873,1.0,1.0,35000,35000,0,0,35000,Null,Null,51932873,407561,2
51933070,3.0,3.0,220000,146000,74000,34,220000,Null,Null,51933070,173547,914
51962360,60.0,60.0,300000,249000,51000,17,300000,Null,Null,51962360,223295,914
51969021,542.0,542.0,189000,123000,66000,35,189000,Null,Null,51969021,288231,53074
51971863,0.0,0.0,18890000,18890000,0,0,18890000,Null,Null,51971863,164793,1815
51984829,0.0,0.0,12000000,12000000,0,0,12000000,Null,Null,51984829,156409,914
51986593,0.0,0.0,9100000,9100000,0,0,9100000,Null,Null,51986593,156409,5385
51993270,0.0,0.0,7000000,7000000,0,0,7000000,Null,Null,51993270,25502,914
51997651,35.0,35.0,19200,16128,3072,16,19200,Null,Null,51997651,111461,23622
51998725,130.0,130.0,458000,229000,229000,50,458000,Null,Null,51998725,63894,1634
52002453,0.0,0.0,4900000,4900000,0,0,4900000,Null,Null,52002453,65095,8061
52003922,159.0,159.0,250000,206000,44000,18,250000,Null,Null,52003922,277519,1883
52004331,322.0,322.0,450000,359000,91000,20,450000,Null,Null,52004331,111461,6305
52027172,19.0,19.0,184000,184000,0,0,184000,Null,Null,52027172,41391,53190
52054103,137.0,137.0,98000,49000,49000,50,98000,Null,Null,52054103,111461,53048
52060568,127.0,127.0,80000,80000,0,0,80000,Null,Null,52060568,111461,914
52064996,0.0,0.0,7200000,7200000,0,0,7200000,Null,Null,52064996,25502,5385
52065003,12.0,12.0,109000,109000,0,0,109000,Null,Null,52065003,111461,914
52070229,179.0,179.0,1450000,829000,621000,43,1450000,Null,Null,52070229,144018,1815
52070959,12.0,12.0,46999,46999,0,0,46999,Null,Null,52070959,111461,914
52093852,1003.0,1003.0,57000,57000,0,0,57000,Null,Null,52093852,111461,1815
52106132,2.0,2.0,3550000,3550000,0,0,3550000,Null,Null,52106132,724571,17170
52106827,384.0,384.0,30000,30000,0,0,30000,Null,Null,52106827,111461,1883
52107862,46.0,46.0,390000,279000,111000,28,390000,Null,Null,52107862,25422,1520
52107871,0.0,0.0,6800000,6800000,0,0,6800000,Null,Null,52107871,25502,914
52108465,0.0,0.0,6300000,6300000,0,0,6300000,Null,Null,52108465,25502,914
52112198,0.0,0.0,6800000,6800000,0,0,6800000,Null,Null,52112198,25502,914
52123005,505.0,505.0,120000,88000,32000,27,120000,Null,Null,52123005,288231,53074
52136047,46.0,46.0,80000,80000,0,0,80000,Null,Null,52136047,111461,914
52141365,0.0,0.0,20000,20000,0,0,20000,Null,Null,52141365,111461,2
52144419,26.0,26.0,39000,39000,0,0,39000,Null,Null,52144419,111461,914
52145833,65.0,65.0,90000,90000,0,0,90000,Null,Null,52145833,111461,8371
52146130,5.0,5.0,139000,139000,0,0,139000,Null,Null,52146130,111461,914
52146810,10.0,10.0,239000,239000,0,0,239000,Null,Null,52146810,111461,914
52148481,0.0,0.0,6500000,6500000,0,0,6500000,Null,Null,52148481,193837,15250
52148677,26.0,26.0,80000,80000,0,0,80000,Null,Null,52148677,111461,914
52151236,884.0,884.0,78000,78000,0,0,78000,Null,Null,52151236,111461,23282
52151340,0.0,0.0,10700000,10700000,0,0,10700000,Null,Null,52151340,193837,15250
52153099,60.0,60.0,34000,34000,0,0,34000,Null,Null,52153099,111461,914
52156047,11.0,11.0,24989,24989,0,0,24989,Null,Null,52156047,111461,27180
52172308,4.0,4.0,66000,66000,0,0,66000,Null,Null,52172308,407561,914
52172616,99.0,99.0,29999,29999,0,0,29999,Null,Null,52172616,111461,914
52173227,855.0,855.0,790000,585000,205000,26,790000,Null,Null,52173227,201089,1883
52180193,101.0,101.0,490000,490000,0,0,490000,Null,Null,52180193,25422,1815
52187161,0.0,0.0,9500,9500,0,0,9500,Null,Null,52187161,111461,1883
52187387,1204.0,1204.0,150000,116000,34000,23,150000,Null,Null,52187387,21271,1520
52216318,1305.0,1305.0,135000,130000,5000,4,135000,Null,Null,52216318,491699,1520
52216336,1685.0,1685.0,159000,136000,23000,14,159000,Null,Null,52216336,491699,1520
52217088,2747.0,2747.0,145000,131000,14000,10,145000,Null,Null,52217088,21273,11605
52234806,71.0,71.0,138000,138000,0,0,138000,Null,Null,52234806,111461,2363
52238726,1115.0,1115.0,210000,155000,55000,26,210000,Null,Null,52238726,252399,53186
52238892,195.0,195.0,48000,48000,0,0,48000,Null,Null,52238892,111461,53054
52240184,182.0,182.0,1592000,1186000,406000,26,1592000,Null,Null,52240184,33203,1520
52240280,1211.0,1211.0,239000,239000,0,0,239000,Null,Null,52240280,472329,1520
52245760,38.0,38.0,39000,39000,0,0,39000,Null,Null,52245760,111461,914
52247229,284.0,284.0,19998,9999,9999,50,19998,Null,Null,52247229,111461,1815
52248624,0.0,0.0,4350000,4350000,0,0,4350000,Null,Null,52248624,111461,1520
52249680,488.0,488.0,115000,115000,0,0,115000,Null,Null,52249680,111461,914
52251328,289.0,289.0,131000,111000,20000,15,131000,Null,Null,52251328,203901,13878
52252624,154.0,154.0,45000,38000,7000,16,45000,Null,Null,52252624,203901,1520
52262763,5.0,5.0,140000,140000,0,0,140000,Null,Null,52262763,111461,914
52262959,56.0,56.0,49000,49000,0,0,49000,Null,Null,52262959,111461,914
52280562,2597.0,2597.0,185000,160000,25000,14,185000,Null,Null,52280562,112882,1520
52280564,4701.0,4701.0,185000,160000,25000,14,185000,Null,Null,52280564,112882,1520
52280823,3.0,3.0,10500000,10500000,0,0,10500000,Null,Null,52280823,228187,1520
52281711,0.0,0.0,58000,58000,0,0,58000,Null,Null,52281711,111461,15250
52286599,16.0,16.0,180000,126000,54000,30,180000,Null,Null,52286599,171149,1815
52293499,176.0,176.0,399000,280000,119000,30,399000,Null,Null,52293499,25422,1520
52295579,333.0,333.0,148700,148700,0,0,148700,Null,Null,52295579,111461,1815
52295646,0.0,0.0,12124000,8660000,3464000,29,12124000,Null,Null,52295646,732431,2
52297710,52.0,52.0,11962,11962,0,0,11962,Null,Null,52297710,111461,1883
52312571,0.0,0.0,6685000,6685000,0,0,6685000,Null,Null,52312571,25502,914
52316356,516.0,516.0,699000,699000,0,0,699000,Null,Null,52316356,569677,1978
52326343,0.0,0.0,2580000,2580000,0,0,2580000,Null,Null,52326343,65095,8061
52327372,0.0,0.0,6800000,6800000,0,0,6800000,Null,Null,52327372,25502,914
52329642,1.0,1.0,10085000,10085000,0,0,10085000,Null,Null,52329642,25502,914
52333193,762.0,762.0,78000,66000,12000,15,78000,Null,Null,52333193,111461,1811
52334532,0.0,0.0,11390000,11390000,0,0,11390000,Null,Null,52334532,217953,7079
52335026,1.0,1.0,15699000,15699000,0,0,15699000,Null,Null,52335026,217953,26652
52339886,144.0,144.0,325000,325000,0,0,325000,Null,Null,52339886,362197,914
52385659,597.0,597.0,49000,49000,0,0,49000,Null,Null,52385659,111461,2363
52402357,329.0,329.0,160000,136000,24000,15,160000,Null,Null,52402357,277519,1883
52416730,282.0,282.0,60000,32000,28000,47,60000,Null,Null,52416730,111461,1883
52424574,128.0,128.0,550000,339000,211000,38,550000,Null,Null,52424574,19312,1815
52460603,0.0,0.0,9030000,9030000,0,0,9030000,Null,Null,52460603,25502,5385
52460880,9.0,9.0,59000,59000,0,0,59000,Null,Null,52460880,111461,23282
52461196,1.0,1.0,88000,88000,0,0,88000,Null,Null,52461196,21733,1583
52468314,1.0,1.0,488000,488000,0,0,488000,Null,Null,52468314,111461,914
52469205,1042.0,1042.0,35000,35000,0,0,35000,Null,Null,52469205,111461,914
52480318,0.0,0.0,2500000,2500000,0,0,2500000,Null,Null,52480318,111461,8061
52481412,2.0,2.0,2200000,2200000,0,0,2200000,Null,Null,52481412,111461,8061
52483298,25.0,25.0,59900,48000,11900,20,59900,Null,Null,52483298,111461,27214
52484490,16.0,16.0,20900,20900,0,0,20900,Null,Null,52484490,111461,1883
52528427,368.0,368.0,397000,397000,0,0,397000,Null,Null,52528427,111461,28480
52529520,55.0,55.0,102000,52530,49470,49,102000,Null,Null,52529520,111461,23058
52574827,4457.0,4457.0,220000,187000,33000,15,220000,Null,Null,52574827,277519,5995
52577179,0.0,0.0,85000,85000,0,0,85000,Null,Null,52577179,111461,1883
52577269,47.0,47.0,41000,41000,0,0,41000,Null,Null,52577269,111461,1883
52578184,607.0,607.0,15000,15000,0,0,15000,Null,Null,52578184,111461,53074
52582326,0.0,0.0,77999,77999,0,0,77999,Null,Null,52582326,111461,23246
52584210,34.0,34.0,850000,499000,351000,41,850000,Null,Null,52584210,19312,1815
52589894,293.0,293.0,108000,108000,0,0,108000,Null,Null,52589894,111461,1815
52590900,92.0,92.0,8000,8000,0,0,8000,Null,Null,52590900,111461,1815
52596656,2.0,2.0,276000,244950,31050,11,276000,Null,Null,52596656,111461,1883
52599291,326.0,326.0,104000,104000,0,0,104000,Null,Null,52599291,111461,1883
52602232,308.0,308.0,139000,139000,0,0,139000,Null,Null,52602232,111461,1815
52608923,902.0,902.0,159000,143100,15900,10,159000,Null,Null,52608923,686325,1815
52615904,227.0,227.0,160000,152000,8000,5,160000,Null,Null,52615904,247667,17170
52618723,52.0,52.0,119000,119000,0,0,119000,Null,Null,52618723,111461,914
52618847,338.0,338.0,350000,350000,0,0,350000,Null,Null,52618847,245857,1520
52620058,24.0,24.0,69000,69000,0,0,69000,Null,Null,52620058,111461,1815
52626374,1.0,1.0,315000,289800,25200,8,315000,Null,Null,52626374,111461,23392
52626381,0.0,0.0,423000,423000,0,0,423000,Null,Null,52626381,111461,23392
52626416,4.0,4.0,401000,401000,0,0,401000,Null,Null,52626416,111461,23392
52637902,1363.0,1363.0,320000,210000,110000,34,320000,Null,Null,52637902,568489,1613
52639277,0.0,0.0,0,4350000,0,0,4350000,Null,Null,52639277,148698,0
52644407,4.0,4.0,90571,90571,0,0,90571,Null,Null,52644407,111461,8371
52644706,4.0,4.0,1999000,1999000,0,0,1999000,Null,Null,52644706,111461,8061
52663450,12.0,12.0,200000,200000,0,0,200000,Null,Null,52663450,143353,1815
52674338,792.0,792.0,60000,58800,1200,2,60000,Null,Null,52674338,21653,1815
52695660,1.0,1.0,158000,158000,0,0,158000,Null,Null,52695660,63894,1634
52701239,1.0,1.0,12820000,12820000,0,0,12820000,Null,Null,52701239,471845,2
52701243,0.0,0.0,14111000,14111000,0,0,14111000,Null,Null,52701243,471845,2
52701276,0.0,0.0,54816000,54816000,0,0,54816000,Null,Null,52701276,19032,2
52701289,0.0,0.0,75220000,75220000,0,0,75220000,Null,Null,52701289,19032,2
52709664,40.0,40.0,220000,220000,0,0,220000,Null,Null,52709664,236637,2136
52730951,1587.0,1587.0,135000,126000,9000,7,135000,Null,Null,52730951,21271,1520
52755780,5.0,5.0,699000,699000,0,0,699000,Null,Null,52755780,111461,914
52756206,3278.0,3278.0,34000,34000,0,0,34000,Null,Null,52756206,7304105,23026
52758862,2163.0,2163.0,185000,185000,0,0,185000,Null,Null,52758862,317315,17162
52760599,53.0,53.0,45000,45000,0,0,45000,Null,Null,52760599,111461,23246
52768572,38.0,38.0,59000,59000,0,0,59000,Null,Null,52768572,111461,1815
52779807,398.0,398.0,450000,450000,0,0,450000,Null,Null,52779807,64932,1601
52809028,259.0,259.0,62000,49000,13000,21,62000,Null,Null,52809028,243693,1815
52846433,0.0,0.0,898000,898000,0,0,898000,Null,Null,52846433,111461,1803
52851970,121.0,121.0,210000,210000,0,0,210000,Null,Null,52851970,111461,1883
52861923,332.0,332.0,200000,200000,0,0,200000,Null,Null,52861923,195137,914
52880237,338.0,338.0,594000,594000,0,0,594000,Null,Null,52880237,179125,1520
52880265,98.0,98.0,3900,3900,0,0,3900,Null,Null,52880265,111461,20254
52882482,40.0,40.0,24000,24000,0,0,24000,Null,Null,52882482,111461,8197
52885368,1665.0,1665.0,79900,79900,0,0,79900,Null,Null,52885368,7304105,1883
52889531,0.0,0.0,45000000,45000000,0,0,45000000,Null,Null,52889531,111461,23102
52889826,742.0,742.0,78000,73000,5000,6,78000,Null,Null,52889826,226401,5531
52893094,75.0,75.0,167000,159000,8000,5,167000,Null,Null,52893094,47882,914
52945747,1038.0,1038.0,71099,71099,0,0,71099,Null,Null,52945747,111461,28682
52999852,14.0,14.0,74144,74144,0,0,74144,Null,Null,52999852,111461,1883
53012051,43.0,43.0,99000,99000,0,0,99000,Null,Null,53012051,111461,1815
53030677,588.0,588.0,164000,164000,0,0,164000,Null,Null,53030677,21274,8217
53032011,225.0,225.0,54000,54000,0,0,54000,Null,Null,53032011,48381,1601
53036292,48.0,48.0,473000,473000,0,0,473000,Null,Null,53036292,295203,2136
53038267,39.0,39.0,55000,55000,0,0,55000,Null,Null,53038267,111461,914
53050845,284.0,284.0,279000,279000,0,0,279000,Null,Null,53050845,111461,1815
53061886,19.0,19.0,220000,220000,0,0,220000,Null,Null,53061886,111461,914
53063443,0.0,0.0,54850,54850,0,0,54850,Null,Null,53063443,111461,23346
53092015,0.0,0.0,0,4740000,0,0,4740000,Null,Null,53092015,148698,0
53116344,15.0,15.0,44900,44900,0,0,44900,Null,Null,53116344,111461,23712
53135572,0.0,0.0,8899000,8899000,0,0,8899000,Null,Null,53135572,111461,15250
53143048,2.0,2.0,34800,34800,0,0,34800,Null,Null,53143048,111461,914
53200833,70.0,70.0,340000,327000,13000,4,340000,Null,Null,53200833,111461,1815
53224806,829.0,829.0,44000,44000,0,0,44000,Null,Null,53224806,745589,1520
53235722,13.0,13.0,40000,40000,0,0,40000,Null,Null,53235722,111461,53074
53238570,708.0,708.0,450000,450000,0,0,450000,Null,Null,53238570,252399,23392
53246522,1.0,1.0,94000,69000,25000,27,94000,Null,Null,53246522,111461,914
53251861,129.0,129.0,160000,160000,0,0,160000,Null,Null,53251861,111461,1815
53252576,54.0,54.0,99000,99000,0,0,99000,Null,Null,53252576,111461,914
53257845,1755.0,1755.0,120000,84000,36000,30,120000,Null,Null,53257845,245945,1883
53259569,0.0,0.0,83174400,66539520,16634880,20,83174400,Null,Null,53259569,718983,1883
53267745,10.0,10.0,414000,184000,230000,56,414000,Null,Null,53267745,156141,3422
53290282,90.0,90.0,164000,164000,0,0,164000,Null,Null,53290282,65071,1520
53296092,827.0,827.0,1250000,1187000,63000,5,1250000,Null,Null,53296092,153733,3422
53308802,2083.0,2083.0,215000,179000,36000,17,215000,Null,Null,53308802,238861,1520
53330127,0.0,0.0,2400000,2400000,0,0,2400000,Null,Null,53330127,111461,8061
53380152,0.0,0.0,950000,950000,0,0,950000,Null,Null,53380152,525323,8061
53381306,1526.0,1526.0,669000,669000,0,0,669000,Null,Null,53381306,174389,1520
53387296,1522.0,1522.0,65000,65000,0,0,65000,Null,Null,53387296,111461,1520
53387907,399.0,399.0,419000,319000,100000,24,419000,Null,Null,53387907,430445,3422
53407674,505.0,505.0,480000,480000,0,0,480000,Null,Null,53407674,111461,6305
53410887,73.0,73.0,79200,79200,0,0,79200,Null,Null,53410887,111461,8170
53445636,1511.0,1511.0,299000,299000,0,0,299000,Null,Null,53445636,74831,1520
53482875,0.0,0.0,11347000,11347000,0,0,11347000,Null,Null,53482875,275769,15320
53484997,2.0,2.0,199000,199000,0,0,199000,Null,Null,53484997,238861,1520
53485600,4244.0,4244.0,215000,169000,46000,21,215000,Null,Null,53485600,238861,1520
53486074,0.0,0.0,22576000,22576000,0,0,22576000,Null,Null,53486074,275769,15320
53486970,0.0,0.0,199000,199000,0,0,199000,Null,Null,53486970,238861,1520
53497035,307.0,307.0,41680,41680,0,0,41680,Null,Null,53497035,21437,2153
53497586,12.0,12.0,85000,85000,0,0,85000,Null,Null,53497586,21437,1883
53498427,128.0,128.0,1800000,1669000,131000,7,1800000,Null,Null,53498427,26689,17170
53500228,0.0,0.0,64325000,64325000,0,0,64325000,Null,Null,53500228,275769,15236
53501938,0.0,0.0,10751000,10751000,0,0,10751000,Null,Null,53501938,275769,15236
53501942,0.0,0.0,13500000,13500000,0,0,13500000,Null,Null,53501942,509985,11516
53501978,0.0,0.0,30421000,30421000,0,0,30421000,Null,Null,53501978,275769,15236
53506406,47.0,47.0,398000,371000,27000,7,398000,Null,Null,53506406,167099,23304
53506478,6445.0,6445.0,430000,327000,103000,24,430000,Null,Null,53506478,238861,1520
53507202,10.0,10.0,5100000,5100000,0,0,5100000,Null,Null,53507202,111461,1815
53507455,14888.0,14888.0,430000,309000,121000,28,430000,Null,Null,53507455,238861,1520
53517169,587.0,587.0,635000,441000,194000,31,635000,Null,Null,53517169,238861,1520
53518058,22.0,22.0,3000,1000,2000,67,3000,Null,Null,53518058,111461,1815
53518269,1014.0,1014.0,635000,441000,194000,31,635000,Null,Null,53518269,238861,1520
53518638,306.0,306.0,5999,5999,0,0,5999,Null,Null,53518638,111461,2363
53520638,1696.0,1696.0,725000,465000,260000,36,725000,Null,Null,53520638,238861,1520
53522519,9193.0,9193.0,725000,399000,326000,45,725000,Null,Null,53522519,238861,1520
53529903,225.0,225.0,39000,39000,0,0,39000,Null,Null,53529903,111461,20492
53541374,0.0,0.0,10900000,10900000,0,0,10900000,Null,Null,53541374,111461,914
53545556,102.0,102.0,91992,83000,8992,10,91992,Null,Null,53545556,111461,1634
53546662,1.0,1.0,289000,289000,0,0,289000,Null,Null,53546662,111461,914
53547831,3987.0,3987.0,19000,19000,0,0,19000,Null,Null,53547831,549763,1815
53547999,2557.0,2557.0,12000,12000,0,0,12000,Null,Null,53547999,549763,1815
53559972,216.0,216.0,376000,304000,72000,19,376000,Null,Null,53559972,74674,1520
53581239,26.0,26.0,9000,9000,0,0,9000,Null,Null,53581239,280349,1815
53583472,10485.0,10485.0,1667000,857000,810000,49,1667000,Null,Null,53583472,48077,1883
53583634,70.0,70.0,899000,619000,280000,31,899000,Null,Null,53583634,18776,3428
53596982,41.0,41.0,94000,48410,45590,49,94000,Null,Null,53596982,111461,1883
53599746,203.0,203.0,19799,19799,0,0,19799,Null,Null,53599746,111461,2363
53600393,0.0,0.0,40000000,40000000,0,0,40000000,Null,Null,53600393,462031,53074
53600690,0.0,0.0,70000000,70000000,0,0,70000000,Null,Null,53600690,462031,53074
53626357,1821.0,1821.0,103000,103000,0,0,103000,Null,Null,53626357,4433917,1883
53637871,13.0,13.0,70000,70000,0,0,70000,Null,Null,53637871,111461,914
53639147,39.0,39.0,61800,61800,0,0,61800,Null,Null,53639147,111461,1815
53639950,170.0,170.0,17000,17000,0,0,17000,Null,Null,53639950,111461,1815
53647975,1121.0,1121.0,150000,125000,25000,17,150000,Null,Null,53647975,252399,23362
53653425,616.0,616.0,330000,220000,110000,33,330000,Null,Null,53653425,221187,1520
53654257,0.0,0.0,10000000,6946000,3054000,31,10000000,Null,Null,53654257,18802,1794
53675800,11.0,11.0,125000,125000,0,0,125000,Null,Null,53675800,111461,914
53703801,94.0,94.0,459000,459000,0,0,459000,Null,Null,53703801,111461,4381
53708547,0.0,0.0,105000,105000,0,0,105000,Null,Null,53708547,111461,1883
53731339,162.0,162.0,50000,35000,15000,30,50000,Null,Null,53731339,111461,1815
53734069,747.0,747.0,400000,400000,0,0,400000,Null,Null,53734069,111461,23634
53785527,36.0,36.0,194000,194000,0,0,194000,Null,Null,53785527,111461,1815
53789448,13856.0,13856.0,799000,799000,0,0,799000,Null,Null,53789448,746615,1883
53792129,176.0,176.0,200000,200000,0,0,200000,Null,Null,53792129,111461,1883
53793241,73.0,73.0,99000,99000,0,0,99000,Null,Null,53793241,111461,914
53830678,1745.0,1745.0,65000,65000,0,0,65000,Null,Null,53830678,252399,2
53835896,0.0,0.0,9590000,6850000,2740000,29,9590000,Null,Null,53835896,405211,914
53849729,129.0,129.0,439000,439000,0,0,439000,Null,Null,53849729,161077,1520
53872440,1.0,1.0,890000,450000,440000,49,890000,Null,Null,53872440,4647777,914
53875429,10.0,10.0,8100000,8100000,0,0,8100000,Null,Null,53875429,499169,17170
53877592,0.0,0.0,5000000,5000000,0,0,5000000,Null,Null,53877592,499169,1520
53895512,0.0,0.0,9200000,9200000,0,0,9200000,Null,Null,53895512,499169,53350
53896361,1.0,1.0,9000000,9000000,0,0,9000000,Null,Null,53896361,463255,53350
53896464,2.0,2.0,8900000,8900000,0,0,8900000,Null,Null,53896464,499169,8227
53896544,0.0,0.0,5500000,5500000,0,0,5500000,Null,Null,53896544,463255,1583
53897221,1.0,1.0,3600000,3600000,0,0,3600000,Null,Null,53897221,463255,1520
53897644,0.0,0.0,9000000,9000000,0,0,9000000,Null,Null,53897644,463255,17170
53897740,0.0,0.0,13000000,13000000,0,0,13000000,Null,Null,53897740,463255,8227
53898615,0.0,0.0,7500000,7500000,0,0,7500000,Null,Null,53898615,506629,8227
53923837,1366.0,1366.0,285000,234000,51000,18,285000,Null,Null,53923837,469887,1520
53926277,12.0,12.0,59000,59000,0,0,59000,Null,Null,53926277,7304105,23026
53926794,3.0,3.0,59000,59000,0,0,59000,Null,Null,53926794,7304105,23026
53954435,855.0,855.0,6490,6490,0,0,6490,Null,Null,53954435,111461,1883
53961165,0.0,0.0,6550000,6550000,0,0,6550000,Null,Null,53961165,405211,914
53973310,3.0,3.0,6071429,6071429,0,0,6071429,Null,Null,53973310,405211,914
53974059,1.0,1.0,6357143,6357143,0,0,6357143,Null,Null,53974059,405211,914
53977465,0.0,0.0,10214286,7150000,3064286,30,10214286,Null,Null,53977465,405211,914
53977671,1.0,1.0,13071429,9150000,3921429,30,13071429,Null,Null,53977671,405211,914
53977721,81.0,81.0,95000,95000,0,0,95000,Null,Null,53977721,111461,1815
53977774,4504.0,4504.0,69000,35000,34000,49,69000,Null,Null,53977774,500047,1815
53978642,0.0,0.0,12214286,8550000,3664286,30,12214286,Null,Null,53978642,405211,914
53978880,0.0,0.0,6228571,6228571,0,0,6228571,Null,Null,53978880,405211,914
53988748,0.0,0.0,9285714,6500000,2785714,30,9285714,Null,Null,53988748,405211,914
53989691,0.0,0.0,8500000,5950000,2550000,30,8500000,Null,Null,53989691,405211,914
53989761,0.0,0.0,6228571,6228571,0,0,6228571,Null,Null,53989761,405211,914
53990634,2.0,2.0,3828571,2680000,1148571,30,3828571,Null,Null,53990634,405211,914
53993627,5.0,5.0,105000,105000,0,0,105000,Null,Null,53993627,111461,914
53999206,157.0,157.0,199000,199000,0,0,199000,Null,Null,53999206,212267,1815
54002659,6.0,6.0,169000,144000,25000,15,169000,Null,Null,54002659,111461,2266
54002739,1693.0,1693.0,599000,489000,110000,18,599000,Null,Null,54002739,19246,1815
54005692,0.0,0.0,5400000,5400000,0,0,5400000,Null,Null,54005692,354721,3424
54014791,0.0,0.0,249999000,149999999,99999001,40,249999000,Null,Null,54014791,542569,1520
54017345,972.0,972.0,370000,285000,85000,23,370000,Null,Null,54017345,50629,2
54017350,12266.0,12266.0,400000,289000,111000,28,400000,Null,Null,54017350,50629,2
54018473,0.0,0.0,9400000,9400000,0,0,9400000,Null,Null,54018473,354721,1601
54019672,0.0,0.0,5200000,5200000,0,0,5200000,Null,Null,54019672,354721,3426
54021862,240.0,240.0,178900,178900,0,0,178900,Null,Null,54021862,410625,1815
54022832,696.0,696.0,1900000,1390000,510000,27,1900000,Null,Null,54022832,51302,1883
54025709,60.0,60.0,10000,7851,2149,21,10000,Null,Null,54025709,111461,1815
54029566,23.0,23.0,169000,126000,43000,25,169000,Null,Null,54029566,111461,2266
54029628,31.0,31.0,105000,105000,0,0,105000,Null,Null,54029628,111461,914
54032161,240.0,240.0,125000,106250,18750,15,125000,Null,Null,54032161,542605,3426
54051521,499.0,499.0,205000,170000,35000,17,205000,Null,Null,54051521,238861,1520
54051681,31.0,31.0,1229000,989000,240000,20,1229000,Null,Null,54051681,46363,914
54051902,0.0,0.0,38500000,38500000,0,0,38500000,Null,Null,54051902,736739,11856
54056083,93.0,93.0,190000,135000,55000,29,190000,Null,Null,54056083,111461,1520
54056610,521.0,521.0,4800,4800,0,0,4800,Null,Null,54056610,171499,1815
54058497,820.0,820.0,245000,198000,47000,19,245000,Null,Null,54058497,22013,1520
54058499,798.0,798.0,199000,161000,38000,19,199000,Null,Null,54058499,22013,1520
54058503,14313.0,14313.0,93000,80000,13000,14,93000,Null,Null,54058503,22013,1520
54071386,779.0,779.0,199000,99500,99500,50,199000,Null,Null,54071386,197767,6305
54075243,196.0,196.0,70000,70000,0,0,70000,Null,Null,54075243,111461,1883
54091925,130.0,130.0,179000,179000,0,0,179000,Null,Null,54091925,197655,1815
54094782,0.0,0.0,0,168000,0,0,168000,Null,Null,54094782,111461,0
54097692,754.0,754.0,32500,31000,1500,5,32500,Null,Null,54097692,19312,2153
54122078,893.0,893.0,59000,57000,2000,3,59000,Null,Null,54122078,19312,1883
54130086,2307.0,2307.0,349000,349000,0,0,349000,Null,Null,54130086,746615,1883
54132706,191.0,191.0,429000,416000,13000,3,429000,Null,Null,54132706,19312,23016
54133085,103.0,103.0,205000,205000,0,0,205000,Null,Null,54133085,19312,1883
54133235,203.0,203.0,154000,154000,0,0,154000,Null,Null,54133235,19312,2153
54138749,546.0,546.0,59000,29500,29500,50,59000,Null,Null,54138749,111461,1520
54145105,6492.0,6492.0,190000,190000,0,0,190000,Null,Null,54145105,746615,1883
54145223,502.0,502.0,350000,350000,0,0,350000,Null,Null,54145223,718093,18876
54145943,0.0,0.0,94000,94000,0,0,94000,Null,Null,54145943,111461,1634
54146896,130.0,130.0,499000,357000,142000,28,499000,Null,Null,54146896,180761,1815
54156958,445.0,445.0,149000,146000,3000,2,149000,Null,Null,54156958,19312,1883
54158035,461.0,461.0,439000,229000,210000,48,439000,Null,Null,54158035,180761,1815
54346374,0.0,0.0,30650000,30650000,0,0,30650000,Null,Null,54346374,691055,2
54346384,0.0,0.0,5950000,5950000,0,0,5950000,Null,Null,54346384,691055,2
54346388,0.0,0.0,6350000,6350000,0,0,6350000,Null,Null,54346388,691055,914
54346413,0.0,0.0,7750000,7750000,0,0,7750000,Null,Null,54346413,691055,914
54346415,0.0,0.0,8950000,8950000,0,0,8950000,Null,Null,54346415,691055,2
54346419,0.0,0.0,5850000,5850000,0,0,5850000,Null,Null,54346419,691055,914
54346427,0.0,0.0,6950000,6950000,0,0,6950000,Null,Null,54346427,691055,914
54346429,0.0,0.0,7250000,7250000,0,0,7250000,Null,Null,54346429,691055,914
54346434,1.0,1.0,6950000,6950000,0,0,6950000,Null,Null,54346434,691055,914
54346436,0.0,0.0,5850000,5850000,0,0,5850000,Null,Null,54346436,691055,914
54346438,0.0,0.0,7350000,7350000,0,0,7350000,Null,Null,54346438,691055,914
54346442,0.0,0.0,5850000,5850000,0,0,5850000,Null,Null,54346442,691055,914
54346444,0.0,0.0,8500000,8500000,0,0,8500000,Null,Null,54346444,691055,914
54346446,0.0,0.0,6750000,6750000,0,0,6750000,Null,Null,54346446,691055,914
54346462,0.0,0.0,8900000,8900000,0,0,8900000,Null,Null,54346462,691055,914
54346464,0.0,0.0,6750000,6750000,0,0,6750000,Null,Null,54346464,691055,914
54346468,0.0,0.0,5950000,5950000,0,0,5950000,Null,Null,54346468,691055,914
54346492,0.0,0.0,5950000,5950000,0,0,5950000,Null,Null,54346492,691055,914
54346494,0.0,0.0,30650000,30650000,0,0,30650000,Null,Null,54346494,691055,2
54346498,0.0,0.0,5850000,5850000,0,0,5850000,Null,Null,54346498,691055,914
54346506,0.0,0.0,6350000,6350000,0,0,6350000,Null,Null,54346506,691055,914
54346510,0.0,0.0,5950000,5950000,0,0,5950000,Null,Null,54346510,691055,914
54346512,0.0,0.0,7750000,7750000,0,0,7750000,Null,Null,54346512,691055,914
54346516,0.0,0.0,8500000,8500000,0,0,8500000,Null,Null,54346516,691055,914
54346525,0.0,0.0,6950000,6950000,0,0,6950000,Null,Null,54346525,691055,914
54346543,0.0,0.0,8950000,8950000,0,0,8950000,Null,Null,54346543,691055,2
54346607,0.0,0.0,7350000,7350000,0,0,7350000,Null,Null,54346607,691055,914
54348370,404.0,404.0,375000,187500,187500,50,375000,Null,Null,54348370,197767,6305
54350196,0.0,0.0,7750000,7750000,0,0,7750000,Null,Null,54350196,691055,914
54350617,656.0,656.0,289000,289000,0,0,289000,Null,Null,54350617,171991,1805
54362918,267.0,267.0,112000,69000,43000,38,112000,Null,Null,54362918,202071,1520
54365685,94.0,94.0,286000,210000,76000,27,286000,Null,Null,54365685,173547,914
54371569,176.0,176.0,898000,689000,209000,23,898000,Null,Null,54371569,46363,914
54378117,85.0,85.0,180000,145000,35000,19,180000,Null,Null,54378117,560853,3422
54385590,2276.0,2276.0,299000,176000,123000,41,299000,Null,Null,54385590,625853,1805
54388985,0.0,0.0,11500000,11500000,0,0,11500000,Null,Null,54388985,691055,5385
54389000,1.0,1.0,5950000,5950000,0,0,5950000,Null,Null,54389000,691055,5385
54389048,0.0,0.0,3250000,3250000,0,0,3250000,Null,Null,54389048,691055,2
54389070,0.0,0.0,11500000,11500000,0,0,11500000,Null,Null,54389070,691055,2
54389091,0.0,0.0,7650000,7650000,0,0,7650000,Null,Null,54389091,691055,2
54389110,0.0,0.0,7650000,7650000,0,0,7650000,Null,Null,54389110,691055,2
54389456,0.0,0.0,11500000,11500000,0,0,11500000,Null,Null,54389456,691055,2
54389470,0.0,0.0,7650000,7650000,0,0,7650000,Null,Null,54389470,691055,5384
54389477,0.0,0.0,7750000,7750000,0,0,7750000,Null,Null,54389477,691055,2
54389479,0.0,0.0,11500000,11500000,0,0,11500000,Null,Null,54389479,691055,2
54389505,0.0,0.0,11500000,11500000,0,0,11500000,Null,Null,54389505,691055,5385
54389519,0.0,0.0,7950000,7950000,0,0,7950000,Null,Null,54389519,691055,5384
54389528,0.0,0.0,12850000,12850000,0,0,12850000,Null,Null,54389528,691055,2
54404644,0.0,0.0,9250000,9250000,0,0,9250000,Null,Null,54404644,691055,914
54404697,0.0,0.0,10150000,10150000,0,0,10150000,Null,Null,54404697,691055,914
54404743,0.0,0.0,8950000,8950000,0,0,8950000,Null,Null,54404743,691055,914
54404750,0.0,0.0,8950000,8950000,0,0,8950000,Null,Null,54404750,691055,914
54406018,7.0,7.0,35000,35000,0,0,35000,Null,Null,54406018,111461,2363
54407711,8.0,8.0,55000,38500,16500,30,55000,Null,Null,54407711,111461,1815
54411570,0.0,0.0,6750000,6750000,0,0,6750000,Null,Null,54411570,691055,2
54411577,0.0,0.0,8950000,8950000,0,0,8950000,Null,Null,54411577,691055,2
54411579,0.0,0.0,6950000,6950000,0,0,6950000,Null,Null,54411579,691055,2
54412879,704.0,704.0,150000,73000,77000,51,150000,Null,Null,54412879,197767,23026
54414221,1319.0,1319.0,99000,89000,10000,10,99000,Null,Null,54414221,548147,1583
54414231,420.0,420.0,125000,112000,13000,10,125000,Null,Null,54414231,548147,1520
54418197,1149.0,1149.0,150000,96000,54000,36,150000,Null,Null,54418197,148844,1520
54440898,2442.0,2442.0,209000,160000,49000,23,209000,Null,Null,54440898,86206,17170
54440972,691.0,691.0,195000,175000,20000,10,195000,Null,Null,54440972,86206,1520
54441169,1674.0,1674.0,498000,348000,150000,30,498000,Null,Null,54441169,86206,1520
54449670,1.0,1.0,18000000,13500000,4500000,25,18000000,Null,Null,54449670,111461,1805
54455240,0.0,0.0,42700000,42700000,0,0,42700000,Null,Null,54455240,736739,1979
54458819,14.0,14.0,78000,78000,0,0,78000,Null,Null,54458819,111461,1520
54461802,1082.0,1082.0,99000,89000,10000,10,99000,Null,Null,54461802,22653,1520
54476660,1480.0,1480.0,220000,182000,38000,17,220000,Null,Null,54476660,835483,1883
54477965,18.0,18.0,239000,239000,0,0,239000,Null,Null,54477965,111461,914
54478757,1918.0,1918.0,300000,222000,78000,26,300000,Null,Null,54478757,835483,1883
54484578,6707.0,6707.0,240000,209000,31000,13,240000,Null,Null,54484578,835483,1883
54485065,152.0,152.0,164000,147000,17000,10,164000,Null,Null,54485065,22653,1520
54485907,1350.0,1350.0,150000,76000,74000,49,150000,Null,Null,54485907,205535,1815
54487123,1129.0,1129.0,159000,118000,41000,26,159000,Null,Null,54487123,205535,1815
54509833,20.0,20.0,518000,259000,259000,50,518000,Null,Null,54509833,111461,3877
54563341,0.0,0.0,8000,8000,0,0,8000,Null,Null,54563341,111461,1815
54568580,217.0,217.0,129000,119000,10000,8,129000,Null,Null,54568580,243693,1815
54581940,3011.0,3011.0,100000,89000,11000,11,100000,Null,Null,54581940,21265,1520
54582729,254.0,254.0,200000,110000,90000,45,200000,Null,Null,54582729,111461,23622
54585744,119.0,119.0,350000,235000,115000,33,350000,Null,Null,54585744,111461,6305
54609191,304.0,304.0,150000,150000,0,0,150000,Null,Null,54609191,205535,1815
54615899,1370.0,1370.0,234000,191000,43000,18,234000,Null,Null,54615899,86206,1520
54616399,233.0,233.0,13900,13900,0,0,13900,Null,Null,54616399,111461,28480
54616409,43.0,43.0,418800,349000,69800,17,418800,Null,Null,54616409,19813,1883
54622263,1402.0,1402.0,449000,291000,158000,35,449000,Null,Null,54622263,19813,1984
54623165,10.0,10.0,12000,8900,3100,26,12000,Null,Null,54623165,567189,1601
54623402,34.0,34.0,150000,150000,0,0,150000,Null,Null,54623402,142542,2
54624288,436.0,436.0,589000,589000,0,0,589000,Null,Null,54624288,19813,1984
54624824,895.0,895.0,100000,57000,43000,43,100000,Null,Null,54624824,205535,1815
54626520,34.0,34.0,200000,200000,0,0,200000,Null,Null,54626520,205535,1815
54630782,17.0,17.0,33000,33000,0,0,33000,Null,Null,54630782,111461,914
54639263,538.0,538.0,50000,48000,2000,4,50000,Null,Null,54639263,205535,1815
54640942,25386.0,25386.0,48000,36000,12000,25,48000,Null,Null,54640942,192731,1520
54643914,12022.0,12022.0,130000,88000,42000,32,130000,Null,Null,54643914,47663,1520
54644755,887.0,887.0,59000,57000,2000,3,59000,Null,Null,54644755,7798357,23042
54647897,2.0,2.0,770000,539000,231000,30,770000,Null,Null,54647897,4647777,914
54650565,1.0,1.0,38000000,32300000,5700000,15,38000000,Null,Null,54650565,111461,1805
54664144,3.0,3.0,3999000,3999000,0,0,3999000,Null,Null,54664144,111461,8061
54682452,659.0,659.0,57000,57000,0,0,57000,Null,Null,54682452,19312,2153
54682532,84.0,84.0,357000,330000,27000,8,357000,Null,Null,54682532,173547,914
54682884,867.0,867.0,375000,375000,0,0,375000,Null,Null,54682884,21278,1520
54683561,9.0,9.0,4400000,3740000,660000,15,4400000,Null,Null,54683561,111461,8061
54685585,37.0,37.0,429000,350000,79000,18,429000,Null,Null,54685585,173547,914
54686184,1976.0,1976.0,114000,114000,0,0,114000,Null,Null,54686184,837855,23042
54687717,405.0,405.0,120000,120000,0,0,120000,Null,Null,54687717,111461,914
54715507,133.0,133.0,230000,230000,0,0,230000,Null,Null,54715507,250531,1520
54717885,137.0,137.0,60000,60000,0,0,60000,Null,Null,54717885,21437,914
54737617,0.0,0.0,3500000,3500000,0,0,3500000,Null,Null,54737617,27449,1520
54746920,327.0,327.0,199000,194000,5000,3,199000,Null,Null,54746920,111461,1815
54748259,61.0,61.0,255000,238000,17000,7,255000,Null,Null,54748259,111461,1815
54749502,92.0,92.0,139000,133000,6000,4,139000,Null,Null,54749502,111461,1815
54757991,0.0,0.0,89222549,71378039,17844510,20,89222549,Null,Null,54757991,718983,1883
54758744,1575.0,1575.0,43080,27000,16080,37,43080,Null,Null,54758744,111461,23010
54763589,84.0,84.0,142000,130000,12000,8,142000,Null,Null,54763589,21274,1520
54789405,278.0,278.0,35000,35000,0,0,35000,Null,Null,54789405,111461,1883
54803298,0.0,0.0,44560000,44560000,0,0,44560000,Null,Null,54803298,111461,23104
54806692,59.0,59.0,170000,170000,0,0,170000,Null,Null,54806692,111461,1815
54850500,1.0,1.0,550000,550000,0,0,550000,Null,Null,54850500,111461,2
54856711,67.0,67.0,13000,13000,0,0,13000,Null,Null,54856711,111461,914
54858064,0.0,0.0,69000,66000,3000,4,69000,Null,Null,54858064,111461,23834
54859640,0.0,0.0,239000,239000,0,0,239000,Null,Null,54859640,111461,914
54864521,13886.0,13886.0,48000,36000,12000,25,48000,Null,Null,54864521,192731,1520
54865932,12075.0,12075.0,48000,36000,12000,25,48000,Null,Null,54865932,192731,8305
54875389,0.0,0.0,215800,215800,0,0,215800,Null,Null,54875389,111461,23362
54882670,7.0,7.0,2900000,2320000,580000,20,2900000,Null,Null,54882670,111461,8061
54887106,64.0,64.0,6900,6210,690,10,6900,Null,Null,54887106,241479,1601
54889765,67.0,67.0,81499,81499,0,0,81499,Null,Null,54889765,21651,1815
54894940,182.0,182.0,89000,89000,0,0,89000,Null,Null,54894940,21651,1815
54896150,0.0,0.0,70000000,70000000,0,0,70000000,Null,Null,54896150,146400,1883
54901410,2.0,2.0,930000,781200,148800,16,930000,Null,Null,54901410,182293,3422
54901875,128.0,128.0,94000,84000,10000,11,94000,Null,Null,54901875,111461,914
54902498,2.0,2.0,39000,39000,0,0,39000,Null,Null,54902498,111461,914
54919818,0.0,0.0,8000000,8000000,0,0,8000000,Null,Null,54919818,111461,15318
54930093,5.0,5.0,7100000,7100000,0,0,7100000,Null,Null,54930093,260977,1520
54972170,55.0,55.0,70000,70000,0,0,70000,Null,Null,54972170,111461,1815
54977688,311.0,311.0,25000,25000,0,0,25000,Null,Null,54977688,111461,1815
54989813,5.0,5.0,2900000,2030000,870000,30,2900000,Null,Null,54989813,111461,8061
55021410,84.0,84.0,189000,189000,0,0,189000,Null,Null,55021410,45589,17170
55023283,106.0,106.0,10500,6900,3600,34,10500,Null,Null,55023283,241479,1601
55045986,268.0,268.0,60000,60000,0,0,60000,Null,Null,55045986,111461,1815
55046412,54.0,54.0,60000,60000,0,0,60000,Null,Null,55046412,111461,1815
55097417,13.0,13.0,149000,149000,0,0,149000,Null,Null,55097417,111461,914
55124901,119.0,119.0,99000,99000,0,0,99000,Null,Null,55124901,111461,23030
55128592,25.0,25.0,272000,240000,32000,12,272000,Null,Null,55128592,173547,914
55135427,0.0,0.0,6500000,6500000,0,0,6500000,Null,Null,55135427,842175,8170
55136506,42.0,42.0,50000,50000,0,0,50000,Null,Null,55136506,407561,914
55139324,174.0,174.0,200000,200000,0,0,200000,Null,Null,55139324,173547,914
55139723,2.0,2.0,257000,187000,70000,27,257000,Null,Null,55139723,173547,914
55157587,0.0,0.0,10627000,10627000,0,0,10627000,Null,Null,55157587,275769,2
55197731,49.0,49.0,190000,190000,0,0,190000,Null,Null,55197731,111461,8061
55202824,20.0,20.0,75000,75000,0,0,75000,Null,Null,55202824,111461,23282
55210024,2477.0,2477.0,400000,198000,202000,51,400000,Null,Null,55210024,205535,1815
55214722,236.0,236.0,95000,95000,0,0,95000,Null,Null,55214722,111461,7064
55267101,320.0,320.0,100000,95000,5000,5,100000,Null,Null,55267101,273281,1520
55289715,1.0,1.0,255000,255000,0,0,255000,Null,Null,55289715,111461,15318
55330326,0.0,0.0,7165000,7165000,0,0,7165000,Null,Null,55330326,842175,8170
55330560,0.0,0.0,30870000,30870000,0,0,30870000,Null,Null,55330560,842175,8170
55331499,0.0,0.0,32385000,32385000,0,0,32385000,Null,Null,55331499,842175,8170
55332117,0.0,0.0,20400000,20400000,0,0,20400000,Null,Null,55332117,842175,8170
55332446,0.0,0.0,7790000,7790000,0,0,7790000,Null,Null,55332446,842175,8170
55334342,0.0,0.0,7090000,7090000,0,0,7090000,Null,Null,55334342,842175,8170
55335584,14.0,14.0,85000,72250,12750,15,85000,Null,Null,55335584,22653,17162
55337871,0.0,0.0,7165000,7165000,0,0,7165000,Null,Null,55337871,842175,8170
55339097,1191.0,1191.0,740000,499000,241000,33,740000,Null,Null,55339097,160211,3422
55351451,13.0,13.0,3500000,3500000,0,0,3500000,Null,Null,55351451,283219,1520
55360828,1.0,1.0,179378,89689,89689,50,179378,Null,Null,55360828,111461,8170
55361011,842.0,842.0,145000,69000,76000,52,145000,Null,Null,55361011,111461,1520
55361571,11.0,11.0,92000,92000,0,0,92000,Null,Null,55361571,407561,914
55365176,1500.0,1500.0,39000,39000,0,0,39000,Null,Null,55365176,7304105,1883
55365677,37.0,37.0,235040,228000,7040,3,235040,Null,Null,55365677,230983,2154
55366213,0.0,0.0,18000,18000,0,0,18000,Null,Null,55366213,111461,914
55370928,1.0,1.0,16500,16500,0,0,16500,Null,Null,55370928,111461,914
55385200,2.0,2.0,16500,16500,0,0,16500,Null,Null,55385200,111461,914
55387151,8.0,8.0,16500,16500,0,0,16500,Null,Null,55387151,111461,914
55387591,0.0,0.0,15000,15000,0,0,15000,Null,Null,55387591,111461,914
55387664,4.0,4.0,15000,15000,0,0,15000,Null,Null,55387664,111461,914
55387801,3.0,3.0,18000,18000,0,0,18000,Null,Null,55387801,111461,914
55387962,0.0,0.0,15000,15000,0,0,15000,Null,Null,55387962,111461,914
55393500,2225.0,2225.0,179000,161000,18000,10,179000,Null,Null,55393500,238861,1520
55427978,37.0,37.0,15789,15789,0,0,15789,Null,Null,55427978,111461,1883
55458692,0.0,0.0,109000,109000,0,0,109000,Null,Null,55458692,111461,914
55461237,3.0,3.0,38999,38999,0,0,38999,Null,Null,55461237,111461,1815
55461727,650.0,650.0,1200000,1080000,120000,10,1200000,Null,Null,55461727,64932,17170
55481938,0.0,0.0,215000,215000,0,0,215000,Null,Null,55481938,111461,2140
55506863,7581.0,7581.0,25000,25000,0,0,25000,Null,Null,55506863,847543,8305
55513444,3.0,3.0,560000,560000,0,0,560000,Null,Null,55513444,111461,15936
55518608,138.0,138.0,590000,584000,6000,1,590000,Null,Null,55518608,725567,1795
55520583,465.0,465.0,45000,44000,1000,2,45000,Null,Null,55520583,111461,1883
55523366,153.0,153.0,139900,139900,0,0,139900,Null,Null,55523366,549763,1815
55550696,5.0,5.0,2000,2000,0,0,2000,Null,Null,55550696,111461,53074
55580718,4.0,4.0,1190000,1190000,0,0,1190000,Null,Null,55580718,110935,1883
55585443,18.0,18.0,50000,50000,0,0,50000,Null,Null,55585443,111461,23622
55598327,219.0,219.0,179000,149001,29999,17,179000,Null,Null,55598327,848485,1815
55598652,687.0,687.0,139000,108000,31000,22,139000,Null,Null,55598652,63747,53074
55600000,82.0,82.0,175000,175000,0,0,175000,Null,Null,55600000,21651,1815
55607299,68.0,68.0,129000,129000,0,0,129000,Null,Null,55607299,111461,914
55611004,65.0,65.0,56000,56000,0,0,56000,Null,Null,55611004,407561,914
55615437,1454.0,1454.0,350000,295000,55000,16,350000,Null,Null,55615437,4238147,8206
55630076,0.0,0.0,55000,55000,0,0,55000,Null,Null,55630076,111461,3177
55642708,189.0,189.0,1650000,1395000,255000,15,1650000,Null,Null,55642708,33203,1520
55664768,173.0,173.0,150000,150000,0,0,150000,Null,Null,55664768,171149,1815
55669191,4976.0,4976.0,260000,167000,93000,36,260000,Null,Null,55669191,245945,1883
55696082,74.0,74.0,59000,59000,0,0,59000,Null,Null,55696082,111461,1815
55725530,55.0,55.0,87000,87000,0,0,87000,Null,Null,55725530,111461,914
55745054,9.0,9.0,119000,119000,0,0,119000,Null,Null,55745054,111461,1883
55768758,966.0,966.0,339000,339000,0,0,339000,Null,Null,55768758,469887,53350
55784191,196.0,196.0,95000,95000,0,0,95000,Null,Null,55784191,850365,1520
55844296,0.0,0.0,9357143,6550000,2807143,30,9357143,Null,Null,55844296,405211,914
55850146,174.0,174.0,349000,340000,9000,3,349000,Null,Null,55850146,111461,1815
55850715,148.0,148.0,374900,342000,32900,9,374900,Null,Null,55850715,111461,1815
55852830,1.0,1.0,8500000,5950000,2550000,30,8500000,Null,Null,55852830,405211,914
55875210,4245.0,4245.0,130000,82000,48000,37,130000,Null,Null,55875210,245945,1883
55890380,680.0,680.0,104000,104000,0,0,104000,Null,Null,55890380,79682,1520
55895699,1906.0,1906.0,280000,280000,0,0,280000,Null,Null,55895699,562001,1520
55900887,3488.0,3488.0,499000,499000,0,0,499000,Null,Null,55900887,835483,1883
55915384,2545.0,2545.0,135000,133000,2000,1,135000,Null,Null,55915384,307609,1520
55936985,0.0,0.0,54585000,54585000,0,0,54585000,Null,Null,55936985,111461,23104
55940335,0.0,0.0,91525000,91525000,0,0,91525000,Null,Null,55940335,111461,23104
55956438,2031.0,2031.0,76000,62000,14000,18,76000,Null,Null,55956438,851519,1883
55963150,177.0,177.0,336900,336900,0,0,336900,Null,Null,55963150,172059,1815
55965969,0.0,0.0,74970000,74970000,0,0,74970000,Null,Null,55965969,111461,23104
56004986,296.0,296.0,69000,69000,0,0,69000,Null,Null,56004986,111461,1804
56014514,6.0,6.0,45000,45000,0,0,45000,Null,Null,56014514,407561,914
56018126,4701.0,4701.0,396000,286000,110000,28,396000,Null,Null,56018126,27918,1520
56029744,33.0,33.0,80000,80000,0,0,80000,Null,Null,56029744,710419,1815
56047447,0.0,0.0,52000000,52000000,0,0,52000000,Null,Null,56047447,720689,1883
56049649,80.0,80.0,69000,63000,6000,9,69000,Null,Null,56049649,21653,12908
56049867,0.0,0.0,20850000,20850000,0,0,20850000,Null,Null,56049867,52315,1805
56070372,6.0,6.0,48000,48000,0,0,48000,Null,Null,56070372,407561,2
56074898,137.0,137.0,85000,85000,0,0,85000,Null,Null,56074898,111461,8371
56077593,3.0,3.0,55000,45000,10000,18,55000,Null,Null,56077593,111461,2
56092343,178.0,178.0,566900,550000,16900,3,566900,Null,Null,56092343,172059,28628
56095909,0.0,0.0,500000,500000,0,0,500000,Null,Null,56095909,111461,15250
56098120,810.0,810.0,300000,249000,51000,17,300000,Null,Null,56098120,79682,1520
56104958,1.0,1.0,340000,206000,134000,39,340000,Null,Null,56104958,4647777,15318
56106376,0.0,0.0,25800000,25800000,0,0,25800000,Null,Null,56106376,746283,1520
56196502,4422.0,4422.0,471900,396000,75900,16,471900,Null,Null,56196502,18984,1815
56209558,87.0,87.0,645000,576000,69000,11,645000,Null,Null,56209558,111457,1803
56227286,8.0,8.0,300000,300000,0,0,300000,Null,Null,56227286,111461,914
56228508,920.0,920.0,119000,119000,0,0,119000,Null,Null,56228508,454787,1883
56234626,30.0,30.0,43000,43000,0,0,43000,Null,Null,56234626,407561,2
56236546,7.0,7.0,44000,44000,0,0,44000,Null,Null,56236546,407561,2
56247996,4.0,4.0,54900,54900,0,0,54900,Null,Null,56247996,111461,1883
56248615,748.0,748.0,90000,45000,45000,50,90000,Null,Null,56248615,500047,1815
56250829,7.0,7.0,490000,490000,0,0,490000,Null,Null,56250829,111461,914
56251133,2.0,2.0,430000,430000,0,0,430000,Null,Null,56251133,111461,914
56251493,0.0,0.0,9642857,9642857,0,0,9642857,Null,Null,56251493,405211,914
56251669,0.0,0.0,9642857,6750000,2892857,30,9642857,Null,Null,56251669,405211,5384
56260034,119.0,119.0,229000,229000,0,0,229000,Null,Null,56260034,19312,1815
56262647,18.0,18.0,29000,29000,0,0,29000,Null,Null,56262647,111461,1815
56273245,0.0,0.0,10214286,7150000,3064286,30,10214286,Null,Null,56273245,405211,914
56274070,0.0,0.0,10214286,7150000,3064286,30,10214286,Null,Null,56274070,405211,914
56303654,0.0,0.0,11760000,11760000,0,0,11760000,Null,Null,56303654,111461,15318
56305444,1399.0,1399.0,178900,178900,0,0,178900,Null,Null,56305444,449693,1520
56308226,3.0,3.0,87000,87000,0,0,87000,Null,Null,56308226,142956,23246
56313543,1478.0,1478.0,20990,20990,0,0,20990,Null,Null,56313543,111461,1815
56317280,1034.0,1034.0,299000,249000,50000,17,299000,Null,Null,56317280,27918,1520
56322894,32.0,32.0,170000,170000,0,0,170000,Null,Null,56322894,111461,914
56336206,1336.0,1336.0,180000,165000,15000,8,180000,Null,Null,56336206,252399,23352
56366313,556.0,556.0,188000,128000,60000,32,188000,Null,Null,56366313,79682,1520
56371532,1142.0,1142.0,400000,282000,118000,30,400000,Null,Null,56371532,307609,1520
56372299,558.0,558.0,250000,149000,101000,40,250000,Null,Null,56372299,856589,50476
56372720,6.0,6.0,37900,37900,0,0,37900,Null,Null,56372720,111461,1634
56377103,796.0,796.0,185000,159000,26000,14,185000,Null,Null,56377103,79688,1520
56381615,964.0,964.0,220000,168000,52000,24,220000,Null,Null,56381615,307609,1520
56383693,743.0,743.0,59000,59000,0,0,59000,Null,Null,56383693,111461,1883
56388178,1137.0,1137.0,263000,219000,44000,17,263000,Null,Null,56388178,79682,1520
56389444,1429.0,1429.0,208000,208000,0,0,208000,Null,Null,56389444,79682,1520
56400156,3.0,3.0,32899,32899,0,0,32899,Null,Null,56400156,111461,23246
56404021,354.0,354.0,135000,112000,23000,17,135000,Null,Null,56404021,269907,1520
56404401,0.0,0.0,70840000,70840000,0,0,70840000,Null,Null,56404401,856973,1883
56404818,0.0,0.0,61340000,61340000,0,0,61340000,Null,Null,56404818,856973,1883
56404821,157.0,157.0,98000,98000,0,0,98000,Null,Null,56404821,111461,1520
56408027,0.0,0.0,59790000,59790000,0,0,59790000,Null,Null,56408027,856973,1883
56415001,0.0,0.0,79717944,63774355,15943589,20,79717944,Null,Null,56415001,718983,1883
56415588,0.0,0.0,73490820,58792656,14698164,20,73490820,Null,Null,56415588,718983,1883
56416127,0.0,0.0,152000000,152000000,0,0,152000000,Null,Null,56416127,856973,1883
56416306,0.0,0.0,60367680,48294144,12073536,20,60367680,Null,Null,56416306,718983,1883
56416568,18.0,18.0,180000,180000,0,0,180000,Null,Null,56416568,111461,914
56417066,0.0,0.0,102743147,82194518,20548629,20,102743147,Null,Null,56417066,718983,1883
56444966,17.0,17.0,209000,209000,0,0,209000,Null,Null,56444966,111461,2
56445715,379.0,379.0,399000,230000,169000,42,399000,Null,Null,56445715,302375,1815
56484177,182.0,182.0,120000,120000,0,0,120000,Null,Null,56484177,857657,1520
56531199,1.0,1.0,14071429,9850000,4221429,30,14071429,Null,Null,56531199,732431,914
56531692,749.0,749.0,298000,298000,0,0,298000,Null,Null,56531692,149699,1520
56532361,0.0,0.0,14071429,9850000,4221429,30,14071429,Null,Null,56532361,732431,914
56532931,81.0,81.0,98000,98000,0,0,98000,Null,Null,56532931,407561,914
56533204,0.0,0.0,11928571,8350000,3578571,30,11928571,Null,Null,56533204,732431,914
56536537,0.0,0.0,9071429,9071429,0,0,9071429,Null,Null,56536537,405211,914
56538424,51.0,51.0,680000,680000,0,0,680000,Null,Null,56538424,527193,1883
56538874,23.0,23.0,32899,32899,0,0,32899,Null,Null,56538874,111461,914
56555197,14.0,14.0,459000,418000,41000,9,459000,Null,Null,56555197,111461,23346
56558512,120.0,120.0,9501,9501,0,0,9501,Null,Null,56558512,111461,1815
56589160,208.0,208.0,649000,633000,16000,2,649000,Null,Null,56589160,150002,1815
56591468,33.0,33.0,402600,322000,80600,20,402600,Null,Null,56591468,25422,1815
56596052,578.0,578.0,144800,144800,0,0,144800,Null,Null,56596052,111461,23258
56606433,515.0,515.0,129000,86000,43000,33,129000,Null,Null,56606433,302375,1815
56608719,1354.0,1354.0,185000,147000,38000,21,185000,Null,Null,56608719,302375,1815
56612464,18.0,18.0,191000,171900,19100,10,191000,Null,Null,56612464,111461,2225
56648484,872.0,872.0,320000,320000,0,0,320000,Null,Null,56648484,562001,1520
56655612,118.0,118.0,290000,290000,0,0,290000,Null,Null,56655612,144317,1883
56680326,2.0,2.0,114000,114000,0,0,114000,Null,Null,56680326,111461,1883
56691678,1.0,1.0,360000,185000,175000,49,360000,Null,Null,56691678,4647777,15318
56694713,64.0,64.0,1473000,1148940,324060,22,1473000,Null,Null,56694713,26150,914
56704532,19.0,19.0,3800000,3800000,0,0,3800000,Null,Null,56704532,231945,1520
56707024,8.0,8.0,151000,151000,0,0,151000,Null,Null,56707024,407561,2
56713451,594.0,594.0,540000,267000,273000,51,540000,Null,Null,56713451,302375,1815
56737206,120.0,120.0,30000,30000,0,0,30000,Null,Null,56737206,197767,23026
56737810,514.0,514.0,149000,68000,81000,54,149000,Null,Null,56737810,197767,23026
56741425,266.0,266.0,54000,54000,0,0,54000,Null,Null,56741425,229809,2685
56742111,147.0,147.0,29500,29500,0,0,29500,Null,Null,56742111,229809,2685
56754276,0.0,0.0,4200000,4200000,0,0,4200000,Null,Null,56754276,215929,17170
56769721,267.0,267.0,209000,205000,4000,2,209000,Null,Null,56769721,697923,23346
56793682,8.0,8.0,85000,85000,0,0,85000,Null,Null,56793682,407561,2
56794260,759.0,759.0,173000,121000,52000,30,173000,Null,Null,56794260,79682,1520
56799621,1562.0,1562.0,68000,49000,19000,28,68000,Null,Null,56799621,625265,1815
56799815,2359.0,2359.0,25000,19000,6000,24,25000,Null,Null,56799815,837479,1815
56812892,3.0,3.0,135000,87750,47250,35,135000,Null,Null,56812892,111461,15250
56815775,26.0,26.0,18992,18992,0,0,18992,Null,Null,56815775,111461,2513
56859344,3885.0,3885.0,249000,112000,137000,55,249000,Null,Null,56859344,302375,1815
56880195,6037.0,6037.0,242000,123000,119000,49,242000,Null,Null,56880195,48077,23282
56885648,2683.0,2683.0,80000,57000,23000,29,80000,Null,Null,56885648,205535,1815
56889347,1973.0,1973.0,245000,139000,106000,43,245000,Null,Null,56889347,302375,1815
56901849,303.0,303.0,35000,35000,0,0,35000,Null,Null,56901849,614727,2514
56902796,4.0,4.0,5010000,3749000,1261000,25,5010000,Null,Null,56902796,26150,914
56918293,357.0,357.0,32000,27200,4800,15,32000,Null,Null,56918293,542605,1520
56943145,97.0,97.0,249000,249000,0,0,249000,Null,Null,56943145,111461,11856
56960113,2.0,2.0,3800000,3500000,300000,8,3800000,Null,Null,56960113,177983,1520
56962715,394.0,394.0,85000,85000,0,0,85000,Null,Null,56962715,111393,5263
56986002,158.0,158.0,415000,211000,204000,49,415000,Null,Null,56986002,26689,1520
56999925,4.0,4.0,200000,130000,70000,35,200000,Null,Null,56999925,4647777,914
57002404,2.0,2.0,80000,80000,0,0,80000,Null,Null,57002404,407561,914
57031893,2.0,2.0,113400,113400,0,0,113400,Null,Null,57031893,111461,1520
57045660,104.0,104.0,60000,40000,20000,33,60000,Null,Null,57045660,48077,23282
57137196,5.0,5.0,260000,157000,103000,40,260000,Null,Null,57137196,4647777,914
57142434,23.0,23.0,46000,46000,0,0,46000,Null,Null,57142434,407561,914
57218426,5.0,5.0,5200000,4800000,400000,8,5200000,Null,Null,57218426,177983,1520
57243183,1404.0,1404.0,990000,699000,291000,29,990000,Null,Null,57243183,25422,1626
57244124,5.0,5.0,240000,154000,86000,36,240000,Null,Null,57244124,4647777,914
57252688,1.0,1.0,16100000,16100000,0,0,16100000,Null,Null,57252688,50307,7079
57272706,8.0,8.0,38000,36000,2000,5,38000,Null,Null,57272706,165571,1883
57280766,170.0,170.0,39000,39000,0,0,39000,Null,Null,57280766,111461,2363
57281829,452.0,452.0,690000,448000,242000,35,690000,Null,Null,57281829,864171,1520
57282392,14.0,14.0,144900,144900,0,0,144900,Null,Null,57282392,111461,23258
57284183,278.0,278.0,129000,129000,0,0,129000,Null,Null,57284183,111461,23246
57302452,12.0,12.0,160000,160000,0,0,160000,Null,Null,57302452,111461,914
57304300,24.0,24.0,290000,198000,92000,32,290000,Null,Null,57304300,150433,1815
57307589,0.0,0.0,11670000,11670000,0,0,11670000,Null,Null,57307589,217953,7079
57316324,2.0,2.0,5200000,4800000,400000,8,5200000,Null,Null,57316324,177983,1520
57316679,0.0,0.0,16100000,16100000,0,0,16100000,Null,Null,57316679,217953,7079
57317304,0.0,0.0,40000000,40000000,0,0,40000000,Null,Null,57317304,865327,7079
57335326,22.0,22.0,835000,835000,0,0,835000,Null,Null,57335326,51302,12590
57345342,158.0,158.0,138000,138000,0,0,138000,Null,Null,57345342,111461,1815
57352509,275.0,275.0,69000,39000,30000,43,69000,Null,Null,57352509,314675,1804
57357455,49.0,49.0,149000,129000,20000,13,149000,Null,Null,57357455,314675,1815
57361555,4.0,4.0,4071429,2850000,1221429,30,4071429,Null,Null,57361555,405211,914
57361875,4.0,4.0,55000,55000,0,0,55000,Null,Null,57361875,111461,914
57363224,0.0,0.0,7500000,5625000,1875000,25,7500000,Null,Null,57363224,258977,17170
57378942,663.0,663.0,32000,32000,0,0,32000,Null,Null,57378942,197767,3178
57379843,2.0,2.0,200000,126000,74000,37,200000,Null,Null,57379843,4647777,914
57387350,1.0,1.0,40000,40000,0,0,40000,Null,Null,57387350,111461,1815
57390063,0.0,0.0,5990000,5990000,0,0,5990000,Null,Null,57390063,111461,15318
57443207,0.0,0.0,28900000,28900000,0,0,28900000,Null,Null,57443207,111461,1520
57462938,0.0,0.0,7071429,7071429,0,0,7071429,Null,Null,57462938,405211,914
57477346,1.0,1.0,16600000,16600000,0,0,16600000,Null,Null,57477346,217953,7079
57478421,0.0,0.0,17590000,17590000,0,0,17590000,Null,Null,57478421,217953,7079
57485701,157.0,157.0,525000,489000,36000,7,525000,Null,Null,57485701,26689,11605
57487972,302.0,302.0,550000,385000,165000,30,550000,Null,Null,57487972,201089,1883
57490837,475.0,475.0,655000,589000,66000,10,655000,Null,Null,57490837,26689,1583
57498842,7.0,7.0,750000,750000,0,0,750000,Null,Null,57498842,154910,1811
57518181,0.0,0.0,150000,146000,4000,3,150000,Null,Null,57518181,858333,1815
57521842,3846.0,3846.0,600000,552000,48000,8,600000,Null,Null,57521842,523789,1883
57523356,789.0,789.0,299000,189500,109500,37,299000,Null,Null,57523356,500047,1805
57649867,7999.0,7999.0,127300,116000,11300,9,127300,Null,Null,57649867,21274,1520
57650806,670.0,670.0,479000,479000,0,0,479000,Null,Null,57650806,111461,11858
57683986,3.0,3.0,1088000,848640,239360,22,1088000,Null,Null,57683986,26150,914
57689660,182.0,182.0,33000,33000,0,0,33000,Null,Null,57689660,614727,2514
57705006,1082.0,1082.0,1100000,880008,219992,20,1100000,Null,Null,57705006,500047,1815
57708582,778.0,778.0,1697000,999000,698000,41,1697000,Null,Null,57708582,48077,2225
57710751,3.0,3.0,4610000,4610000,0,0,4610000,Null,Null,57710751,199801,1520
57715384,961.0,961.0,145000,145000,0,0,145000,Null,Null,57715384,223635,1520
57730609,0.0,0.0,2000,2000,0,0,2000,Null,Null,57730609,111461,2685
57731468,31.0,31.0,10000,9900,100,1,10000,Null,Null,57731468,111461,1520
57748047,202.0,202.0,45000,45000,0,0,45000,Null,Null,57748047,111461,1815
57750831,0.0,0.0,8400000,5880000,2520000,30,8400000,Null,Null,57750831,405211,914
57750941,0.0,0.0,8400000,5880000,2520000,30,8400000,Null,Null,57750941,405211,914
57751321,1.0,1.0,9170000,6550000,2620000,29,9170000,Null,Null,57751321,405211,914
57751719,0.0,0.0,9590000,6850000,2740000,29,9590000,Null,Null,57751719,405211,914
57751787,0.0,0.0,8330000,5950000,2380000,29,8330000,Null,Null,57751787,405211,914
57751877,0.0,0.0,8190000,5950000,2240000,27,8190000,Null,Null,57751877,405211,914
57751938,0.0,0.0,10785714,6550000,4235714,39,10785714,Null,Null,57751938,405211,914
57752024,0.0,0.0,10785714,6550000,4235714,39,10785714,Null,Null,57752024,405211,914
57752855,0.0,0.0,6550000,6550000,0,0,6550000,Null,Null,57752855,405211,914
57753026,0.0,0.0,8330000,5950000,2380000,29,8330000,Null,Null,57753026,405211,914
57753350,0.0,0.0,8232000,5880000,2352000,29,8232000,Null,Null,57753350,405211,914
57754633,0.0,0.0,8232000,5880000,2352000,29,8232000,Null,Null,57754633,405211,914
57759987,337.0,337.0,369000,172000,197000,53,369000,Null,Null,57759987,500047,1811
57760139,0.0,0.0,8232000,5880000,2352000,29,8232000,Null,Null,57760139,405211,914
57764206,0.0,0.0,25000000,25000000,0,0,25000000,Null,Null,57764206,111461,1805
57773894,0.0,0.0,11570000,11570000,0,0,11570000,Null,Null,57773894,217953,7079
57774455,0.0,0.0,13220000,13220000,0,0,13220000,Null,Null,57774455,217953,7079
57774670,63.0,63.0,415000,214000,201000,48,415000,Null,Null,57774670,560853,3422
57774896,13.0,13.0,29000,29000,0,0,29000,Null,Null,57774896,111461,1883
57775827,0.0,0.0,14071429,9850000,4221429,30,14071429,Null,Null,57775827,405211,914
57776098,0.0,0.0,16780000,16780000,0,0,16780000,Null,Null,57776098,217953,7079
57776173,2.0,2.0,98000,98000,0,0,98000,Null,Null,57776173,885693,15250
57777826,100.0,100.0,35000,35000,0,0,35000,Null,Null,57777826,145029,1883
57780414,25.0,25.0,290000,290000,0,0,290000,Null,Null,57780414,111461,914
57783000,1020.0,1020.0,550000,499000,51000,9,550000,Null,Null,57783000,872337,1520
57800422,8.0,8.0,97000,97000,0,0,97000,Null,Null,57800422,111461,3990
57802295,529.0,529.0,59000,59000,0,0,59000,Null,Null,57802295,21274,1520
57806426,0.0,0.0,14071429,9850000,4221429,30,14071429,Null,Null,57806426,732431,914
57809866,5121.0,5121.0,2490000,1830000,660000,27,2490000,Null,Null,57809866,25422,1795
57821370,1.0,1.0,4600000,4600000,0,0,4600000,Null,Null,57821370,463255,17170
57825125,625.0,625.0,490000,249000,241000,49,490000,Null,Null,57825125,302375,1815
57839940,18.0,18.0,190000,190000,0,0,190000,Null,Null,57839940,111461,914
57841587,161.0,161.0,179000,179000,0,0,179000,Null,Null,57841587,21653,1815
57863885,61.0,61.0,150000,150000,0,0,150000,Null,Null,57863885,111461,2140
57868739,0.0,0.0,9100000,6500000,2600000,29,9100000,Null,Null,57868739,405211,914
57877027,0.0,0.0,12000000,12000000,0,0,12000000,Null,Null,57877027,463255,1601
57882652,2.0,2.0,4500000,4500000,0,0,4500000,Null,Null,57882652,463255,3424
57884951,1.0,1.0,4500000,4500000,0,0,4500000,Null,Null,57884951,463255,3424
57885567,0.0,0.0,8000000,8000000,0,0,8000000,Null,Null,57885567,463255,1601
57895602,0.0,0.0,11970000,8550000,3420000,29,11970000,Null,Null,57895602,405211,914
57896901,18.0,18.0,379000,379000,0,0,379000,Null,Null,57896901,856589,2340
57897482,0.0,0.0,6500000,6500000,0,0,6500000,Null,Null,57897482,405211,914
57897567,75.0,75.0,249000,242000,7000,3,249000,Null,Null,57897567,19312,1815
57898079,0.0,0.0,6785714,6785714,0,0,6785714,Null,Null,57898079,405211,914
57898253,0.0,0.0,6785714,6785714,0,0,6785714,Null,Null,57898253,405211,914
57898702,0.0,0.0,4750000,3629000,1121000,24,4750000,Null,Null,57898702,258977,53350
57902939,0.0,0.0,9785714,9785714,0,0,9785714,Null,Null,57902939,405211,914
57905389,0.0,0.0,16000,16000,0,0,16000,Null,Null,57905389,111461,914
57905714,0.0,0.0,8000000,8000000,0,0,8000000,Null,Null,57905714,859857,1520
57906782,3.0,3.0,17500,17500,0,0,17500,Null,Null,57906782,111461,914
57909857,0.0,0.0,9785714,6850000,2935714,30,9785714,Null,Null,57909857,405211,914
57916185,12.0,12.0,292000,189800,102200,35,292000,Null,Null,57916185,111461,914
57918262,5.0,5.0,337000,219050,117950,35,337000,Null,Null,57918262,111461,914
57921432,4.0,4.0,305000,198250,106750,35,305000,Null,Null,57921432,111461,15250
57924258,0.0,0.0,8500000,5950000,2550000,30,8500000,Null,Null,57924258,405211,914
57930330,0.0,0.0,8500000,5950000,2550000,30,8500000,Null,Null,57930330,405211,914
57937382,0.0,0.0,8900000,8900000,0,0,8900000,Null,Null,57937382,193837,15320
57938156,6.0,6.0,3700000,3441000,259000,7,3700000,Null,Null,57938156,367577,1520
57939463,0.0,0.0,12810000,9150000,3660000,29,12810000,Null,Null,57939463,405211,914
57945711,11.0,11.0,228900,228900,0,0,228900,Null,Null,57945711,111461,23258
57956288,0.0,0.0,9450000,6750000,2700000,29,9450000,Null,Null,57956288,405211,914
57956312,0.0,0.0,9450000,6750000,2700000,29,9450000,Null,Null,57956312,405211,914
57956720,90.0,90.0,93000,90000,3000,3,93000,Null,Null,57956720,111461,1815
57964265,0.0,0.0,299000,299000,0,0,299000,Null,Null,57964265,111461,15318
57971022,0.0,0.0,7900000,7900000,0,0,7900000,Null,Null,57971022,405211,914
57971281,0.0,0.0,6400000,6400000,0,0,6400000,Null,Null,57971281,405211,914
57971649,1075.0,1075.0,593000,289000,304000,51,593000,Null,Null,57971649,48077,2
57975613,307.0,307.0,189000,185000,4000,2,189000,Null,Null,57975613,312329,1815
57983689,55.0,55.0,65000,65000,0,0,65000,Null,Null,57983689,407561,2
57992977,0.0,0.0,12124000,8660000,3464000,29,12124000,Null,Null,57992977,732431,914
57993138,0.0,0.0,12124000,8660000,3464000,29,12124000,Null,Null,57993138,732431,914
57993262,0.0,0.0,12124000,8660000,3464000,29,12124000,Null,Null,57993262,732431,914
57993350,0.0,0.0,12124000,8660000,3464000,29,12124000,Null,Null,57993350,732431,914
57993420,0.0,0.0,9086000,6490000,2596000,29,9086000,Null,Null,57993420,732431,914
57993447,0.0,0.0,9086000,6490000,2596000,29,9086000,Null,Null,57993447,732431,914
57994034,0.0,0.0,9086000,6490000,2596000,29,9086000,Null,Null,57994034,732431,914
57994351,0.0,0.0,9506000,6490000,3016000,32,9506000,Null,Null,57994351,732431,914
57995280,0.0,0.0,11550000,8250000,3300000,29,11550000,Null,Null,57995280,732431,914
57995338,0.0,0.0,12371429,8660000,3711429,30,12371429,Null,Null,57995338,732431,914
57995349,0.0,0.0,12371429,8660000,3711429,30,12371429,Null,Null,57995349,732431,914
57995368,0.0,0.0,12371429,8660000,3711429,30,12371429,Null,Null,57995368,732431,914
57997337,0.0,0.0,11550000,8250000,3300000,29,11550000,Null,Null,57997337,732431,914
57998155,1.0,1.0,11785714,8250000,3535714,30,11785714,Null,Null,57998155,732431,914
57998205,0.0,0.0,11970000,8550000,3420000,29,11970000,Null,Null,57998205,732431,914
57998212,1.0,1.0,11550000,8250000,3300000,29,11550000,Null,Null,57998212,732431,914
57998216,0.0,0.0,11970000,8550000,3420000,29,11970000,Null,Null,57998216,732431,914
57998225,0.0,0.0,9730000,9730000,0,0,9730000,Null,Null,57998225,732431,914
57998330,0.0,0.0,9730000,6950000,2780000,29,9730000,Null,Null,57998330,732431,914
57998389,0.0,0.0,9730000,6950000,2780000,29,9730000,Null,Null,57998389,732431,914
57998783,0.0,0.0,12214286,8550000,3664286,30,12214286,Null,Null,57998783,732431,914
57998847,0.0,0.0,12214286,8550000,3664286,30,12214286,Null,Null,57998847,732431,914
57998984,0.0,0.0,12214286,8550000,3664286,30,12214286,Null,Null,57998984,732431,914
57999080,0.0,0.0,11785714,8250000,3535714,30,11785714,Null,Null,57999080,732431,914
57999123,0.0,0.0,12214286,8550000,3664286,30,12214286,Null,Null,57999123,732431,914
57999394,1707.0,1707.0,229000,195000,34000,15,229000,Null,Null,57999394,697923,23346
58002749,1.0,1.0,990000,990000,0,0,990000,Null,Null,58002749,46363,914
58002786,728.0,728.0,279000,205000,74000,27,279000,Null,Null,58002786,230607,1883
58009763,0.0,0.0,6017429,6017429,0,0,6017429,Null,Null,58009763,405211,914
58010021,14.0,14.0,6880000,6880000,0,0,6880000,Null,Null,58010021,286789,1520
58010310,48.0,48.0,739000,739000,0,0,739000,Null,Null,58010310,18851,1811
58015485,0.0,0.0,1600000,1600000,0,0,1600000,Null,Null,58015485,111461,914
58023971,148.0,148.0,358000,358000,0,0,358000,Null,Null,58023971,243693,1815
58024318,0.0,0.0,7685714,7685714,0,0,7685714,Null,Null,58024318,405211,914
58032475,332.0,332.0,99000,99000,0,0,99000,Null,Null,58032475,111461,1815
58035707,0.0,0.0,11980000,8386000,3594000,30,11980000,Null,Null,58035707,405211,914
58035841,0.0,0.0,7542857,7542857,0,0,7542857,Null,Null,58035841,405211,914
58036140,0.0,0.0,7400000,7400000,0,0,7400000,Null,Null,58036140,405211,914
58036269,0.0,0.0,7642857,7642857,0,0,7642857,Null,Null,58036269,405211,914
58036458,295.0,295.0,65000,65000,0,0,65000,Null,Null,58036458,85014,1520
58036723,0.0,0.0,18357143,12850000,5507143,30,18357143,Null,Null,58036723,405211,914
58037360,0.0,0.0,10214286,7150000,3064286,30,10214286,Null,Null,58037360,405211,914
58047660,0.0,0.0,15000000,10500000,4500000,30,15000000,Null,Null,58047660,405211,914
58049077,0.0,0.0,6071429,6071429,0,0,6071429,Null,Null,58049077,405211,914
58049499,0.0,0.0,7685714,7685714,0,0,7685714,Null,Null,58049499,405211,914
58053818,974.0,974.0,40000,36800,3200,8,40000,Null,Null,58053818,211415,1622
58056643,0.0,0.0,5928571,4150000,1778571,30,5928571,Null,Null,58056643,405211,914
58061817,0.0,0.0,6228571,6228571,0,0,6228571,Null,Null,58061817,405211,914
58063486,0.0,0.0,6228571,6228571,0,0,6228571,Null,Null,58063486,405211,914
58064652,0.0,0.0,8357143,8357143,0,0,8357143,Null,Null,58064652,405211,914
58065346,25.0,25.0,2990000,1850000,1140000,38,2990000,Null,Null,58065346,247549,2
58068284,0.0,0.0,9785714,9785714,0,0,9785714,Null,Null,58068284,405211,914
58068704,0.0,0.0,8357143,5850000,2507143,30,8357143,Null,Null,58068704,405211,914
58073638,85.0,85.0,194560,136192,58368,30,194560,Null,Null,58073638,258135,1815
58074109,178.0,178.0,246720,172704,74016,30,246720,Null,Null,58074109,258135,1815
58080959,28.0,28.0,130000,130000,0,0,130000,Null,Null,58080959,258135,1815
58081042,53.0,53.0,45000,45000,0,0,45000,Null,Null,58081042,407561,2
58081048,3.0,3.0,59000,59000,0,0,59000,Null,Null,58081048,407561,2
58086742,0.0,0.0,6900000,6900000,0,0,6900000,Null,Null,58086742,405211,914
58097686,0.0,0.0,10214286,7150000,3064286,30,10214286,Null,Null,58097686,405211,914
58098394,108.0,108.0,9000,6000,3000,33,9000,Null,Null,58098394,111461,914
58114425,304.0,304.0,36000,36000,0,0,36000,Null,Null,58114425,111461,1815
58115333,0.0,0.0,10214286,7150000,3064286,30,10214286,Null,Null,58115333,405211,914
58115638,0.0,0.0,10214286,7150000,3064286,30,10214286,Null,Null,58115638,405211,914
58115867,0.0,0.0,6500000,6500000,0,0,6500000,Null,Null,58115867,405211,914
58116117,0.0,0.0,6214286,6214286,0,0,6214286,Null,Null,58116117,405211,914
58118522,114.0,114.0,7000,6000,1000,14,7000,Null,Null,58118522,46335,1634
58125334,70.0,70.0,100000,100000,0,0,100000,Null,Null,58125334,111461,1815
58125942,80.0,80.0,290900,285082,5818,2,290900,Null,Null,58125942,111461,1815
58129443,498.0,498.0,43000,43000,0,0,43000,Null,Null,58129443,111461,2238
58130482,18.0,18.0,35000,24500,10500,30,35000,Null,Null,58130482,419129,1815
58131960,0.0,0.0,6500000,6500000,0,0,6500000,Null,Null,58131960,405211,914
58138346,1.0,1.0,43000,43000,0,0,43000,Null,Null,58138346,842373,1815
58142441,3.0,3.0,330000,134000,196000,59,330000,Null,Null,58142441,111461,1883
58146831,0.0,0.0,2500000,2500000,0,0,2500000,Null,Null,58146831,111461,8061
58151291,660.0,660.0,1100000,568000,532000,48,1100000,Null,Null,58151291,146479,1811
58156247,7.0,7.0,96000,96000,0,0,96000,Null,Null,58156247,111461,5995
58167285,0.0,0.0,909000,909000,0,0,909000,Null,Null,58167285,111461,1883
58173187,2.0,2.0,269000,269000,0,0,269000,Null,Null,58173187,111461,914
58173318,737.0,737.0,25000,25000,0,0,25000,Null,Null,58173318,50629,2153
58186016,9.0,9.0,79900,79900,0,0,79900,Null,Null,58186016,111461,1805
58186136,7.0,7.0,193000,193000,0,0,193000,Null,Null,58186136,167853,914
58189148,21.0,21.0,63000,63000,0,0,63000,Null,Null,58189148,148818,53074
58189658,156.0,156.0,89000,89000,0,0,89000,Null,Null,58189658,111461,53054
58193090,3.0,3.0,337000,219050,117950,35,337000,Null,Null,58193090,111461,914
58207084,124.0,124.0,79000,71890,7110,9,79000,Null,Null,58207084,21653,1804
58207789,8.0,8.0,119000,77350,41650,35,119000,Null,Null,58207789,111461,914
58211548,58.0,58.0,9500,9310,190,2,9500,Null,Null,58211548,111461,1815
58214750,14419.0,14419.0,9000,9000,0,0,9000,Null,Null,58214750,865351,8305
58214935,3.0,3.0,79000,51350,27650,35,79000,Null,Null,58214935,111461,15236
58221022,0.0,0.0,24999,24999,0,0,24999,Null,Null,58221022,111461,1815
58244051,29.0,29.0,329000,329000,0,0,329000,Null,Null,58244051,111461,914
58251130,3.0,3.0,380000,380000,0,0,380000,Null,Null,58251130,150002,1815
58252037,569.0,569.0,36000,31000,5000,14,36000,Null,Null,58252037,41048,2685
58255782,0.0,0.0,9785714,9785714,0,0,9785714,Null,Null,58255782,405211,914
58255907,0.0,0.0,15000000,10500000,4500000,30,15000000,Null,Null,58255907,405211,914
58256836,0.0,0.0,9785714,6850000,2935714,30,9785714,Null,Null,58256836,405211,914
58257035,2.0,2.0,9500000,6650000,2850000,30,9500000,Null,Null,58257035,405211,914
58261800,5.0,5.0,182000,182000,0,0,182000,Null,Null,58261800,505165,914
58270425,0.0,0.0,9785714,6850000,2935714,30,9785714,Null,Null,58270425,405211,914
58272457,0.0,0.0,7257143,7257143,0,0,7257143,Null,Null,58272457,405211,914
58272577,0.0,0.0,7257143,7257143,0,0,7257143,Null,Null,58272577,405211,914
58273102,0.0,0.0,6500000,6500000,0,0,6500000,Null,Null,58273102,405211,914
58275658,45.0,45.0,72000,72000,0,0,72000,Null,Null,58275658,167853,914
58276693,0.0,0.0,6017429,6017429,0,0,6017429,Null,Null,58276693,405211,914
58276707,1.0,1.0,279000,279000,0,0,279000,Null,Null,58276707,111461,15318
58277016,0.0,0.0,6017429,6017429,0,0,6017429,Null,Null,58277016,405211,914
58281854,44.0,44.0,850000,699000,151000,18,850000,Null,Null,58281854,111461,914
58292274,4847.0,4847.0,158000,134000,24000,15,158000,Null,Null,58292274,22653,1520
58292292,14170.0,14170.0,144000,122000,22000,15,144000,Null,Null,58292292,22653,1520
58296241,6.0,6.0,186000,186000,0,0,186000,Null,Null,58296241,111461,914
58297381,0.0,0.0,8500000,8500000,0,0,8500000,Null,Null,58297381,405211,914
58297773,0.0,0.0,7542857,7542857,0,0,7542857,Null,Null,58297773,405211,914
58298092,0.0,0.0,7828571,7828571,0,0,7828571,Null,Null,58298092,405211,914
58298176,496.0,496.0,399000,399000,0,0,399000,Null,Null,58298176,171991,1805
58308559,0.0,0.0,9450000,6750000,2700000,29,9450000,Null,Null,58308559,405211,914
58309735,8.0,8.0,490000,249000,241000,49,490000,Null,Null,58309735,4647777,914
58311261,208.0,208.0,531000,448000,83000,16,531000,Null,Null,58311261,243693,2
58311382,0.0,0.0,6171429,6171429,0,0,6171429,Null,Null,58311382,405211,914
58311568,0.0,0.0,6857143,6857143,0,0,6857143,Null,Null,58311568,405211,914
58311830,3011.0,3011.0,18000,11900,6100,34,18000,Null,Null,58311830,288231,5450
58324319,32.0,32.0,100000,100000,0,0,100000,Null,Null,58324319,147723,914
58328551,0.0,0.0,13071429,9150000,3921429,30,13071429,Null,Null,58328551,405211,914
58329183,0.0,0.0,45000000,38250000,6750000,15,45000000,Null,Null,58329183,111461,1805
58329338,16.0,16.0,620000,620000,0,0,620000,Null,Null,58329338,867937,914
58329362,0.0,0.0,7542857,7542857,0,0,7542857,Null,Null,58329362,405211,914
58329377,0.0,0.0,7685714,7685714,0,0,7685714,Null,Null,58329377,405211,914
58329524,0.0,0.0,6500000,6500000,0,0,6500000,Null,Null,58329524,405211,914
58330288,0.0,0.0,11928571,8350000,3578571,30,11928571,Null,Null,58330288,732431,914
58330356,0.0,0.0,9271429,6490000,2781429,30,9271429,Null,Null,58330356,732431,914
58330545,0.0,0.0,9271429,6490000,2781429,30,9271429,Null,Null,58330545,732431,914
58340599,1798.0,1798.0,899000,690000,209000,23,899000,Null,Null,58340599,19246,1815
58357614,4111.0,4111.0,390000,390000,0,0,390000,Null,Null,58357614,304627,2020
58363420,189.0,189.0,150000,150000,0,0,150000,Null,Null,58363420,111461,1520
58364191,0.0,0.0,11785714,8250000,3535714,30,11785714,Null,Null,58364191,732431,914
58364633,0.0,0.0,21490000,21490000,0,0,21490000,Null,Null,58364633,114527,1815
58367055,0.0,0.0,10357143,7250000,3107143,30,10357143,Null,Null,58367055,732431,914
58372917,0.0,0.0,10357143,7250000,3107143,30,10357143,Null,Null,58372917,732431,914
58373087,0.0,0.0,10357143,10357143,0,0,10357143,Null,Null,58373087,732431,914
58373223,4.0,4.0,1140000,799000,341000,30,1140000,Null,Null,58373223,4647777,914
58373562,0.0,0.0,9928571,6950000,2978571,30,9928571,Null,Null,58373562,732431,914
58373681,0.0,0.0,9271429,6490000,2781429,30,9271429,Null,Null,58373681,732431,914
58374058,0.0,0.0,9271429,9271429,0,0,9271429,Null,Null,58374058,732431,914
58374078,0.0,0.0,9271429,9271429,0,0,9271429,Null,Null,58374078,732431,914
58374241,0.0,0.0,9271429,6490000,2781429,30,9271429,Null,Null,58374241,732431,914
58374765,0.0,0.0,9928571,6950000,2978571,30,9928571,Null,Null,58374765,732431,914
58393093,940.0,940.0,2500000,1101000,1399000,56,2500000,Null,Null,58393093,500047,1805
58398846,2.0,2.0,299000,299000,0,0,299000,Null,Null,58398846,111461,914
58404714,34.0,34.0,189000,99000,90000,48,189000,Null,Null,58404714,4647777,914
58406318,15.0,15.0,590000,299000,291000,49,590000,Null,Null,58406318,4647777,914
58407340,137.0,137.0,15000,14850,150,1,15000,Null,Null,58407340,111461,2234
58407534,187.0,187.0,305000,305000,0,0,305000,Null,Null,58407534,53832,1520
58410483,163.0,163.0,65000,27000,38000,58,65000,Null,Null,58410483,111461,914
58411441,20.0,20.0,190000,99000,91000,48,190000,Null,Null,58411441,4647777,914
58415187,804.0,804.0,290000,159000,131000,45,290000,Null,Null,58415187,851519,1883
58439345,3.0,3.0,803000,626340,176660,22,803000,Null,Null,58439345,26150,914
58442111,0.0,0.0,10200000,10200000,0,0,10200000,Null,Null,58442111,860053,914
58445143,0.0,0.0,11500000,11500000,0,0,11500000,Null,Null,58445143,860053,914
58448882,27.0,27.0,16500,16500,0,0,16500,Null,Null,58448882,111461,1883
58451521,422.0,422.0,109000,109000,0,0,109000,Null,Null,58451521,746615,2685
58456287,6.0,6.0,15000,15000,0,0,15000,Null,Null,58456287,505165,914
58456783,2326.0,2326.0,58000,58000,0,0,58000,Null,Null,58456783,111461,2514
58459904,7.0,7.0,31000,31000,0,0,31000,Null,Null,58459904,505165,914
58488552,921.0,921.0,459000,459000,0,0,459000,Null,Null,58488552,183325,1520
58493223,0.0,0.0,11000000,11000000,0,0,11000000,Null,Null,58493223,111461,914
58499996,66.0,66.0,175000,161000,14000,8,175000,Null,Null,58499996,111461,1815
58512087,0.0,0.0,17500000,12500000,5000000,29,17500000,Null,Null,58512087,405211,914
58519309,212.0,212.0,106000,106000,0,0,106000,Null,Null,58519309,294273,11753
58530142,1109.0,1109.0,320000,275000,45000,14,320000,Null,Null,58530142,238407,17170
58530502,22.0,22.0,120000,120000,0,0,120000,Null,Null,58530502,147723,914
58531344,88.0,88.0,87900,87900,0,0,87900,Null,Null,58531344,111461,1815
58536309,759.0,759.0,599000,469000,130000,22,599000,Null,Null,58536309,856589,1520
58545954,536.0,536.0,50000,30000,20000,40,50000,Null,Null,58545954,201773,1601
58547647,1855.0,1855.0,990000,499000,491000,50,990000,Null,Null,58547647,625853,1805
58551379,72.0,72.0,95000,89000,6000,6,95000,Null,Null,58551379,454665,1520
58554537,259.0,259.0,39000,22000,17000,44,39000,Null,Null,58554537,314675,1815
58555279,1.0,1.0,10400000,9672000,728000,7,10400000,Null,Null,58555279,367577,1520
58556244,2.0,2.0,18500000,18500000,0,0,18500000,Null,Null,58556244,499169,8227
58561724,229.0,229.0,20000,20000,0,0,20000,Null,Null,58561724,111461,1815
58562388,0.0,0.0,9310000,6650000,2660000,29,9310000,Null,Null,58562388,405211,914
58562483,0.0,0.0,9310000,6650000,2660000,29,9310000,Null,Null,58562483,405211,914
58563041,0.0,0.0,7542857,7542857,0,0,7542857,Null,Null,58563041,405211,914
58601328,609.0,609.0,600000,530000,70000,12,600000,Null,Null,58601328,145656,1520
58601415,294.0,294.0,400000,400000,0,0,400000,Null,Null,58601415,145656,1520
58605089,0.0,0.0,3400000,3400000,0,0,3400000,Null,Null,58605089,27449,1520
58613238,701.0,701.0,89000,63000,26000,29,89000,Null,Null,58613238,637535,8199
58624734,362.0,362.0,4790000,3460000,1330000,28,4790000,Null,Null,58624734,18641,1811
58654956,1111.0,1111.0,139000,139000,0,0,139000,Null,Null,58654956,3034457,1520
58665005,0.0,0.0,3500000,3500000,0,0,3500000,Null,Null,58665005,427535,8170
58667454,2125.0,2125.0,392000,282000,110000,28,392000,Null,Null,58667454,47664,1520
58673652,8256.0,8256.0,174000,116000,58000,33,174000,Null,Null,58673652,47664,1520
58676808,1308.0,1308.0,52000,43500,8500,16,52000,Null,Null,58676808,164391,2
58676812,1982.0,1982.0,72000,58500,13500,19,72000,Null,Null,58676812,164391,2
58676814,2434.0,2434.0,63000,57000,6000,10,63000,Null,Null,58676814,164391,1520
58676878,7803.0,7803.0,184000,120000,64000,35,184000,Null,Null,58676878,47664,1520
58695066,22.0,22.0,5799000,5799000,0,0,5799000,Null,Null,58695066,616207,1520
58696466,2.0,2.0,3800000,3750000,50000,1,3800000,Null,Null,58696466,199801,1520
58716174,317.0,317.0,39000,39000,0,0,39000,Null,Null,58716174,867031,914
58716783,9.0,9.0,3500000,3500000,0,0,3500000,Null,Null,58716783,111461,11935
58727383,0.0,0.0,99300,99300,0,0,99300,Null,Null,58727383,111461,1883
58731231,801.0,801.0,149000,149000,0,0,149000,Null,Null,58731231,21266,2
58731233,1272.0,1272.0,144000,129000,15000,10,144000,Null,Null,58731233,491699,1520
58731234,20198.0,20198.0,129000,111000,18000,14,129000,Null,Null,58731234,21271,1520
58731239,5704.0,5704.0,106000,100000,6000,6,106000,Null,Null,58731239,21266,1520
58731268,792.0,792.0,144000,124000,20000,14,144000,Null,Null,58731268,491699,1520
58736477,1966.0,1966.0,169000,136000,33000,20,169000,Null,Null,58736477,205535,1815
58744960,206.0,206.0,170000,170000,0,0,170000,Null,Null,58744960,25403,11605
58762994,1557.0,1557.0,169000,146000,23000,14,169000,Null,Null,58762994,21265,1520
58763019,461.0,461.0,230000,205000,25000,11,230000,Null,Null,58763019,21265,1520
58800808,373.0,373.0,112000,75600,36400,33,112000,Null,Null,58800808,922779,1520
58802544,534.0,534.0,250000,250000,0,0,250000,Null,Null,58802544,111461,2225
58803167,1323.0,1323.0,375000,245000,130000,35,375000,Null,Null,58803167,245063,1520
58804363,714.0,714.0,171000,99000,72000,42,171000,Null,Null,58804363,48077,2513
58806457,72.0,72.0,208999,208999,0,0,208999,Null,Null,58806457,165403,8170
58811344,96.0,96.0,56800,30000,26800,47,56800,Null,Null,58811344,111461,1883
58811954,407.0,407.0,198000,196000,2000,1,198000,Null,Null,58811954,33203,1520
58812581,0.0,0.0,8000000,8000000,0,0,8000000,Null,Null,58812581,463255,1601
58814335,968.0,968.0,1950000,1290000,660000,34,1950000,Null,Null,58814335,51302,1883
58828647,1544.0,1544.0,1350000,890000,460000,34,1350000,Null,Null,58828647,51302,1883
58840638,1538.0,1538.0,399000,299000,100000,25,399000,Null,Null,58840638,697923,12590
58850613,1727.0,1727.0,210000,141750,68250,33,210000,Null,Null,58850613,541755,1520
58855259,0.0,0.0,3380000,3380000,0,0,3380000,Null,Null,58855259,922767,1583
58858745,0.0,0.0,10490000,10490000,0,0,10490000,Null,Null,58858745,185211,11935
58860001,1.0,1.0,4600000,3990000,610000,13,4600000,Null,Null,58860001,185211,11689
58866481,7.0,7.0,171000,171000,0,0,171000,Null,Null,58866481,111461,1883
58880438,1780.0,1780.0,297000,249000,48000,16,297000,Null,Null,58880438,111461,8171
58889100,1.0,1.0,19000,19000,0,0,19000,Null,Null,58889100,111461,1815
58901864,1.0,1.0,19000,19000,0,0,19000,Null,Null,58901864,505165,914
58915092,0.0,0.0,6500000,6500000,0,0,6500000,Null,Null,58915092,733583,1520
58923306,0.0,0.0,7000000,7000000,0,0,7000000,Null,Null,58923306,430485,15318
58930785,334.0,334.0,189000,189000,0,0,189000,Null,Null,58930785,111461,1804
58932028,882.0,882.0,99000,99000,0,0,99000,Null,Null,58932028,894177,23304
58936322,0.0,0.0,5380000,5380000,0,0,5380000,Null,Null,58936322,922767,53350
58937454,12.0,12.0,4000000,4000000,0,0,4000000,Null,Null,58937454,499169,1601
58947928,72.0,72.0,85000,85000,0,0,85000,Null,Null,58947928,111461,1815
58953455,286.0,286.0,129000,129000,0,0,129000,Null,Null,58953455,111461,1804
58962618,816.0,816.0,1100000,635000,465000,42,1100000,Null,Null,58962618,631569,1520
58966553,159.0,159.0,459000,452000,7000,2,459000,Null,Null,58966553,695669,23126
58971532,38.0,38.0,141000,141000,0,0,141000,Null,Null,58971532,111461,8371
58978006,862.0,862.0,59000,59000,0,0,59000,Null,Null,58978006,149537,23362
58984049,221.0,221.0,295000,264000,31000,11,295000,Null,Null,58984049,111461,1815
59044202,360.0,360.0,83000,83000,0,0,83000,Null,Null,59044202,927055,1820
59045788,269.0,269.0,200000,200000,0,0,200000,Null,Null,59045788,927055,1815
59047203,1028.0,1028.0,75376,37688,37688,50,75376,Null,Null,59047203,111461,27180
59052059,1164.0,1164.0,229000,193000,36000,16,229000,Null,Null,59052059,807369,1520
59071629,0.0,0.0,95232000,95232000,0,0,95232000,Null,Null,59071629,183111,23376
59071660,484.0,484.0,80000,80000,0,0,80000,Null,Null,59071660,111461,27214
59078477,149.0,149.0,1083000,678000,405000,37,1083000,Null,Null,59078477,33203,1520
59080318,596.0,596.0,144900,122000,22900,16,144900,Null,Null,59080318,217777,1520
59084364,3640.0,3640.0,280000,159000,121000,43,280000,Null,Null,59084364,314675,1805
59084567,192.0,192.0,11000,7000,4000,36,11000,Null,Null,59084567,111461,914
59085965,2918.0,2918.0,528000,223000,305000,58,528000,Null,Null,59085965,219695,8225
59090334,208.0,208.0,1690000,1290000,400000,24,1690000,Null,Null,59090334,153086,1815
59092666,359.0,359.0,458000,274000,184000,40,458000,Null,Null,59092666,219695,23802
59098787,3.0,3.0,15000,15000,0,0,15000,Null,Null,59098787,111461,914
59113001,0.0,0.0,9590000,6850000,2740000,29,9590000,Null,Null,59113001,405211,914
59114254,0.0,0.0,9590000,6850000,2740000,29,9590000,Null,Null,59114254,298489,914
59119255,0.0,0.0,1987,1987,0,0,1987,Null,Null,59119255,111461,23112
59163919,1960.0,1960.0,130000,79000,51000,39,130000,Null,Null,59163919,245945,1883
59171869,6.0,6.0,2721000,1898000,823000,30,2721000,Null,Null,59171869,26150,914
59173497,3.0,3.0,2122000,2122000,0,0,2122000,Null,Null,59173497,26150,914
59180531,4.0,4.0,1270000,1270000,0,0,1270000,Null,Null,59180531,26150,914
59197827,44.0,44.0,66000,66000,0,0,66000,Null,Null,59197827,111461,914
59207486,0.0,0.0,37500000,37500000,0,0,37500000,Null,Null,59207486,433227,1520
59217491,11.0,11.0,258752,258752,0,0,258752,Null,Null,59217491,47882,1778
59226192,0.0,0.0,7450000,7450000,0,0,7450000,Null,Null,59226192,218151,15318
59236451,38.0,38.0,642000,642000,0,0,642000,Null,Null,59236451,183325,1520
59238383,1042.0,1042.0,295000,164000,131000,44,295000,Null,Null,59238383,212575,27128
59238482,583.0,583.0,19000,19000,0,0,19000,Null,Null,59238482,111461,1815
59238608,809.0,809.0,458000,249000,209000,46,458000,Null,Null,59238608,219695,8225
59238709,342.0,342.0,22000,22000,0,0,22000,Null,Null,59238709,111461,1815
59238806,4.0,4.0,3950000,3950000,0,0,3950000,Null,Null,59238806,111461,8061
59239151,581.0,581.0,60000,60000,0,0,60000,Null,Null,59239151,111461,1815
59239672,366.0,366.0,23000,23000,0,0,23000,Null,Null,59239672,111461,1815
59243874,26.0,26.0,120000,120000,0,0,120000,Null,Null,59243874,111461,914
59256972,17.0,17.0,220000,220000,0,0,220000,Null,Null,59256972,111461,914
59259444,1566.0,1566.0,190000,180500,9500,5,190000,Null,Null,59259444,839837,53186
59264229,2009.0,2009.0,609000,403000,206000,34,609000,Null,Null,59264229,238861,7061
59264739,467.0,467.0,609000,426000,183000,30,609000,Null,Null,59264739,238861,1520
59273521,312.0,312.0,97000,87300,9700,10,97000,Null,Null,59273521,839837,2685
59288213,564.0,564.0,290000,285000,5000,2,290000,Null,Null,59288213,201089,1883
59306865,650.0,650.0,389000,389000,0,0,389000,Null,Null,59306865,362757,1804
59314717,18.0,18.0,52000,52000,0,0,52000,Null,Null,59314717,111461,3990
59318679,587.0,587.0,238000,218000,20000,8,238000,Null,Null,59318679,697923,23346
59321158,8.0,8.0,5980000,4690000,1290000,22,5980000,Null,Null,59321158,508313,1520
59321334,25.0,25.0,6200000,6200000,0,0,6200000,Null,Null,59321334,508313,1520
59335335,0.0,0.0,6500000,6500000,0,0,6500000,Null,Null,59335335,463255,2347
59337591,0.0,0.0,8400000,8400000,0,0,8400000,Null,Null,59337591,463255,1583
59339201,0.0,0.0,8600000,8600000,0,0,8600000,Null,Null,59339201,463255,1583
59355019,0.0,0.0,350000,350000,0,0,350000,Null,Null,59355019,111461,1815
59358608,923.0,923.0,52000,52000,0,0,52000,Null,Null,59358608,185677,53074
59359188,940.0,940.0,49000,26000,23000,47,49000,Null,Null,59359188,186605,53190
59379773,191.0,191.0,33900,33900,0,0,33900,Null,Null,59379773,111461,1815
59383916,5.0,5.0,1131000,1131000,0,0,1131000,Null,Null,59383916,26150,914
59386141,2.0,2.0,57999,57999,0,0,57999,Null,Null,59386141,111461,5995
59387881,1163.0,1163.0,230000,209000,21000,9,230000,Null,Null,59387881,697923,23346
59388779,11.0,11.0,150000,130000,20000,13,150000,Null,Null,59388779,111461,1815
59388840,96.0,96.0,180000,180000,0,0,180000,Null,Null,59388840,111461,1815
59397731,1.0,1.0,4000000,4000000,0,0,4000000,Null,Null,59397731,859857,1520
59399179,7.0,7.0,1190000,1190000,0,0,1190000,Null,Null,59399179,461413,914
59401658,4.0,4.0,118000,118000,0,0,118000,Null,Null,59401658,111461,23246
59404303,8.0,8.0,165000,165000,0,0,165000,Null,Null,59404303,111461,914
59410271,10.0,10.0,83500,83500,0,0,83500,Null,Null,59410271,111461,1883
59410891,275.0,275.0,141700,109000,32700,23,141700,Null,Null,59410891,7798357,23362
59419361,182.0,182.0,165000,165000,0,0,165000,Null,Null,59419361,612431,53074
59423519,0.0,0.0,7000000,7000000,0,0,7000000,Null,Null,59423519,610057,914
59423944,3.0,3.0,4114286,2880000,1234286,30,4114286,Null,Null,59423944,610057,914
59429946,1.0,1.0,4128571,2890000,1238571,30,4128571,Null,Null,59429946,610057,914
59435343,14.0,14.0,907000,725000,182000,20,907000,Null,Null,59435343,26150,914
59453440,2.0,2.0,263000,263000,0,0,263000,Null,Null,59453440,167853,15250
59453794,91.0,91.0,169000,169000,0,0,169000,Null,Null,59453794,111461,23346
59460380,45.0,45.0,96000,70000,26000,27,96000,Null,Null,59460380,111461,914
59460499,10.0,10.0,29000,13000,16000,55,29000,Null,Null,59460499,111461,914
59466052,13.0,13.0,63000,63000,0,0,63000,Null,Null,59466052,111461,1815
59467549,0.0,0.0,3857143,2700000,1157143,30,3857143,Null,Null,59467549,610057,914
59468415,12.0,12.0,2657143,1860000,797143,30,2657143,Null,Null,59468415,610057,914
59469347,21.0,21.0,2214286,1550000,664286,30,2214286,Null,Null,59469347,610057,914
59473854,479.0,479.0,135000,135000,0,0,135000,Null,Null,59473854,734429,1520
59478795,0.0,0.0,5500000,5500000,0,0,5500000,Null,Null,59478795,506629,1601
59479717,49.0,49.0,395000,329000,66000,17,395000,Null,Null,59479717,19018,2334
59480154,82.0,82.0,850000,490000,360000,42,850000,Null,Null,59480154,234665,1626
59482156,0.0,0.0,81900000,81900000,0,0,81900000,Null,Null,59482156,244563,1979
59482840,1155.0,1155.0,699000,306000,393000,56,699000,Null,Null,59482840,505907,1815
59491112,0.0,0.0,4214286,2950000,1264286,30,4214286,Null,Null,59491112,610057,914
59497078,0.0,0.0,6720000,6720000,0,0,6720000,Null,Null,59497078,929563,8170
59497084,0.0,0.0,9520000,9520000,0,0,9520000,Null,Null,59497084,929563,8170
59506822,2.0,2.0,1785714,1250000,535714,30,1785714,Null,Null,59506822,610057,914
59506958,558.0,558.0,200000,110000,90000,45,200000,Null,Null,59506958,550695,1520
59519631,0.0,0.0,2508000,2508000,0,0,2508000,Null,Null,59519631,25422,1789
59549110,544.0,544.0,50000,29000,21000,42,50000,Null,Null,59549110,111461,1815
59598451,198.0,198.0,15000,15000,0,0,15000,Null,Null,59598451,111461,1883
59603586,2.0,2.0,14800000,14800000,0,0,14800000,Null,Null,59603586,939519,7079
59606337,0.0,0.0,4599000,4599000,0,0,4599000,Null,Null,59606337,949831,1520
59681636,0.0,0.0,11390000,11390000,0,0,11390000,Null,Null,59681636,218151,15318
60025441,10.0,10.0,350000,350000,0,0,350000,Null,Null,60025441,195137,914
60087497,0.0,0.0,7560000,7200000,360000,5,7560000,Null,Null,60087497,217131,1520
60206621,113.0,113.0,1100000,650000,450000,41,1100000,Null,Null,60206621,19312,1815
60210004,125.0,125.0,89900,89900,0,0,89900,Null,Null,60210004,111461,2140
60684152,1928.0,1928.0,370000,270000,100000,27,370000,Null,Null,60684152,221187,1613
60709422,984.0,984.0,273000,252000,21000,8,273000,Null,Null,60709422,523789,23254
60720934,135.0,135.0,534400,512000,22400,4,534400,Null,Null,60720934,111461,1815
60807085,1.0,1.0,13500000,13500000,0,0,13500000,Null,Null,60807085,444709,914
60842534,0.0,0.0,7050000,7050000,0,0,7050000,Null,Null,60842534,444709,15250
60859365,2.0,2.0,2646000,2646000,0,0,2646000,Null,Null,60859365,26150,914
60867458,37.0,37.0,213952,149766,64186,30,213952,Null,Null,60867458,111461,23184
60871436,1.0,1.0,3282000,2461500,820500,25,3282000,Null,Null,60871436,26150,914
61278429,58.0,58.0,125000,125000,0,0,125000,Null,Null,61278429,111461,1936
61436002,0.0,0.0,12500000,12500000,0,0,12500000,Null,Null,61436002,893943,11516
61443429,177.0,177.0,549000,549000,0,0,549000,Null,Null,61443429,20271,1815
61505492,0.0,0.0,15500000,15500000,0,0,15500000,Null,Null,61505492,893943,11516
62216290,37.0,37.0,549000,549000,0,0,549000,Null,Null,62216290,46363,914
62219309,2.0,2.0,3990000,2850000,1140000,29,3990000,Null,Null,62219309,610057,914
62231649,29.0,29.0,42000,42000,0,0,42000,Null,Null,62231649,111461,1883
62242668,45.0,45.0,699000,685020,13980,2,699000,Null,Null,62242668,523467,8061
62250964,276.0,276.0,113400,76545,36855,33,113400,Null,Null,62250964,922859,1520
62266000,620.0,620.0,57000,57000,0,0,57000,Null,Null,62266000,111461,1815
62321510,111.0,111.0,445000,445000,0,0,445000,Null,Null,62321510,48621,23246
62377771,36.0,36.0,3700000,3367000,333000,9,3700000,Null,Null,62377771,111461,1520
62380181,1.0,1.0,34980000,34980000,0,0,34980000,Null,Null,62380181,153444,1805
62404870,0.0,0.0,39990000,39990000,0,0,39990000,Null,Null,62404870,218151,914
62407768,0.0,0.0,14860000,14860000,0,0,14860000,Null,Null,62407768,218151,914
62445418,2274.0,2274.0,6690000,6550000,140000,2,6690000,Null,Null,62445418,18641,1811
62463756,0.0,0.0,820000,820000,0,0,820000,Null,Null,62463756,430485,15318
62469165,630.0,630.0,164000,164000,0,0,164000,Null,Null,62469165,697923,23346
62638300,70.0,70.0,450000,450000,0,0,450000,Null,Null,62638300,189445,1815
62659126,1.0,1.0,1249000,1249000,0,0,1249000,Null,Null,62659126,46363,914
62665022,0.0,0.0,10880000,10880000,0,0,10880000,Null,Null,62665022,1773095,1520
62734233,0.0,0.0,12300000,12300000,0,0,12300000,Null,Null,62734233,111461,914
62737131,3.0,3.0,4362000,4362000,0,0,4362000,Null,Null,62737131,1773095,11935
62746418,284.0,284.0,125000,125000,0,0,125000,Null,Null,62746418,179387,1883
62758016,213.0,213.0,110000,90000,20000,18,110000,Null,Null,62758016,173547,15318
62758138,155.0,155.0,635000,475000,160000,25,635000,Null,Null,62758138,47489,17170
62780882,0.0,0.0,6000000,6000000,0,0,6000000,Null,Null,62780882,859857,1520
62782971,0.0,0.0,4120000,4120000,0,0,4120000,Null,Null,62782971,1773095,1520
62807846,197.0,197.0,450000,335000,115000,26,450000,Null,Null,62807846,47427,1520
63042665,94.0,94.0,270000,270000,0,0,270000,Null,Null,63042665,937185,3426
63051860,2742.0,2742.0,189000,153000,36000,19,189000,Null,Null,63051860,835483,1883
63095796,12.0,12.0,10000,10000,0,0,10000,Null,Null,63095796,111461,8205
63132455,5.0,5.0,1250000,790000,460000,37,1250000,Null,Null,63132455,204731,914
63133571,979.0,979.0,180000,165000,15000,8,180000,Null,Null,63133571,252399,23352
63171394,1470.0,1470.0,24000,24000,0,0,24000,Null,Null,63171394,549763,1815
63180258,249.0,249.0,81000,69000,12000,15,81000,Null,Null,63180258,41403,1520
63181811,593.0,593.0,81000,69000,12000,15,81000,Null,Null,63181811,41403,1520
63183467,2.0,2.0,3563000,3563000,0,0,3563000,Null,Null,63183467,1773095,11937
63189511,0.0,0.0,3563000,3563000,0,0,3563000,Null,Null,63189511,1773095,11937
63281893,0.0,0.0,149000,149000,0,0,149000,Null,Null,63281893,885693,914
63448475,8.0,8.0,1250000,790000,460000,37,1250000,Null,Null,63448475,204731,914
63471339,396.0,396.0,93000,93000,0,0,93000,Null,Null,63471339,49242,8300
63511644,1110.0,1110.0,290000,290000,0,0,290000,Null,Null,63511644,49331,8170
63524260,1709.0,1709.0,199000,168000,31000,16,199000,Null,Null,63524260,929841,1520
63536208,808.0,808.0,120000,79000,41000,34,120000,Null,Null,63536208,856589,1815
63563274,1.0,1.0,4000000,4000000,0,0,4000000,Null,Null,63563274,463255,17170
63626604,1.0,1.0,6815000,6133500,681500,10,6815000,Null,Null,63626604,26150,914
63661859,0.0,0.0,10010000,7150000,2860000,29,10010000,Null,Null,63661859,405211,914
63793228,924.0,924.0,398000,210800,187200,47,398000,Null,Null,63793228,219695,1520
63881915,0.0,0.0,10010000,7150000,2860000,29,10010000,Null,Null,63881915,405211,914
63885053,0.0,0.0,10010000,7150000,2860000,29,10010000,Null,Null,63885053,405211,914
63886149,0.0,0.0,10010000,7150000,2860000,29,10010000,Null,Null,63886149,405211,914
63887525,1.0,1.0,10010000,7150000,2860000,29,10010000,Null,Null,63887525,405211,914
63900730,296.0,296.0,398000,258000,140000,35,398000,Null,Null,63900730,219695,8225
63906398,232.0,232.0,145000,145000,0,0,145000,Null,Null,63906398,710419,1815
63911076,305.0,305.0,40000,40000,0,0,40000,Null,Null,63911076,111461,1815
63912442,2145.0,2145.0,26500,26500,0,0,26500,Null,Null,63912442,111461,1815
63964407,4.0,4.0,1322000,1189800,132200,10,1322000,Null,Null,63964407,26150,914
64307571,600.0,600.0,15000,15000,0,0,15000,Null,Null,64307571,288231,5450
64350322,3.0,3.0,35000,35000,0,0,35000,Null,Null,64350322,111461,7064
64618364,0.0,0.0,112000,112000,0,0,112000,Null,Null,64618364,111461,23246
64700139,508.0,508.0,400000,319000,81000,20,400000,Null,Null,64700139,697923,23346
64715770,2.0,2.0,7100000,6532000,568000,8,7100000,Null,Null,64715770,111461,1520
64756714,58.0,58.0,149000,149000,0,0,149000,Null,Null,64756714,111461,914
64762415,588.0,588.0,149000,149000,0,0,149000,Null,Null,64762415,450299,1815
64988886,195.0,195.0,534000,297000,237000,44,534000,Null,Null,64988886,48077,2
64994332,408.0,408.0,468000,227800,240200,51,468000,Null,Null,64994332,219695,8225
65011722,310.0,310.0,300000,300000,0,0,300000,Null,Null,65011722,274015,914
65023938,7.0,7.0,99000,99000,0,0,99000,Null,Null,65023938,111461,914
65028561,2.0,2.0,23900000,23900000,0,0,23900000,Null,Null,65028561,153444,1805
65037736,0.0,0.0,34105000,34105000,0,0,34105000,Null,Null,65037736,153444,1805
65074378,1824.0,1824.0,55000,52000,3000,5,55000,Null,Null,65074378,111461,1815
65091422,4.0,4.0,6990000,6990000,0,0,6990000,Null,Null,65091422,112735,1795
65100080,610.0,610.0,950000,950000,0,0,950000,Null,Null,65100080,64932,1520
65100091,735.0,735.0,620000,550000,70000,11,620000,Null,Null,65100091,64932,2
65100098,1465.0,1465.0,620000,550000,70000,11,620000,Null,Null,65100098,64932,1520
65100105,1519.0,1519.0,950000,950000,0,0,950000,Null,Null,65100105,64932,1520
65125491,657.0,657.0,64000,52000,12000,19,64000,Null,Null,65125491,79682,1520
65380177,24.0,24.0,62500,62500,0,0,62500,Null,Null,65380177,185075,2347
65384695,1.0,1.0,58000,58000,0,0,58000,Null,Null,65384695,111461,914
65401394,1041.0,1041.0,112000,75600,36400,33,112000,Null,Null,65401394,3185581,1520
65462489,15.0,15.0,3519000,3519000,0,0,3519000,Null,Null,65462489,19018,1634
65473715,2.0,2.0,3519000,3519000,0,0,3519000,Null,Null,65473715,19018,1634
65492829,18.0,18.0,3990000,3990000,0,0,3990000,Null,Null,65492829,112735,1795
65493315,196.0,196.0,233000,233000,0,0,233000,Null,Null,65493315,221169,17170
65580383,4.0,4.0,19000,19000,0,0,19000,Null,Null,65580383,111461,8371
65864823,81.0,81.0,40000,28000,12000,30,40000,Null,Null,65864823,111461,914
65946632,61.0,61.0,459000,459000,0,0,459000,Null,Null,65946632,212149,1520
65955086,174.0,174.0,39000,39000,0,0,39000,Null,Null,65955086,867031,914
66076758,226.0,226.0,1714000,1106000,608000,35,1714000,Null,Null,66076758,195207,1520
66082740,0.0,0.0,3800000,3800000,0,0,3800000,Null,Null,66082740,1902711,1520
66086532,10.0,10.0,3519000,3519000,0,0,3519000,Null,Null,66086532,19018,1634
66105233,0.0,0.0,3800000,3800000,0,0,3800000,Null,Null,66105233,1902711,53350
66105581,0.0,0.0,3800000,3800000,0,0,3800000,Null,Null,66105581,1902711,1520
66107927,0.0,0.0,3800000,3800000,0,0,3800000,Null,Null,66107927,1902711,1520
66108357,0.0,0.0,3800000,3800000,0,0,3800000,Null,Null,66108357,1902711,1520
66114343,0.0,0.0,42430000,42430000,0,0,42430000,Null,Null,66114343,148220,2154
66115031,22.0,22.0,493000,493000,0,0,493000,Null,Null,66115031,295203,2136
66198772,0.0,0.0,8330000,5950000,2380000,29,8330000,Null,Null,66198772,405211,914
66200338,0.0,0.0,8330000,5950000,2380000,29,8330000,Null,Null,66200338,405211,914
66209816,9.0,9.0,154000,154000,0,0,154000,Null,Null,66209816,111461,914
66234206,0.0,0.0,17273000,17273000,0,0,17273000,Null,Null,66234206,26150,914
66409534,0.0,0.0,12708000,11437200,1270800,10,12708000,Null,Null,66409534,26150,914
66469559,1948.0,1948.0,398000,258000,140000,35,398000,Null,Null,66469559,219695,1520
66486229,62.0,62.0,189000,181000,8000,4,189000,Null,Null,66486229,111461,1815
66489581,1.0,1.0,17750000,17750000,0,0,17750000,Null,Null,66489581,218151,914
66511024,1056.0,1056.0,57000,26000,31000,54,57000,Null,Null,66511024,500047,1815
66511294,13.0,13.0,40000,40000,0,0,40000,Null,Null,66511294,111461,914
66528947,1395.0,1395.0,13900,13900,0,0,13900,Null,Null,66528947,288231,1883
66540656,19.0,19.0,179000,179000,0,0,179000,Null,Null,66540656,246045,1815
66541696,774.0,774.0,29000,28420,580,2,29000,Null,Null,66541696,111461,1815
66576427,419.0,419.0,31900,31900,0,0,31900,Null,Null,66576427,111461,6305
66583622,0.0,0.0,6185000,6185000,0,0,6185000,Null,Null,66583622,25502,914
66583646,0.0,0.0,6185000,6185000,0,0,6185000,Null,Null,66583646,25502,914
66590807,0.0,0.0,13860000,13860000,0,0,13860000,Null,Null,66590807,25502,914
66591878,3.0,3.0,12535000,11281500,1253500,10,12535000,Null,Null,66591878,26150,914
66593027,0.0,0.0,20308000,18277200,2030800,10,20308000,Null,Null,66593027,26150,914
66598362,4.0,4.0,1167000,1050300,116700,10,1167000,Null,Null,66598362,26150,914
66598528,1.0,1.0,6046000,6046000,0,0,6046000,Null,Null,66598528,26150,914
66604122,1.0,1.0,8464000,7617600,846400,10,8464000,Null,Null,66604122,26150,914
66604663,31.0,31.0,599000,499000,100000,17,599000,Null,Null,66604663,205957,8170
66607423,43.0,43.0,75000,75000,0,0,75000,Null,Null,66607423,111461,914
66611124,1.0,1.0,15545000,13990500,1554500,10,15545000,Null,Null,66611124,26150,914
66611538,5.0,5.0,1088000,848640,239360,22,1088000,Null,Null,66611538,26150,914
66612976,0.0,0.0,5885000,5885000,0,0,5885000,Null,Null,66612976,25502,914
66613498,0.0,0.0,7685000,7685000,0,0,7685000,Null,Null,66613498,25502,914
66617118,26.0,26.0,39998,19999,19999,50,39998,Null,Null,66617118,111461,1815
66618484,65.0,65.0,359000,359000,0,0,359000,Null,Null,66618484,453105,1520
66620077,11.0,11.0,57300,57300,0,0,57300,Null,Null,66620077,111461,1815
66621525,440.0,440.0,506000,279000,227000,45,506000,Null,Null,66621525,48077,2
66628603,1074.0,1074.0,13900,13900,0,0,13900,Null,Null,66628603,288231,1883
66631385,0.0,0.0,9485000,9485000,0,0,9485000,Null,Null,66631385,25502,914
66640235,26673.0,26673.0,279000,231000,48000,17,279000,Null,Null,66640235,21265,1520
66664256,1725.0,1725.0,9000,9000,0,0,9000,Null,Null,66664256,865351,8305
66672429,78.0,78.0,10400,10400,0,0,10400,Null,Null,66672429,111461,1883
66672533,11.0,11.0,31000,31000,0,0,31000,Null,Null,66672533,505165,914
66673963,8.0,8.0,35000,35000,0,0,35000,Null,Null,66673963,505165,15250
66674129,2.0,2.0,35000,35000,0,0,35000,Null,Null,66674129,505165,15250
66674136,228.0,228.0,95000,95000,0,0,95000,Null,Null,66674136,356031,13878
66676903,0.0,0.0,3300000,1650000,1650000,50,3300000,Null,Null,66676903,111461,15318
66680135,21.0,21.0,29000,29000,0,0,29000,Null,Null,66680135,505165,914
66680748,0.0,0.0,3300000,1650000,1650000,50,3300000,Null,Null,66680748,111461,15318
66680807,55.0,55.0,650000,366000,284000,44,650000,Null,Null,66680807,145567,1804
66681107,105.0,105.0,449000,449000,0,0,449000,Null,Null,66681107,281769,49722
66708181,1904.0,1904.0,80000,80000,0,0,80000,Null,Null,66708181,549763,1815
66726281,10.0,10.0,1350000,1170000,180000,13,1350000,Null,Null,66726281,870947,3422
66798490,76.0,76.0,149000,149000,0,0,149000,Null,Null,66798490,21265,1520
66806395,0.0,0.0,68000,68000,0,0,68000,Null,Null,66806395,111461,1883
66877577,1873.0,1873.0,89000,89000,0,0,89000,Null,Null,66877577,864561,2225
66902640,10.0,10.0,9000,9000,0,0,9000,Null,Null,66902640,111461,2
66903607,64.0,64.0,25000,25000,0,0,25000,Null,Null,66903607,111461,2
66904281,1.0,1.0,16000,16000,0,0,16000,Null,Null,66904281,111461,2
66948895,71.0,71.0,17891,17891,0,0,17891,Null,Null,66948895,111461,23258
67000173,0.0,0.0,7350000,6615000,735000,10,7350000,Null,Null,67000173,205847,1520
67017650,582.0,582.0,138000,116000,22000,16,138000,Null,Null,67017650,49242,8300
67056051,996.0,996.0,178000,178000,0,0,178000,Null,Null,67056051,885047,1815
67057767,1883.0,1883.0,159000,159000,0,0,159000,Null,Null,67057767,775567,1883
67070699,62.0,62.0,50000,33000,17000,34,50000,Null,Null,67070699,212647,53048
67087592,819.0,819.0,790000,790000,0,0,790000,Null,Null,67087592,3812995,1520
67088623,620.0,620.0,536000,284000,252000,47,536000,Null,Null,67088623,219695,8225
67110418,47.0,47.0,445000,435000,10000,2,445000,Null,Null,67110418,273243,1520
67173628,634.0,634.0,55000,55000,0,0,55000,Null,Null,67173628,21437,8371
67186443,1.0,1.0,5200000,5200000,0,0,5200000,Null,Null,67186443,260977,1520
67195663,1.0,1.0,590000,590000,0,0,590000,Null,Null,67195663,47803,11897
67233619,168.0,168.0,15200,15200,0,0,15200,Null,Null,67233619,111461,15318
67237361,0.0,0.0,13990000,13990000,0,0,13990000,Null,Null,67237361,218151,15318
67238390,0.0,0.0,6680000,6680000,0,0,6680000,Null,Null,67238390,218151,914
67238972,0.0,0.0,13990000,13990000,0,0,13990000,Null,Null,67238972,218151,15318
67240852,73.0,73.0,1290000,792000,498000,39,1290000,Null,Null,67240852,110682,1815
67245629,26.0,26.0,17000,17000,0,0,17000,Null,Null,67245629,374079,5450
67253710,66.0,66.0,85652,42826,42826,50,85652,Null,Null,67253710,111461,3175
67254426,2.0,2.0,1750000,1250000,500000,29,1750000,Null,Null,67254426,610057,914
67262282,267.0,267.0,89000,89000,0,0,89000,Null,Null,67262282,111461,1883
67278995,3.0,3.0,19000,19000,0,0,19000,Null,Null,67278995,111461,15320
67279633,0.0,0.0,23900000,23900000,0,0,23900000,Null,Null,67279633,939519,11516
67336799,0.0,0.0,28900000,28900000,0,0,28900000,Null,Null,67336799,939519,11516
67343939,0.0,0.0,24226000,24226000,0,0,24226000,Null,Null,67343939,19032,1803
67349560,0.0,0.0,42999999,42999999,0,0,42999999,Null,Null,67349560,858925,1883
67361105,0.0,0.0,38900000,38900000,0,0,38900000,Null,Null,67361105,939519,11516
67367853,0.0,0.0,45500000,45500000,0,0,45500000,Null,Null,67367853,939519,11516
67384986,0.0,0.0,52600000,52600000,0,0,52600000,Null,Null,67384986,939519,11516
67421152,7564.0,7564.0,215000,194000,21000,10,215000,Null,Null,67421152,86206,3422
67445781,38.0,38.0,112000,112000,0,0,112000,Null,Null,67445781,111461,1815
67492090,3.0,3.0,499000,299000,200000,40,499000,Null,Null,67492090,183257,914
67517393,423.0,423.0,67000,67000,0,0,67000,Null,Null,67517393,174069,1815
67561868,15.0,15.0,25000,25000,0,0,25000,Null,Null,67561868,111461,2153
67649521,0.0,0.0,25300000,25300000,0,0,25300000,Null,Null,67649521,191611,1815
67650750,958.0,958.0,160000,153000,7000,4,160000,Null,Null,67650750,3866781,23362
67660686,32.0,32.0,139000,139000,0,0,139000,Null,Null,67660686,878839,1883
67707813,374.0,374.0,99000,99000,0,0,99000,Null,Null,67707813,4433917,23276
67709566,402.0,402.0,18000,9270,8730,49,18000,Null,Null,67709566,111461,1815
67803254,0.0,0.0,5500000,5500000,0,0,5500000,Null,Null,67803254,260977,1520
67810097,621.0,621.0,1050000,559000,491000,47,1050000,Null,Null,67810097,225619,1520
67811819,2.0,2.0,189000,189000,0,0,189000,Null,Null,67811819,111461,1883
67859784,83.0,83.0,130500,125000,5500,4,130500,Null,Null,67859784,111461,1815
67863752,15.0,15.0,169000,161000,8000,5,169000,Null,Null,67863752,111461,1815
67907870,3377.0,3377.0,567600,431000,136600,24,567600,Null,Null,67907870,18984,1815
67916796,20.0,20.0,181100,181100,0,0,181100,Null,Null,67916796,111461,2225
67932480,1469.0,1469.0,850000,722500,127500,15,850000,Null,Null,67932480,148559,23388
67937873,450.0,450.0,370000,314500,55500,15,370000,Null,Null,67937873,148559,1883
67937938,1.0,1.0,330000,330000,0,0,330000,Null,Null,67937938,183257,914
67952235,45.0,45.0,8900,8900,0,0,8900,Null,Null,67952235,111461,1815
67975846,79.0,79.0,40900,40900,0,0,40900,Null,Null,67975846,3970517,1815
67979625,32.0,32.0,12000,12000,0,0,12000,Null,Null,67979625,111461,1815
67986941,0.0,0.0,17857143,12500000,5357143,30,17857143,Null,Null,67986941,405211,914
67989361,0.0,0.0,17857143,12500000,5357143,30,17857143,Null,Null,67989361,405211,914
67989898,0.0,0.0,379000,379000,0,0,379000,Null,Null,67989898,111461,1883
67994302,0.0,0.0,8071429,8071429,0,0,8071429,Null,Null,67994302,405211,914
68005401,6854.0,6854.0,392000,282000,110000,28,392000,Null,Null,68005401,47664,1520
68025108,0.0,0.0,22214286,15550000,6664286,30,22214286,Null,Null,68025108,732431,914
68034681,1170.0,1170.0,120000,85000,35000,29,120000,Null,Null,68034681,464405,1883
68059624,82.0,82.0,150000,150000,0,0,150000,Null,Null,68059624,111461,914
68063149,3.0,3.0,179000,179000,0,0,179000,Null,Null,68063149,111461,2
68074237,2.0,2.0,98000,98000,0,0,98000,Null,Null,68074237,111461,914
68165960,516.0,516.0,999000,839000,160000,16,999000,Null,Null,68165960,3978875,1626
68187835,993.0,993.0,285000,285000,0,0,285000,Null,Null,68187835,516689,53074
68188298,2130.0,2130.0,18000,9900,8100,45,18000,Null,Null,68188298,474145,8305
68234937,40.0,40.0,150000,150000,0,0,150000,Null,Null,68234937,111461,914
68235675,0.0,0.0,33999,33999,0,0,33999,Null,Null,68235675,111461,1815
68237610,117.0,117.0,20000,20000,0,0,20000,Null,Null,68237610,21437,914
68250779,2077.0,2077.0,185000,185000,0,0,185000,Null,Null,68250779,619995,1520
68257243,37.0,37.0,69000,69000,0,0,69000,Null,Null,68257243,111461,2
68279598,41.0,41.0,349000,349000,0,0,349000,Null,Null,68279598,312329,1815
68279712,1318.0,1318.0,130000,88000,42000,32,130000,Null,Null,68279712,47663,1520
68281314,5019.0,5019.0,130000,88000,42000,32,130000,Null,Null,68281314,47663,1520
68281783,1025.0,1025.0,130000,88000,42000,32,130000,Null,Null,68281783,47663,1520
68283313,144.0,144.0,199000,145000,54000,27,199000,Null,Null,68283313,3970517,1815
68332656,341.0,341.0,490000,343000,147000,30,490000,Null,Null,68332656,864171,11605
68341522,1147.0,1147.0,390000,273000,117000,30,390000,Null,Null,68341522,864171,1583
68353931,13.0,13.0,16000,16000,0,0,16000,Null,Null,68353931,111461,914
68354050,15.0,15.0,390000,240000,150000,38,390000,Null,Null,68354050,183257,914
68354444,41.0,41.0,99000,69000,30000,30,99000,Null,Null,68354444,111461,1811
68358114,0.0,0.0,0,350000,130000,0,350000,Null,Null,68358114,26675,0
68358766,2.0,2.0,16000,16000,0,0,16000,Null,Null,68358766,111461,914
68359531,3.0,3.0,16000,16000,0,0,16000,Null,Null,68359531,111461,914
68360730,219.0,219.0,475000,475000,0,0,475000,Null,Null,68360730,150002,1815
68362255,0.0,0.0,16000,16000,0,0,16000,Null,Null,68362255,111461,914
68363605,107.0,107.0,4700000,4280000,420000,9,4700000,Null,Null,68363605,222015,1520
68368171,11.0,11.0,16000,16000,0,0,16000,Null,Null,68368171,111461,914
68377224,1289.0,1289.0,30000,22200,7800,26,30000,Null,Null,68377224,3977923,1601
68399030,3.0,3.0,980000,980000,0,0,980000,Null,Null,68399030,46363,914
68410867,121.0,121.0,229000,229000,0,0,229000,Null,Null,68410867,411307,1883
68413077,29.0,29.0,285000,285000,0,0,285000,Null,Null,68413077,21651,23246
68420147,11.0,11.0,84797,84797,0,0,84797,Null,Null,68420147,111461,1815
68427702,1041.0,1041.0,199000,189050,9950,5,199000,Null,Null,68427702,25403,1520
68428513,21.0,21.0,98000,98000,0,0,98000,Null,Null,68428513,111461,49722
68429877,9007.0,9007.0,350000,256000,94000,27,350000,Null,Null,68429877,47663,1520
68438139,239.0,239.0,129000,125000,4000,3,129000,Null,Null,68438139,312329,1815
68439014,1.0,1.0,14950000,14950000,0,0,14950000,Null,Null,68439014,749425,28870
68467585,820.0,820.0,490000,490000,0,0,490000,Null,Null,68467585,2630119,1815
68474165,4.0,4.0,390000,230000,160000,41,390000,Null,Null,68474165,183257,914
68478297,3958.0,3958.0,39000,39000,0,0,39000,Null,Null,68478297,185677,53074
68491597,2267.0,2267.0,170000,138000,32000,19,170000,Null,Null,68491597,64943,2
68491719,606.0,606.0,250000,202000,48000,19,250000,Null,Null,68491719,64943,2
68494154,103.0,103.0,43000,43000,0,0,43000,Null,Null,68494154,660029,23622
68495317,1.0,1.0,14278000,14278000,0,0,14278000,Null,Null,68495317,749425,28870
68497878,0.0,0.0,10299000,10299000,0,0,10299000,Null,Null,68497878,111461,1520
68502142,20.0,20.0,410000,320000,90000,22,410000,Null,Null,68502142,183257,914
68513020,275.0,275.0,189000,189000,0,0,189000,Null,Null,68513020,111461,23622
68518477,411.0,411.0,900001,900001,0,0,900001,Null,Null,68518477,2630119,1815
68521325,236.0,236.0,45000,45000,0,0,45000,Null,Null,68521325,155734,23304
68533843,0.0,0.0,14890000,14890000,0,0,14890000,Null,Null,68533843,749425,28870
68535273,50.0,50.0,395000,395000,0,0,395000,Null,Null,68535273,111461,8068
68537974,1819.0,1819.0,170000,120000,50000,29,170000,Null,Null,68537974,143130,1520
68539925,34.0,34.0,349900,349900,0,0,349900,Null,Null,68539925,111461,1520
68540189,154.0,154.0,400000,280000,120000,30,400000,Null,Null,68540189,3977923,3424
68563011,0.0,0.0,17990,17990,0,0,17990,Null,Null,68563011,111461,1815
68565401,0.0,0.0,65000,65000,0,0,65000,Null,Null,68565401,111461,53048
68569188,49.0,49.0,59000,51000,8000,14,59000,Null,Null,68569188,111461,1815
68572201,5.0,5.0,450000,278000,172000,38,450000,Null,Null,68572201,183257,914
68577434,527.0,527.0,295000,173900,121100,41,295000,Null,Null,68577434,726473,1520
68581486,5.0,5.0,330000,297000,33000,10,330000,Null,Null,68581486,183257,914
68584753,0.0,0.0,16500000,10536000,5964000,36,16500000,Null,Null,68584753,416127,17170
68591841,2.0,2.0,410000,410000,0,0,410000,Null,Null,68591841,183257,15318
68594185,3.0,3.0,10199000,10199000,0,0,10199000,Null,Null,68594185,111461,1520
68611707,0.0,0.0,250000,250000,0,0,250000,Null,Null,68611707,3806307,11827
68611709,0.0,0.0,250000,250000,0,0,250000,Null,Null,68611709,3806307,11827
68693081,0.0,0.0,12490000,8176000,4314000,35,12490000,Null,Null,68693081,18802,1789
68716601,926.0,926.0,50000,43000,7000,14,50000,Null,Null,68716601,41048,2511
68716605,978.0,978.0,117000,89000,28000,24,117000,Null,Null,68716605,41048,1883
68736740,966.0,966.0,250000,139000,111000,44,250000,Null,Null,68736740,183203,2
68737242,39.0,39.0,199000,199000,0,0,199000,Null,Null,68737242,63894,1634
68741500,0.0,0.0,77899,75000,2899,4,77899,Null,Null,68741500,111461,23304
68753517,746.0,746.0,390000,229000,161000,41,390000,Null,Null,68753517,625853,1815
68759980,0.0,0.0,8071429,8071429,0,0,8071429,Null,Null,68759980,405211,914
68767294,1.0,1.0,125000,125000,0,0,125000,Null,Null,68767294,111461,1883
68768032,0.0,0.0,16500000,16500000,0,0,16500000,Null,Null,68768032,196425,1815
68773604,71.0,71.0,509000,509000,0,0,509000,Null,Null,68773604,49242,8305
68785171,200.0,200.0,54000,54000,0,0,54000,Null,Null,68785171,111461,914
68793627,4876.0,4876.0,320000,139000,181000,57,320000,Null,Null,68793627,314675,1815
68801867,136.0,136.0,37700,31900,5800,15,37700,Null,Null,68801867,111461,1815
68823687,1395.0,1395.0,399000,379000,20000,5,399000,Null,Null,68823687,885047,1815
68826659,1979.0,1979.0,337000,173000,164000,49,337000,Null,Null,68826659,48077,1520
68826859,0.0,0.0,15600000,15600000,0,0,15600000,Null,Null,68826859,749425,4966
68832828,1158.0,1158.0,702000,434000,268000,38,702000,Null,Null,68832828,48077,8170
68832830,306.0,306.0,701000,417000,284000,41,701000,Null,Null,68832830,48077,8170
68832832,981.0,981.0,394000,234000,160000,41,394000,Null,Null,68832832,48077,8170
68840521,0.0,0.0,4200000,4200000,0,0,4200000,Null,Null,68840521,111461,8061
68842354,0.0,0.0,3200000,3200000,0,0,3200000,Null,Null,68842354,111461,8061
68846901,355.0,355.0,900000,700000,200000,22,900000,Null,Null,68846901,51302,1883
68847367,2.0,2.0,2900000,2900000,0,0,2900000,Null,Null,68847367,111461,8061
68847758,1.0,1.0,785000,785000,0,0,785000,Null,Null,68847758,51302,1883
68856990,1.0,1.0,299000,299000,0,0,299000,Null,Null,68856990,111461,15318
68896469,105.0,105.0,34900,34900,0,0,34900,Null,Null,68896469,111461,8371
68942787,2257.0,2257.0,325000,262000,63000,19,325000,Null,Null,68942787,63894,1634
68985569,0.0,0.0,195000,195000,0,0,195000,Null,Null,68985569,111461,23258
68985833,1044.0,1044.0,57001,57001,0,0,57001,Null,Null,68985833,2630119,1815
68991005,10.0,10.0,20000,20000,0,0,20000,Null,Null,68991005,3748887,2784
68995320,11.0,11.0,84000,84000,0,0,84000,Null,Null,68995320,149308,1815
69078074,0.0,0.0,79000,79000,0,0,79000,Null,Null,69078074,111461,2
69078439,1.0,1.0,69999,69999,0,0,69999,Null,Null,69078439,111461,2234
69090743,17.0,17.0,15600,15600,0,0,15600,Null,Null,69090743,111461,15320
69091093,3.0,3.0,15000,15000,0,0,15000,Null,Null,69091093,111461,15320
69091102,52.0,52.0,19000,19000,0,0,19000,Null,Null,69091102,111461,2
69092094,31.0,31.0,19000,19000,0,0,19000,Null,Null,69092094,111461,2
69174556,296.0,296.0,84000,45600,38400,46,84000,Null,Null,69174556,48077,1520
69193092,562.0,562.0,119000,84000,35000,29,119000,Null,Null,69193092,230607,1883
69226574,87.0,87.0,31850,32000,0,0,31850,Null,Null,69226574,21437,1883
69238917,569.0,569.0,144900,144900,0,0,144900,Null,Null,69238917,21651,1815
69243877,214.0,214.0,1358000,1358000,0,0,1358000,Null,Null,69243877,145337,1520
69248810,0.0,0.0,172000,172000,0,0,172000,Null,Null,69248810,111461,6305
69253904,342.0,342.0,49000,43610,5390,11,49000,Null,Null,69253904,837721,1883
69255890,1.0,1.0,3496000,3496000,0,0,3496000,Null,Null,69255890,259989,17170
69324324,18.0,18.0,139000,99000,40000,29,139000,Null,Null,69324324,111461,1622
69327492,411.0,411.0,400000,299000,101000,25,400000,Null,Null,69327492,111461,23254
69440582,0.0,0.0,12500000,12500000,0,0,12500000,Null,Null,69440582,228187,1520
69457234,69.0,69.0,120000,120000,0,0,120000,Null,Null,69457234,149308,1815
69500507,1.0,1.0,59000,59000,0,0,59000,Null,Null,69500507,50034,5995
69539565,14.0,14.0,45000,45000,0,0,45000,Null,Null,69539565,111461,914
69539666,52.0,52.0,39000,39000,0,0,39000,Null,Null,69539666,111461,914
69625329,0.0,0.0,9928571,6950000,2978571,30,9928571,Null,Null,69625329,405211,914
69640954,29.0,29.0,650000,490000,160000,25,650000,Null,Null,69640954,183257,914
69641146,0.0,0.0,7900000,7900000,0,0,7900000,Null,Null,69641146,405211,5385
69645186,0.0,0.0,3928571,2750000,1178571,30,3928571,Null,Null,69645186,610057,5385
69699630,0.0,0.0,39975000,39975000,0,0,39975000,Null,Null,69699630,156411,28862
69699691,0.0,0.0,830000,830000,0,0,830000,Null,Null,69699691,111461,15318
69709888,0.0,0.0,31200000,31200000,0,0,31200000,Null,Null,69709888,156411,28862
69709934,0.0,0.0,4299000,4299000,0,0,4299000,Null,Null,69709934,550647,17170
69741184,5.0,5.0,120000,120000,0,0,120000,Null,Null,69741184,111461,23258
69764763,0.0,0.0,14214286,9950000,4264286,30,14214286,Null,Null,69764763,405211,914
69764816,0.0,0.0,14214286,9950000,4264286,30,14214286,Null,Null,69764816,405211,914
69837010,0.0,0.0,6850000,6850000,0,0,6850000,Null,Null,69837010,50763,15250
69839247,0.0,0.0,12190000,12190000,0,0,12190000,Null,Null,69839247,144779,1805
69843631,331.0,331.0,279000,259000,20000,7,279000,Null,Null,69843631,4065253,23254
69843993,4.0,4.0,89000,89000,0,0,89000,Null,Null,69843993,111461,15318
69884238,13.0,13.0,59000,59000,0,0,59000,Null,Null,69884238,111461,15318
69909973,2005.0,2005.0,159999,159999,0,0,159999,Null,Null,69909973,111461,23832
69929041,1087.0,1087.0,50000,50000,0,0,50000,Null,Null,69929041,111461,2337
69931916,248.0,248.0,599000,349000,250000,42,599000,Null,Null,69931916,111458,1815
69978395,633.0,633.0,198000,198000,0,0,198000,Null,Null,69978395,885047,1815
70002562,267.0,267.0,165000,156000,9000,5,165000,Null,Null,70002562,111461,23048
70020000,224.0,224.0,22000,22000,0,0,22000,Null,Null,70020000,111461,2
70077152,3.0,3.0,49000,49000,0,0,49000,Null,Null,70077152,111461,15250
70083074,6.0,6.0,1129000,1129000,0,0,1129000,Null,Null,70083074,51302,1883
70115294,737.0,737.0,57598,28799,28799,50,57598,Null,Null,70115294,111461,1815
70128921,18.0,18.0,139000,139000,0,0,139000,Null,Null,70128921,111461,914
70193175,49.0,49.0,608320,425824,182496,30,608320,Null,Null,70193175,111461,1520
70196873,29.0,29.0,450000,450000,0,0,450000,Null,Null,70196873,427581,914
70203275,150.0,150.0,120000,120000,0,0,120000,Null,Null,70203275,111461,49722
70211260,0.0,0.0,26500000,26500000,0,0,26500000,Null,Null,70211260,111461,1520
70372700,719.0,719.0,499000,465000,34000,7,499000,Null,Null,70372700,4251381,23246
70379205,0.0,0.0,9642857,6750000,2892857,30,9642857,Null,Null,70379205,405211,5384
70383740,0.0,0.0,9642857,6750000,2892857,30,9642857,Null,Null,70383740,405211,5384
70411921,0.0,0.0,19900,19900,0,0,19900,Null,Null,70411921,111461,1815
70419101,15.0,15.0,150000,94000,56000,37,150000,Null,Null,70419101,300165,1634
70440173,73.0,73.0,249000,249000,0,0,249000,Null,Null,70440173,111461,1815
70441032,414.0,414.0,99000,83000,16000,16,99000,Null,Null,70441032,79440,1634
70473110,4.0,4.0,13600,13600,0,0,13600,Null,Null,70473110,111461,15236
70495152,308.0,308.0,75000,61000,14000,19,75000,Null,Null,70495152,50653,1520
70495154,358.0,358.0,61000,50000,11000,18,61000,Null,Null,70495154,50653,1520
70508642,58.0,58.0,84900,84900,0,0,84900,Null,Null,70508642,111461,1815
70509100,853.0,853.0,350000,272000,78000,22,350000,Null,Null,70509100,258419,1520
70511684,145.0,145.0,81000,81000,0,0,81000,Null,Null,70511684,4066651,1520
70524690,1070.0,1070.0,600000,389000,211000,35,600000,Null,Null,70524690,4244853,1815
70550671,177.0,177.0,258000,258000,0,0,258000,Null,Null,70550671,182293,1520
70564013,26.0,26.0,40817,40817,0,0,40817,Null,Null,70564013,111461,2266
70567509,21.0,21.0,7000000,4500000,2500000,36,7000000,Null,Null,70567509,427097,17170
70567995,5.0,5.0,5750000,4500000,1250000,22,5750000,Null,Null,70567995,427097,17170
70600277,10.0,10.0,196000,196000,0,0,196000,Null,Null,70600277,111461,15250
70602645,0.0,0.0,9800000,9800000,0,0,9800000,Null,Null,70602645,111461,15318
70626692,0.0,0.0,48000000,48000000,0,0,48000000,Null,Null,70626692,4093985,1520
70626741,0.0,0.0,70000000,70000000,0,0,70000000,Null,Null,70626741,4093985,2340
70632006,0.0,0.0,4000000,4000000,0,0,4000000,Null,Null,70632006,148049,1520
70633870,3984.0,3984.0,50000,38000,12000,24,50000,Null,Null,70633870,192731,8305
70655135,968.0,968.0,1899000,990000,909000,48,1899000,Null,Null,70655135,160533,4381
70656791,13910.0,13910.0,125000,125000,0,0,125000,Null,Null,70656791,863033,2514
70661243,4144.0,4144.0,595000,539000,56000,9,595000,Null,Null,70661243,47489,1583
70662253,35063.0,35063.0,535000,479000,56000,10,535000,Null,Null,70662253,47489,1520
70662873,4227.0,4227.0,395000,359000,36000,9,395000,Null,Null,70662873,47489,1583
70664408,6.0,6.0,10500,10500,0,0,10500,Null,Null,70664408,111461,15236
70664508,5.0,5.0,329000,329000,0,0,329000,Null,Null,70664508,111461,15318
70667459,3.0,3.0,450000,319000,131000,29,450000,Null,Null,70667459,173547,15318
70669622,70.0,70.0,119000,119000,0,0,119000,Null,Null,70669622,149308,1815
70691829,1234.0,1234.0,50000,50000,0,0,50000,Null,Null,70691829,805681,914
70722342,142.0,142.0,495000,495000,0,0,495000,Null,Null,70722342,47489,3422
70737452,396.0,396.0,300000,284000,16000,5,300000,Null,Null,70737452,47489,1520
70767092,11.0,11.0,120000,88000,32000,27,120000,Null,Null,70767092,111461,15318
70770671,0.0,0.0,3500000,3500000,0,0,3500000,Null,Null,70770671,18804,1520
70771349,10.0,10.0,3490000,3490000,0,0,3490000,Null,Null,70771349,18804,1520
70772235,361.0,361.0,95000,91000,4000,4,95000,Null,Null,70772235,111461,1811
70773149,1.0,1.0,89000,65000,24000,27,89000,Null,Null,70773149,111461,15250
70780911,130.0,130.0,6990000,6160000,830000,12,6990000,Null,Null,70780911,20215,1805
70782264,1.0,1.0,24999,24999,0,0,24999,Null,Null,70782264,111461,2948
70784089,1.0,1.0,1499000,1199000,300000,20,1499000,Null,Null,70784089,18804,1634
70789367,2.0,2.0,10500,10500,0,0,10500,Null,Null,70789367,111461,15236
70809049,892.0,892.0,155000,155000,0,0,155000,Null,Null,70809049,235879,1520
70816908,0.0,0.0,9800000,9800000,0,0,9800000,Null,Null,70816908,111461,15318
70818712,97.0,97.0,519000,499000,20000,4,519000,Null,Null,70818712,18804,1520
70820849,1029.0,1029.0,58000,55000,3000,5,58000,Null,Null,70820849,19312,1883
70824100,16.0,16.0,4399000,3667000,732000,17,4399000,Null,Null,70824100,18804,1520
70824754,650.0,650.0,580000,229000,351000,61,580000,Null,Null,70824754,464405,23362
70832055,629.0,629.0,219000,199000,20000,9,219000,Null,Null,70832055,18804,1634
70832712,0.0,0.0,3390000,3390000,0,0,3390000,Null,Null,70832712,18804,1634
70834665,680.0,680.0,250000,119000,131000,52,250000,Null,Null,70834665,464405,23362
70835274,0.0,0.0,20000,20000,0,0,20000,Null,Null,70835274,111461,1634
70839193,8.0,8.0,2100000,1575000,525000,25,2100000,Null,Null,70839193,111461,8061
70840667,299.0,299.0,25000,24000,1000,4,25000,Null,Null,70840667,19312,1883
70841244,315.0,315.0,63000,63000,0,0,63000,Null,Null,70841244,111461,15318
70843099,995.0,995.0,550000,245000,305000,55,550000,Null,Null,70843099,143130,8225
70855173,3.0,3.0,5500000,4300000,1200000,22,5500000,Null,Null,70855173,427097,17170
70894746,56.0,56.0,390000,300000,90000,23,390000,Null,Null,70894746,243693,1815
70895043,760.0,760.0,729000,729000,0,0,729000,Null,Null,70895043,111454,1815
70896322,0.0,0.0,2347800,2347800,0,0,2347800,Null,Null,70896322,111461,15318
70898819,2122.0,2122.0,43000,43000,0,0,43000,Null,Null,70898819,863033,2514
70906467,1596.0,1596.0,48000,48000,0,0,48000,Null,Null,70906467,863033,2514
70908740,185.0,185.0,96000,58000,38000,40,96000,Null,Null,70908740,243693,1815
70914768,1379.0,1379.0,27800,27800,0,0,27800,Null,Null,70914768,111461,28480
71005991,3938.0,3938.0,174000,107000,67000,39,174000,Null,Null,71005991,48077,1883
71056691,528.0,528.0,125000,113000,12000,10,125000,Null,Null,71056691,50662,1520
71056693,0.0,0.0,6500000,6500000,0,0,6500000,Null,Null,71056693,405211,977
71059115,241.0,241.0,59000,58000,1000,2,59000,Null,Null,71059115,111461,1815
71059329,0.0,0.0,6500000,6500000,0,0,6500000,Null,Null,71059329,405211,977
71062803,230.0,230.0,349000,349000,0,0,349000,Null,Null,71062803,111461,23010
71063120,485.0,485.0,165000,165000,0,0,165000,Null,Null,71063120,111461,23622
71074280,371.0,371.0,180000,169000,11000,6,180000,Null,Null,71074280,291385,1520
71075600,394.0,394.0,243000,223000,20000,8,243000,Null,Null,71075600,291385,1520
71076384,348.0,348.0,159000,116000,43000,27,159000,Null,Null,71076384,3970517,1815
71083443,5.0,5.0,829000,829000,0,0,829000,Null,Null,71083443,46363,977
71087453,246.0,246.0,1450000,999000,451000,31,1450000,Null,Null,71087453,153086,1815
71088250,128.0,128.0,550000,369000,181000,33,550000,Null,Null,71088250,153086,12908
71091864,1031.0,1031.0,119000,119000,0,0,119000,Null,Null,71091864,111461,2657
71093754,1367.0,1367.0,351800,269000,82800,24,351800,Null,Null,71093754,282185,13878
71094027,99.0,99.0,300000,210000,90000,30,300000,Null,Null,71094027,500047,1815
71100477,157.0,157.0,89000,89000,0,0,89000,Null,Null,71100477,111461,1815
71111080,1241.0,1241.0,105000,105000,0,0,105000,Null,Null,71111080,456351,23588
71111117,109.0,109.0,95000,95000,0,0,95000,Null,Null,71111117,111461,1815
71111211,714.0,714.0,458000,229000,229000,50,458000,Null,Null,71111211,63894,1520
71148741,34.0,34.0,183000,183000,0,0,183000,Null,Null,71148741,4215399,1520
71174837,1815.0,1815.0,88000,88000,0,0,88000,Null,Null,71174837,245945,1883
71178441,875.0,875.0,115000,115000,0,0,115000,Null,Null,71178441,837855,5995
71187205,270.0,270.0,99000,69000,30000,30,99000,Null,Null,71187205,111461,23052
71200200,632.0,632.0,150000,132000,18000,12,150000,Null,Null,71200200,231023,1520
71203334,0.0,0.0,7680000,7680000,0,0,7680000,Null,Null,71203334,732431,1778
71203511,1.0,1.0,7680000,7680000,0,0,7680000,Null,Null,71203511,732431,1778
71206737,268.0,268.0,135000,121500,13500,10,135000,Null,Null,71206737,837721,1883
71214037,383.0,383.0,499000,320000,179000,36,499000,Null,Null,71214037,63967,1520
71288304,199.0,199.0,550000,130000,420000,76,550000,Null,Null,71288304,31627,1984
71289210,33.0,33.0,17820,8910,8910,50,17820,Null,Null,71289210,111461,1815
71289500,128.0,128.0,17774,8887,8887,50,17774,Null,Null,71289500,111461,1815
71291990,193.0,193.0,78700,75000,3700,5,78700,Null,Null,71291990,111461,1815
71296273,13.0,13.0,70000,36050,33950,49,70000,Null,Null,71296273,111461,1634
71324530,0.0,0.0,38507000,38507000,0,0,38507000,Null,Null,71324530,412629,1883
71355851,738.0,738.0,645000,490000,155000,24,645000,Null,Null,71355851,221187,1520
71505389,687.0,687.0,570001,570001,0,0,570001,Null,Null,71505389,2630119,1815
71512916,342.0,342.0,490000,400000,90000,18,490000,Null,Null,71512916,221187,1520
71513166,34.0,34.0,4199000,3494000,705000,17,4199000,Null,Null,71513166,18804,1634
71518873,0.0,0.0,939000,939000,0,0,939000,Null,Null,71518873,48077,1883
71518875,743.0,743.0,744000,458000,286000,38,744000,Null,Null,71518875,48077,1883
71518878,558.0,558.0,1248000,765000,483000,39,1248000,Null,Null,71518878,48077,1883
71523904,149.0,149.0,189000,158000,31000,16,189000,Null,Null,71523904,111461,1634
71526385,62.0,62.0,165000,165000,0,0,165000,Null,Null,71526385,4424515,1883
71544914,201.0,201.0,199000,187000,12000,6,199000,Null,Null,71544914,27464,53190
71641304,827.0,827.0,115000,89000,26000,23,115000,Null,Null,71641304,3970517,1815
71656427,47.0,47.0,54598,27299,27299,50,54598,Null,Null,71656427,205535,1815
71663537,125.0,125.0,65000,35499,29501,45,65000,Null,Null,71663537,111461,53048
71672203,3532.0,3532.0,79000,72000,7000,9,79000,Null,Null,71672203,18845,1815
71672934,282.0,282.0,635000,474000,161000,25,635000,Null,Null,71672934,47489,1520
71674971,331.0,331.0,599000,349000,250000,42,599000,Null,Null,71674971,171991,1805
71890908,2405.0,2405.0,412000,282000,130000,32,412000,Null,Null,71890908,41048,23832
71901189,3.0,3.0,679000,679000,0,0,679000,Null,Null,71901189,46363,977
71904532,0.0,0.0,4400000,3520000,880000,20,4400000,Null,Null,71904532,258977,3424
71924152,724.0,724.0,160000,144000,16000,10,160000,Null,Null,71924152,839837,53186
71924330,31.0,31.0,390000,249000,141000,36,390000,Null,Null,71924330,48077,2234
71925351,282.0,282.0,350000,161000,189000,54,350000,Null,Null,71925351,234815,1520
71925401,854.0,854.0,260000,163000,97000,37,260000,Null,Null,71925401,4224691,1883
71937321,19.0,19.0,2300000,1650000,650000,28,2300000,Null,Null,71937321,111461,23634
71949942,2.0,2.0,12690000,12690000,0,0,12690000,Null,Null,71949942,217953,28860
71950236,19002.0,19002.0,233000,208000,25000,11,233000,Null,Null,71950236,21269,1520
71952100,62.0,62.0,1200000,480000,720000,60,1200000,Null,Null,71952100,535885,1815
71961217,141.0,141.0,175000,175000,0,0,175000,Null,Null,71961217,864561,23246
71961298,59.0,59.0,1900,1900,0,0,1900,Null,Null,71961298,864561,2363
71979742,1353.0,1353.0,235000,193000,42000,18,235000,Null,Null,71979742,86206,1520
71984863,0.0,0.0,3710000,3710000,0,0,3710000,Null,Null,71984863,259989,1601
71989001,0.0,0.0,3710000,3710000,0,0,3710000,Null,Null,71989001,259989,3424
71999227,549.0,549.0,2870000,1580000,1290000,45,2870000,Null,Null,71999227,31627,2136
71999833,611.0,611.0,105000,105000,0,0,105000,Null,Null,71999833,225363,1520
72001514,0.0,0.0,8557413,5990189,2567224,30,8557413,Null,Null,72001514,405211,1778
72001961,0.0,0.0,8557143,5990000,2567143,30,8557143,Null,Null,72001961,405211,1778
72003782,14.0,14.0,96900,96900,0,0,96900,Null,Null,72003782,111461,1815
72004290,0.0,0.0,8928571,6250000,2678571,30,8928571,Null,Null,72004290,405211,1778
72006539,90.0,90.0,32000,32000,0,0,32000,Null,Null,72006539,21437,8371
72006895,12.0,12.0,35000,35000,0,0,35000,Null,Null,72006895,21437,8371
72007237,90.0,90.0,45000,45000,0,0,45000,Null,Null,72007237,21437,8371
72008742,0.0,0.0,8928571,6250000,2678571,30,8928571,Null,Null,72008742,405211,1778
72008812,0.0,0.0,9214286,6450000,2764286,30,9214286,Null,Null,72008812,405211,1778
72008836,0.0,0.0,9214286,9214286,0,0,9214286,Null,Null,72008836,405211,1778
72009313,0.0,0.0,10971429,7680000,3291429,30,10971429,Null,Null,72009313,732431,1778
72009378,0.0,0.0,10971429,7680000,3291429,30,10971429,Null,Null,72009378,732431,1778
72009463,0.0,0.0,10971429,7680000,3291429,30,10971429,Null,Null,72009463,732431,1778
72015075,1631.0,1631.0,189000,134000,55000,29,189000,Null,Null,72015075,709163,23228
72016327,74.0,74.0,199000,182000,17000,9,199000,Null,Null,72016327,505907,1815
72016703,625.0,625.0,400000,229000,171000,43,400000,Null,Null,72016703,4011099,2849
72016946,4.0,4.0,40700,40700,0,0,40700,Null,Null,72016946,111461,23362
72025176,417.0,417.0,105000,105000,0,0,105000,Null,Null,72025176,354595,17162
72026352,511.0,511.0,13900,13900,0,0,13900,Null,Null,72026352,288231,1883
72033262,2496.0,2496.0,230000,195000,35000,15,230000,Null,Null,72033262,548147,1520
72037054,2302.0,2302.0,250000,212000,38000,15,250000,Null,Null,72037054,548147,1520
72040937,7.0,7.0,590000,430000,160000,27,590000,Null,Null,72040937,183257,8371
72041074,329.0,329.0,1599000,873000,726000,45,1599000,Null,Null,72041074,500047,1815
72046925,10.0,10.0,80000,80000,0,0,80000,Null,Null,72046925,427581,8371
72049662,7.0,7.0,150000,150000,0,0,150000,Null,Null,72049662,111461,23032
72079123,0.0,0.0,15890000,15890000,0,0,15890000,Null,Null,72079123,477955,28860
72079880,0.0,0.0,17160000,17160000,0,0,17160000,Null,Null,72079880,477955,28860
72080446,0.0,0.0,21620000,21620000,0,0,21620000,Null,Null,72080446,477955,28860
72081129,47.0,47.0,198000,188000,10000,5,198000,Null,Null,72081129,192493,1815
72081657,0.0,0.0,24680000,24680000,0,0,24680000,Null,Null,72081657,477955,28860
72082625,0.0,0.0,25340000,25340000,0,0,25340000,Null,Null,72082625,477955,28860
72082648,1411.0,1411.0,119000,99000,20000,17,119000,Null,Null,72082648,231023,1520
72082913,0.0,0.0,26030000,26030000,0,0,26030000,Null,Null,72082913,477955,28860
72092344,0.0,0.0,26050000,26050000,0,0,26050000,Null,Null,72092344,477955,28860
72093563,0.0,0.0,15420000,15420000,0,0,15420000,Null,Null,72093563,477955,28860
72093668,60.0,60.0,133000,133000,0,0,133000,Null,Null,72093668,21437,8371
72094038,23.0,23.0,82000,82000,0,0,82000,Null,Null,72094038,21437,8371
72095605,414.0,414.0,55000,55000,0,0,55000,Null,Null,72095605,21437,8371
72095740,240.0,240.0,82000,82000,0,0,82000,Null,Null,72095740,21437,8371
72095958,24.0,24.0,205440,143808,61632,30,205440,Null,Null,72095958,111461,1815
72096486,0.0,0.0,13000000,9750000,3250000,25,13000000,Null,Null,72096486,46007,8227
72109547,36.0,36.0,77000,76900,100,0,77000,Null,Null,72109547,225363,1520
72120292,0.0,0.0,8177000,8177000,0,0,8177000,Null,Null,72120292,25502,1778
72122386,0.0,0.0,7577000,7577000,0,0,7577000,Null,Null,72122386,25502,1778
72128462,14.0,14.0,39000,39000,0,0,39000,Null,Null,72128462,111461,8371
72135186,26.0,26.0,142000,78000,64000,45,142000,Null,Null,72135186,111461,15250
72136931,0.0,0.0,9357143,6550000,2807143,30,9357143,Null,Null,72136931,405211,1778
72139431,0.0,0.0,9357143,9357143,0,0,9357143,Null,Null,72139431,405211,1778
72180189,156.0,156.0,709000,709000,0,0,709000,Null,Null,72180189,150002,1815
72182202,0.0,0.0,8377000,8377000,0,0,8377000,Null,Null,72182202,25502,1778
72182640,0.0,0.0,7877000,7877000,0,0,7877000,Null,Null,72182640,25502,1778
72182876,1.0,1.0,9177000,9177000,0,0,9177000,Null,Null,72182876,25502,1778
72183143,0.0,0.0,9877000,9877000,0,0,9877000,Null,Null,72183143,25502,1778
72183275,0.0,0.0,9177000,9177000,0,0,9177000,Null,Null,72183275,25502,1778
72183328,0.0,0.0,9177000,9177000,0,0,9177000,Null,Null,72183328,25502,1778
72193419,87.0,87.0,120000,120000,0,0,120000,Null,Null,72193419,373635,1815
72203125,21.0,21.0,8700000,7843000,857000,10,8700000,Null,Null,72203125,4093985,1520
72204655,4.0,4.0,10500000,9168000,1332000,13,10500000,Null,Null,72204655,4093985,2340
72223002,9.0,9.0,4250000,4250000,0,0,4250000,Null,Null,72223002,111461,1520
72283443,260.0,260.0,320000,320000,0,0,320000,Null,Null,72283443,111461,1883
72285990,1355.0,1355.0,450000,245000,205000,46,450000,Null,Null,72285990,4224691,1520
72286199,4581.0,4581.0,350000,225000,125000,36,350000,Null,Null,72286199,4224691,1520
72290345,19.0,19.0,3099000,3099000,0,0,3099000,Null,Null,72290345,183625,1789
72292517,119.0,119.0,75000,75000,0,0,75000,Null,Null,72292517,111461,8371
72310352,11.0,11.0,2990000,2990000,0,0,2990000,Null,Null,72310352,3979027,1794
72310420,11.0,11.0,3090000,3090000,0,0,3090000,Null,Null,72310420,3979027,1794
72314077,6.0,6.0,89000,89000,0,0,89000,Null,Null,72314077,885693,8371
72323456,2.0,2.0,19000,19000,0,0,19000,Null,Null,72323456,111461,1778
72323964,16.0,16.0,125000,125000,0,0,125000,Null,Null,72323964,111461,977
72324302,8.0,8.0,19000,19000,0,0,19000,Null,Null,72324302,111461,977
72330277,1.0,1.0,7150000,5362500,1787500,25,7150000,Null,Null,72330277,416127,8227
72331210,4.0,4.0,39000,39000,0,0,39000,Null,Null,72331210,111461,1815
72331309,0.0,0.0,19000,19000,0,0,19000,Null,Null,72331309,111461,1778
72332230,2.0,2.0,99000,99000,0,0,99000,Null,Null,72332230,111461,23362
72334399,0.0,0.0,2377,2377,0,0,2377,Null,Null,72334399,111461,2363
72341010,98.0,98.0,1350000,1350000,0,0,1350000,Null,Null,72341010,182293,1520
72455227,662.0,662.0,199000,149000,50000,25,199000,Null,Null,72455227,625265,1815
72459016,6.0,6.0,139000,139000,0,0,139000,Null,Null,72459016,484375,23258
72479013,0.0,0.0,4500000,4500000,0,0,4500000,Null,Null,72479013,464951,8227
72506145,489.0,489.0,35000,35000,0,0,35000,Null,Null,72506145,474145,8305
72506843,64.0,64.0,69000,69000,0,0,69000,Null,Null,72506843,111461,1815
72507719,0.0,0.0,1000,1000,0,0,1000,Null,Null,72507719,111461,2363
72515117,707.0,707.0,149000,129000,20000,13,149000,Null,Null,72515117,111461,1883
72517715,0.0,0.0,4900000,3675000,1225000,25,4900000,Null,Null,72517715,416127,8227
72522218,258.0,258.0,350000,239000,111000,32,350000,Null,Null,72522218,420823,23394
72524935,2.0,2.0,190000,190000,0,0,190000,Null,Null,72524935,427581,8371
72527573,6.0,6.0,165000,165000,0,0,165000,Null,Null,72527573,484375,23258
72540227,15.0,15.0,172900,172900,0,0,172900,Null,Null,72540227,111461,1815
72540740,1389.0,1389.0,69000,49000,20000,29,69000,Null,Null,72540740,625265,1815
72543046,4.0,4.0,19990,19990,0,0,19990,Null,Null,72543046,111461,2
72543784,4453.0,4453.0,280000,159000,121000,43,280000,Null,Null,72543784,4234729,1520
72543922,3.0,3.0,63900,62000,1900,3,63900,Null,Null,72543922,111461,3177
72548947,0.0,0.0,99000,99000,0,0,99000,Null,Null,72548947,111461,1883
72554623,15.0,15.0,129000,129000,0,0,129000,Null,Null,72554623,111461,8371
72555195,761.0,761.0,250000,152000,98000,39,250000,Null,Null,72555195,578757,1520
72558678,21.0,21.0,623000,534000,89000,14,623000,Null,Null,72558678,144018,8371
72559527,435.0,435.0,390000,199000,191000,49,390000,Null,Null,72559527,20324,2225
72562875,389.0,389.0,299000,299000,0,0,299000,Null,Null,72562875,47882,1778
72564309,8.0,8.0,234900,234900,0,0,234900,Null,Null,72564309,111461,1815
72573421,33.0,33.0,45000,39000,6000,13,45000,Null,Null,72573421,625265,1815
72588776,0.0,0.0,9999000,9999000,0,0,9999000,Null,Null,72588776,111461,2340
72593076,0.0,0.0,3760000,3760000,0,0,3760000,Null,Null,72593076,929067,17170
72603628,0.0,0.0,11850000,10665000,1185000,10,11850000,Null,Null,72603628,704815,8371
72612252,32.0,32.0,17800,17800,0,0,17800,Null,Null,72612252,111461,8371
72623840,3.0,3.0,199000,199000,0,0,199000,Null,Null,72623840,427581,8371
72627730,5.0,5.0,27000,23000,4000,15,27000,Null,Null,72627730,111461,2
72636913,155.0,155.0,129000,115000,14000,11,129000,Null,Null,72636913,21651,1815
72641551,67.0,67.0,48000,48000,0,0,48000,Null,Null,72641551,111461,23834
72641851,167.0,167.0,625000,389000,236000,38,625000,Null,Null,72641851,31627,1883
72644676,2810.0,2810.0,1250000,780000,470000,38,1250000,Null,Null,72644676,631569,1520
72646362,1151.0,1151.0,275000,275000,0,0,275000,Null,Null,72646362,878839,1883
72652203,11824.0,11824.0,350000,179000,171000,49,350000,Null,Null,72652203,48077,1883
72652604,4.0,4.0,14990000,14990000,0,0,14990000,Null,Null,72652604,20215,1805
72656351,125.0,125.0,279000,279000,0,0,279000,Null,Null,72656351,47882,1778
72657935,3.0,3.0,360000,360000,0,0,360000,Null,Null,72657935,111461,8371
72659983,407.0,407.0,150000,95000,55000,37,150000,Null,Null,72659983,484375,23258
72685546,1.0,1.0,3350000,3350000,0,0,3350000,Null,Null,72685546,215649,1520
72703286,4.0,4.0,268999,268999,0,0,268999,Null,Null,72703286,47882,1778
72708146,4.0,4.0,57500,57500,0,0,57500,Null,Null,72708146,111461,1984
72711789,269.0,269.0,350000,312000,38000,11,350000,Null,Null,72711789,22013,1520
72711793,438.0,438.0,250000,202000,48000,19,250000,Null,Null,72711793,112882,3422
72711795,376.0,376.0,350000,312000,38000,11,350000,Null,Null,72711795,22013,17170
72722793,2.0,2.0,1710000,1199000,511000,30,1710000,Null,Null,72722793,4647777,8371
72723335,53.0,53.0,279000,279000,0,0,279000,Null,Null,72723335,18984,1815
72724960,2.0,2.0,19000,19000,0,0,19000,Null,Null,72724960,111461,1778
72725402,230.0,230.0,939000,545000,394000,42,939000,Null,Null,72725402,18984,1815
72733899,490.0,490.0,199000,189000,10000,5,199000,Null,Null,72733899,578915,23800
72740929,72.0,72.0,1569000,1569000,0,0,1569000,Null,Null,72740929,936613,1520
72741438,41.0,41.0,3250000,3250000,0,0,3250000,Null,Null,72741438,4243517,1520
72741682,6.0,6.0,4480000,4480000,0,0,4480000,Null,Null,72741682,936613,1520
72742478,3.0,3.0,4800000,4800000,0,0,4800000,Null,Null,72742478,936509,1520
72743343,0.0,0.0,5100000,5100000,0,0,5100000,Null,Null,72743343,4238249,1520
72743990,0.0,0.0,5100000,5100000,0,0,5100000,Null,Null,72743990,4238249,53350
72744553,0.0,0.0,4700000,4700000,0,0,4700000,Null,Null,72744553,4238249,1601
72744882,11.0,11.0,850000,850000,0,0,850000,Null,Null,72744882,496357,8371
72745023,1.0,1.0,3900000,3900000,0,0,3900000,Null,Null,72745023,4238249,17170
72746857,63.0,63.0,899000,899000,0,0,899000,Null,Null,72746857,18984,1815
72747022,0.0,0.0,5400000,5400000,0,0,5400000,Null,Null,72747022,4238249,1520
72747251,0.0,0.0,4900000,4900000,0,0,4900000,Null,Null,72747251,4238249,1601
72749782,0.0,0.0,19000,19000,0,0,19000,Null,Null,72749782,111461,1778
72750093,348.0,348.0,124000,107000,17000,14,124000,Null,Null,72750093,3985581,1883
72751318,513.0,513.0,249000,206000,43000,17,249000,Null,Null,72751318,3985581,1883
72752985,60.0,60.0,381905,343714,38191,10,381905,Null,Null,72752985,469431,1520
72772127,1.0,1.0,4000000,4000000,0,0,4000000,Null,Null,72772127,4244773,11873
72786041,5.0,5.0,269000,269000,0,0,269000,Null,Null,72786041,324891,8371
72790514,2197.0,2197.0,150000,135500,14500,10,150000,Null,Null,72790514,841593,1520
72790654,922.0,922.0,129000,129000,0,0,129000,Null,Null,72790654,632685,17162
72791305,1.0,1.0,92000,92000,0,0,92000,Null,Null,72791305,885693,8371
72793524,172.0,172.0,77670,77670,0,0,77670,Null,Null,72793524,111461,1815
72796676,6887.0,6887.0,229000,187000,42000,18,229000,Null,Null,72796676,4244853,28682
72797082,880.0,880.0,662000,385000,277000,42,662000,Null,Null,72797082,48077,1883
72798536,2.0,2.0,3450000,3450000,0,0,3450000,Null,Null,72798536,215649,1520
72798596,0.0,0.0,3450000,3450000,0,0,3450000,Null,Null,72798596,215649,1520
72801993,489.0,489.0,75000,63750,11250,15,75000,Null,Null,72801993,542605,1612
72802278,0.0,0.0,8890000,7999000,891000,10,8890000,Null,Null,72802278,4647777,8371
72811154,142.0,142.0,430000,299000,131000,30,430000,Null,Null,72811154,153086,1815
72811865,257.0,257.0,500000,349000,151000,30,500000,Null,Null,72811865,153086,1815
72812080,308.0,308.0,550000,369000,181000,33,550000,Null,Null,72812080,153086,1815
72818491,855.0,855.0,400000,239000,161000,40,400000,Null,Null,72818491,4244853,1815
72820274,1.0,1.0,3450000,3450000,0,0,3450000,Null,Null,72820274,215649,1520
72829989,188.0,188.0,39000,39000,0,0,39000,Null,Null,72829989,4647777,23112
72855465,0.0,0.0,14999,14999,0,0,14999,Null,Null,72855465,111461,8371
72864994,995.0,995.0,788000,398000,390000,49,788000,Null,Null,72864994,4246951,8225
72877888,630.0,630.0,235000,189000,46000,20,235000,Null,Null,72877888,74674,1520
72886718,0.0,0.0,0,8700000,0,0,8700000,Null,Null,72886718,148698,0
72894385,245.0,245.0,250000,142000,108000,43,250000,Null,Null,72894385,4244853,1815
72904497,1592.0,1592.0,350000,179000,171000,49,350000,Null,Null,72904497,484375,23258
72907942,11.0,11.0,16000,16000,0,0,16000,Null,Null,72907942,111461,1778
72907962,241.0,241.0,299000,259000,40000,13,299000,Null,Null,72907962,4244853,1815
72910363,0.0,0.0,2000,2000,0,0,2000,Null,Null,72910363,111461,2363
72924805,453.0,453.0,640000,388000,252000,39,640000,Null,Null,72924805,4246951,1520
72928043,367.0,367.0,129000,129000,0,0,129000,Null,Null,72928043,226401,1811
72934529,1.0,1.0,3496000,3496000,0,0,3496000,Null,Null,72934529,259989,17170
72941056,3.0,3.0,195000,195000,0,0,195000,Null,Null,72941056,111461,8371
72944511,1269.0,1269.0,550000,289000,261000,47,550000,Null,Null,72944511,484375,23258
72946699,1.0,1.0,3724000,3724000,0,0,3724000,Null,Null,72946699,259989,17170
72950323,1341.0,1341.0,1113000,633000,480000,43,1113000,Null,Null,72950323,238861,1520
72957917,914.0,914.0,92000,60000,32000,35,92000,Null,Null,72957917,47664,17162
72958067,2.0,2.0,3960000,3960000,0,0,3960000,Null,Null,72958067,848709,3426
72964878,484.0,484.0,29000,29000,0,0,29000,Null,Null,72964878,111461,1815
72967700,0.0,0.0,540000,292499,247501,46,540000,Null,Null,72967700,111461,7078
73089488,69.0,69.0,990000,599000,391000,39,990000,Null,Null,73089488,246045,1815
73100586,2.0,2.0,225000,225000,0,0,225000,Null,Null,73100586,484375,23258
73100646,607.0,607.0,500000,269000,231000,46,500000,Null,Null,73100646,484375,23258
73109974,0.0,0.0,25000,18000,7000,28,25000,Null,Null,73109974,111461,15320
73110755,9.0,9.0,860000,774000,86000,10,860000,Null,Null,73110755,867995,5384
73113608,310.0,310.0,65000,65000,0,0,65000,Null,Null,73113608,50655,23282
73116651,1064.0,1064.0,490000,410000,80000,16,490000,Null,Null,73116651,20215,1811
73116895,39.0,39.0,137000,137000,0,0,137000,Null,Null,73116895,111461,1883
73119996,6.0,6.0,80000,80000,0,0,80000,Null,Null,73119996,111625,1815
73124602,1512.0,1512.0,677000,369000,308000,45,677000,Null,Null,73124602,48077,1883
73125530,439.0,439.0,362000,219000,143000,40,362000,Null,Null,73125530,48077,2225
73147684,91.0,91.0,14499,14499,0,0,14499,Null,Null,73147684,111461,1883
73159057,8.0,8.0,589000,589000,0,0,589000,Null,Null,73159057,21651,28454
73159447,529.0,529.0,150000,114000,36000,24,150000,Null,Null,73159447,21271,1520
73159766,279.0,279.0,150000,75000,75000,50,150000,Null,Null,73159766,630179,28480
73161165,1181.0,1181.0,78000,78000,0,0,78000,Null,Null,73161165,18845,1815
73165085,988.0,988.0,1750000,1580000,170000,10,1750000,Null,Null,73165085,18984,1815
73166945,280.0,280.0,2999000,2428000,571000,19,2999000,Null,Null,73166945,18984,1815
73169208,17.0,17.0,8500,8500,0,0,8500,Null,Null,73169208,111461,1622
73170496,897.0,897.0,100500,99000,1500,1,100500,Null,Null,73170496,273971,8300
73172151,385.0,385.0,160000,152000,8000,5,160000,Null,Null,73172151,273971,8300
73175118,0.0,0.0,10000,6000,4000,40,10000,Null,Null,73175118,48381,1601
73176764,309.0,309.0,349000,349000,0,0,349000,Null,Null,73176764,885047,1815
73179180,6809.0,6809.0,225000,205000,20000,9,225000,Null,Null,73179180,18845,1815
73180505,1316.0,1316.0,72000,72000,0,0,72000,Null,Null,73180505,49242,8300
73188683,610.0,610.0,350000,320000,30000,9,350000,Null,Null,73188683,4244853,1815
73200748,286.0,286.0,139000,69500,69500,50,139000,Null,Null,73200748,4259829,1778
73222724,15.0,15.0,65000,65000,0,0,65000,Null,Null,73222724,111461,8371
73229352,27.0,27.0,390000,390000,0,0,390000,Null,Null,73229352,209501,1815
73237382,175.0,175.0,319000,319000,0,0,319000,Null,Null,73237382,21278,1520
73246805,331.0,331.0,549000,274000,275000,50,549000,Null,Null,73246805,63967,1634
73249678,81.0,81.0,2000,2000,0,0,2000,Null,Null,73249678,111461,11935
73251840,120.0,120.0,339000,339000,0,0,339000,Null,Null,73251840,151948,1520
73258372,72.0,72.0,18000,18000,0,0,18000,Null,Null,73258372,111461,15250
73258681,1968.0,1968.0,569000,234000,335000,59,569000,Null,Null,73258681,111461,8400
73258986,251.0,251.0,150000,146000,4000,3,150000,Null,Null,73258986,111461,1815
73261273,148.0,148.0,520000,520000,0,0,520000,Null,Null,73261273,25277,28452
73261935,1415.0,1415.0,149000,118000,31000,21,149000,Null,Null,73261935,4244853,28480
73272411,23.0,23.0,427413,299189,128224,30,427413,Null,Null,73272411,505907,1815
73272523,1.0,1.0,989000,989000,0,0,989000,Null,Null,73272523,46363,977
73272837,1856.0,1856.0,333000,297000,36000,11,333000,Null,Null,73272837,21273,1520
73276050,398.0,398.0,295000,250750,44250,15,295000,Null,Null,73276050,542605,11605
73278406,54.0,54.0,1680000,1680000,0,0,1680000,Null,Null,73278406,936509,1520
73279927,41.0,41.0,450000,239000,211000,47,450000,Null,Null,73279927,535885,20244
73282711,98.0,98.0,8000,8000,0,0,8000,Null,Null,73282711,111461,8225
73283164,1330.0,1330.0,54000,45000,9000,17,54000,Null,Null,73283164,201259,11605
73283203,1222.0,1222.0,199000,189000,10000,5,199000,Null,Null,73283203,238861,1520
73284283,0.0,0.0,65990000,59391000,6599000,10,65990000,Null,Null,73284283,18985,2977
73295335,2.0,2.0,89000,89000,0,0,89000,Null,Null,73295335,111461,8371
73296168,1.0,1.0,89000,89000,0,0,89000,Null,Null,73296168,111461,8371
73314056,659.0,659.0,99000,65000,34000,34,99000,Null,Null,73314056,230607,2513
73314528,67.0,67.0,59000,53000,6000,10,59000,Null,Null,73314528,19312,2153
73314682,517.0,517.0,1300000,724000,576000,44,1300000,Null,Null,73314682,146479,1811
73315307,6525.0,6525.0,119000,109000,10000,8,119000,Null,Null,73315307,18845,1815
73322326,9.0,9.0,98000,98000,0,0,98000,Null,Null,73322326,185075,11605
73324095,1316.0,1316.0,1149000,1060000,89000,8,1149000,Null,Null,73324095,177927,12864
73340203,21.0,21.0,150000,93500,56500,38,150000,Null,Null,73340203,111461,28598
73353333,286.0,286.0,269000,188000,81000,30,269000,Null,Null,73353333,230607,23258
73357368,3.0,3.0,12950000,12950000,0,0,12950000,Null,Null,73357368,50307,2324
73357747,0.0,0.0,5328000,3996000,1332000,25,5328000,Null,Null,73357747,689449,53350
73359412,7.0,7.0,989000,989000,0,0,989000,Null,Null,73359412,46363,5385
73370326,649.0,649.0,150000,150000,0,0,150000,Null,Null,73370326,805681,8513
73371622,23.0,23.0,110000,110000,0,0,110000,Null,Null,73371622,149308,28578
73383975,7.0,7.0,38700,26000,12700,33,38700,Null,Null,73383975,111461,28480
73383988,35.0,35.0,2990,2990,0,0,2990,Null,Null,73383988,111461,1815
73397512,501.0,501.0,80000,66000,14000,18,80000,Null,Null,73397512,478585,1628
73398642,289.0,289.0,809000,779000,30000,4,809000,Null,Null,73398642,18804,28454
73401906,420.0,420.0,369000,295000,74000,20,369000,Null,Null,73401906,856971,11879
73417188,1357.0,1357.0,50000,50000,0,0,50000,Null,Null,73417188,805681,8516
73420992,232.0,232.0,25000,22000,3000,12,25000,Null,Null,73420992,111461,49724
73429228,447.0,447.0,119000,119000,0,0,119000,Null,Null,73429228,632685,17162
73464817,2294.0,2294.0,141000,91000,50000,35,141000,Null,Null,73464817,204895,6305
73466625,1106.0,1106.0,999000,560000,439000,44,999000,Null,Null,73466625,204895,6305
73467694,2519.0,2519.0,1141000,679000,462000,40,1141000,Null,Null,73467694,204895,6305
73476789,161.0,161.0,1430000,1350000,80000,6,1430000,Null,Null,73476789,53335,28644
73493365,1398.0,1398.0,129000,86000,43000,33,129000,Null,Null,73493365,709163,1883
73498231,10.0,10.0,980000,980000,0,0,980000,Null,Null,73498231,46363,5384
73502149,1854.0,1854.0,21000,15000,6000,29,21000,Null,Null,73502149,204895,2363
73503576,465.0,465.0,999000,594000,405000,41,999000,Null,Null,73503576,204895,6305
73521432,279.0,279.0,156900,156900,0,0,156900,Null,Null,73521432,111461,28596
73525956,2.0,2.0,441000,441000,0,0,441000,Null,Null,73525956,370711,11905
73526371,119.0,119.0,189000,181000,8000,4,189000,Null,Null,73526371,111461,28596
73529207,24.0,24.0,699000,569000,130000,19,699000,Null,Null,73529207,46363,5384
73529777,2675.0,2675.0,999000,594000,405000,41,999000,Null,Null,73529777,204895,6305
73532408,1178.0,1178.0,129000,100000,29000,22,129000,Null,Null,73532408,238407,17170
73535800,79.0,79.0,255000,237150,17850,7,255000,Null,Null,73535800,4269901,49724
73550854,2.0,2.0,10000,10000,0,0,10000,Null,Null,73550854,111461,1622
73574817,22.0,22.0,414000,319000,95000,23,414000,Null,Null,73574817,173547,15320
73574991,915.0,915.0,390000,229000,161000,41,390000,Null,Null,73574991,4271555,1613
73578957,7.0,7.0,3480000,3480000,0,0,3480000,Null,Null,73578957,4019225,11857
73579683,0.0,0.0,6909000,6218100,690900,10,6909000,Null,Null,73579683,26150,8512
73579836,0.0,0.0,6909000,6218100,690900,10,6909000,Null,Null,73579836,26150,8512
73580134,0.0,0.0,7526000,6773400,752600,10,7526000,Null,Null,73580134,26150,8512
73580429,0.0,0.0,8636000,7772400,863600,10,8636000,Null,Null,73580429,26150,8512
73591263,0.0,0.0,717000,717000,0,0,717000,Null,Null,73591263,111461,2136
73592303,162.0,162.0,399000,399000,0,0,399000,Null,Null,73592303,879421,28454
73598275,0.0,0.0,15150000,15150000,0,0,15150000,Null,Null,73598275,52315,8064
73603441,670.0,670.0,135000,110000,25000,19,135000,Null,Null,73603441,156043,1520
73606173,143.0,143.0,548000,274000,274000,50,548000,Null,Null,73606173,4246951,8225
73607516,1977.0,1977.0,366000,352000,14000,4,366000,Null,Null,73607516,149699,1583
73609586,470.0,470.0,450000,245000,205000,46,450000,Null,Null,73609586,4224691,8225
73610037,218.0,218.0,160000,160000,0,0,160000,Null,Null,73610037,111461,23032
73611332,40.0,40.0,455000,298000,157000,35,455000,Null,Null,73611332,243693,3804
73613964,43.0,43.0,160960,160960,0,0,160960,Null,Null,73613964,111461,17186
73620690,112.0,112.0,45000,45000,0,0,45000,Null,Null,73620690,939243,8305
73622188,824.0,824.0,99000,38000,61000,62,99000,Null,Null,73622188,500047,28480
73631483,576.0,576.0,650000,325000,325000,50,650000,Null,Null,73631483,25501,8170
73632586,2477.0,2477.0,199000,68000,131000,66,199000,Null,Null,73632586,4246951,8602
73632595,0.0,0.0,24900000,23655000,1245000,5,24900000,Null,Null,73632595,20215,8067
73637331,10.0,10.0,135000,114000,21000,16,135000,Null,Null,73637331,4274875,5872
73638934,1579.0,1579.0,450000,169000,281000,62,450000,Null,Null,73638934,31627,1883
73638938,2629.0,2629.0,358000,168300,189700,53,358000,Null,Null,73638938,4246951,1520
73639522,970.0,970.0,19000,15000,4000,21,19000,Null,Null,73639522,4259821,1883
73639668,1495.0,1495.0,220000,99000,121000,55,220000,Null,Null,73639668,314675,2324
73640967,1528.0,1528.0,19000,15000,4000,21,19000,Null,Null,73640967,4259821,1883
73644584,464.0,464.0,69000,46000,23000,33,69000,Null,Null,73644584,500047,28428
73648998,229.0,229.0,18000,18000,0,0,18000,Null,Null,73648998,111461,8371
73649660,447.0,447.0,19000,19000,0,0,19000,Null,Null,73649660,111461,8516
73652466,4.0,4.0,16000,16000,0,0,16000,Null,Null,73652466,111461,2
73657949,0.0,0.0,20500000,19475000,1025000,5,20500000,Null,Null,73657949,50331,2324
73676255,24.0,24.0,18000,18000,0,0,18000,Null,Null,73676255,111461,15318
73688130,0.0,0.0,14000000,13300000,700000,5,14000000,Null,Null,73688130,50331,8064
73688517,510.0,510.0,399000,289000,110000,28,399000,Null,Null,73688517,314675,1836
73717853,0.0,0.0,12100000,12100000,0,0,12100000,Null,Null,73717853,50331,11518
73731363,233.0,233.0,99000,49000,50000,51,99000,Null,Null,73731363,53195,20244
73731649,1.0,1.0,803000,626340,176660,22,803000,Null,Null,73731649,26150,8511
73737383,271.0,271.0,19774,9887,9887,50,19774,Null,Null,73737383,111461,28576
73738667,11.0,11.0,24000,24000,0,0,24000,Null,Null,73738667,111461,2
73738671,6.0,6.0,19000,19000,0,0,19000,Null,Null,73738671,111461,2
73747701,73.0,73.0,500000,250000,250000,50,500000,Null,Null,73747701,500047,8400
73751947,264.0,264.0,500000,276000,224000,45,500000,Null,Null,73751947,500047,8400
73753804,74.0,74.0,750000,449000,301000,40,750000,Null,Null,73753804,153086,28460
73754955,0.0,0.0,13930000,9950000,3980000,29,13930000,Null,Null,73754955,405211,8512
73754996,59.0,59.0,165000,165000,0,0,165000,Null,Null,73754996,171459,8513
73768914,92.0,92.0,83999,83999,0,0,83999,Null,Null,73768914,163707,28574
73771544,25.0,25.0,34000,34000,0,0,34000,Null,Null,73771544,162313,28574
73772600,38.0,38.0,84000,79000,5000,6,84000,Null,Null,73772600,18420,1820
73775727,220.0,220.0,275000,275000,0,0,275000,Null,Null,73775727,21651,8400
73775892,173.0,173.0,937000,599000,338000,36,937000,Null,Null,73775892,851519,23658
73784809,245.0,245.0,359000,353000,6000,2,359000,Null,Null,73784809,46335,1520
73785211,34.0,34.0,178000,178000,0,0,178000,Null,Null,73785211,46335,1634
73785488,1795.0,1795.0,1000000,488000,512000,51,1000000,Null,Null,73785488,110935,1883
73785537,466.0,466.0,67000,67000,0,0,67000,Null,Null,73785537,938179,2514
73785816,637.0,637.0,189000,188000,1000,1,189000,Null,Null,73785816,46335,1634
73788989,0.0,0.0,3900000,3900000,0,0,3900000,Null,Null,73788989,209187,53350
73811766,14.0,14.0,1058000,1058000,0,0,1058000,Null,Null,73811766,18802,8067
73821908,107.0,107.0,8000,8000,0,0,8000,Null,Null,73821908,111461,11935
73824900,210.0,210.0,84000,84000,0,0,84000,Null,Null,73824900,111461,27212
73833717,2.0,2.0,9000,8910,90,1,9000,Null,Null,73833717,111461,1819
73834128,36.0,36.0,135000,135000,0,0,135000,Null,Null,73834128,111461,20250
73834463,286.0,286.0,210000,210000,0,0,210000,Null,Null,73834463,619995,11859
73835897,8.0,8.0,799000,689000,110000,14,799000,Null,Null,73835897,46363,5385
73836787,0.0,0.0,99000000,99000000,0,0,99000000,Null,Null,73836787,111461,23072
73838616,39.0,39.0,300000,300000,0,0,300000,Null,Null,73838616,111461,53074
73839993,9.0,9.0,14999,14999,0,0,14999,Null,Null,73839993,111461,15318
73841542,217.0,217.0,415000,310000,105000,25,415000,Null,Null,73841542,26689,1613
73842403,61.0,61.0,225000,225000,0,0,225000,Null,Null,73842403,111461,8061
73842873,1.0,1.0,5000,5000,0,0,5000,Null,Null,73842873,111461,49724
73843510,0.0,0.0,8000,8000,0,0,8000,Null,Null,73843510,111461,49724
73861620,0.0,0.0,13930000,9950000,3980000,29,13930000,Null,Null,73861620,405211,8512
73861766,1.0,1.0,9730000,6950000,2780000,29,9730000,Null,Null,73861766,405211,8512
73861938,1.0,1.0,6950000,6950000,0,0,6950000,Null,Null,73861938,405211,8512
73862804,0.0,0.0,8386000,5990000,2396000,29,8386000,Null,Null,73862804,405211,8512
73862894,0.0,0.0,8386000,5990000,2396000,29,8386000,Null,Null,73862894,405211,8512
73871124,0.0,0.0,12000,12000,0,0,12000,Null,Null,73871124,111461,49724
73873223,14.0,14.0,12999000,12999000,0,0,12999000,Null,Null,73873223,185209,28644
73873738,98.0,98.0,25000,25000,0,0,25000,Null,Null,73873738,111461,15250
73873866,80.0,80.0,35000,35000,0,0,35000,Null,Null,73873866,111461,15250
73878037,162.0,162.0,1052000,639000,413000,39,1052000,Null,Null,73878037,851519,23658
73881507,43.0,43.0,5000,5000,0,0,5000,Null,Null,73881507,111461,49724
73893946,2.0,2.0,17000,17000,0,0,17000,Null,Null,73893946,111461,27546
73914995,64.0,64.0,12000,12000,0,0,12000,Null,Null,73914995,111461,49728
73919012,0.0,0.0,9900000,9900000,0,0,9900000,Null,Null,73919012,228187,1520
73921325,4.0,4.0,16000,16000,0,0,16000,Null,Null,73921325,111461,27546
73921463,278.0,278.0,270000,169000,101000,37,270000,Null,Null,73921463,355541,1613
73925328,26.0,26.0,255000,210000,45000,18,255000,Null,Null,73925328,225363,1583
73935625,27.0,27.0,1000,1000,0,0,1000,Null,Null,73935625,111461,2363
73953897,0.0,0.0,12560000,12560000,0,0,12560000,Null,Null,73953897,885749,8512
73953901,210.0,210.0,475000,405000,70000,15,475000,Null,Null,73953901,200189,11881
73954600,1.0,1.0,23000,23000,0,0,23000,Null,Null,73954600,111461,5384
73955462,12.0,12.0,24000,24000,0,0,24000,Null,Null,73955462,111461,5384
73983505,80.0,80.0,100000,59000,41000,41,100000,Null,Null,73983505,4647777,15236
73983551,0.0,0.0,179000,179000,0,0,179000,Null,Null,73983551,111461,1936
73985382,1.0,1.0,320000,160000,160000,50,320000,Null,Null,73985382,4647777,15318
73987485,1599.0,1599.0,1090000,901000,189000,17,1090000,Null,Null,73987485,20215,2324
73987516,0.0,0.0,14900000,14900000,0,0,14900000,Null,Null,73987516,20215,6653
74011705,97.0,97.0,147278,147278,0,0,147278,Null,Null,74011705,370711,11905
74013930,225.0,225.0,19000,19000,0,0,19000,Null,Null,74013930,111461,2337
74014046,1908.0,1908.0,138000,71000,67000,49,138000,Null,Null,74014046,48077,23340
74027101,0.0,0.0,7150000,7150000,0,0,7150000,Null,Null,74027101,885749,8512
74027211,0.0,0.0,7350000,7350000,0,0,7350000,Null,Null,74027211,885749,8512
74028823,0.0,0.0,7350000,7350000,0,0,7350000,Null,Null,74028823,885749,8512
74028850,0.0,0.0,7150000,7150000,0,0,7150000,Null,Null,74028850,885749,8512
74028898,0.0,0.0,7150000,7150000,0,0,7150000,Null,Null,74028898,885749,8512
74028942,0.0,0.0,7350000,7350000,0,0,7350000,Null,Null,74028942,885749,8512
74030194,5.0,5.0,18000,18000,0,0,18000,Null,Null,74030194,111461,15250
74037442,2.0,2.0,299000,249000,50000,17,299000,Null,Null,74037442,111461,1936
74154800,152.0,152.0,209000,209000,0,0,209000,Null,Null,74154800,862545,8602
74167275,125.0,125.0,132000,132000,0,0,132000,Null,Null,74167275,542605,8206
74172795,27.0,27.0,3356000,2515000,841000,25,3356000,Null,Null,74172795,26150,8512
74173109,13.0,13.0,5337000,3798000,1539000,29,5337000,Null,Null,74173109,26150,8513
74190625,95.0,95.0,290000,290000,0,0,290000,Null,Null,74190625,149308,28486
74192960,769.0,769.0,1750000,1083000,667000,38,1750000,Null,Null,74192960,631569,1520
74196948,145.0,145.0,295000,265500,29500,10,295000,Null,Null,74196948,4269901,1883
74203364,106.0,106.0,599000,409000,190000,32,599000,Null,Null,74203364,46363,5384
74209976,6.0,6.0,200000,200000,0,0,200000,Null,Null,74209976,111461,15318
74212316,694.0,694.0,188000,98000,90000,48,188000,Null,Null,74212316,4246951,8602
74212735,615.0,615.0,188000,114000,74000,39,188000,Null,Null,74212735,4246951,8602
74215409,115.0,115.0,29000,27550,1450,5,29000,Null,Null,74215409,4269901,11923
74227207,0.0,0.0,6517000,6517000,0,0,6517000,Null,Null,74227207,885749,8512
74234330,271.0,271.0,790000,790000,0,0,790000,Null,Null,74234330,423053,8512
74256249,1.0,1.0,6350000,6350000,0,0,6350000,Null,Null,74256249,885749,8512
74256360,81.0,81.0,59359,59359,0,0,59359,Null,Null,74256360,111461,7064
74257575,788.0,788.0,2750000,1650000,1100000,40,2750000,Null,Null,74257575,631569,2340
74257819,545.0,545.0,480000,248000,232000,48,480000,Null,Null,74257819,171991,5531
74259499,150.0,150.0,190000,95000,95000,50,190000,Null,Null,74259499,484375,23258
74265058,345.0,345.0,139000,139000,0,0,139000,Null,Null,74265058,504203,20174
74267658,94.0,94.0,178980,178980,0,0,178980,Null,Null,74267658,111461,2225
74279173,17.0,17.0,69000,69000,0,0,69000,Null,Null,74279173,111461,15320
74296343,45.0,45.0,220000,129000,91000,41,220000,Null,Null,74296343,48077,1984
74296344,848.0,848.0,264000,137000,127000,48,264000,Null,Null,74296344,48077,1984
74296404,6.0,6.0,15000,15000,0,0,15000,Null,Null,74296404,111461,15318
74307186,691.0,691.0,350000,295000,55000,16,350000,Null,Null,74307186,276745,3426
74307765,784.0,784.0,352000,182000,170000,48,352000,Null,Null,74307765,48077,2136
74307989,0.0,0.0,9680000,9680000,0,0,9680000,Null,Null,74307989,111461,2340
74308679,59.0,59.0,198778,198778,0,0,198778,Null,Null,74308679,370711,11905
74309478,50.0,50.0,149000,149000,0,0,149000,Null,Null,74309478,680981,49722
74311720,368.0,368.0,240000,209000,31000,13,240000,Null,Null,74311720,47663,1637
74343712,417.0,417.0,46000,46000,0,0,46000,Null,Null,74343712,111461,3805
74361382,268.0,268.0,26000,13000,13000,50,26000,Null,Null,74361382,4647777,15318
74380138,652.0,652.0,500000,355000,145000,29,500000,Null,Null,74380138,4011099,2514
74387377,2301.0,2301.0,127000,127000,0,0,127000,Null,Null,74387377,4254887,1883
74392984,26.0,26.0,34000,34000,0,0,34000,Null,Null,74392984,111461,8516
74396976,4221.0,4221.0,171000,99000,72000,42,171000,Null,Null,74396976,48077,2513
74403984,19.0,19.0,27000,27000,0,0,27000,Null,Null,74403984,111461,8513
74409316,538.0,538.0,349000,114000,235000,67,349000,Null,Null,74409316,302375,1838
74409358,498.0,498.0,119000,85000,34000,29,119000,Null,Null,74409358,230607,23052
74439635,0.0,0.0,3800000,3800000,0,0,3800000,Null,Null,74439635,209187,53350
74440049,755.0,755.0,880000,836000,44000,5,880000,Null,Null,74440049,202607,1520
74440051,1489.0,1489.0,800000,760000,40000,5,800000,Null,Null,74440051,202607,1520
74446838,0.0,0.0,7990000,7990000,0,0,7990000,Null,Null,74446838,885749,8512
74446943,0.0,0.0,7990000,7990000,0,0,7990000,Null,Null,74446943,885749,8512
74447048,0.0,0.0,8290000,8290000,0,0,8290000,Null,Null,74447048,885749,8512
74447181,0.0,0.0,8290000,8290000,0,0,8290000,Null,Null,74447181,885749,8512
74447465,0.0,0.0,5850000,5850000,0,0,5850000,Null,Null,74447465,885749,8512
74447787,0.0,0.0,5850000,5850000,0,0,5850000,Null,Null,74447787,885749,8512
74450527,4729.0,4729.0,628000,358000,270000,43,628000,Null,Null,74450527,4246951,8225
74491450,0.0,0.0,5800000,4350000,1450000,25,5800000,Null,Null,74491450,416127,8227
74492258,1556.0,1556.0,139000,139000,0,0,139000,Null,Null,74492258,49242,8300
74494910,423.0,423.0,23000,11500,11500,50,23000,Null,Null,74494910,4647777,15318
74495234,34.0,34.0,589000,589000,0,0,589000,Null,Null,74495234,46363,5384
74497023,22.0,22.0,28000,14000,14000,50,28000,Null,Null,74497023,4647777,15318
74498670,3.0,3.0,214900,214900,0,0,214900,Null,Null,74498670,21651,12908
74501282,73.0,73.0,26000,13000,13000,50,26000,Null,Null,74501282,4647777,15318
74501291,7.0,7.0,26000,13000,13000,50,26000,Null,Null,74501291,4647777,15318
74501293,73.0,73.0,26000,13000,13000,50,26000,Null,Null,74501293,4647777,15318
74527291,1968.0,1968.0,698000,358000,340000,49,698000,Null,Null,74527291,4246951,8225
74527302,53.0,53.0,38000,38000,0,0,38000,Null,Null,74527302,111461,15250
74534016,0.0,0.0,6545000,6545000,0,0,6545000,Null,Null,74534016,259989,17170
74534174,0.0,0.0,6000,6000,0,0,6000,Null,Null,74534174,111461,28480
74537541,4.0,4.0,28000,28000,0,0,28000,Null,Null,74537541,111461,5384
74538244,16.0,16.0,69500,69500,0,0,69500,Null,Null,74538244,111461,28578
74540152,638.0,638.0,144000,118000,26000,18,144000,Null,Null,74540152,4246951,1520
74540247,104.0,104.0,368000,198000,170000,46,368000,Null,Null,74540247,4246951,1520
74552693,2.0,2.0,45000,45000,0,0,45000,Null,Null,74552693,111461,23258
74559065,471.0,471.0,668000,348000,320000,48,668000,Null,Null,74559065,4246951,8225
74560808,0.0,0.0,10299000,10299000,0,0,10299000,Null,Null,74560808,111461,2340
74561072,534.0,534.0,78000,58000,20000,26,78000,Null,Null,74561072,4246951,1520
74563363,1.0,1.0,3850000,3850000,0,0,3850000,Null,Null,74563363,260977,11885
74594525,96.0,96.0,589000,589000,0,0,589000,Null,Null,74594525,46363,977
74598515,2278.0,2278.0,149000,149000,0,0,149000,Null,Null,74598515,549763,23362
74607743,426.0,426.0,328000,198000,130000,40,328000,Null,Null,74607743,4246951,1520
74608134,817.0,817.0,93000,83700,9300,10,93000,Null,Null,74608134,612965,8305
74625053,1.0,1.0,12000000,12000000,0,0,12000000,Null,Null,74625053,4284003,11935
74625130,3.0,3.0,1140000,889200,250800,22,1140000,Null,Null,74625130,26150,8512
74625269,219.0,219.0,75000,61000,14000,19,75000,Null,Null,74625269,112886,3426
74629168,3.0,3.0,932000,661720,270280,29,932000,Null,Null,74629168,26150,8512
74629311,387.0,387.0,500000,235000,265000,53,500000,Null,Null,74629311,500047,2324
74640666,394.0,394.0,75000,65000,10000,13,75000,Null,Null,74640666,185875,1613
74640670,1426.0,1426.0,250000,239000,11000,4,250000,Null,Null,74640670,185875,1520
74684872,11.0,11.0,390000,390000,0,0,390000,Null,Null,74684872,47882,8512
74690414,1.0,1.0,5500000,4400000,1100000,20,5500000,Null,Null,74690414,231355,3424
74745016,12.0,12.0,556000,556000,0,0,556000,Null,Null,74745016,47803,11859
74749721,109.0,109.0,2980000,2652000,328000,11,2980000,Null,Null,74749721,18984,3428
74755009,344.0,344.0,27000,27000,0,0,27000,Null,Null,74755009,111461,27544
74773356,5.0,5.0,8000,7000,1000,13,8000,Null,Null,74773356,111461,11935
74776150,0.0,0.0,4450000,4450000,0,0,4450000,Null,Null,74776150,183625,28856
74793510,0.0,0.0,9699000,9699000,0,0,9699000,Null,Null,74793510,111461,2340
74820436,8.0,8.0,55000,55000,0,0,55000,Null,Null,74820436,145914,20174
74824588,0.0,0.0,6670000,6000000,670000,10,6670000,Null,Null,74824588,4647777,15318
74829195,30.0,30.0,22000,22000,0,0,22000,Null,Null,74829195,111461,5384
74831675,61.0,61.0,29000,27550,1450,5,29000,Null,Null,74831675,4269901,23026
74850073,4.0,4.0,7500,7500,0,0,7500,Null,Null,74850073,111461,28480
74852415,159.0,159.0,338000,184000,154000,46,338000,Null,Null,74852415,4246951,1520
74853177,259.0,259.0,68000,38000,30000,44,68000,Null,Null,74853177,4246951,1520
74853731,201.0,201.0,190000,190000,0,0,190000,Null,Null,74853731,111461,49722
74857653,0.0,0.0,65020000,65020000,0,0,65020000,Null,Null,74857653,218967,7079
74858414,0.0,0.0,93350000,93350000,0,0,93350000,Null,Null,74858414,218967,7079
74858773,95.0,95.0,279000,279000,0,0,279000,Null,Null,74858773,3985581,1883
74859074,432.0,432.0,169000,149000,20000,12,169000,Null,Null,74859074,3985581,1883
74860473,16.0,16.0,73500,73500,0,0,73500,Null,Null,74860473,111461,2514
74860644,243.0,243.0,500000,227000,273000,55,500000,Null,Null,74860644,500047,1811
74886177,27.0,27.0,30000,30000,0,0,30000,Null,Null,74886177,111461,5384
74890302,833.0,833.0,199000,119000,80000,40,199000,Null,Null,74890302,625265,28574
74891073,107.0,107.0,70700,70700,0,0,70700,Null,Null,74891073,111461,1832
74892725,0.0,0.0,19999000,12143000,7856000,39,19999000,Null,Null,74892725,18776,7273
74892961,0.0,0.0,9000,9000,0,0,9000,Null,Null,74892961,111461,20222
74909451,113.0,113.0,399000,399000,0,0,399000,Null,Null,74909451,111461,6305
74912653,651.0,651.0,199000,199000,0,0,199000,Null,Null,74912653,4409909,28480
74912675,39.0,39.0,990000,769000,221000,22,990000,Null,Null,74912675,18984,3428
74914618,175.0,175.0,349000,349000,0,0,349000,Null,Null,74914618,20304,2136
74923685,315.0,315.0,120000,120000,0,0,120000,Null,Null,74923685,21653,28574
74926626,329.0,329.0,50000,45000,5000,10,50000,Null,Null,74926626,111461,1634
74935039,0.0,0.0,15550000,15550000,0,0,15550000,Null,Null,74935039,217953,2324
74944335,24.0,24.0,470000,247000,223000,47,470000,Null,Null,74944335,19034,12908
74947859,13.0,13.0,8500,8500,0,0,8500,Null,Null,74947859,111461,7064
74953170,224.0,224.0,30000,15000,15000,50,30000,Null,Null,74953170,4647777,15318
74953327,151.0,151.0,380000,200000,180000,47,380000,Null,Null,74953327,19034,5006
74973204,881.0,881.0,230000,155000,75000,33,230000,Null,Null,74973204,4224691,5905
74979014,45.0,45.0,20799,20799,0,0,20799,Null,Null,74979014,111461,20222
74979558,12.0,12.0,171000,135000,36000,21,171000,Null,Null,74979558,111461,15320
74983835,1.0,1.0,350000,192500,157500,45,350000,Null,Null,74983835,150522,15250
74987374,29.0,29.0,90000,90000,0,0,90000,Null,Null,74987374,4307205,1831
74989524,396.0,396.0,596000,298000,298000,50,596000,Null,Null,74989524,4246951,8225
75070037,16.0,16.0,98900,98900,0,0,98900,Null,Null,75070037,4224691,28682
75082841,201.0,201.0,72600,72600,0,0,72600,Null,Null,75082841,4224691,28682
75126128,127.0,127.0,31500,31500,0,0,31500,Null,Null,75126128,111461,15318
75302784,258.0,258.0,330000,316000,14000,4,330000,Null,Null,75302784,3866781,23102
75307295,1215.0,1215.0,35000,24000,11000,31,35000,Null,Null,75307295,886923,8305
75315653,0.0,0.0,21890000,21890000,0,0,21890000,Null,Null,75315653,477955,28860
75315771,4.0,4.0,8000,8000,0,0,8000,Null,Null,75315771,111461,7064
75316241,0.0,0.0,19989000,19989000,0,0,19989000,Null,Null,75316241,111461,2340
75318981,134.0,134.0,650000,552500,97500,15,650000,Null,Null,75318981,19034,5006
75319550,0.0,0.0,63600000,63600000,0,0,63600000,Null,Null,75319550,477955,28860
75330036,9.0,9.0,8000,8000,0,0,8000,Null,Null,75330036,111461,7064
75337445,399.0,399.0,100000,64000,36000,36,100000,Null,Null,75337445,4224691,28480
75339729,914.0,914.0,140000,85000,55000,39,140000,Null,Null,75339729,4011099,2234
75340681,5020.0,5020.0,120000,82000,38000,32,120000,Null,Null,75340681,245945,23622
75341307,0.0,0.0,19020000,19020000,0,0,19020000,Null,Null,75341307,477955,28860
75341399,0.0,0.0,24490000,24490000,0,0,24490000,Null,Null,75341399,477955,28860
75342332,0.0,0.0,12670000,12670000,0,0,12670000,Null,Null,75342332,477955,8064
75343605,2232.0,2232.0,1885000,1244000,641000,34,1885000,Null,Null,75343605,160211,3422
75345447,0.0,0.0,16790000,16790000,0,0,16790000,Null,Null,75345447,477955,8064
75345747,4710.0,4710.0,393000,275000,118000,30,393000,Null,Null,75345747,86206,1520
75349058,0.0,0.0,19780000,19780000,0,0,19780000,Null,Null,75349058,477955,28860
75353278,0.0,0.0,21740000,21740000,0,0,21740000,Null,Null,75353278,477955,28860
75354717,1051.0,1051.0,350000,266000,84000,24,350000,Null,Null,75354717,245945,23622
75356087,687.0,687.0,60000,60000,0,0,60000,Null,Null,75356087,111461,2514
75362178,63.0,63.0,1280000,965000,315000,25,1280000,Null,Null,75362178,18776,28646
75362844,1.0,1.0,456000,456000,0,0,456000,Null,Null,75362844,665539,15320
75378154,1.0,1.0,17779000,17779000,0,0,17779000,Null,Null,75378154,111461,2340
75397375,143.0,143.0,220000,220000,0,0,220000,Null,Null,75397375,4307205,4429
75401427,114.0,114.0,139500,139500,0,0,139500,Null,Null,75401427,111461,20492
75409136,469.0,469.0,248000,148000,100000,40,248000,Null,Null,75409136,4246951,8602
75409313,261.0,261.0,97000,58000,39000,40,97000,Null,Null,75409313,4246951,8602
75409484,4.0,4.0,25000,25000,0,0,25000,Null,Null,75409484,111461,28480
75411540,32.0,32.0,139000,139000,0,0,139000,Null,Null,75411540,4269901,11911
75418241,396.0,396.0,33000,31350,1650,5,33000,Null,Null,75418241,4269901,53048
75418439,213.0,213.0,145000,145000,0,0,145000,Null,Null,75418439,111461,28574
75424505,29.0,29.0,140000,140000,0,0,140000,Null,Null,75424505,111461,2
75432779,0.0,0.0,15220000,15220000,0,0,15220000,Null,Null,75432779,477955,28860
75434280,0.0,0.0,7920000,6336000,1584000,20,7920000,Null,Null,75434280,45884,5384
75434583,164.0,164.0,29000,27550,1450,5,29000,Null,Null,75434583,4269901,20236
75440160,684.0,684.0,1000,1000,0,0,1000,Null,Null,75440160,111461,2363
75441527,1.0,1.0,14000,7000,7000,50,14000,Null,Null,75441527,111461,2340
75446813,130.0,130.0,1498000,1498000,0,0,1498000,Null,Null,75446813,505907,4593
75448879,67.0,67.0,75000,75000,0,0,75000,Null,Null,75448879,111461,20174
75478111,314.0,314.0,49000,46550,2450,5,49000,Null,Null,75478111,4269901,27212
75514008,79.0,79.0,59000,59000,0,0,59000,Null,Null,75514008,111461,28484
75523405,2668.0,2668.0,189000,118000,71000,38,189000,Null,Null,75523405,4246951,1520
75528793,602.0,602.0,168000,118000,50000,30,168000,Null,Null,75528793,4246951,8602
75548937,1.0,1.0,6250000,6250000,0,0,6250000,Null,Null,75548937,111461,11933
75549435,43.0,43.0,589000,449000,140000,24,589000,Null,Null,75549435,46363,5384
75574549,442.0,442.0,500000,216000,284000,57,500000,Null,Null,75574549,500047,5531
75582647,538.0,538.0,219000,219000,0,0,219000,Null,Null,75582647,21651,28460
75587969,158.0,158.0,176000,99000,77000,44,176000,Null,Null,75587969,625853,4428
75589943,23.0,23.0,1199000,1199000,0,0,1199000,Null,Null,75589943,46363,5385
75597928,307.0,307.0,85000,80750,4250,5,85000,Null,Null,75597928,839837,3877
75609705,75.0,75.0,569000,479000,90000,16,569000,Null,Null,75609705,46363,5384
75614175,71.0,71.0,72900,72900,0,0,72900,Null,Null,75614175,171991,1837
75615959,4435.0,4435.0,89000,89000,0,0,89000,Null,Null,75615959,746615,2685
75619163,1.0,1.0,220000,159000,61000,28,220000,Null,Null,75619163,4275489,11879
75620816,3.0,3.0,2000,2000,0,0,2000,Null,Null,75620816,111461,27214
75621730,1014.0,1014.0,210000,175000,35000,17,210000,Null,Null,75621730,4275591,11869
75624900,726.0,726.0,650000,355000,295000,45,650000,Null,Null,75624900,4401579,2784
75627035,73.0,73.0,499000,499000,0,0,499000,Null,Null,75627035,879421,28454
75627647,213.0,213.0,99000,79000,20000,20,99000,Null,Null,75627647,112081,23304
75640683,74.0,74.0,157000,139000,18000,11,157000,Null,Null,75640683,4427297,11877
75641000,3.0,3.0,44000,44000,0,0,44000,Null,Null,75641000,111461,5385
75655835,94.0,94.0,68540,60000,8540,12,68540,Null,Null,75655835,171991,1838
75659112,5274.0,5274.0,130000,120000,10000,8,130000,Null,Null,75659112,523789,23658
75661165,245.0,245.0,73600,73600,0,0,73600,Null,Null,75661165,111461,23052
75664370,531.0,531.0,199000,199000,0,0,199000,Null,Null,75664370,111461,23362
75664735,106.0,106.0,899000,516000,383000,43,899000,Null,Null,75664735,63967,1634
75678269,327.0,327.0,30000,9000,21000,70,30000,Null,Null,75678269,111461,1815
75678362,551.0,551.0,95000,95000,0,0,95000,Null,Null,75678362,111461,53190
75678665,25.0,25.0,899000,899000,0,0,899000,Null,Null,75678665,464185,5267
75697296,7.0,7.0,9799999,9799999,0,0,9799999,Null,Null,75697296,111461,2340
75702967,193.0,193.0,1080000,995000,85000,8,1080000,Null,Null,75702967,523789,23642
75703442,27.0,27.0,68679,68679,0,0,68679,Null,Null,75703442,111461,3177
75703864,6.0,6.0,9200000,9200000,0,0,9200000,Null,Null,75703864,111461,11933
75707483,1.0,1.0,110000,110000,0,0,110000,Null,Null,75707483,111461,5385
75715449,180.0,180.0,54000,54000,0,0,54000,Null,Null,75715449,111461,5384
75727537,125.0,125.0,150000,142500,7500,5,150000,Null,Null,75727537,4269901,23282
75762781,4.0,4.0,5160000,5160000,0,0,5160000,Null,Null,75762781,227957,11845
75763939,75.0,75.0,409900,409900,0,0,409900,Null,Null,75763939,111461,8073
75767360,0.0,0.0,690000,690000,0,0,690000,Null,Null,75767360,46363,5384
75783271,0.0,0.0,11850000,10665000,1185000,10,11850000,Null,Null,75783271,704815,15236
75783351,1239.0,1239.0,160000,160000,0,0,160000,Null,Null,75783351,821321,2513
75794505,594.0,594.0,225000,191250,33750,15,225000,Null,Null,75794505,277519,3177
75801356,92.0,92.0,539000,539000,0,0,539000,Null,Null,75801356,146479,1811
75814756,199.0,199.0,1990000,1450000,540000,27,1990000,Null,Null,75814756,157347,11933
75825790,0.0,0.0,19000,19000,0,0,19000,Null,Null,75825790,111461,15318
75826179,382.0,382.0,298000,198000,100000,34,298000,Null,Null,75826179,4246951,8602
75828777,0.0,0.0,4900000,4900000,0,0,4900000,Null,Null,75828777,499169,8206
75830990,4.0,4.0,8300000,8300000,0,0,8300000,Null,Null,75830990,499169,8227
75832222,1.0,1.0,5270000,5220000,50000,1,5270000,Null,Null,75832222,199801,11885
75832520,789.0,789.0,196000,147000,49000,25,196000,Null,Null,75832520,4431399,13878
75836319,913.0,913.0,119000,119000,0,0,119000,Null,Null,75836319,454787,1883
75840487,139.0,139.0,280000,210000,70000,25,280000,Null,Null,75840487,4431443,11859
75842514,1031.0,1031.0,350000,160000,190000,54,350000,Null,Null,75842514,308227,11851
75946733,29.0,29.0,240000,240000,0,0,240000,Null,Null,75946733,40971,8220
75964520,518.0,518.0,8000,8000,0,0,8000,Null,Null,75964520,193683,8305
75980492,348.0,348.0,2750000,1093000,1657000,60,2750000,Null,Null,75980492,500047,7081
75983726,30.0,30.0,133000,130000,3000,2,133000,Null,Null,75983726,199801,11885
75986578,4.0,4.0,6600000,6600000,0,0,6600000,Null,Null,75986578,499169,8227
75997194,1716.0,1716.0,688000,388000,300000,44,688000,Null,Null,75997194,4246951,8225
76001295,215.0,215.0,500000,236000,264000,53,500000,Null,Null,76001295,500047,5531
76001622,1.0,1.0,99000,69000,30000,30,99000,Null,Null,76001622,111461,15318
76010108,2.0,2.0,519000,519000,0,0,519000,Null,Null,76010108,46363,5384
76029816,0.0,0.0,14560000,14560000,0,0,14560000,Null,Null,76029816,217953,8067
76034327,30.0,30.0,38900,38900,0,0,38900,Null,Null,76034327,111461,28736
76035270,0.0,0.0,13160000,12999000,161000,1,13160000,Null,Null,76035270,199801,11885
76042092,0.0,0.0,7090000,7090000,0,0,7090000,Null,Null,76042092,111461,15936
76042693,0.0,0.0,9690000,9690000,0,0,9690000,Null,Null,76042693,111461,2340
76053234,783.0,783.0,480000,299000,181000,38,480000,Null,Null,76053234,65071,1520
76058957,810.0,810.0,427000,292000,135000,32,427000,Null,Null,76058957,204895,6305
76067387,108.0,108.0,89000,78000,11000,12,89000,Null,Null,76067387,21653,28732
76068336,215.0,215.0,1650000,1650000,0,0,1650000,Null,Null,76068336,25964,11905
76071267,0.0,0.0,13470000,13470000,0,0,13470000,Null,Null,76071267,477955,28860
76085058,109.0,109.0,17900,17900,0,0,17900,Null,Null,76085058,111461,20244
76086746,15.0,15.0,164000,164000,0,0,164000,Null,Null,76086746,111461,15236
76110606,5.0,5.0,74000,74000,0,0,74000,Null,Null,76110606,111461,8198
76122941,1295.0,1295.0,171000,152000,19000,11,171000,Null,Null,76122941,424177,1520
76123310,83.0,83.0,39000,39000,0,0,39000,Null,Null,76123310,111461,20244
76124937,182.0,182.0,210000,175000,35000,17,210000,Null,Null,76124937,156043,1520
76131857,106.0,106.0,35000,29000,6000,17,35000,Null,Null,76131857,111461,1815
76133761,3567.0,3567.0,15000,9900,5100,34,15000,Null,Null,76133761,886923,8305
76134414,5163.0,5163.0,15000,11500,3500,23,15000,Null,Null,76134414,886923,8305
76142126,265.0,265.0,249000,214000,35000,14,249000,Null,Null,76142126,33036,12908
76143898,157.0,157.0,659000,434000,225000,34,659000,Null,Null,76143898,111461,2340
76143952,29.0,29.0,209000,189000,20000,10,209000,Null,Null,76143952,243693,12294
76145926,37.0,37.0,65000,65000,0,0,65000,Null,Null,76145926,111461,5384
76148124,74.0,74.0,172000,113000,59000,34,172000,Null,Null,76148124,243693,28480
76151721,8.0,8.0,1580000,1580000,0,0,1580000,Null,Null,76151721,111461,15250
76151876,0.0,0.0,360000,360000,0,0,360000,Null,Null,76151876,111461,15320
76158697,642.0,642.0,150000,150000,0,0,150000,Null,Null,76158697,3989771,11825
76166201,1427.0,1427.0,175000,119000,56000,32,175000,Null,Null,76166201,886923,8305
76168172,255.0,255.0,54000,29700,24300,45,54000,Null,Null,76168172,886923,8305
76168193,211.0,211.0,90000,49500,40500,45,90000,Null,Null,76168193,886923,8305
76178104,1557.0,1557.0,299000,265000,34000,11,299000,Null,Null,76178104,79682,11833
76181684,1138.0,1138.0,20000,20000,0,0,20000,Null,Null,76181684,171991,1815
76182173,156.0,156.0,780000,780000,0,0,780000,Null,Null,76182173,153733,3422
76185205,0.0,0.0,13600000,13600000,0,0,13600000,Null,Null,76185205,4439203,8073
76185279,45.0,45.0,1995000,1470000,525000,26,1995000,Null,Null,76185279,50655,1883
76195377,72.0,72.0,15000,8000,7000,47,15000,Null,Null,76195377,886923,8305
76197046,535.0,535.0,15000,9900,5100,34,15000,Null,Null,76197046,886923,8305
76197599,2.0,2.0,5750000,4300000,1450000,25,5750000,Null,Null,76197599,427097,17170
76200988,0.0,0.0,187000,187000,0,0,187000,Null,Null,76200988,111461,23082
76205655,0.0,0.0,11500000,11500000,0,0,11500000,Null,Null,76205655,111461,7273
76205808,74.0,74.0,420000,356000,64000,15,420000,Null,Null,76205808,845301,5267
76207294,0.0,0.0,75000000,75000000,0,0,75000000,Null,Null,76207294,4440139,8165
76210034,502.0,502.0,298000,218000,80000,27,298000,Null,Null,76210034,4246951,8602
76212747,363.0,363.0,128000,78000,50000,39,128000,Null,Null,76212747,4246951,8602
76223125,0.0,0.0,12000000,12000000,0,0,12000000,Null,Null,76223125,733583,11845
76225928,59.0,59.0,15000,15000,0,0,15000,Null,Null,76225928,111461,53190
76226179,9.0,9.0,39000,39000,0,0,39000,Null,Null,76226179,111461,15318
76226402,5.0,5.0,35000,35000,0,0,35000,Null,Null,76226402,111461,15318
76252649,262.0,262.0,160000,99000,61000,38,160000,Null,Null,76252649,697923,23366
76268998,0.0,0.0,20851000,18765900,2085100,10,20851000,Null,Null,76268998,26150,8513
76269000,0.0,0.0,18877000,16989300,1887700,10,18877000,Null,Null,76269000,26150,8513
76269282,0.0,0.0,8225000,7402500,822500,10,8225000,Null,Null,76269282,26150,8513
76269284,0.0,0.0,10364000,9327600,1036400,10,10364000,Null,Null,76269284,26150,8513
76269419,0.0,0.0,10882000,9793800,1088200,10,10882000,Null,Null,76269419,26150,8513
76271242,0.0,0.0,14990000,13490000,1500000,10,14990000,Null,Null,76271242,144779,2324
76285662,120.0,120.0,83500,50000,33500,40,83500,Null,Null,76285662,474145,8305
76286274,2.0,2.0,460000,460000,0,0,460000,Null,Null,76286274,4271555,1613
76296295,1.0,1.0,9000,9000,0,0,9000,Null,Null,76296295,111461,28478
76296601,44.0,44.0,2000,2000,0,0,2000,Null,Null,76296601,111461,23246
76352577,58.0,58.0,5000,5000,0,0,5000,Null,Null,76352577,111461,11831
76354823,0.0,0.0,139000,139000,0,0,139000,Null,Null,76354823,111461,15318
76357325,261.0,261.0,459000,459000,0,0,459000,Null,Null,76357325,4409909,28482
76359175,5.0,5.0,2570000,1800000,770000,30,2570000,Null,Null,76359175,4647777,15318
76372039,3.0,3.0,690000,350000,340000,49,690000,Null,Null,76372039,4647777,15250
76399145,8.0,8.0,110000,110000,0,0,110000,Null,Null,76399145,111461,15318
76401112,1.0,1.0,117900,117900,0,0,117900,Null,Null,76401112,111461,15318
76403999,164.0,164.0,560000,392000,168000,30,560000,Null,Null,76403999,254399,3422
76405310,2.0,2.0,220000,220000,0,0,220000,Null,Null,76405310,111461,15318
76406994,155.0,155.0,298000,198000,100000,34,298000,Null,Null,76406994,4246951,8602
76407764,0.0,0.0,19635000,19635000,0,0,19635000,Null,Null,76407764,191611,12876
76418098,31.0,31.0,51998,51998,0,0,51998,Null,Null,76418098,111461,2
76425458,283.0,283.0,320000,215000,105000,33,320000,Null,Null,76425458,3970517,28480
76446399,13.0,13.0,150000,150000,0,0,150000,Null,Null,76446399,111461,15318
76449975,0.0,0.0,75000000,75000000,0,0,75000000,Null,Null,76449975,4440139,11935
76468352,100.0,100.0,33799,33799,0,0,33799,Null,Null,76468352,111461,2514
76472940,7.0,7.0,75000,75000,0,0,75000,Null,Null,76472940,174391,1883
76473301,78.0,78.0,139000,139000,0,0,139000,Null,Null,76473301,274577,28484
76480235,8448.0,8448.0,26000,26000,0,0,26000,Null,Null,76480235,777069,6742
76507958,9.0,9.0,35000,35000,0,0,35000,Null,Null,76507958,111461,2
76509074,12.0,12.0,45000,25000,20000,44,45000,Null,Null,76509074,111461,15320
76514380,1144.0,1144.0,100000,61000,39000,39,100000,Null,Null,76514380,456351,53190
76545899,328.0,328.0,545000,545000,0,0,545000,Null,Null,76545899,516689,1979
76551091,1184.0,1184.0,250000,165000,85000,34,250000,Null,Null,76551091,227665,1520
76551578,108.0,108.0,130000,130000,0,0,130000,Null,Null,76551578,111461,28428
76577395,162.0,162.0,125000,123000,2000,2,125000,Null,Null,76577395,25964,11905
76596657,383.0,383.0,148000,84000,64000,43,148000,Null,Null,76596657,4246951,1520
76656992,318.0,318.0,259000,239000,20000,8,259000,Null,Null,76656992,862545,8602
76658958,627.0,627.0,180000,180000,0,0,180000,Null,Null,76658958,111461,2685
76682734,224.0,224.0,180000,135000,45000,25,180000,Null,Null,76682734,152363,11605
76682966,362.0,362.0,165000,140250,24750,15,165000,Null,Null,76682966,542605,13878
76696556,1738.0,1738.0,12800,8000,4800,38,12800,Null,Null,76696556,111461,3177
76738100,570.0,570.0,42000,42000,0,0,42000,Null,Null,76738100,739589,2685
76738826,1.0,1.0,300000,300000,0,0,300000,Null,Null,76738826,111461,15318
76775262,944.0,944.0,236000,199000,37000,16,236000,Null,Null,76775262,79688,1613
76776118,167.0,167.0,800000,648000,152000,19,800000,Null,Null,76776118,232747,11885
76776131,957.0,957.0,118000,100000,18000,15,118000,Null,Null,76776131,79688,1613
76777344,648.0,648.0,248000,138000,110000,44,248000,Null,Null,76777344,4246951,8602
76777564,317.0,317.0,1199000,690000,509000,42,1199000,Null,Null,76777564,196181,2657
76779853,4.0,4.0,48000,48000,0,0,48000,Null,Null,76779853,111461,23058
76781344,0.0,0.0,11670000,11670000,0,0,11670000,Null,Null,76781344,217953,7079
76795655,19.0,19.0,179000,179000,0,0,179000,Null,Null,76795655,111461,15320
76797145,37.0,37.0,39000,33000,6000,15,39000,Null,Null,76797145,419129,28574
76824043,66.0,66.0,555000,555000,0,0,555000,Null,Null,76824043,879421,28454
76834277,1964.0,1964.0,135000,135000,0,0,135000,Null,Null,76834277,746615,1883
77015287,223.0,223.0,299000,299000,0,0,299000,Null,Null,77015287,430445,3422
77026005,309.0,309.0,325000,325000,0,0,325000,Null,Null,77026005,372895,1613
77029995,8.0,8.0,83998,41999,41999,50,83998,Null,Null,77029995,111461,23622
77030141,60.0,60.0,52000,52000,0,0,52000,Null,Null,77030141,111461,23184
77037462,34.0,34.0,50000,50000,0,0,50000,Null,Null,77037462,111461,5385
77037685,33.0,33.0,48000,48000,0,0,48000,Null,Null,77037685,111461,5384
77043266,469.0,469.0,49000,49000,0,0,49000,Null,Null,77043266,182349,11512
77044347,522.0,522.0,95000,95000,0,0,95000,Null,Null,77044347,182349,11512
77046342,560.0,560.0,185000,185000,0,0,185000,Null,Null,77046342,182349,1520
77050877,256.0,256.0,57000,57000,0,0,57000,Null,Null,77050877,155108,2685
77093076,0.0,0.0,9478000,6770000,2708000,29,9478000,Null,Null,77093076,405211,8512
77093084,0.0,0.0,9478000,6770000,2708000,29,9478000,Null,Null,77093084,405211,8512
77094737,1857.0,1857.0,130000,130000,0,0,130000,Null,Null,77094737,3867703,1627
77105404,1361.0,1361.0,18000,9900,8100,45,18000,Null,Null,77105404,886923,8305
77106464,0.0,0.0,3900000,3900000,0,0,3900000,Null,Null,77106464,27398,2340
77109749,0.0,0.0,3550000,3550000,0,0,3550000,Null,Null,77109749,27398,2340
77118069,65.0,65.0,110000,110000,0,0,110000,Null,Null,77118069,22095,1630
77125504,1472.0,1472.0,199000,199000,0,0,199000,Null,Null,77125504,4507671,5264
77149788,0.0,0.0,17000000,11105000,5895000,35,17000000,Null,Null,77149788,416127,8227
77150777,132.0,132.0,98000,58000,40000,41,98000,Null,Null,77150777,4246951,8602
77152489,0.0,0.0,12440000,12440000,0,0,12440000,Null,Null,77152489,4507657,8073
77154649,14.0,14.0,79000,79000,0,0,79000,Null,Null,77154649,111461,15936
77155306,0.0,0.0,13420000,13420000,0,0,13420000,Null,Null,77155306,4507657,5566
77156467,2.0,2.0,8500,8500,0,0,8500,Null,Null,77156467,273633,1601
77156720,7.0,7.0,115000,115000,0,0,115000,Null,Null,77156720,217777,13878
77157644,165.0,165.0,18200,18200,0,0,18200,Null,Null,77157644,21280,13878
77181073,0.0,0.0,9590000,6850000,2740000,29,9590000,Null,Null,77181073,405211,8512
77186586,1.0,1.0,5500000,5450000,50000,1,5500000,Null,Null,77186586,199801,11885
77196791,8.0,8.0,11990000,11990000,0,0,11990000,Null,Null,77196791,111461,2340
77197936,0.0,0.0,22270000,22270000,0,0,22270000,Null,Null,77197936,218967,8073
77198984,0.0,0.0,37470000,37470000,0,0,37470000,Null,Null,77198984,218967,8073
77199634,1.0,1.0,17990000,12850000,5140000,29,17990000,Null,Null,77199634,405211,8512
77199734,1.0,1.0,17990000,12850000,5140000,29,17990000,Null,Null,77199734,405211,8512
77199817,0.0,0.0,17990000,12850000,5140000,29,17990000,Null,Null,77199817,405211,8512
77199912,0.0,0.0,17990000,12850000,5140000,29,17990000,Null,Null,77199912,405211,8512
77223237,0.0,0.0,11270000,11270000,0,0,11270000,Null,Null,77223237,218967,7079
77232030,190.0,190.0,170000,170000,0,0,170000,Null,Null,77232030,226401,2971
77232396,475.0,475.0,200000,94000,106000,53,200000,Null,Null,77232396,500047,1815
77241200,0.0,0.0,8999,8999,0,0,8999,Null,Null,77241200,111461,1634
77242268,4.0,4.0,5750000,4300000,1450000,25,5750000,Null,Null,77242268,427097,17170
77242489,2.0,2.0,10589000,10589000,0,0,10589000,Null,Null,77242489,4509065,11935
77249874,0.0,0.0,5750000,4300000,1450000,25,5750000,Null,Null,77249874,427097,17170
77284898,0.0,0.0,9450000,6750000,2700000,29,9450000,Null,Null,77284898,405211,5384
77304729,306.0,306.0,15000,9900,5100,34,15000,Null,Null,77304729,111461,1883
77305646,6628.0,6628.0,715000,499000,216000,30,715000,Null,Null,77305646,160211,3422
77315431,306.0,306.0,19998,19998,0,0,19998,Null,Null,77315431,111461,23052
77316748,423.0,423.0,850000,330000,520000,61,850000,Null,Null,77316748,449693,11861
77323536,3.0,3.0,5750000,4300000,1450000,25,5750000,Null,Null,77323536,427097,17170
77323913,0.0,0.0,13000000,13000000,0,0,13000000,Null,Null,77323913,27449,8165
77324207,191.0,191.0,229000,229000,0,0,229000,Null,Null,77324207,151948,1636
77330582,0.0,0.0,36999999,36999999,0,0,36999999,Null,Null,77330582,4440449,23446
77348600,417.0,417.0,39000,15000,24000,62,39000,Null,Null,77348600,630179,6742
77426044,77.0,77.0,240000,139000,101000,42,240000,Null,Null,77426044,630179,28682
77543879,1.0,1.0,7910000,7910000,0,0,7910000,Null,Null,77543879,929563,8170
77557267,0.0,0.0,10710000,10710000,0,0,10710000,Null,Null,77557267,929563,8170
77558147,264.0,264.0,599000,599000,0,0,599000,Null,Null,77558147,4409909,28482
77561080,113.0,113.0,32000,32000,0,0,32000,Null,Null,77561080,111461,5384
77563234,32.0,32.0,32000,32000,0,0,32000,Null,Null,77563234,111461,8512
77579867,0.0,0.0,15790000,15790000,0,0,15790000,Null,Null,77579867,4439171,7079
77579926,1.0,1.0,13170000,13170000,0,0,13170000,Null,Null,77579926,4439171,7079
77581086,2.0,2.0,7260000,7260000,0,0,7260000,Null,Null,77581086,199801,11885
77621931,1.0,1.0,989000,989000,0,0,989000,Null,Null,77621931,46363,5385
77625403,0.0,0.0,6800000,6800000,0,0,6800000,Null,Null,77625403,234143,11847
77625404,1.0,1.0,7400000,7400000,0,0,7400000,Null,Null,77625404,234143,11847
77625410,0.0,0.0,6900000,6900000,0,0,6900000,Null,Null,77625410,234143,11847
77625411,0.0,0.0,6900000,6900000,0,0,6900000,Null,Null,77625411,234143,11847
77625415,3.0,3.0,6900000,6900000,0,0,6900000,Null,Null,77625415,234143,11847
77625423,0.0,0.0,6300000,6300000,0,0,6300000,Null,Null,77625423,234143,11847
77661738,39.0,39.0,150000,150000,0,0,150000,Null,Null,77661738,111461,23622
77662822,191.0,191.0,1000000,561000,439000,44,1000000,Null,Null,77662822,500047,7081
77673897,335.0,335.0,500000,238000,262000,52,500000,Null,Null,77673897,500047,5531
77674184,0.0,0.0,19100000,19100000,0,0,19100000,Null,Null,77674184,4508621,7079
77675085,721.0,721.0,141900,133000,8900,6,141900,Null,Null,77675085,21271,11835
77675089,355.0,355.0,166000,142000,24000,14,166000,Null,Null,77675089,21271,11835
77675093,301.0,301.0,158000,135000,23000,15,158000,Null,Null,77675093,21271,11835
77680539,0.0,0.0,8890000,8000000,890000,10,8890000,Null,Null,77680539,4647777,15318
77684485,1560.0,1560.0,990000,379000,611000,62,990000,Null,Null,77684485,272829,8308
77698905,5.0,5.0,5200000,5200000,0,0,5200000,Null,Null,77698905,111461,11885
77705624,0.0,0.0,520000,520000,0,0,520000,Null,Null,77705624,407203,2020
77710417,3.0,3.0,16960000,16960000,0,0,16960000,Null,Null,77710417,156529,12876
77712096,0.0,0.0,13250000,13250000,0,0,13250000,Null,Null,77712096,217953,7079
77712886,0.0,0.0,22070000,22070000,0,0,22070000,Null,Null,77712886,4508621,7079
77713077,0.0,0.0,21460000,21460000,0,0,21460000,Null,Null,77713077,4508621,7079
77713479,0.0,0.0,11970000,11970000,0,0,11970000,Null,Null,77713479,4508621,7079
77717420,0.0,0.0,13100000,13100000,0,0,13100000,Null,Null,77717420,4508621,7079
77718188,0.0,0.0,14590000,14590000,0,0,14590000,Null,Null,77718188,4508621,7079
77718222,0.0,0.0,24000,5000,19000,79,24000,Null,Null,77718222,111461,8193
77729379,0.0,0.0,11780000,11780000,0,0,11780000,Null,Null,77729379,4508621,7079
77742302,11.0,11.0,278000,139000,139000,50,278000,Null,Null,77742302,4259829,8512
77743994,243.0,243.0,689000,689000,0,0,689000,Null,Null,77743994,4409909,28482
77745077,547.0,547.0,150000,150000,0,0,150000,Null,Null,77745077,214705,13878
77747671,539.0,539.0,19000,15000,4000,21,19000,Null,Null,77747671,4259821,2234
77749014,3.0,3.0,5200000,4940000,260000,5,5200000,Null,Null,77749014,367577,11873
77749059,790.0,790.0,248000,90000,158000,64,248000,Null,Null,77749059,4246951,8602
77749869,276.0,276.0,198000,128000,70000,35,198000,Null,Null,77749869,4246951,1520
77775165,81.0,81.0,159000,99000,60000,38,159000,Null,Null,77775165,48077,2
77779979,363.0,363.0,699000,399000,300000,43,699000,Null,Null,77779979,737285,8300
77780811,8.0,8.0,31000,31000,0,0,31000,Null,Null,77780811,41661,1627
77868208,1341.0,1341.0,849000,427000,422000,50,849000,Null,Null,77868208,302375,4880
77896206,6.0,6.0,75000,75000,0,0,75000,Null,Null,77896206,111461,15318
77910067,461.0,461.0,980000,449000,531000,54,980000,Null,Null,77910067,150433,12908
77924648,366.0,366.0,490000,490000,0,0,490000,Null,Null,77924648,614847,53350
77962744,622.0,622.0,65000,61750,3250,5,65000,Null,Null,77962744,4269901,23258
77969095,1.0,1.0,4800000,4300000,500000,10,4800000,Null,Null,77969095,427097,53350
77970110,22.0,22.0,44000,44000,0,0,44000,Null,Null,77970110,111461,2
77985910,0.0,0.0,4000000,4000000,0,0,4000000,Null,Null,77985910,234143,11847
77985914,0.0,0.0,6200000,6200000,0,0,6200000,Null,Null,77985914,234143,11847
77985923,0.0,0.0,6100000,6100000,0,0,6100000,Null,Null,77985923,234143,11847
77986600,401.0,401.0,350000,284000,66000,19,350000,Null,Null,77986600,156145,17170
77987600,13.0,13.0,180000,180000,0,0,180000,Null,Null,77987600,111461,20492
77990689,157.0,157.0,80000,80000,0,0,80000,Null,Null,77990689,111461,20492
78007672,856.0,856.0,279000,179000,100000,36,279000,Null,Null,78007672,114328,1583
78010514,883.0,883.0,79000,79000,0,0,79000,Null,Null,78010514,111461,20492
78010530,1570.0,1570.0,390000,199000,191000,49,390000,Null,Null,78010530,246045,12908
78013747,162.0,162.0,1800000,900000,900000,50,1800000,Null,Null,78013747,500047,7081
78024857,0.0,0.0,5750000,4300000,1450000,25,5750000,Null,Null,78024857,427097,53350
78025846,2745.0,2745.0,59000,42000,17000,29,59000,Null,Null,78025846,4430657,2685
78027437,409.0,409.0,299000,275000,24000,8,299000,Null,Null,78027437,111459,1813
78032039,57.0,57.0,98000,98000,0,0,98000,Null,Null,78032039,46335,17162
78045152,0.0,0.0,169000,169000,0,0,169000,Null,Null,78045152,288389,15320
78045609,3.0,3.0,179000,179000,0,0,179000,Null,Null,78045609,288389,15318
78045740,0.0,0.0,7000,7000,0,0,7000,Null,Null,78045740,288389,15936
78046067,17.0,17.0,7000,7000,0,0,7000,Null,Null,78046067,288389,15320
78046269,0.0,0.0,189000,189000,0,0,189000,Null,Null,78046269,288389,15236
78046273,2.0,2.0,179000,179000,0,0,179000,Null,Null,78046273,288389,15320
78046327,2.0,2.0,255200,255200,0,0,255200,Null,Null,78046327,288389,15318
78046875,1.0,1.0,239000,239000,0,0,239000,Null,Null,78046875,288389,15250
78046956,39.0,39.0,16000,16000,0,0,16000,Null,Null,78046956,288389,15936
78046996,1.0,1.0,169000,169000,0,0,169000,Null,Null,78046996,288389,15320
78047286,1.0,1.0,172080,172080,0,0,172080,Null,Null,78047286,288389,15236
78280123,5068.0,5068.0,346000,255000,91000,26,346000,Null,Null,78280123,41661,1520
78280482,1905.0,1905.0,326000,235000,91000,28,326000,Null,Null,78280482,41661,1627
78280986,1811.0,1811.0,346000,251000,95000,27,346000,Null,Null,78280986,41661,1520
78282312,65.0,65.0,289000,289000,0,0,289000,Null,Null,78282312,281769,49722
78288227,30.0,30.0,490000,160000,330000,67,490000,Null,Null,78288227,150433,12908
78498187,337.0,337.0,110000,87000,23000,21,110000,Null,Null,78498187,232723,10228
78503804,285.0,285.0,26000,13000,13000,50,26000,Null,Null,78503804,4647777,15318
78509478,585.0,585.0,188000,118000,70000,37,188000,Null,Null,78509478,4246951,8602
78510737,8.0,8.0,3500000,3500000,0,0,3500000,Null,Null,78510737,847683,11873
78511171,4.0,4.0,13990000,13990000,0,0,13990000,Null,Null,78511171,114527,2657
78513565,0.0,0.0,4200000,4200000,0,0,4200000,Null,Null,78513565,622483,53350
78523281,0.0,0.0,9900,9900,0,0,9900,Null,Null,78523281,111461,28480
78550183,0.0,0.0,14900000,14690000,210000,1,14900000,Null,Null,78550183,20215,8067
78618316,406.0,406.0,16900,16900,0,0,16900,Null,Null,78618316,111461,3877
78622503,29.0,29.0,200000,149662,50338,25,200000,Null,Null,78622503,143353,20240
78623505,0.0,0.0,17500000,17500000,0,0,17500000,Null,Null,78623505,185209,28644
78632653,1697.0,1697.0,129000,129000,0,0,129000,Null,Null,78632653,709163,1883
78633940,457.0,457.0,269000,269000,0,0,269000,Null,Null,78633940,25422,23042
78885777,32.0,32.0,350000,350000,0,0,350000,Null,Null,78885777,424977,8511
78886913,10.0,10.0,9000,9000,0,0,9000,Null,Null,78886913,111461,2
78887023,136.0,136.0,10880,10880,0,0,10880,Null,Null,78887023,111461,2337
78890431,155.0,155.0,95175,94000,1175,1,95175,Null,Null,78890431,111461,23276
78913376,187.0,187.0,195000,195000,0,0,195000,Null,Null,78913376,4528657,8512
78913904,0.0,0.0,10398000,10398000,0,0,10398000,Null,Null,78913904,111461,2340
78913992,1.0,1.0,17890000,17890000,0,0,17890000,Null,Null,78913992,111461,2340
78917483,51.0,51.0,470000,456000,14000,3,470000,Null,Null,78917483,312329,5267
78940158,312.0,312.0,267900,226000,41900,16,267900,Null,Null,78940158,111461,1832
78946345,115.0,115.0,278000,139000,139000,50,278000,Null,Null,78946345,4259829,8512
78950742,21.0,21.0,278000,139000,139000,50,278000,Null,Null,78950742,4259829,8512
78953855,0.0,0.0,6950000,6255000,695000,10,6950000,Null,Null,78953855,704815,15236
78954119,60.0,60.0,4000,4000,0,0,4000,Null,Null,78954119,111461,11929
78957956,569.0,569.0,125000,74000,51000,41,125000,Null,Null,78957956,4245215,8192
78964736,660.0,660.0,65000,39000,26000,40,65000,Null,Null,78964736,4011099,23052
78970546,2.0,2.0,17890000,17890000,0,0,17890000,Null,Null,78970546,111461,2340
78973881,1.0,1.0,5500000,5450000,50000,1,5500000,Null,Null,78973881,199801,11885
78984765,127.0,127.0,15500,15500,0,0,15500,Null,Null,78984765,111461,15318
78985738,11.0,11.0,29000,29000,0,0,29000,Null,Null,78985738,111461,15318
78988817,1.0,1.0,14880000,14880000,0,0,14880000,Null,Null,78988817,18641,28392
79007527,204.0,204.0,33000,33000,0,0,33000,Null,Null,79007527,632589,13878
79008498,245.0,245.0,79000,49000,30000,38,79000,Null,Null,79008498,32909,17170
79008576,47.0,47.0,189000,119000,70000,37,189000,Null,Null,79008576,32909,8227
79112094,1.0,1.0,11300000,11300000,0,0,11300000,Null,Null,79112094,228187,11943
79239628,46.0,46.0,204120,194000,10120,5,204120,Null,Null,79239628,529027,8223
79245522,0.0,0.0,97470000,97470000,0,0,97470000,Null,Null,79245522,217953,7079
79267304,1291.0,1291.0,150000,68000,82000,55,150000,Null,Null,79267304,197767,23026
79289052,0.0,0.0,28050000,28050000,0,0,28050000,Null,Null,79289052,217953,7079
79323009,466.0,466.0,666000,613000,53000,8,666000,Null,Null,79323009,523789,23658
79381806,0.0,0.0,17760000,17760000,0,0,17760000,Null,Null,79381806,217953,7079
79411031,16.0,16.0,3912000,2789000,1123000,29,3912000,Null,Null,79411031,26150,8513
79411238,4.0,4.0,150000,93988,56012,37,150000,Null,Null,79411238,166419,28576
79411383,1088.0,1088.0,119000,103000,16000,13,119000,Null,Null,79411383,112882,1520
79411386,2037.0,2037.0,185000,160000,25000,14,185000,Null,Null,79411386,112882,1520
79445601,2.0,2.0,50000,50000,0,0,50000,Null,Null,79445601,162313,28576
79445924,1509.0,1509.0,49000,43610,5390,11,49000,Null,Null,79445924,4269901,23800
79461140,60.0,60.0,499400,349580,149820,30,499400,Null,Null,79461140,193677,23238
79560442,0.0,0.0,9699000,9699000,0,0,9699000,Null,Null,79560442,111461,2340
79581485,0.0,0.0,4200000,4200000,0,0,4200000,Null,Null,79581485,622483,53350
79582066,2.0,2.0,6490000,4635750,1854250,29,6490000,Null,Null,79582066,26150,8512
79619644,0.0,0.0,9699000,9699000,0,0,9699000,Null,Null,79619644,111461,2340
79637285,2.0,2.0,9860000,9860000,0,0,9860000,Null,Null,79637285,111461,2340
79637916,20.0,20.0,2500,2500,0,0,2500,Null,Null,79637916,111461,23254
79665351,276.0,276.0,164500,164500,0,0,164500,Null,Null,79665351,111461,23246
79665870,0.0,0.0,9799999,9799999,0,0,9799999,Null,Null,79665870,111461,2340
79667658,0.0,0.0,6400000,6400000,0,0,6400000,Null,Null,79667658,21886,5385
79667840,0.0,0.0,5300000,2650000,2650000,50,5300000,Null,Null,79667840,214179,8511
79667847,0.0,0.0,6900000,6900000,0,0,6900000,Null,Null,79667847,214179,8511
79671333,1.0,1.0,3830000,3830000,0,0,3830000,Null,Null,79671333,259989,17170
79680444,13.0,13.0,9499,9499,0,0,9499,Null,Null,79680444,111461,11923
79691104,1955.0,1955.0,215000,196000,19000,9,215000,Null,Null,79691104,245945,1883
79781499,8.0,8.0,8636000,6168750,2467250,29,8636000,Null,Null,79781499,26150,8512
79814352,6.0,6.0,7900,7900,0,0,7900,Null,Null,79814352,111461,11831
79837581,0.0,0.0,100000,100000,0,0,100000,Null,Null,79837581,111461,15250
79888313,299.0,299.0,429000,257000,172000,40,429000,Null,Null,79888313,19813,1883
79959839,0.0,0.0,6000,6000,0,0,6000,Null,Null,79959839,111461,8198
79971957,273.0,273.0,209000,209000,0,0,209000,Null,Null,79971957,111461,23362
80132874,1.0,1.0,2900000,2175000,725000,25,2900000,Null,Null,80132874,111461,8061
80138957,2071.0,2071.0,185000,160000,25000,14,185000,Null,Null,80138957,112882,3422
80412457,65.0,65.0,350000,265000,85000,24,350000,Null,Null,80412457,111461,49722
80417240,131.0,131.0,450000,432000,18000,4,450000,Null,Null,80417240,3866781,23102
80439471,0.0,0.0,504000,504000,0,0,504000,Null,Null,80439471,111461,49722
80439490,281.0,281.0,1990000,1590000,400000,20,1990000,Null,Null,80439490,196181,2657
80446970,275.0,275.0,500000,248000,252000,50,500000,Null,Null,80446970,500047,2324
80469655,423.0,423.0,127000,127000,0,0,127000,Null,Null,80469655,182349,11512
80470573,18.0,18.0,350000,285000,65000,19,350000,Null,Null,80470573,111461,49722
80583091,0.0,0.0,1129000,1129000,0,0,1129000,Null,Null,80583091,19813,1883
80583316,312.0,312.0,1829000,1369000,460000,25,1829000,Null,Null,80583316,19813,1883
80583451,487.0,487.0,1299000,779000,520000,40,1299000,Null,Null,80583451,19813,2136
80617683,3878.0,3878.0,479000,239000,240000,50,479000,Null,Null,80617683,19813,1883
80625573,0.0,0.0,6800000,6800000,0,0,6800000,Null,Null,80625573,234143,11847
80666842,11.0,11.0,16906,16000,906,5,16906,Null,Null,80666842,111461,23042
80699263,10.0,10.0,21000,21000,0,0,21000,Null,Null,80699263,111461,2
80699380,5.0,5.0,18000,18000,0,0,18000,Null,Null,80699380,111461,2
80699383,2.0,2.0,15000,15000,0,0,15000,Null,Null,80699383,111461,2
80737012,8.0,8.0,315000,285000,30000,10,315000,Null,Null,80737012,111461,49722
80857582,667.0,667.0,46191,41992,4199,9,46191,Null,Null,80857582,274577,28484
80859671,411.0,411.0,59000,59000,0,0,59000,Null,Null,80859671,4224691,11941
80874505,0.0,0.0,9999,9999,0,0,9999,Null,Null,80874505,111461,23258
80879097,0.0,0.0,20460000,20460000,0,0,20460000,Null,Null,80879097,218967,8073
80931424,550.0,550.0,93800,93800,0,0,93800,Null,Null,80931424,111461,2514
80932325,175.0,175.0,9700,9700,0,0,9700,Null,Null,80932325,111461,28480
80933783,13.0,13.0,777000,528750,248250,32,777000,Null,Null,80933783,26150,8513
80945560,1.0,1.0,26850000,26850000,0,0,26850000,Null,Null,80945560,218967,7079
80946681,20.0,20.0,49000,49000,0,0,49000,Null,Null,80946681,111461,2
80947712,2.0,2.0,80000,80000,0,0,80000,Null,Null,80947712,111461,15318
80959641,525.0,525.0,500000,222000,278000,56,500000,Null,Null,80959641,500047,2324
80960308,796.0,796.0,325000,259000,66000,20,325000,Null,Null,80960308,4534193,2340
80964740,941.0,941.0,500000,289000,211000,42,500000,Null,Null,80964740,4224691,2334
80968385,1.0,1.0,3700000,3700000,0,0,3700000,Null,Null,80968385,111461,11911
80968531,2.0,2.0,3750000,3750000,0,0,3750000,Null,Null,80968531,111461,11911
80973404,0.0,0.0,9671429,6770000,2901429,30,9671429,Null,Null,80973404,405211,8511
80973450,0.0,0.0,9671429,6770000,2901429,30,9671429,Null,Null,80973450,405211,8511
80975020,0.0,0.0,9017429,6350000,2667429,30,9017429,Null,Null,80975020,732431,8511
80975120,0.0,0.0,18000000,15300000,2700000,15,18000000,Null,Null,80975120,111461,2324
80976198,3.0,3.0,14000,14000,0,0,14000,Null,Null,80976198,111461,15320
80977344,132.0,132.0,59000,59000,0,0,59000,Null,Null,80977344,111461,28626
81007575,79.0,79.0,499000,257000,242000,48,499000,Null,Null,81007575,201773,1520
81014564,129.0,129.0,390000,255000,135000,35,390000,Null,Null,81014564,201773,1520
81085669,308.0,308.0,129000,116000,13000,10,129000,Null,Null,81085669,22653,1520
81087546,1523.0,1523.0,44000,44000,0,0,44000,Null,Null,81087546,155263,1831
81089185,867.0,867.0,350000,259000,91000,26,350000,Null,Null,81089185,245945,8314
81091088,84.0,84.0,180000,108000,72000,40,180000,Null,Null,81091088,212575,27128
81125162,177.0,177.0,479000,304000,175000,37,479000,Null,Null,81125162,31627,1883
81136326,5.0,5.0,1500,1500,0,0,1500,Null,Null,81136326,111461,2363
81136847,0.0,0.0,15000,15000,0,0,15000,Null,Null,81136847,111461,15320
81177146,115.0,115.0,287000,166000,121000,42,287000,Null,Null,81177146,505907,3804
81213029,7.0,7.0,5000,5000,0,0,5000,Null,Null,81213029,111461,11831
81223362,0.0,0.0,12000,12000,0,0,12000,Null,Null,81223362,111461,2
81264856,69.0,69.0,249000,249000,0,0,249000,Null,Null,81264856,505907,4593
81291846,87.0,87.0,65000,59000,6000,9,65000,Null,Null,81291846,4534193,23058
81304013,168.0,168.0,350000,179000,171000,49,350000,Null,Null,81304013,111461,11911
81314457,145.0,145.0,278000,139000,139000,50,278000,Null,Null,81314457,4259829,8512
81318056,63.0,63.0,278000,139000,139000,50,278000,Null,Null,81318056,4259829,8512
81320710,141.0,141.0,346600,346600,0,0,346600,Null,Null,81320710,184299,23702
81408261,6.0,6.0,76000,76000,0,0,76000,Null,Null,81408261,111461,5385
81437719,22.0,22.0,291864,145932,145932,50,291864,Null,Null,81437719,143256,28596
81440459,39.0,39.0,35000,35000,0,0,35000,Null,Null,81440459,111461,5384
81441117,0.0,0.0,14640000,14640000,0,0,14640000,Null,Null,81441117,4508621,7079
81499751,0.0,0.0,13660000,13660000,0,0,13660000,Null,Null,81499751,4508621,7079
81500297,428.0,428.0,63000,47250,15750,25,63000,Null,Null,81500297,4423429,17186
81511219,5.0,5.0,7000000,4300000,2700000,39,7000000,Null,Null,81511219,427097,17170
81550021,223.0,223.0,39000,39000,0,0,39000,Null,Null,81550021,111461,12294
81554579,1.0,1.0,5750000,4300000,1450000,25,5750000,Null,Null,81554579,427097,3426
81566870,291.0,291.0,79000,79000,0,0,79000,Null,Null,81566870,244117,8220
81577986,3678.0,3678.0,6500,6500,0,0,6500,Null,Null,81577986,821321,2225
81593033,1.0,1.0,69000,69000,0,0,69000,Null,Null,81593033,111461,8371
81597675,14.0,14.0,85000,85000,0,0,85000,Null,Null,81597675,705271,28484
81598047,23.0,23.0,3450000,3399000,51000,1,3450000,Null,Null,81598047,199801,11885
81612110,0.0,0.0,0,539000,0,0,539000,Null,Null,81612110,46363,0
81634803,0.0,0.0,12000,12000,0,0,12000,Null,Null,81634803,111461,2
81635120,0.0,0.0,16000,16000,0,0,16000,Null,Null,81635120,111461,2
81646820,3.0,3.0,3799000,3799000,0,0,3799000,Null,Null,81646820,18851,8067
81647765,0.0,0.0,2800000,2800000,0,0,2800000,Null,Null,81647765,111461,8061
81647773,0.0,0.0,4100000,4100000,0,0,4100000,Null,Null,81647773,111461,8061
81647780,0.0,0.0,3200000,3200000,0,0,3200000,Null,Null,81647780,111461,8061
81697666,6.0,6.0,85000,85000,0,0,85000,Null,Null,81697666,111461,23154
81723566,396.0,396.0,699000,679000,20000,3,699000,Null,Null,81723566,212371,2225
81735463,102.0,102.0,185000,95000,90000,49,185000,Null,Null,81735463,4589937,3422
81757513,0.0,0.0,15000,15000,0,0,15000,Null,Null,81757513,111461,2
81757516,1.0,1.0,15000,15000,0,0,15000,Null,Null,81757516,111461,2
81757558,94.0,94.0,20000,20000,0,0,20000,Null,Null,81757558,111461,2
81757568,162.0,162.0,15000,15000,0,0,15000,Null,Null,81757568,111461,2
81757576,1.0,1.0,250000,250000,0,0,250000,Null,Null,81757576,111461,2
81757577,0.0,0.0,29999,29999,0,0,29999,Null,Null,81757577,111461,2
81757593,1.0,1.0,15000,15000,0,0,15000,Null,Null,81757593,111461,2
81757596,6.0,6.0,30000,30000,0,0,30000,Null,Null,81757596,111461,2
81757614,12.0,12.0,18000,18000,0,0,18000,Null,Null,81757614,111461,2
81757657,18.0,18.0,15000,15000,0,0,15000,Null,Null,81757657,111461,2
81757793,16.0,16.0,50000,50000,0,0,50000,Null,Null,81757793,111461,2
81757884,4.0,4.0,180000,180000,0,0,180000,Null,Null,81757884,111461,2
81757926,7.0,7.0,150000,150000,0,0,150000,Null,Null,81757926,111461,2
81757979,8.0,8.0,100000,100000,0,0,100000,Null,Null,81757979,111461,2
81758034,22.0,22.0,38000,38000,0,0,38000,Null,Null,81758034,111461,2
81758036,19.0,19.0,15000,15000,0,0,15000,Null,Null,81758036,111461,2
81758051,10.0,10.0,15000,15000,0,0,15000,Null,Null,81758051,111461,2
81758052,3.0,3.0,26000,26000,0,0,26000,Null,Null,81758052,111461,2
81758059,11.0,11.0,25000,25000,0,0,25000,Null,Null,81758059,111461,2
81758072,6.0,6.0,18000,18000,0,0,18000,Null,Null,81758072,111461,2
81758101,8.0,8.0,20000,20000,0,0,20000,Null,Null,81758101,111461,2
81758133,1.0,1.0,50000,50000,0,0,50000,Null,Null,81758133,111461,2
81758149,8.0,8.0,50000,50000,0,0,50000,Null,Null,81758149,111461,2
81758280,0.0,0.0,18000,18000,0,0,18000,Null,Null,81758280,111461,2
81758287,0.0,0.0,15000,15000,0,0,15000,Null,Null,81758287,111461,2
81758331,9.0,9.0,36000,36000,0,0,36000,Null,Null,81758331,111461,2
81758349,0.0,0.0,18000,18000,0,0,18000,Null,Null,81758349,111461,2
81758398,1.0,1.0,14000,14000,0,0,14000,Null,Null,81758398,111461,2
81758453,1.0,1.0,15000,15000,0,0,15000,Null,Null,81758453,111461,2
81800560,0.0,0.0,4800000,4800000,0,0,4800000,Null,Null,81800560,111461,11885
81897334,23.0,23.0,899000,899000,0,0,899000,Null,Null,81897334,26689,1520
81926706,2.0,2.0,29000,25000,4000,14,29000,Null,Null,81926706,111461,6742
81936241,1681.0,1681.0,85000,76000,9000,11,85000,Null,Null,81936241,4065253,23622
81937450,21.0,21.0,115000,115000,0,0,115000,Null,Null,81937450,111461,27180
81963793,12.0,12.0,79000,79000,0,0,79000,Null,Null,81963793,111461,20244
81964004,0.0,0.0,13800,8000,5800,42,13800,Null,Null,81964004,111461,1819
81964315,90.0,90.0,449000,449000,0,0,449000,Null,Null,81964315,525257,28682
81985875,12.0,12.0,18999,18999,0,0,18999,Null,Null,81985875,111461,27214
82015880,37.0,37.0,7000,7000,0,0,7000,Null,Null,82015880,505165,15318
82023997,7.0,7.0,43000,43000,0,0,43000,Null,Null,82023997,111461,8512
82033657,47.0,47.0,300000,171999,128001,43,300000,Null,Null,82033657,4251451,28596
82075493,0.0,0.0,10000000,6946000,3054000,31,10000000,Null,Null,82075493,18802,1794
82093148,4.0,4.0,47000,47000,0,0,47000,Null,Null,82093148,111461,5384
82107182,27.0,27.0,34597,34597,0,0,34597,Null,Null,82107182,111461,1634
82107183,1.0,1.0,19000,19000,0,0,19000,Null,Null,82107183,111461,2
82172786,0.0,0.0,21890000,21890000,0,0,21890000,Null,Null,82172786,477955,28860
82230120,59.0,59.0,59000,59000,0,0,59000,Null,Null,82230120,4600133,1636
82230801,12.0,12.0,9390000,8110000,1280000,14,9390000,Null,Null,82230801,21673,2324
82384677,4.0,4.0,17900,16000,1900,11,17900,Null,Null,82384677,111461,23042
82387995,0.0,0.0,19622000,19622000,0,0,19622000,Null,Null,82387995,540183,15936
82388155,0.0,0.0,8437500,8437500,0,0,8437500,Null,Null,82388155,540183,15318
82403069,1014.0,1014.0,69000,66930,2070,3,69000,Null,Null,82403069,612965,8305
82412659,0.0,0.0,70000,70000,0,0,70000,Null,Null,82412659,111461,2
82412738,31.0,31.0,120000,120000,0,0,120000,Null,Null,82412738,111461,2
82412758,21.0,21.0,180000,180000,0,0,180000,Null,Null,82412758,111461,2
82412819,3.0,3.0,110000,110000,0,0,110000,Null,Null,82412819,147723,2
82412853,56.0,56.0,100000,100000,0,0,100000,Null,Null,82412853,111461,2
82412877,14.0,14.0,10000,10000,0,0,10000,Null,Null,82412877,111461,2
82413064,8.0,8.0,12000,12000,0,0,12000,Null,Null,82413064,111461,2
82414216,704.0,704.0,18000,10500,7500,42,18000,Null,Null,82414216,886923,8305
82438829,160.0,160.0,109000,109000,0,0,109000,Null,Null,82438829,197767,53048
82444541,0.0,0.0,24680000,24680000,0,0,24680000,Null,Null,82444541,477955,28860
82482005,0.0,0.0,12937500,12937500,0,0,12937500,Null,Null,82482005,540183,15250
82482460,51.0,51.0,47000,47000,0,0,47000,Null,Null,82482460,111461,2
82482608,3.0,3.0,4500,4500,0,0,4500,Null,Null,82482608,111461,2
82486974,0.0,0.0,22500000,22500000,0,0,22500000,Null,Null,82486974,540183,15250
82489336,8.0,8.0,10000,10000,0,0,10000,Null,Null,82489336,111461,11923
82502988,0.0,0.0,8520000,8520000,0,0,8520000,Null,Null,82502988,214183,8512
82503003,0.0,0.0,7920000,6336000,1584000,20,7920000,Null,Null,82503003,45884,5384
82503173,0.0,0.0,6300000,6300000,0,0,6300000,Null,Null,82503173,150519,5385
82529821,0.0,0.0,9450000,9450000,0,0,9450000,Null,Null,82529821,540183,15318
82529856,0.0,0.0,11340000,11340000,0,0,11340000,Null,Null,82529856,540183,15318
82532026,0.0,0.0,24187500,24187500,0,0,24187500,Null,Null,82532026,540183,15318
82552406,0.0,0.0,12937500,12937500,0,0,12937500,Null,Null,82552406,540183,15318
82567459,6.0,6.0,49000,49000,0,0,49000,Null,Null,82567459,111461,28484
82569524,0.0,0.0,10687500,10687500,0,0,10687500,Null,Null,82569524,540183,15318
82650940,0.0,0.0,15000000,15000000,0,0,15000000,Null,Null,82650940,540183,15318
82721609,2026.0,2026.0,1263000,680000,583000,46,1263000,Null,Null,82721609,48077,1626
82721610,864.0,864.0,1584000,977000,607000,38,1584000,Null,Null,82721610,48077,1520
82831636,114.0,114.0,179000,179000,0,0,179000,Null,Null,82831636,805681,8513
82832880,71.0,71.0,160000,160000,0,0,160000,Null,Null,82832880,111461,49722
82843943,28.0,28.0,170000,170000,0,0,170000,Null,Null,82843943,111461,23436
82846838,12.0,12.0,16000,16000,0,0,16000,Null,Null,82846838,111461,8516
82859839,161.0,161.0,120000,99000,21000,18,120000,Null,Null,82859839,143607,8197
82874965,76.0,76.0,40000,20000,20000,50,40000,Null,Null,82874965,4647777,15250
82877750,99.0,99.0,40000,20000,20000,50,40000,Null,Null,82877750,4647777,15250
82884382,100.0,100.0,8000,8000,0,0,8000,Null,Null,82884382,209853,1613
82895673,0.0,0.0,108000,108000,0,0,108000,Null,Null,82895673,111461,23658
82938639,1.0,1.0,10980000,10980000,0,0,10980000,Null,Null,82938639,111461,2340
82939785,5.0,5.0,125000,125000,0,0,125000,Null,Null,82939785,111461,27544
82941407,2.0,2.0,1050000,1050000,0,0,1050000,Null,Null,82941407,40901,23642
82942264,0.0,0.0,20340000,20340000,0,0,20340000,Null,Null,82942264,477955,28860
82942612,22.0,22.0,560000,560000,0,0,560000,Null,Null,82942612,423053,8512
82947547,0.0,0.0,19070000,19070000,0,0,19070000,Null,Null,82947547,477955,28860
82948238,405.0,405.0,86500,83000,3500,4,86500,Null,Null,82948238,111461,53074
82948682,272.0,272.0,500000,270000,230000,46,500000,Null,Null,82948682,500047,2324
82955763,50.0,50.0,19000,18810,190,1,19000,Null,Null,82955763,111461,28480
82955918,415.0,415.0,500000,226000,274000,55,500000,Null,Null,82955918,500047,1811
82961066,37.0,37.0,265000,257000,8000,3,265000,Null,Null,82961066,111461,1836
83202743,357.0,357.0,50000,45000,5000,10,50000,Null,Null,83202743,583511,11835
83202928,1353.0,1353.0,235000,189000,46000,20,235000,Null,Null,83202928,79682,11833
83203236,0.0,0.0,48873000,48873000,0,0,48873000,Null,Null,83203236,206015,23270
83336209,212.0,212.0,104000,69000,35000,34,104000,Null,Null,83336209,79682,11833
83352993,714.0,714.0,37000,33500,3500,9,37000,Null,Null,83352993,79688,8223
83369106,67.0,67.0,345000,240000,105000,30,345000,Null,Null,83369106,173547,15320
83375313,199.0,199.0,2000,2000,0,0,2000,Null,Null,83375313,111461,2
83376602,176.0,176.0,600000,309000,291000,49,600000,Null,Null,83376602,359427,11605
83398188,226.0,226.0,97000,97000,0,0,97000,Null,Null,83398188,4635339,23622
83398435,396.0,396.0,52500,52500,0,0,52500,Null,Null,83398435,4635339,23622
83405659,7.0,7.0,251000,251000,0,0,251000,Null,Null,83405659,144477,3175
83410208,44.0,44.0,250000,137999,112001,45,250000,Null,Null,83410208,111461,27194
83423219,1181.0,1181.0,40000,40000,0,0,40000,Null,Null,83423219,274275,8305
83470533,322.0,322.0,100000,99000,1000,1,100000,Null,Null,83470533,155263,1831
83471720,30.0,30.0,68000,68000,0,0,68000,Null,Null,83471720,111461,8193
83479006,102.0,102.0,340000,340000,0,0,340000,Null,Null,83479006,111461,27180
83492069,0.0,0.0,14300000,14300000,0,0,14300000,Null,Null,83492069,217953,28860
83664593,8.0,8.0,7800,7800,0,0,7800,Null,Null,83664593,111461,8205
83665380,6.0,6.0,22000,22000,0,0,22000,Null,Null,83665380,111461,8205
83665420,0.0,0.0,9100,9100,0,0,9100,Null,Null,83665420,111461,8205
83665470,0.0,0.0,6500,6500,0,0,6500,Null,Null,83665470,111461,8205
83743419,41.0,41.0,44998,44998,0,0,44998,Null,Null,83743419,111461,23346
83745806,4.0,4.0,8900,8900,0,0,8900,Null,Null,83745806,111461,2
83750008,241.0,241.0,135900,135900,0,0,135900,Null,Null,83750008,111461,28598
83750781,0.0,0.0,18980000,18980000,0,0,18980000,Null,Null,83750781,111461,2340
83752184,1383.0,1383.0,16000,15520,480,3,16000,Null,Null,83752184,111461,18876
83775252,70.0,70.0,600000,400000,200000,33,600000,Null,Null,83775252,152763,23588
83778002,3.0,3.0,84500,84500,0,0,84500,Null,Null,83778002,111461,15320
83827766,144.0,144.0,81000,81000,0,0,81000,Null,Null,83827766,111461,20492
83847675,249.0,249.0,107500,107500,0,0,107500,Null,Null,83847675,111461,2514
83857610,7.0,7.0,19990000,19990000,0,0,19990000,Null,Null,83857610,18641,28392
83924065,21.0,21.0,56999,56999,0,0,56999,Null,Null,83924065,111461,23244
83925078,0.0,0.0,13680000,13680000,0,0,13680000,Null,Null,83925078,4610513,7079
83927709,653.0,653.0,35000,35000,0,0,35000,Null,Null,83927709,111461,8314
83927711,269.0,269.0,35000,35000,0,0,35000,Null,Null,83927711,111461,8314
83927931,335.0,335.0,155000,155000,0,0,155000,Null,Null,83927931,454787,1883
83929721,169.0,169.0,210000,210000,0,0,210000,Null,Null,83929721,4307205,1815
83982862,192.0,192.0,250000,139000,111000,44,250000,Null,Null,83982862,153086,12294
84073071,0.0,0.0,6500000,6500000,0,0,6500000,Null,Null,84073071,111461,2
84075781,0.0,0.0,11230000,11230000,0,0,11230000,Null,Null,84075781,4610513,7079
84080877,357.0,357.0,255000,225000,30000,12,255000,Null,Null,84080877,25422,1634
84103595,3.0,3.0,1118900,1118900,0,0,1118900,Null,Null,84103595,111461,23834
84107855,4.0,4.0,1990,1990,0,0,1990,Null,Null,84107855,111461,2363
84132752,1309.0,1309.0,1745000,1169000,576000,33,1745000,Null,Null,84132752,160211,3422
84138398,3.0,3.0,12620000,12620000,0,0,12620000,Null,Null,84138398,4439171,7079
84155050,1.0,1.0,450000,298000,152000,34,450000,Null,Null,84155050,183257,15250
84195597,1.0,1.0,15560000,15560000,0,0,15560000,Null,Null,84195597,885749,8511
84195614,0.0,0.0,15560000,15560000,0,0,15560000,Null,Null,84195614,885749,8511
84196464,0.0,0.0,8246000,5850000,2396000,29,8246000,Null,Null,84196464,885749,8511
84202279,1.0,1.0,28496000,28496000,0,0,28496000,Null,Null,84202279,19032,28392
84229772,0.0,0.0,12850000,12850000,0,0,12850000,Null,Null,84229772,885749,8511
84248403,0.0,0.0,95000,95000,0,0,95000,Null,Null,84248403,111461,15318
84262999,0.0,0.0,8976800,6750000,2226800,25,8976800,Null,Null,84262999,885749,8511
84266736,0.0,0.0,8976800,6750000,2226800,25,8976800,Null,Null,84266736,885749,8511
84268089,0.0,0.0,8976800,6750000,2226800,25,8976800,Null,Null,84268089,885749,8511
84271105,5.0,5.0,145000,145000,0,0,145000,Null,Null,84271105,111461,2
84271618,16.0,16.0,145000,145000,0,0,145000,Null,Null,84271618,111461,27544
84282348,0.0,0.0,17420000,17420000,0,0,17420000,Null,Null,84282348,4508621,7079
84285434,2.0,2.0,990000,495000,495000,50,990000,Null,Null,84285434,111461,15318
84298395,0.0,0.0,18550000,18550000,0,0,18550000,Null,Null,84298395,4508621,7079
84301483,0.0,0.0,9515800,6756000,2759800,29,9515800,Null,Null,84301483,885749,8511
84305157,0.0,0.0,3950000,3950000,0,0,3950000,Null,Null,84305157,625233,53350
84320491,0.0,0.0,7150000,7150000,0,0,7150000,Null,Null,84320491,885749,8511
84340413,458.0,458.0,37900,37900,0,0,37900,Null,Null,84340413,111461,28428
84346196,0.0,0.0,16100000,16100000,0,0,16100000,Null,Null,84346196,4508621,7079
84376854,74.0,74.0,136000,136000,0,0,136000,Null,Null,84376854,48727,11605
84376992,0.0,0.0,4800000,4320000,480000,10,4800000,Null,Null,84376992,937137,11849
84382719,4.0,4.0,3900000,3510000,390000,10,3900000,Null,Null,84382719,937137,11849
84426505,0.0,0.0,12910000,12910000,0,0,12910000,Null,Null,84426505,4508621,7079
84438541,24.0,24.0,31000,31000,0,0,31000,Null,Null,84438541,407561,15318
84446727,120.0,120.0,6000,6000,0,0,6000,Null,Null,84446727,111461,1815
84446750,2.0,2.0,6500,6500,0,0,6500,Null,Null,84446750,111461,1815
84447952,3.0,3.0,6500,6500,0,0,6500,Null,Null,84447952,111461,1815
84448574,1.0,1.0,7000,7000,0,0,7000,Null,Null,84448574,111461,1815
84544873,137.0,137.0,58888,58888,0,0,58888,Null,Null,84544873,111461,1634
84547406,6.0,6.0,156000,156000,0,0,156000,Null,Null,84547406,111461,15318
84548577,1.0,1.0,218400,218400,0,0,218400,Null,Null,84548577,111461,15320
84552385,6.0,6.0,114000,114000,0,0,114000,Null,Null,84552385,111461,5995
84563855,15.0,15.0,125000,125000,0,0,125000,Null,Null,84563855,111461,27544
84566059,30.0,30.0,149000,149000,0,0,149000,Null,Null,84566059,290071,28454
84566545,4550.0,4550.0,155000,155000,0,0,155000,Null,Null,84566545,290071,53190
84583740,0.0,0.0,6500000,6500000,0,0,6500000,Null,Null,84583740,885749,8511
84594233,0.0,0.0,7800000,5850000,1950000,25,7800000,Null,Null,84594233,174699,8512
84594235,601.0,601.0,80000,80000,0,0,80000,Null,Null,84594235,4202899,28482
84594356,1.0,1.0,7800000,5850000,1950000,25,7800000,Null,Null,84594356,174699,8512
84598556,3.0,3.0,30000,17000,13000,43,30000,Null,Null,84598556,4647777,15250
84637300,7.0,7.0,7500000,6750000,750000,10,7500000,Null,Null,84637300,842073,11857
84650843,1.0,1.0,209000,209000,0,0,209000,Null,Null,84650843,111461,23010
84698481,8.0,8.0,30000,18000,12000,40,30000,Null,Null,84698481,4647777,15250
84710499,577.0,577.0,1090000,1090000,0,0,1090000,Null,Null,84710499,4599785,2018
84717324,0.0,0.0,21500000,16125000,5375000,25,21500000,Null,Null,84717324,111461,2324
84731846,4.0,4.0,199000,199000,0,0,199000,Null,Null,84731846,111461,2
84736505,7.0,7.0,60800,55000,5800,10,60800,Null,Null,84736505,111461,1883
84750921,48.0,48.0,20000,10000,10000,50,20000,Null,Null,84750921,4647777,15250
84757299,0.0,0.0,590000,590000,0,0,590000,Null,Null,84757299,111684,1796
84759965,6.0,6.0,100000,50000,50000,50,100000,Null,Null,84759965,4647777,15250
84801947,232.0,232.0,289000,289000,0,0,289000,Null,Null,84801947,307609,1583
84802787,8.0,8.0,9000,9000,0,0,9000,Null,Null,84802787,111461,8197
84803632,90.0,90.0,99000,96000,3000,3,99000,Null,Null,84803632,312329,28482
84843205,7.0,7.0,99000,97020,1980,2,99000,Null,Null,84843205,111461,49726
84845535,0.0,0.0,6000000,6000000,0,0,6000000,Null,Null,84845535,111461,8170
84852786,8.0,8.0,45000,45000,0,0,45000,Null,Null,84852786,111461,5385
84875620,394.0,394.0,128000,88000,40000,31,128000,Null,Null,84875620,4246951,8602
84878780,85.0,85.0,1550000,1550000,0,0,1550000,Null,Null,84878780,18641,9013
84881883,1.0,1.0,10500000,7350000,3150000,30,10500000,Null,Null,84881883,405211,8511
84882009,0.0,0.0,8928571,8928571,0,0,8928571,Null,Null,84882009,405211,5384
84882063,0.0,0.0,8928571,8928571,0,0,8928571,Null,Null,84882063,405211,5384
84882655,0.0,0.0,9214286,9214286,0,0,9214286,Null,Null,84882655,405211,5385
84882792,0.0,0.0,9214286,6450000,2764286,30,9214286,Null,Null,84882792,405211,5385
84882875,0.0,0.0,9214286,9214286,0,0,9214286,Null,Null,84882875,405211,5385
84883095,0.0,0.0,9214286,9214286,0,0,9214286,Null,Null,84883095,405211,5385
84886093,717.0,717.0,344000,267000,77000,22,344000,Null,Null,84886093,41048,23006
84892692,1.0,1.0,199000,199000,0,0,199000,Null,Null,84892692,111461,15236
84909841,0.0,0.0,15773800,11860000,3913800,25,15773800,Null,Null,84909841,885749,8511
84910660,0.0,0.0,15773800,11860000,3913800,25,15773800,Null,Null,84910660,885749,8511
84911958,0.0,0.0,65000,65000,0,0,65000,Null,Null,84911958,842373,28594
84912509,0.0,0.0,26586000,19990000,6596000,25,26586000,Null,Null,84912509,885749,8511
84913684,0.0,0.0,19990000,19990000,0,0,19990000,Null,Null,84913684,885749,8511
84914987,0.0,0.0,26586000,19990000,6596000,25,26586000,Null,Null,84914987,885749,8511
84920611,1.0,1.0,11350000,11350000,0,0,11350000,Null,Null,84920611,885749,8511
84939661,7.0,7.0,5500,5500,0,0,5500,Null,Null,84939661,111461,2
84950796,0.0,0.0,5180500,5180500,0,0,5180500,Null,Null,84950796,205847,11857
84952492,54.0,54.0,320000,245000,75000,23,320000,Null,Null,84952492,873091,11875
84953200,214.0,214.0,279000,182000,97000,35,279000,Null,Null,84953200,230607,6305
85025547,8.0,8.0,2340,2340,0,0,2340,Null,Null,85025547,111461,23800
85042408,0.0,0.0,3552000,3552000,0,0,3552000,Null,Null,85042408,25422,2
85047181,32.0,32.0,9000,9000,0,0,9000,Null,Null,85047181,111461,17186
85047318,0.0,0.0,15000,15000,0,0,15000,Null,Null,85047318,111461,15250
85051379,228.0,228.0,57000,45000,12000,21,57000,Null,Null,85051379,198785,1752
85085365,1.0,1.0,44000000,44000000,0,0,44000000,Null,Null,85085365,146400,23438
85118373,171.0,171.0,139000,135000,4000,3,139000,Null,Null,85118373,21651,12294
85170499,0.0,0.0,14893000,14893000,0,0,14893000,Null,Null,85170499,19032,5566
85185759,1.0,1.0,9690000,9690000,0,0,9690000,Null,Null,85185759,111461,2340
85208543,47.0,47.0,565000,565000,0,0,565000,Null,Null,85208543,150002,2
85239189,11.0,11.0,2500,2500,0,0,2500,Null,Null,85239189,111461,2363
85239200,0.0,0.0,7800,7800,0,0,7800,Null,Null,85239200,111461,8205
85239884,191.0,191.0,2000,1000,1000,50,2000,Null,Null,85239884,111461,2
85239928,0.0,0.0,17850,17850,0,0,17850,Null,Null,85239928,111461,2
85240537,259.0,259.0,3200,1650,1550,48,3200,Null,Null,85240537,111461,2
85255282,217.0,217.0,257000,257000,0,0,257000,Null,Null,85255282,745957,2153
85259421,3.0,3.0,109000,80000,29000,27,109000,Null,Null,85259421,111461,15250
85272993,16.0,16.0,3809000,2855000,954000,25,3809000,Null,Null,85272993,26150,8513
85288766,33.0,33.0,350000,195000,155000,44,350000,Null,Null,85288766,259421,1601
85343156,745.0,745.0,165000,165000,0,0,165000,Null,Null,85343156,734429,17170
85351583,34.0,34.0,32000,32000,0,0,32000,Null,Null,85351583,111461,53054
85370888,0.0,0.0,16191000,16191000,0,0,16191000,Null,Null,85370888,4640693,5566
85370912,0.0,0.0,32032000,32032000,0,0,32032000,Null,Null,85370912,4640693,5566
85370928,0.0,0.0,15641000,15641000,0,0,15641000,Null,Null,85370928,4743793,11516
85370961,0.0,0.0,14327000,14327000,0,0,14327000,Null,Null,85370961,4640693,5566
85371049,0.0,0.0,11631000,11631000,0,0,11631000,Null,Null,85371049,4649297,7079
85371090,0.0,0.0,20197000,20197000,0,0,20197000,Null,Null,85371090,18985,26652
85371161,0.0,0.0,12444000,12444000,0,0,12444000,Null,Null,85371161,4649297,7079
85371300,0.0,0.0,17940000,17940000,0,0,17940000,Null,Null,85371300,4649283,7079
85371368,0.0,0.0,13668000,13668000,0,0,13668000,Null,Null,85371368,4649299,8073
85371377,0.0,0.0,11567000,11567000,0,0,11567000,Null,Null,85371377,4649297,7079
85374977,9.0,9.0,3380000,1690000,1690000,50,3380000,Null,Null,85374977,239653,11893
85378414,0.0,0.0,25597000,25597000,0,0,25597000,Null,Null,85378414,632261,12864
85384559,6.0,6.0,230000,230000,0,0,230000,Null,Null,85384559,111461,15250
85389534,0.0,0.0,15987000,15987000,0,0,15987000,Null,Null,85389534,632261,20250
85389581,0.0,0.0,51783000,51783000,0,0,51783000,Null,Null,85389581,548965,23576
85390246,4.0,4.0,1300,1300,0,0,1300,Null,Null,85390246,111461,27180
85391412,0.0,0.0,2100,2100,0,0,2100,Null,Null,85391412,111461,27180
85391476,0.0,0.0,1600,1600,0,0,1600,Null,Null,85391476,111461,27180
85396315,321.0,321.0,595000,545000,50000,8,595000,Null,Null,85396315,560863,11859
85460045,67.0,67.0,134000,134000,0,0,134000,Null,Null,85460045,21653,28454
85482946,2.0,2.0,136000,136000,0,0,136000,Null,Null,85482946,48077,4342
85557422,0.0,0.0,9499000,9499000,0,0,9499000,Null,Null,85557422,111461,2340
85625173,2596.0,2596.0,85000,69000,16000,19,85000,Null,Null,85625173,198555,1616
85660439,0.0,0.0,109000,80000,29000,27,109000,Null,Null,85660439,111461,15250
85668356,0.0,0.0,5070000,3802500,1267500,25,5070000,Null,Null,85668356,174699,8512
85668665,1.0,1.0,4340000,3255000,1085000,25,4340000,Null,Null,85668665,174699,8512
85668763,1.0,1.0,4610000,3457500,1152500,25,4610000,Null,Null,85668763,174699,8512
85678517,25.0,25.0,18148,9074,9074,50,18148,Null,Null,85678517,419129,28484
85689971,0.0,0.0,6500,6500,0,0,6500,Null,Null,85689971,111461,8205
85690456,0.0,0.0,9100,9100,0,0,9100,Null,Null,85690456,111461,8202
85690778,0.0,0.0,3900,3900,0,0,3900,Null,Null,85690778,111461,8205
85692961,0.0,0.0,6500,6500,0,0,6500,Null,Null,85692961,111461,8202
85692989,10.0,10.0,3900,3900,0,0,3900,Null,Null,85692989,111461,8202
85693183,1.0,1.0,3900,3900,0,0,3900,Null,Null,85693183,111461,8202
85693704,0.0,0.0,5200,5200,0,0,5200,Null,Null,85693704,111461,8205
85695388,0.0,0.0,9100,9100,0,0,9100,Null,Null,85695388,111461,8202
85698602,69.0,69.0,3900,3900,0,0,3900,Null,Null,85698602,111461,8202
85763912,115.0,115.0,198000,198000,0,0,198000,Null,Null,85763912,111461,12590
85764027,2.0,2.0,9699000,9699000,0,0,9699000,Null,Null,85764027,111461,2
85764117,0.0,0.0,9699000,9699000,0,0,9699000,Null,Null,85764117,111461,2340
85764604,250.0,250.0,22000,22000,0,0,22000,Null,Null,85764604,867647,23416
85799997,130.0,130.0,1483000,1410000,73000,5,1483000,Null,Null,85799997,111457,1803
85930722,163.0,163.0,389000,389000,0,0,389000,Null,Null,85930722,21653,53190
86018342,1452.0,1452.0,149000,149000,0,0,149000,Null,Null,86018342,274577,28484
86023849,22.0,22.0,59000,59000,0,0,59000,Null,Null,86023849,111461,8516
86150416,361.0,361.0,82000,82000,0,0,82000,Null,Null,86150416,111461,20492
86174955,1376.0,1376.0,300000,300000,0,0,300000,Null,Null,86174955,185875,1520
86218124,83.0,83.0,46400,38976,7424,16,46400,Null,Null,86218124,111461,23622
86297289,15.0,15.0,87000,84000,3000,3,87000,Null,Null,86297289,111461,2
86307485,136.0,136.0,18490000,18490000,0,0,18490000,Null,Null,86307485,18641,28392
86376338,109.0,109.0,216000,91000,125000,58,216000,Null,Null,86376338,111461,2019
86401644,173.0,173.0,230000,230000,0,0,230000,Null,Null,86401644,111461,23258
86413674,1.0,1.0,6500,6500,0,0,6500,Null,Null,86413674,111461,2
86516579,176.0,176.0,50000,45000,5000,10,50000,Null,Null,86516579,111461,53048
86529842,168.0,168.0,500000,259000,241000,48,500000,Null,Null,86529842,201773,1601
86539325,139.0,139.0,198000,167000,31000,16,198000,Null,Null,86539325,192947,8300
86560919,16.0,16.0,7800,7800,0,0,7800,Null,Null,86560919,111461,8205
86561454,5.0,5.0,7800,7800,0,0,7800,Null,Null,86561454,111461,8205
86573440,23.0,23.0,5000,5000,0,0,5000,Null,Null,86573440,111461,8197
86573468,5.0,5.0,16000,9000,7000,44,16000,Null,Null,86573468,111461,8196
86573512,9.0,9.0,15000,8000,7000,47,15000,Null,Null,86573512,111461,8205
86573600,17.0,17.0,11000,8000,3000,27,11000,Null,Null,86573600,111461,1634
86583452,15.0,15.0,8500,8000,500,6,8500,Null,Null,86583452,111461,8193
86583495,5.0,5.0,10000,7000,3000,30,10000,Null,Null,86583495,111461,8193
86589249,93.0,93.0,1175000,649000,526000,45,1175000,Null,Null,86589249,47489,1520
86678081,7.0,7.0,24050,24050,0,0,24050,Null,Null,86678081,111461,15318
86678082,51.0,51.0,22100,22100,0,0,22100,Null,Null,86678082,111461,15318
86678182,23.0,23.0,16900,16900,0,0,16900,Null,Null,86678182,111461,15318
86729443,39.0,39.0,600000,429000,171000,29,600000,Null,Null,86729443,173547,15320
86778768,0.0,0.0,27800000,27800000,0,0,27800000,Null,Null,86778768,167287,6653
86804175,0.0,0.0,11440000,11440000,0,0,11440000,Null,Null,86804175,451817,28644
86904600,9.0,9.0,18000,18000,0,0,18000,Null,Null,86904600,842373,28594
86908249,0.0,0.0,1850000,1665000,185000,10,1850000,Null,Null,86908249,704815,15320
86917295,47.0,47.0,29000,29000,0,0,29000,Null,Null,86917295,842373,28594
86926258,0.0,0.0,16450000,16450000,0,0,16450000,Null,Null,86926258,167287,6653
86929728,0.0,0.0,14500000,14500000,0,0,14500000,Null,Null,86929728,167287,6653
86962504,296.0,296.0,84000,84000,0,0,84000,Null,Null,86962504,111461,53054
86962523,409.0,409.0,65000,65000,0,0,65000,Null,Null,86962523,111461,53054
86962784,2.0,2.0,26999,26999,0,0,26999,Null,Null,86962784,111461,27180
86963089,556.0,556.0,32000,32000,0,0,32000,Null,Null,86963089,111461,53054
86986581,74.0,74.0,260800,182560,78240,30,260800,Null,Null,86986581,111461,1838
86993952,18.0,18.0,67000,36000,31000,46,67000,Null,Null,86993952,111461,15236
87021486,1.0,1.0,16300000,16300000,0,0,16300000,Null,Null,87021486,167287,6653
87026721,5.0,5.0,25000,25000,0,0,25000,Null,Null,87026721,362745,28584
87043312,0.0,0.0,12900000,12900000,0,0,12900000,Null,Null,87043312,167287,6653
87054131,75.0,75.0,60000,60000,0,0,60000,Null,Null,87054131,230537,53058
87093899,56.0,56.0,43000,26000,17000,40,43000,Null,Null,87093899,111461,15236
87106876,752.0,752.0,280000,189000,91000,33,280000,Null,Null,87106876,246045,12294
87107826,274.0,274.0,450000,269000,181000,40,450000,Null,Null,87107826,246045,1815
87108370,229.0,229.0,260000,139000,121000,47,260000,Null,Null,87108370,246045,12294
87111708,0.0,0.0,11000,11000,0,0,11000,Null,Null,87111708,111461,2
87111776,1.0,1.0,72000,72000,0,0,72000,Null,Null,87111776,111461,15236
87113603,1.0,1.0,90000,90000,0,0,90000,Null,Null,87113603,111461,15250
87131268,224.0,224.0,450000,275000,175000,39,450000,Null,Null,87131268,4509271,1883
87165552,141.0,141.0,45000,45000,0,0,45000,Null,Null,87165552,198557,11835
87168304,23.0,23.0,198000,198000,0,0,198000,Null,Null,87168304,21651,28682
87212382,200.0,200.0,150000,119000,31000,21,150000,Null,Null,87212382,246045,12294
87302178,19.0,19.0,75000,75000,0,0,75000,Null,Null,87302178,111461,23362
87343512,4.0,4.0,11990000,11990000,0,0,11990000,Null,Null,87343512,114527,2657
87391989,387.0,387.0,345000,276000,69000,20,345000,Null,Null,87391989,277519,1883
87412550,660.0,660.0,220000,109000,111000,50,220000,Null,Null,87412550,630179,1805
87437077,413.0,413.0,39000,9000,30000,77,39000,Null,Null,87437077,630179,1831
87451243,111.0,111.0,19000,19000,0,0,19000,Null,Null,87451243,4298221,28574
87483157,0.0,0.0,12090000,11485500,604500,5,12090000,Null,Null,87483157,153444,28870
87484969,0.0,0.0,47782150,47782150,0,0,47782150,Null,Null,87484969,846663,23246
87549332,3.0,3.0,42000,42000,0,0,42000,Null,Null,87549332,111461,15936
87549913,1.0,1.0,12000,12000,0,0,12000,Null,Null,87549913,111461,15236
87550171,85.0,85.0,8000,8000,0,0,8000,Null,Null,87550171,111461,15320
87553189,22.0,22.0,8000,8000,0,0,8000,Null,Null,87553189,111461,15320
87553675,0.0,0.0,13000,13000,0,0,13000,Null,Null,87553675,111461,15318
87555259,1.0,1.0,15000,15000,0,0,15000,Null,Null,87555259,111461,15250
87555573,7.0,7.0,10530,10530,0,0,10530,Null,Null,87555573,111461,15250
87560205,2.0,2.0,84000,84000,0,0,84000,Null,Null,87560205,111461,15250
87561196,0.0,0.0,18000,18000,0,0,18000,Null,Null,87561196,111461,15320
87563441,4.0,4.0,84000,84000,0,0,84000,Null,Null,87563441,111461,15250
87563453,1.0,1.0,76000,76000,0,0,76000,Null,Null,87563453,111461,15250
87612641,0.0,0.0,10000,10000,0,0,10000,Null,Null,87612641,111461,2
87622434,144.0,144.0,545000,509000,36000,7,545000,Null,Null,87622434,47489,1520
87649351,0.0,0.0,6600000,6600000,0,0,6600000,Null,Null,87649351,174699,7449
87651020,12.0,12.0,9100,9100,0,0,9100,Null,Null,87651020,111461,20222
87651024,114.0,114.0,1300,1300,0,0,1300,Null,Null,87651024,111461,1883
87651135,1.0,1.0,2470,2470,0,0,2470,Null,Null,87651135,111461,23432
87651508,1.0,1.0,305000,305000,0,0,305000,Null,Null,87651508,50034,5995
87665866,10.0,10.0,199000,199000,0,0,199000,Null,Null,87665866,111461,49722
87670324,2.0,2.0,16400000,16400000,0,0,16400000,Null,Null,87670324,50307,7079
87675294,1404.0,1404.0,299001,299001,0,0,299001,Null,Null,87675294,2630119,2657
87676099,136.0,136.0,26700,26700,0,0,26700,Null,Null,87676099,111461,2514
87703881,22.0,22.0,479000,479000,0,0,479000,Null,Null,87703881,568851,5531
87703885,184.0,184.0,179000,179000,0,0,179000,Null,Null,87703885,183795,1628
87749124,0.0,0.0,5000,5000,0,0,5000,Null,Null,87749124,111461,2
87767595,10.0,10.0,3900,3900,0,0,3900,Null,Null,87767595,111461,2
87767761,4.0,4.0,208000,208000,0,0,208000,Null,Null,87767761,111461,15236
87774059,0.0,0.0,10000,10000,0,0,10000,Null,Null,87774059,111461,8198
87777620,3.0,3.0,84500,84500,0,0,84500,Null,Null,87777620,111461,15236
87784960,0.0,0.0,17500000,17500000,0,0,17500000,Null,Null,87784960,5215439,2340
87828508,0.0,0.0,6964500,6964500,0,0,6964500,Null,Null,87828508,4642465,15236
87828604,24.0,24.0,378900,369000,9900,3,378900,Null,Null,87828604,111461,7079
87831027,13.0,13.0,268999,268999,0,0,268999,Null,Null,87831027,111461,23236
87841069,39.0,39.0,15500,15500,0,0,15500,Null,Null,87841069,111461,1831
87851024,1.0,1.0,7071429,7071429,0,0,7071429,Null,Null,87851024,4529099,8511
87851132,0.0,0.0,6928571,6928571,0,0,6928571,Null,Null,87851132,4529099,8511
87864652,9.0,9.0,2500,2500,0,0,2500,Null,Null,87864652,111461,3177
87866117,0.0,0.0,2500,2500,0,0,2500,Null,Null,87866117,111461,3179
87866915,0.0,0.0,589000,589000,0,0,589000,Null,Null,87866915,111461,1796
87881318,203.0,203.0,539000,479000,60000,11,539000,Null,Null,87881318,25422,12908
87889514,0.0,0.0,7928571,7928571,0,0,7928571,Null,Null,87889514,4529099,8511
87890303,0.0,0.0,8214286,8214286,0,0,8214286,Null,Null,87890303,4529099,8511
87898797,18.0,18.0,40000,40000,0,0,40000,Null,Null,87898797,111461,8516
87898931,0.0,0.0,13804000,13804000,0,0,13804000,Null,Null,87898931,4642465,15236
87900508,1018.0,1018.0,110000,110000,0,0,110000,Null,Null,87900508,18845,1820
87903831,835.0,835.0,195000,195000,0,0,195000,Null,Null,87903831,18845,1820
87909039,0.0,0.0,4040000,3918800,121200,3,4040000,Null,Null,87909039,27398,2340
87909056,0.0,0.0,5950000,5950000,0,0,5950000,Null,Null,87909056,4642465,15236
87913382,11346.0,11346.0,56000,28000,28000,50,56000,Null,Null,87913382,4246951,8602
87915014,3.0,3.0,8900000,7300000,1600000,18,8900000,Null,Null,87915014,27398,2340
87915015,0.0,0.0,4150000,3550000,600000,14,4150000,Null,Null,87915015,27398,8225
87915246,5.0,5.0,187000,187000,0,0,187000,Null,Null,87915246,111461,27196
87960170,0.0,0.0,5889000,5889000,0,0,5889000,Null,Null,87960170,4642465,15236
87960330,1042.0,1042.0,3000,2000,1000,33,3000,Null,Null,87960330,111461,2363
87960571,0.0,0.0,7294000,7294000,0,0,7294000,Null,Null,87960571,4642465,15236
87961653,2.0,2.0,19000,12000,7000,37,19000,Null,Null,87961653,111461,15250
87964479,0.0,0.0,9860000,9860000,0,0,9860000,Null,Null,87964479,111461,2
87964699,0.0,0.0,17450000,17450000,0,0,17450000,Null,Null,87964699,111461,2
87964745,0.0,0.0,9799999,9799999,0,0,9799999,Null,Null,87964745,111461,2
87964958,3.0,3.0,9799999,9799999,0,0,9799999,Null,Null,87964958,111461,2
87964995,0.0,0.0,9799999,9799999,0,0,9799999,Null,Null,87964995,111461,2
87965089,0.0,0.0,210000,210000,0,0,210000,Null,Null,87965089,111461,23112
87971363,225.0,225.0,9100,9100,0,0,9100,Null,Null,87971363,111461,2
87984521,0.0,0.0,9750,9750,0,0,9750,Null,Null,87984521,111461,15236
87984693,0.0,0.0,13000,13000,0,0,13000,Null,Null,87984693,111461,15250
87984704,2.0,2.0,9750,9750,0,0,9750,Null,Null,87984704,111461,15236
87984720,1.0,1.0,8450,8450,0,0,8450,Null,Null,87984720,111461,15236
87984723,0.0,0.0,11700,11700,0,0,11700,Null,Null,87984723,111461,15236
87984758,32.0,32.0,7670,7670,0,0,7670,Null,Null,87984758,111461,2
87984922,3.0,3.0,18000,18000,0,0,18000,Null,Null,87984922,111461,2
87984992,4.0,4.0,6500,6500,0,0,6500,Null,Null,87984992,111461,15236
87985191,2.0,2.0,13000,13000,0,0,13000,Null,Null,87985191,177783,2
87985200,22.0,22.0,2470,2470,0,0,2470,Null,Null,87985200,111461,2
87985203,9.0,9.0,10400,10400,0,0,10400,Null,Null,87985203,111461,2
87985210,4.0,4.0,6500,6500,0,0,6500,Null,Null,87985210,111461,15236
87985216,53.0,53.0,7670,7670,0,0,7670,Null,Null,87985216,111461,2
87985378,31.0,31.0,12740,12740,0,0,12740,Null,Null,87985378,111461,15236
87986024,5.0,5.0,6420000,5099000,1321000,21,6420000,Null,Null,87986024,111461,11935
88013122,0.0,0.0,6000,4000,2000,33,6000,Null,Null,88013122,111461,1819
88041250,508.0,508.0,240000,120000,120000,50,240000,Null,Null,88041250,234331,1601
88047489,50.0,50.0,16000,16000,0,0,16000,Null,Null,88047489,111461,5905
88069618,4.0,4.0,194000,194000,0,0,194000,Null,Null,88069618,111461,23778
88073058,371.0,371.0,200000,158000,42000,21,200000,Null,Null,88073058,144018,20236
88081266,0.0,0.0,6500000,6500000,0,0,6500000,Null,Null,88081266,4529099,8511
88083785,0.0,0.0,6500000,6500000,0,0,6500000,Null,Null,88083785,4529099,8511
88084664,0.0,0.0,6500000,6500000,0,0,6500000,Null,Null,88084664,4529099,8511
88085506,0.0,0.0,6214286,6214286,0,0,6214286,Null,Null,88085506,4529099,8511
88095771,1337.0,1337.0,1310000,790000,520000,40,1310000,Null,Null,88095771,64932,1520
88191430,116.0,116.0,500000,238000,262000,52,500000,Null,Null,88191430,500047,2324
88196592,0.0,0.0,7500,7500,0,0,7500,Null,Null,88196592,111461,20254
88202423,3.0,3.0,182000,172900,9100,5,182000,Null,Null,88202423,111461,23778
88206665,140.0,140.0,918000,765000,153000,17,918000,Null,Null,88206665,19018,2334
88222310,1598.0,1598.0,35000,35000,0,0,35000,Null,Null,88222310,4401579,23340
88223765,144.0,144.0,390000,390000,0,0,390000,Null,Null,88223765,150215,11845
88230880,753.0,753.0,45000,45000,0,0,45000,Null,Null,88230880,111461,2488
88231687,0.0,0.0,7928571,7928571,0,0,7928571,Null,Null,88231687,4529099,8511
88231799,0.0,0.0,8214286,8214286,0,0,8214286,Null,Null,88231799,4529099,8511
88240507,0.0,0.0,11887,11887,0,0,11887,Null,Null,88240507,111461,2
88240633,3.0,3.0,160000,160000,0,0,160000,Null,Null,88240633,111461,5995
88241130,1502.0,1502.0,35000,35000,0,0,35000,Null,Null,88241130,4401579,23340
88246679,0.0,0.0,6642857,6642857,0,0,6642857,Null,Null,88246679,4529099,8511
88344995,0.0,0.0,6800000,6800000,0,0,6800000,Null,Null,88344995,111461,8170
88778005,39.0,39.0,86656,60659,25997,30,86656,Null,Null,88778005,111461,28428
88779170,5.0,5.0,19000,19000,0,0,19000,Null,Null,88779170,111461,8516
88782585,0.0,0.0,57500000,57500000,0,0,57500000,Null,Null,88782585,856973,27196
88784406,25.0,25.0,1397,1000,397,28,1397,Null,Null,88784406,111461,27214
88784408,101.0,101.0,1000,1000,0,0,1000,Null,Null,88784408,111461,23432
88790329,8.0,8.0,175000,175000,0,0,175000,Null,Null,88790329,111461,15318
88796298,664.0,664.0,150000,99000,51000,34,150000,Null,Null,88796298,246045,20174
88796437,640.0,640.0,150000,99000,51000,34,150000,Null,Null,88796437,246045,20174
88796546,299.0,299.0,535000,486000,49000,9,535000,Null,Null,88796546,150002,5267
88796681,292.0,292.0,190000,129000,61000,32,190000,Null,Null,88796681,246045,28722
88798139,1887.0,1887.0,390000,219000,171000,44,390000,Null,Null,88798139,246045,3804
88798444,115.0,115.0,150000,109000,41000,27,150000,Null,Null,88798444,246045,28740
88798681,3.0,3.0,2177000,1480500,696500,32,2177000,Null,Null,88798681,26150,8511
88801107,1.0,1.0,120000,120000,0,0,120000,Null,Null,88801107,111461,15318
88813678,878.0,878.0,1999,1999,0,0,1999,Null,Null,88813678,111461,2685
88821719,1.0,1.0,219000,175200,43800,20,219000,Null,Null,88821719,111461,15318
88914388,1197.0,1197.0,139000,83000,56000,40,139000,Null,Null,88914388,737237,23042
88915864,0.0,0.0,10233600,10233600,0,0,10233600,Null,Null,88915864,4642465,15236
88916772,98.0,98.0,790000,429000,361000,46,790000,Null,Null,88916772,246045,12908
88917067,0.0,0.0,9144000,9144000,0,0,9144000,Null,Null,88917067,4642465,15236
88921203,0.0,0.0,6699000,6699000,0,0,6699000,Null,Null,88921203,4642465,15236
88928025,145.0,145.0,250200,129000,121200,48,250200,Null,Null,88928025,46703,53190
88928273,736.0,736.0,325000,325000,0,0,325000,Null,Null,88928273,79709,4408
88950702,0.0,0.0,6800000,6800000,0,0,6800000,Null,Null,88950702,924277,11885
88952092,190.0,190.0,160000,80000,80000,50,160000,Null,Null,88952092,4655669,17170
88967146,274.0,274.0,120000,78000,42000,35,120000,Null,Null,88967146,22095,1630
89042540,0.0,0.0,3500,3500,0,0,3500,Null,Null,89042540,111461,2363
89043119,0.0,0.0,46999,46999,0,0,46999,Null,Null,89043119,111461,23362
89045093,217.0,217.0,120000,82500,37500,31,120000,Null,Null,89045093,478585,1628
89051419,296.0,296.0,1119000,615000,504000,45,1119000,Null,Null,89051419,19813,1883
89051554,0.0,0.0,13950000,13950000,0,0,13950000,Null,Null,89051554,1141905,11518
89051669,193.0,193.0,129000,129000,0,0,129000,Null,Null,89051669,111461,2
89052700,8.0,8.0,15000,5000,10000,67,15000,Null,Null,89052700,111461,2
89054016,15.0,15.0,184000,179000,5000,3,184000,Null,Null,89054016,111461,5995
89055340,336.0,336.0,1369000,1369000,0,0,1369000,Null,Null,89055340,19813,1883
89059914,103.0,103.0,3380000,1690000,1690000,50,3380000,Null,Null,89059914,239653,1520
89065862,0.0,0.0,7785714,7785714,0,0,7785714,Null,Null,89065862,4683951,8511
89066024,0.0,0.0,8357143,5850000,2507143,30,8357143,Null,Null,89066024,4683951,8511
89069934,1.0,1.0,8357143,5850000,2507143,30,8357143,Null,Null,89069934,4683951,8511
89072244,0.0,0.0,9642857,6750000,2892857,30,9642857,Null,Null,89072244,4683951,8511
89125595,64.0,64.0,113000,113000,0,0,113000,Null,Null,89125595,111461,20182
89139805,3861.0,3861.0,10000,6000,4000,40,10000,Null,Null,89139805,886923,8305
89143038,0.0,0.0,19170000,19170000,0,0,19170000,Null,Null,89143038,167287,11518
89143960,0.0,0.0,11900,11900,0,0,11900,Null,Null,89143960,111461,23010
89146313,0.0,0.0,8785714,6150000,2635714,30,8785714,Null,Null,89146313,4683951,8511
89146349,0.0,0.0,8785714,6150000,2635714,30,8785714,Null,Null,89146349,4683951,8511
89146369,0.0,0.0,8785714,6150000,2635714,30,8785714,Null,Null,89146369,4683951,8511
89151228,0.0,0.0,9071429,9071429,0,0,9071429,Null,Null,89151228,4683951,8511
89151384,0.0,0.0,9071429,6350000,2721429,30,9071429,Null,Null,89151384,4683951,8511
89151429,0.0,0.0,9071429,6350000,2721429,30,9071429,Null,Null,89151429,4683951,8511
89151432,0.0,0.0,9017429,6312200,2705229,30,9017429,Null,Null,89151432,4683951,8511
89154708,2.0,2.0,25000,25000,0,0,25000,Null,Null,89154708,111461,15320
89165584,4.0,4.0,5000000,4500000,500000,10,5000000,Null,Null,89165584,842073,11857
89204299,1417.0,1417.0,80000,49000,31000,39,80000,Null,Null,89204299,111461,17186
89208874,562.0,562.0,519000,325000,194000,37,519000,Null,Null,89208874,18984,3428
89209810,105.0,105.0,27390,27390,0,0,27390,Null,Null,89209810,111461,20182
89210688,15.0,15.0,21000,9000,12000,57,21000,Null,Null,89210688,111461,2
89222036,2.0,2.0,8500000,8500000,0,0,8500000,Null,Null,89222036,47678,2342
89222282,4.0,4.0,13500000,13500000,0,0,13500000,Null,Null,89222282,47678,2342
89227279,784.0,784.0,69000,34000,35000,51,69000,Null,Null,89227279,168669,3710
89233680,256.0,256.0,65000,65000,0,0,65000,Null,Null,89233680,111461,5995
89244169,0.0,0.0,10000,10000,0,0,10000,Null,Null,89244169,111461,8205
89245624,1176.0,1176.0,80000,49000,31000,39,80000,Null,Null,89245624,111461,17186
89396069,0.0,0.0,23780000,17835000,5945000,25,23780000,Null,Null,89396069,167287,20170
89416302,0.0,0.0,7642857,7642857,0,0,7642857,Null,Null,89416302,4683951,8511
89421634,9.0,9.0,635000,635000,0,0,635000,Null,Null,89421634,165313,3990
89426806,116.0,116.0,6900,6900,0,0,6900,Null,Null,89426806,111461,2
89427290,8.0,8.0,8000,8000,0,0,8000,Null,Null,89427290,111461,8205
89427326,5.0,5.0,15000,15000,0,0,15000,Null,Null,89427326,111461,2363
89441903,7753.0,7753.0,44500,44500,0,0,44500,Null,Null,89441903,886923,8305
89453215,297.0,297.0,65000,65000,0,0,65000,Null,Null,89453215,422017,1820
89456087,0.0,0.0,37500000,37500000,0,0,37500000,Null,Null,89456087,4688011,11935
89463597,306.0,306.0,22000,22000,0,0,22000,Null,Null,89463597,143398,4452
89465583,0.0,0.0,32710000,24532500,8177500,25,32710000,Null,Null,89465583,167287,20170
89465894,0.0,0.0,39580000,29685000,9895000,25,39580000,Null,Null,89465894,167287,20170
89467227,0.0,0.0,27770000,20827500,6942500,25,27770000,Null,Null,89467227,167287,20170
89467263,398.0,398.0,88000,88000,0,0,88000,Null,Null,89467263,111461,8314
89469263,0.0,0.0,27770000,20827500,6942500,25,27770000,Null,Null,89469263,167287,20170
89472384,9.0,9.0,6500,6500,0,0,6500,Null,Null,89472384,111461,11935
89472443,0.0,0.0,7500,7500,0,0,7500,Null,Null,89472443,111461,8197
89473136,0.0,0.0,6900,6900,0,0,6900,Null,Null,89473136,111461,28480
89473437,140.0,140.0,17800,17800,0,0,17800,Null,Null,89473437,111461,2760
89491905,242.0,242.0,99000,99000,0,0,99000,Null,Null,89491905,4515995,28482
89519485,113.0,113.0,310000,310000,0,0,310000,Null,Null,89519485,197767,2234
89578371,0.0,0.0,1886,1886,0,0,1886,Null,Null,89578371,111461,23112
89624944,24.0,24.0,150000,150000,0,0,150000,Null,Null,89624944,111461,28594
89625320,46.0,46.0,29900,29900,0,0,29900,Null,Null,89625320,111461,20174
89637493,11.0,11.0,195000,195000,0,0,195000,Null,Null,89637493,110996,5566
89637519,0.0,0.0,8000,8000,0,0,8000,Null,Null,89637519,111461,5566
89637536,0.0,0.0,6086,6086,0,0,6086,Null,Null,89637536,111461,8073
89639305,1.0,1.0,152000,152000,0,0,152000,Null,Null,89639305,111461,2
89639373,0.0,0.0,17000,17000,0,0,17000,Null,Null,89639373,111461,2
89639987,2.0,2.0,9100,9100,0,0,9100,Null,Null,89639987,111461,2
89641322,1.0,1.0,17000,17000,0,0,17000,Null,Null,89641322,111461,2
89641558,0.0,0.0,17000,17000,0,0,17000,Null,Null,89641558,111461,2
89641951,0.0,0.0,17000,17000,0,0,17000,Null,Null,89641951,111461,2
89642309,1.0,1.0,17000,17000,0,0,17000,Null,Null,89642309,111461,2
89642389,0.0,0.0,15000,15000,0,0,15000,Null,Null,89642389,111461,2
89642406,0.0,0.0,13000,13000,0,0,13000,Null,Null,89642406,111461,2
89642725,554.0,554.0,58000,51040,6960,12,58000,Null,Null,89642725,4269901,1883
89648374,1.0,1.0,17110,17110,0,0,17110,Null,Null,89648374,111461,15320
89648483,0.0,0.0,8450,8450,0,0,8450,Null,Null,89648483,111461,2
89648501,1.0,1.0,7507,7507,0,0,7507,Null,Null,89648501,111461,15320
89648520,0.0,0.0,9100,9100,0,0,9100,Null,Null,89648520,111461,2
89648540,0.0,0.0,8872,8872,0,0,8872,Null,Null,89648540,111461,2
89648578,0.0,0.0,5947,5947,0,0,5947,Null,Null,89648578,111461,2
89651192,0.0,0.0,7605,7605,0,0,7605,Null,Null,89651192,111461,15320
89651201,0.0,0.0,9750,9750,0,0,9750,Null,Null,89651201,111461,2
89653895,0.0,0.0,19630000,14722500,4907500,25,19630000,Null,Null,89653895,167287,20170
89656348,160.0,160.0,28500,28500,0,0,28500,Null,Null,89656348,111461,28480
89661496,0.0,0.0,2599,2599,0,0,2599,Null,Null,89661496,111461,2363
89675410,0.0,0.0,27800000,27800000,0,0,27800000,Null,Null,89675410,4691865,11935
89691201,166.0,166.0,359000,359000,0,0,359000,Null,Null,89691201,541293,1520
89692612,457.0,457.0,500000,222000,278000,56,500000,Null,Null,89692612,500047,8400
89701209,49.0,49.0,30900,30900,0,0,30900,Null,Null,89701209,111461,2514
89718996,589.0,589.0,340000,198000,142000,42,340000,Null,Null,89718996,4011099,53054
89753515,10.0,10.0,108000,108000,0,0,108000,Null,Null,89753515,203101,1752
89774434,23.0,23.0,79900,79900,0,0,79900,Null,Null,89774434,111461,23242
89823328,18.0,18.0,5460,5460,0,0,5460,Null,Null,89823328,111461,2
89824145,117.0,117.0,158000,158000,0,0,158000,Null,Null,89824145,31835,1752
89824210,1.0,1.0,7500,7500,0,0,7500,Null,Null,89824210,111461,8205
89878687,13.0,13.0,105000,94500,10500,10,105000,Null,Null,89878687,111461,15250
89879018,17.0,17.0,420000,378000,42000,10,420000,Null,Null,89879018,111461,15318
89879051,6.0,6.0,155000,139500,15500,10,155000,Null,Null,89879051,111461,15250
89879290,17.0,17.0,85000,76500,8500,10,85000,Null,Null,89879290,111461,15236
89879364,8.0,8.0,113000,101700,11300,10,113000,Null,Null,89879364,111461,15250
89889105,365.0,365.0,49000,26000,23000,47,49000,Null,Null,89889105,308227,11883
89931480,123.0,123.0,219000,219000,0,0,219000,Null,Null,89931480,31835,1752
89937454,1.0,1.0,46999,46999,0,0,46999,Null,Null,89937454,111461,27180
89963692,0.0,0.0,14500,14500,0,0,14500,Null,Null,89963692,111461,15236
89978933,1.0,1.0,1500,1500,0,0,1500,Null,Null,89978933,5225483,1883
89979124,0.0,0.0,1500,1500,0,0,1500,Null,Null,89979124,5225483,2363
89979154,0.0,0.0,6900,6900,0,0,6900,Null,Null,89979154,111461,2
89979226,21.0,21.0,9500,9000,500,5,9500,Null,Null,89979226,111461,2
89979431,2.0,2.0,1500,1500,0,0,1500,Null,Null,89979431,5225483,2363
89980304,143.0,143.0,500000,379000,121000,24,500000,Null,Null,89980304,19312,1815
89980825,6.0,6.0,285000,285000,0,0,285000,Null,Null,89980825,484375,23258
89984164,109.0,109.0,329000,239000,90000,27,329000,Null,Null,89984164,886923,8305
89992214,2778.0,2778.0,125000,69000,56000,45,125000,Null,Null,89992214,484375,23258
89993203,9.0,9.0,348000,348000,0,0,348000,Null,Null,89993203,111461,15318
90023969,98.0,98.0,50700,32000,18700,37,50700,Null,Null,90023969,111461,23010
90023970,497.0,497.0,130000,65000,65000,50,130000,Null,Null,90023970,111461,23010
90023981,626.0,626.0,10400,7000,3400,33,10400,Null,Null,90023981,111461,23010
90082542,92.0,92.0,129000,85000,44000,34,129000,Null,Null,90082542,4529021,1811
90088708,0.0,0.0,7800,7800,0,0,7800,Null,Null,90088708,111461,2
90089711,2.0,2.0,6500,6500,0,0,6500,Null,Null,90089711,111461,28472
90090068,0.0,0.0,7800,7800,0,0,7800,Null,Null,90090068,111461,2
90090265,0.0,0.0,9100,9100,0,0,9100,Null,Null,90090265,111461,2
90091708,43.0,43.0,47700,47700,0,0,47700,Null,Null,90091708,111461,2
90094334,0.0,0.0,8400,8400,0,0,8400,Null,Null,90094334,111461,2
90094929,0.0,0.0,7800,7800,0,0,7800,Null,Null,90094929,111461,2
90111408,4.0,4.0,125000,125000,0,0,125000,Null,Null,90111408,111461,15320
90119083,58.0,58.0,29000,29000,0,0,29000,Null,Null,90119083,143249,23508
90172759,35.0,35.0,23000,23000,0,0,23000,Null,Null,90172759,111461,2
90185010,486.0,486.0,95000,95000,0,0,95000,Null,Null,90185010,111461,27214
90218797,2194.0,2194.0,326000,235000,91000,28,326000,Null,Null,90218797,41661,1520
90229557,0.0,0.0,7800,7800,0,0,7800,Null,Null,90229557,111461,8201
90229960,0.0,0.0,6500,6500,0,0,6500,Null,Null,90229960,111461,8202
90230688,0.0,0.0,5200,5200,0,0,5200,Null,Null,90230688,111461,1622
90231119,0.0,0.0,7800,7800,0,0,7800,Null,Null,90231119,111461,1622
90232773,0.0,0.0,7800,7800,0,0,7800,Null,Null,90232773,111461,8199
90234363,0.0,0.0,7800,7800,0,0,7800,Null,Null,90234363,111461,1622
90236102,0.0,0.0,7800,7800,0,0,7800,Null,Null,90236102,111461,8202
90236174,0.0,0.0,6500,6500,0,0,6500,Null,Null,90236174,111461,8202
90236366,0.0,0.0,6500,6500,0,0,6500,Null,Null,90236366,111461,8202
90237090,0.0,0.0,7800,7800,0,0,7800,Null,Null,90237090,111461,1622
90237111,0.0,0.0,7800,7800,0,0,7800,Null,Null,90237111,111461,8202
90237543,0.0,0.0,6500,6500,0,0,6500,Null,Null,90237543,111461,8202
90239851,0.0,0.0,3640000,3640000,0,0,3640000,Null,Null,90239851,111461,1622
90240132,3.0,3.0,3900,3900,0,0,3900,Null,Null,90240132,111461,1622
90240211,0.0,0.0,6500,6500,0,0,6500,Null,Null,90240211,111461,8202
90300664,0.0,0.0,42350000,42350000,0,0,42350000,Null,Null,90300664,111461,27232
90331609,1342.0,1342.0,233000,148800,84200,36,233000,Null,Null,90331609,245945,11911
90438300,17.0,17.0,19000,19000,0,0,19000,Null,Null,90438300,111461,23042
90439719,364.0,364.0,29000,29000,0,0,29000,Null,Null,90439719,111461,2136
90439729,0.0,0.0,30000,30000,0,0,30000,Null,Null,90439729,111461,53074
90441185,0.0,0.0,92500000,81400000,11100000,12,92500000,Null,Null,90441185,167287,6653
90449797,0.0,0.0,22990000,20231200,2758800,12,22990000,Null,Null,90449797,167287,8067
90465074,1.0,1.0,499000,350000,149000,30,499000,Null,Null,90465074,423053,8512
90474407,55.0,55.0,840000,756000,84000,10,840000,Null,Null,90474407,227665,3424
90475341,0.0,0.0,16746000,14736480,2009520,12,16746000,Null,Null,90475341,167287,11518
90475599,0.0,0.0,20302000,17865760,2436240,12,20302000,Null,Null,90475599,167287,11516
90475710,0.0,0.0,34678000,30516640,4161360,12,34678000,Null,Null,90475710,167287,28862
90480080,483.0,483.0,789000,398000,391000,50,789000,Null,Null,90480080,160533,4381
90503559,4.0,4.0,1190000,1190000,0,0,1190000,Null,Null,90503559,46363,5384
90523892,1058.0,1058.0,568000,568000,0,0,568000,Null,Null,90523892,48077,3177
90526146,0.0,0.0,6000000,6000000,0,0,6000000,Null,Null,90526146,251973,11868
90530495,620.0,620.0,310000,250000,60000,19,310000,Null,Null,90530495,4251381,2016
90531871,3510.0,3510.0,190000,157000,33000,17,190000,Null,Null,90531871,4251381,2016
90572910,276.0,276.0,139000,83000,56000,40,139000,Null,Null,90572910,737237,23042
90574751,1.0,1.0,3208000,3208000,0,0,3208000,Null,Null,90574751,26150,8513
90576435,167.0,167.0,25000,25000,0,0,25000,Null,Null,90576435,111461,15318
90582019,3.0,3.0,5750000,4300000,1450000,25,5750000,Null,Null,90582019,368017,8306
90582116,0.0,0.0,15350000,15350000,0,0,15350000,Null,Null,90582116,167287,11518
90584510,78.0,78.0,150000,150000,0,0,150000,Null,Null,90584510,4702857,1623
90601408,0.0,0.0,2377,2377,0,0,2377,Null,Null,90601408,111461,2363
90615497,2.0,2.0,12290000,12290000,0,0,12290000,Null,Null,90615497,239655,8066
90683425,3780.0,3780.0,49000,42000,7000,14,49000,Null,Null,90683425,21261,1520
90716154,44.0,44.0,1300,1300,0,0,1300,Null,Null,90716154,111461,2
90716192,0.0,0.0,1300,1300,0,0,1300,Null,Null,90716192,111461,2
90716928,0.0,0.0,5200,5200,0,0,5200,Null,Null,90716928,111461,2
90717585,19.0,19.0,1300,1300,0,0,1300,Null,Null,90717585,111461,2
90719195,239.0,239.0,26000,26000,0,0,26000,Null,Null,90719195,111461,2
90719200,14.0,14.0,29000,29000,0,0,29000,Null,Null,90719200,111461,2
90719211,27.0,27.0,14250,14250,0,0,14250,Null,Null,90719211,111461,2
90719212,19.0,19.0,15000,15000,0,0,15000,Null,Null,90719212,111461,15236
90719250,149.0,149.0,15000,15000,0,0,15000,Null,Null,90719250,111461,15236
90719344,106.0,106.0,27000,8000,19000,70,27000,Null,Null,90719344,111461,15236
90719616,60.0,60.0,15000,15000,0,0,15000,Null,Null,90719616,111461,15236
90719645,10.0,10.0,15000,15000,0,0,15000,Null,Null,90719645,111461,15236
90720015,1.0,1.0,49000,49000,0,0,49000,Null,Null,90720015,111461,15250
90720138,158.0,158.0,15000,15000,0,0,15000,Null,Null,90720138,111461,15236
90720284,0.0,0.0,135200,135200,0,0,135200,Null,Null,90720284,111461,2
90720324,121.0,121.0,15000,15000,0,0,15000,Null,Null,90720324,111461,15236
90720554,16.0,16.0,36000,36000,0,0,36000,Null,Null,90720554,111461,15250
90720613,71.0,71.0,15000,15000,0,0,15000,Null,Null,90720613,111461,15236
90720669,9.0,9.0,30000,30000,0,0,30000,Null,Null,90720669,111461,2
90721643,0.0,0.0,0,160000,239000,0,160000,Null,Null,90721643,111461,0
90722134,0.0,0.0,21500000,21500000,0,0,21500000,Null,Null,90722134,167287,28874
90725512,3.0,3.0,38000,38000,0,0,38000,Null,Null,90725512,111461,15250
90725791,13.0,13.0,20000,20000,0,0,20000,Null,Null,90725791,111461,2
90742001,225.0,225.0,196000,119000,77000,39,196000,Null,Null,90742001,48077,2225
90799326,278.0,278.0,2500,2500,0,0,2500,Null,Null,90799326,111461,18876
90799619,70.0,70.0,1500,1500,0,0,1500,Null,Null,90799619,111461,53054
90835460,0.0,0.0,15450000,15450000,0,0,15450000,Null,Null,90835460,167287,11518
90835709,0.0,0.0,13950000,13950000,0,0,13950000,Null,Null,90835709,167287,11518
90841904,1.0,1.0,3790000,3560000,230000,6,3790000,Null,Null,90841904,520533,2340
90850064,24.0,24.0,119000,119000,0,0,119000,Null,Null,90850064,111461,23778
90850071,345.0,345.0,169000,169000,0,0,169000,Null,Null,90850071,111461,23778
90908213,116.0,116.0,29000,29000,0,0,29000,Null,Null,90908213,111461,15236
90911052,0.0,0.0,3500000,3500000,0,0,3500000,Null,Null,90911052,111461,8170
90919467,0.0,0.0,13000,13000,0,0,13000,Null,Null,90919467,4706223,2
90919970,2.0,2.0,318500,318500,0,0,318500,Null,Null,90919970,4706223,15250
90941236,2.0,2.0,54000,27000,27000,50,54000,Null,Null,90941236,111461,15320
90945671,114.0,114.0,8000,8000,0,0,8000,Null,Null,90945671,111461,5905
90945704,18.0,18.0,16500,16500,0,0,16500,Null,Null,90945704,111461,15320
90974241,9.0,9.0,12500,12500,0,0,12500,Null,Null,90974241,111461,11935
90984975,21.0,21.0,195000,195000,0,0,195000,Null,Null,90984975,111461,28468
90994386,1.0,1.0,29000,29000,0,0,29000,Null,Null,90994386,111461,3178
91003282,340.0,340.0,27000,18900,8100,30,27000,Null,Null,91003282,63747,4452
91011492,108.0,108.0,14000,14000,0,0,14000,Null,Null,91011492,111461,15236
91013563,1542.0,1542.0,55000,55000,0,0,55000,Null,Null,91013563,114568,10413
91020853,580.0,580.0,399000,399000,0,0,399000,Null,Null,91020853,171991,2324
91071799,1.0,1.0,270000,270000,0,0,270000,Null,Null,91071799,114328,1583
91075349,49.0,49.0,39000,39000,0,0,39000,Null,Null,91075349,111461,28576
91075442,169.0,169.0,39000,39000,0,0,39000,Null,Null,91075442,111461,28576
91094690,87.0,87.0,120000,120000,0,0,120000,Null,Null,91094690,4522605,28576
91121630,0.0,0.0,17990000,17990000,0,0,17990000,Null,Null,91121630,885749,8511
91121742,0.0,0.0,17990000,17990000,0,0,17990000,Null,Null,91121742,885749,8511
91124859,161.0,161.0,288000,288000,0,0,288000,Null,Null,91124859,885047,28480
91126861,3.0,3.0,453699,453699,0,0,453699,Null,Null,91126861,111461,2
91159173,30.0,30.0,3089000,3089000,0,0,3089000,Null,Null,91159173,419263,28856
91189530,49.0,49.0,474000,459000,15000,3,474000,Null,Null,91189530,243693,4593
91189740,318.0,318.0,21000,15000,6000,29,21000,Null,Null,91189740,243693,20222
91189749,54.0,54.0,125000,80000,45000,36,125000,Null,Null,91189749,243693,3805
91190504,5.0,5.0,378000,378000,0,0,378000,Null,Null,91190504,243693,28688
91190769,78.0,78.0,92000,92000,0,0,92000,Null,Null,91190769,243693,5566
91191211,202.0,202.0,112000,112000,0,0,112000,Null,Null,91191211,243693,3805
91191232,167.0,167.0,105000,68000,37000,35,105000,Null,Null,91191232,243693,3805
91192540,444.0,444.0,28000,28000,0,0,28000,Null,Null,91192540,243693,20222
91241820,178.0,178.0,47878,23939,23939,50,47878,Null,Null,91241820,509221,28484
91246081,23.0,23.0,3395,2954,441,13,3395,Null,Null,91246081,111461,2685
91256307,2532.0,2532.0,164000,81600,82400,50,164000,Null,Null,91256307,4246951,8602
91257464,339.0,339.0,168000,149000,19000,11,168000,Null,Null,91257464,192947,8300
91271951,87.0,87.0,18679,18679,0,0,18679,Null,Null,91271951,111461,23216
91271958,2.0,2.0,6900,6900,0,0,6900,Null,Null,91271958,111461,2
91273061,5048.0,5048.0,106000,106000,0,0,106000,Null,Null,91273061,863033,2514
91275720,0.0,0.0,49400000,49400000,0,0,49400000,Null,Null,91275720,165313,23112
91281318,6.0,6.0,9090000,9090000,0,0,9090000,Null,Null,91281318,419263,28856
91284340,2.0,2.0,20000000,15000000,5000000,25,20000000,Null,Null,91284340,40734,1520
91302543,26.0,26.0,7700,7700,0,0,7700,Null,Null,91302543,111461,11935
91313130,0.0,0.0,12950000,12950000,0,0,12950000,Null,Null,91313130,167287,28860
91316159,0.0,0.0,12124000,8660000,3464000,29,12124000,Null,Null,91316159,732431,8511
91316414,0.0,0.0,12124000,8660000,3464000,29,12124000,Null,Null,91316414,732431,8511
91316462,0.0,0.0,12124000,8660000,3464000,29,12124000,Null,Null,91316462,732431,8511
91324677,0.0,0.0,8890000,6350000,2540000,29,8890000,Null,Null,91324677,732431,8511
91341201,647.0,647.0,5490,5490,0,0,5490,Null,Null,91341201,111461,5450
91344044,0.0,0.0,9310000,6650000,2660000,29,9310000,Null,Null,91344044,732431,8511
91389210,8.0,8.0,135000,135000,0,0,135000,Null,Null,91389210,111461,23236
91390820,227.0,227.0,430000,252000,178000,41,430000,Null,Null,91390820,370711,8168
91419320,1.0,1.0,88000,88000,0,0,88000,Null,Null,91419320,885693,15318
91432684,26.0,26.0,1950,1950,0,0,1950,Null,Null,91432684,111461,53074
91449215,0.0,0.0,6500,6000,500,8,6500,Null,Null,91449215,111461,2
91449992,8.0,8.0,360000,360000,0,0,360000,Null,Null,91449992,114328,1583
91450200,95.0,95.0,18000,12000,6000,33,18000,Null,Null,91450200,111461,2
91471707,16.0,16.0,208000,208000,0,0,208000,Null,Null,91471707,111461,15236
91474188,9.0,9.0,153000,153000,0,0,153000,Null,Null,91474188,111461,15236
91515954,0.0,0.0,4150000,4150000,0,0,4150000,Null,Null,91515954,111461,11943
91516163,1.0,1.0,4450000,4450000,0,0,4450000,Null,Null,91516163,111461,11943
91516881,0.0,0.0,4200000,4200000,0,0,4200000,Null,Null,91516881,111461,11831
91517035,0.0,0.0,4875000,4875000,0,0,4875000,Null,Null,91517035,111461,11935
91517140,13.0,13.0,9500,9500,0,0,9500,Null,Null,91517140,111461,11831
91517171,0.0,0.0,3600000,3600000,0,0,3600000,Null,Null,91517171,111461,11943
91517175,0.0,0.0,3950000,3950000,0,0,3950000,Null,Null,91517175,111461,11943
91517182,0.0,0.0,3550000,3550000,0,0,3550000,Null,Null,91517182,111461,11935
91517249,0.0,0.0,4719000,4719000,0,0,4719000,Null,Null,91517249,111461,11943
91531237,6.0,6.0,8800,8800,0,0,8800,Null,Null,91531237,111461,28480
91546617,0.0,0.0,1999,1999,0,0,1999,Null,Null,91546617,111461,2
91553032,181.0,181.0,40000,28000,12000,30,40000,Null,Null,91553032,63747,53074
91564197,16.0,16.0,120000,120000,0,0,120000,Null,Null,91564197,111461,2
91565426,6.0,6.0,15000,9000,6000,40,15000,Null,Null,91565426,111461,8193
91565658,311.0,311.0,171000,89000,82000,48,171000,Null,Null,91565658,111422,8300
91565733,335.0,335.0,70000,35000,35000,50,70000,Null,Null,91565733,478585,1628
91566341,0.0,0.0,7357143,7357143,0,0,7357143,Null,Null,91566341,4683951,8511
91566964,143.0,143.0,70000,35000,35000,50,70000,Null,Null,91566964,478585,1628
91604437,159.0,159.0,33000,33000,0,0,33000,Null,Null,91604437,111461,53074
91604492,33.0,33.0,490000,354000,136000,28,490000,Null,Null,91604492,114328,1520
91604685,318.0,318.0,549000,494000,55000,10,549000,Null,Null,91604685,114328,1520
91604825,29.0,29.0,1088000,740250,347750,32,1088000,Null,Null,91604825,26150,8511
91611008,0.0,0.0,8000,8000,0,0,8000,Null,Null,91611008,111461,11831
91612670,6697.0,6697.0,5990000,3220000,2770000,46,5990000,Null,Null,91612670,25643,1795
91623830,92.0,92.0,3900,3900,0,0,3900,Null,Null,91623830,111461,11935
91624167,5.0,5.0,7000,7000,0,0,7000,Null,Null,91624167,111461,8205
91627260,12.0,12.0,9500,9500,0,0,9500,Null,Null,91627260,111461,11935
91627709,22.0,22.0,2000,2000,0,0,2000,Null,Null,91627709,111461,8193
91628867,22.0,22.0,9999,9999,0,0,9999,Null,Null,91628867,111461,8205
91629086,9.0,9.0,1600,1600,0,0,1600,Null,Null,91629086,111461,2
91629356,1.0,1.0,7000,7000,0,0,7000,Null,Null,91629356,111461,2
91629688,5.0,5.0,1500,1500,0,0,1500,Null,Null,91629688,111461,2
91650346,0.0,0.0,8999000,8999000,0,0,8999000,Null,Null,91650346,111461,11935
91652004,0.0,0.0,3489000,3489000,0,0,3489000,Null,Null,91652004,182293,17170
91664519,0.0,0.0,37500000,37500000,0,0,37500000,Null,Null,91664519,4688011,11935
91720838,0.0,0.0,3750000,3750000,0,0,3750000,Null,Null,91720838,414313,11847
91753273,596.0,596.0,57000,48000,9000,16,57000,Null,Null,91753273,4489095,1630
91774606,4.0,4.0,245000,245000,0,0,245000,Null,Null,91774606,114328,11605
91816286,284.0,284.0,268000,254600,13400,5,268000,Null,Null,91816286,111459,1813
91830581,31.0,31.0,211000,211000,0,0,211000,Null,Null,91830581,111461,23392
91832817,0.0,0.0,14370000,14370000,0,0,14370000,Null,Null,91832817,217953,7079
91834810,133.0,133.0,305000,305000,0,0,305000,Null,Null,91834810,199801,11885
91836155,0.0,0.0,630000,630000,0,0,630000,Null,Null,91836155,112638,1796
91847994,1.0,1.0,55000,55000,0,0,55000,Null,Null,91847994,111461,15320
91852489,0.0,0.0,4200000,4200000,0,0,4200000,Null,Null,91852489,622483,53350
91853270,196.0,196.0,159000,154000,5000,3,159000,Null,Null,91853270,111461,3178
91853326,0.0,0.0,4200000,4200000,0,0,4200000,Null,Null,91853326,622483,53350
91859512,0.0,0.0,34300000,30184000,4116000,12,34300000,Null,Null,91859512,167287,28868
91859621,0.0,0.0,32500000,28600000,3900000,12,32500000,Null,Null,91859621,167287,28868
91859686,0.0,0.0,51500000,45320000,6180000,12,51500000,Null,Null,91859686,167287,28868
91865173,262.0,262.0,760000,702000,58000,8,760000,Null,Null,91865173,215231,5267
91869059,10.0,10.0,989000,989000,0,0,989000,Null,Null,91869059,46363,5384
91892226,1620.0,1620.0,500000,449000,51000,10,500000,Null,Null,91892226,4244853,4380
92006565,0.0,0.0,9799999,9799999,0,0,9799999,Null,Null,92006565,111461,2340
92011003,44.0,44.0,4900,4900,0,0,4900,Null,Null,92011003,111461,2
92047654,13.0,13.0,850000,299000,551000,65,850000,Null,Null,92047654,111461,28576
92071009,0.0,0.0,17599000,17599000,0,0,17599000,Null,Null,92071009,111461,2340
92084797,34.0,34.0,185000,165000,20000,11,185000,Null,Null,92084797,21651,12908
92126830,1.0,1.0,1950,1950,0,0,1950,Null,Null,92126830,111461,2
92135596,1.0,1.0,32000000,32000000,0,0,32000000,Null,Null,92135596,167287,2324
92135856,0.0,0.0,13400000,13400000,0,0,13400000,Null,Null,92135856,167287,2324
92135880,0.0,0.0,36500000,36500000,0,0,36500000,Null,Null,92135880,167287,8067
92146083,1.0,1.0,31500000,31500000,0,0,31500000,Null,Null,92146083,167287,2324
92146086,1659.0,1659.0,634000,458000,176000,28,634000,Null,Null,92146086,21261,1630
92146177,0.0,0.0,105850000,105850000,0,0,105850000,Null,Null,92146177,167287,2324
92146378,0.0,0.0,6500,6500,0,0,6500,Null,Null,92146378,111461,2
92146548,3.0,3.0,219700,219700,0,0,219700,Null,Null,92146548,111461,2
92146630,1.0,1.0,229000,229000,0,0,229000,Null,Null,92146630,111461,2
92147419,0.0,0.0,1300,1300,0,0,1300,Null,Null,92147419,111461,2
92149684,0.0,0.0,11700,11700,0,0,11700,Null,Null,92149684,111461,2
92150189,4.0,4.0,349700,349700,0,0,349700,Null,Null,92150189,111461,2
92150501,1.0,1.0,219700,219700,0,0,219700,Null,Null,92150501,111461,2
92159183,28.0,28.0,486000,438000,48000,10,486000,Null,Null,92159183,21261,1630
92159194,2002.0,2002.0,616000,438000,178000,29,616000,Null,Null,92159194,21261,1520
92159200,21.0,21.0,460000,398000,62000,13,460000,Null,Null,92159200,21261,1520
92159205,240.0,240.0,350000,260000,90000,26,350000,Null,Null,92159205,21261,1630
92166740,0.0,0.0,60000,36899,23101,39,60000,Null,Null,92166740,111461,2
92346647,3.0,3.0,19000,19000,0,0,19000,Null,Null,92346647,111461,15318
92349786,19.0,19.0,19000,19000,0,0,19000,Null,Null,92349786,111461,15318
92370180,25.0,25.0,111000,111000,0,0,111000,Null,Null,92370180,111461,15318
92370398,1.0,1.0,74000,74000,0,0,74000,Null,Null,92370398,111461,15236
92370680,0.0,0.0,14000,14000,0,0,14000,Null,Null,92370680,111461,15318
92370755,0.0,0.0,14000,14000,0,0,14000,Null,Null,92370755,111461,15318
92371349,1.0,1.0,219000,219000,0,0,219000,Null,Null,92371349,111461,15250
92371438,0.0,0.0,10000,10000,0,0,10000,Null,Null,92371438,111461,15318
92371743,0.0,0.0,6825000,6825000,0,0,6825000,Null,Null,92371743,111461,15936
92372745,29.0,29.0,14000,14000,0,0,14000,Null,Null,92372745,111461,15318
92373533,8.0,8.0,17000,17000,0,0,17000,Null,Null,92373533,111461,15318
92374153,4.0,4.0,164000,164000,0,0,164000,Null,Null,92374153,111461,15236
92374337,0.0,0.0,7000,7000,0,0,7000,Null,Null,92374337,111461,15250
92375473,0.0,0.0,7000,7000,0,0,7000,Null,Null,92375473,111461,15236
92387171,1050.0,1050.0,17000,17000,0,0,17000,Null,Null,92387171,225615,5450
92403906,0.0,0.0,19380000,19380000,0,0,19380000,Null,Null,92403906,74552,10413
92453371,679.0,679.0,130000,130000,0,0,130000,Null,Null,92453371,837855,5995
92454199,524.0,524.0,349000,229000,120000,34,349000,Null,Null,92454199,111461,8225
92495931,0.0,0.0,53500000,53500000,0,0,53500000,Null,Null,92495931,167287,8064
92496889,0.0,0.0,25500000,25500000,0,0,25500000,Null,Null,92496889,167287,11518
92497038,0.0,0.0,22500000,22500000,0,0,22500000,Null,Null,92497038,167287,11518
92498384,0.0,0.0,33500000,33500000,0,0,33500000,Null,Null,92498384,167287,28860
92498614,0.0,0.0,19800000,19800000,0,0,19800000,Null,Null,92498614,167287,28860
92499269,9.0,9.0,136500,136500,0,0,136500,Null,Null,92499269,111461,2
92499842,0.0,0.0,14200000,14200000,0,0,14200000,Null,Null,92499842,167287,28860
92521124,57.0,57.0,38999,38999,0,0,38999,Null,Null,92521124,111461,5995
92544420,4.0,4.0,19000,3000,16000,84,19000,Null,Null,92544420,111461,8193
92547200,0.0,0.0,47900000,47900000,0,0,47900000,Null,Null,92547200,167287,2324
92550278,0.0,0.0,17590000,17590000,0,0,17590000,Null,Null,92550278,111461,2340
92559231,236.0,236.0,57000,50500,6500,11,57000,Null,Null,92559231,156143,17162
92581654,38.0,38.0,1300,1300,0,0,1300,Null,Null,92581654,111461,27214
92587326,268.0,268.0,160000,155000,5000,3,160000,Null,Null,92587326,111461,23042
92621519,0.0,0.0,15000,15000,0,0,15000,Null,Null,92621519,324891,49726
92622087,0.0,0.0,6000,6000,0,0,6000,Null,Null,92622087,324891,49726
92622944,0.0,0.0,6000,6000,0,0,6000,Null,Null,92622944,324891,49726
92624491,3.0,3.0,329000,329000,0,0,329000,Null,Null,92624491,324891,49722
92625061,1.0,1.0,14000,14000,0,0,14000,Null,Null,92625061,324891,49726
92626802,3.0,3.0,206000,206000,0,0,206000,Null,Null,92626802,324891,49722
92627280,7.0,7.0,169000,169000,0,0,169000,Null,Null,92627280,324891,49722
92628853,0.0,0.0,6000,6000,0,0,6000,Null,Null,92628853,324891,49726
92641341,1.0,1.0,13000,13000,0,0,13000,Null,Null,92641341,324891,49726
92698521,335.0,335.0,2990000,2250000,740000,25,2990000,Null,Null,92698521,4664555,23464
92714902,0.0,0.0,109000,80000,29000,27,109000,Null,Null,92714902,111461,15318
92777792,4.0,4.0,8900,8900,0,0,8900,Null,Null,92777792,111461,28674
92801514,0.0,0.0,4810000,3515000,1295000,27,4810000,Null,Null,92801514,46007,53350
92815971,0.0,0.0,18000,18000,0,0,18000,Null,Null,92815971,111461,15250
92815974,0.0,0.0,18000,18000,0,0,18000,Null,Null,92815974,111461,2
92817164,0.0,0.0,17000,17000,0,0,17000,Null,Null,92817164,111461,15250
92817188,66.0,66.0,18000,18000,0,0,18000,Null,Null,92817188,111461,2
92817245,3.0,3.0,24000,24000,0,0,24000,Null,Null,92817245,111461,15250
92817274,8.0,8.0,18500,18500,0,0,18500,Null,Null,92817274,111461,2
92817327,31.0,31.0,33000,17000,16000,48,33000,Null,Null,92817327,111461,15250
92817522,42.0,42.0,20500,8000,12500,61,20500,Null,Null,92817522,111461,15236
92819972,7.0,7.0,35000,35000,0,0,35000,Null,Null,92819972,111461,15250
92872088,0.0,0.0,34000,17000,17000,50,34000,Null,Null,92872088,4647777,15318
92901245,0.0,0.0,58500000,58500000,0,0,58500000,Null,Null,92901245,167287,2324
92905407,16.0,16.0,155000,155000,0,0,155000,Null,Null,92905407,111461,49724
92925139,282.0,282.0,20000,20000,0,0,20000,Null,Null,92925139,196423,2340
92957153,2.0,2.0,34000,17000,17000,50,34000,Null,Null,92957153,4647777,15318
92964825,4.0,4.0,12000,6000,6000,50,12000,Null,Null,92964825,4647777,15318
92984745,14.0,14.0,298000,298000,0,0,298000,Null,Null,92984745,111461,15318
93010689,61.0,61.0,18200,17836,364,2,18200,Null,Null,93010689,111461,28682
93078800,7331.0,7331.0,106000,97000,9000,8,106000,Null,Null,93078800,21266,1520
93151281,0.0,0.0,62500000,62500000,0,0,62500000,Null,Null,93151281,167287,2324
93154028,232.0,232.0,185000,185000,0,0,185000,Null,Null,93154028,74999,27214
93181812,0.0,0.0,50390000,50390000,0,0,50390000,Null,Null,93181812,153444,23464
93194040,0.0,0.0,14000,14000,0,0,14000,Null,Null,93194040,111461,15320
93194573,0.0,0.0,9000,9000,0,0,9000,Null,Null,93194573,111461,15320
93232319,0.0,0.0,19900000,19900000,0,0,19900000,Null,Null,93232319,217953,7079
93233670,0.0,0.0,19900000,19900000,0,0,19900000,Null,Null,93233670,217953,7079
93245336,17.0,17.0,2600,2600,0,0,2600,Null,Null,93245336,143006,1634
93245442,1.0,1.0,9800,9800,0,0,9800,Null,Null,93245442,111461,11935
93246401,3.0,3.0,6500,6500,0,0,6500,Null,Null,93246401,111461,8205
93290863,3.0,3.0,85000,65000,20000,24,85000,Null,Null,93290863,111461,15250
93318213,0.0,0.0,5999000,5999000,0,0,5999000,Null,Null,93318213,111461,8061
93337888,0.0,0.0,9799999,9799999,0,0,9799999,Null,Null,93337888,111461,2340
93388751,22.0,22.0,619000,619000,0,0,619000,Null,Null,93388751,111461,23254
93457801,381.0,381.0,399000,379050,19950,5,399000,Null,Null,93457801,183251,11767
93502532,0.0,0.0,1990000,1990000,0,0,1990000,Null,Null,93502532,19673,1795
93705182,68.0,68.0,539000,539000,0,0,539000,Null,Null,93705182,111461,28398
93759655,0.0,0.0,16500000,16500000,0,0,16500000,Null,Null,93759655,111461,11933
93760107,702.0,702.0,285000,285000,0,0,285000,Null,Null,93760107,516689,23246
93764321,16.0,16.0,130000,130000,0,0,130000,Null,Null,93764321,111461,15250
93819008,173.0,173.0,69000,69000,0,0,69000,Null,Null,93819008,111461,15318
93840468,646.0,646.0,996000,598000,398000,40,996000,Null,Null,93840468,4246951,8225
93849412,0.0,0.0,54500000,54500000,0,0,54500000,Null,Null,93849412,433227,2340
93871142,70.0,70.0,199000,199000,0,0,199000,Null,Null,93871142,111461,2340
93931238,93.0,93.0,199000,125000,74000,37,199000,Null,Null,93931238,3970517,2659
94002994,1.0,1.0,9100,9100,0,0,9100,Null,Null,94002994,111461,2
94087656,450.0,450.0,110000,110000,0,0,110000,Null,Null,94087656,878331,11879
94095237,0.0,0.0,36500000,36500000,0,0,36500000,Null,Null,94095237,433227,2340
94118366,60.0,60.0,150000,125000,25000,17,150000,Null,Null,94118366,192947,8300
94118705,225.0,225.0,96000,80000,16000,17,96000,Null,Null,94118705,192947,8300
94134983,0.0,0.0,11420000,11420000,0,0,11420000,Null,Null,94134983,4768715,12864
94134990,0.0,0.0,15847000,15847000,0,0,15847000,Null,Null,94134990,4768715,12864
94135007,0.0,0.0,46000000,46000000,0,0,46000000,Null,Null,94135007,19788,12864
94135048,0.0,0.0,29000000,29000000,0,0,29000000,Null,Null,94135048,4282231,12864
94135118,0.0,0.0,15700000,15700000,0,0,15700000,Null,Null,94135118,184297,12864
94135186,0.0,0.0,23873000,23873000,0,0,23873000,Null,Null,94135186,579633,12864
94135241,0.0,0.0,42471000,42471000,0,0,42471000,Null,Null,94135241,4282231,12864
94146543,202.0,202.0,280000,264000,16000,6,280000,Null,Null,94146543,257373,1641
94150153,0.0,0.0,6500,6500,0,0,6500,Null,Null,94150153,111461,11935
94225349,54.0,54.0,11600,9744,1856,16,11600,Null,Null,94225349,111461,8172
94304443,405.0,405.0,1253001,1227000,26001,2,1253001,Null,Null,94304443,2630119,2657
94343463,120.0,120.0,102000,102000,0,0,102000,Null,Null,94343463,294273,11753
94347561,9.0,9.0,599000,599000,0,0,599000,Null,Null,94347561,19312,28454
94385050,46.0,46.0,2500,2500,0,0,2500,Null,Null,94385050,111461,53074
94427509,0.0,0.0,42000000,42000000,0,0,42000000,Null,Null,94427509,433227,2340
94453667,0.0,0.0,1050000,1050000,0,0,1050000,Null,Null,94453667,472079,8061
94454526,1.0,1.0,12300,12300,0,0,12300,Null,Null,94454526,111461,2
94464050,0.0,0.0,11700,11700,0,0,11700,Null,Null,94464050,111461,2
94466301,21.0,21.0,1300,1300,0,0,1300,Null,Null,94466301,111461,23254
94468420,0.0,0.0,1146600,711000,435600,38,1146600,Null,Null,94468420,111461,2
94469895,4.0,4.0,12300,12300,0,0,12300,Null,Null,94469895,111461,2
94520541,0.0,0.0,9999,9999,0,0,9999,Null,Null,94520541,111461,2
94626794,0.0,0.0,4000,3500,500,13,4000,Null,Null,94626794,111461,8225
94628942,0.0,0.0,4000,3800,200,5,4000,Null,Null,94628942,111461,8225
94656236,555.0,555.0,7990000,5700000,2290000,29,7990000,Null,Null,94656236,4403455,23450
94659732,0.0,0.0,7000000,4300000,2700000,39,7000000,Null,Null,94659732,427097,53350
94700631,159.0,159.0,189000,189000,0,0,189000,Null,Null,94700631,7368269,23392
94724836,1.0,1.0,43000,43000,0,0,43000,Null,Null,94724836,111461,7449
94724913,1724.0,1724.0,70000,57000,13000,19,70000,Null,Null,94724913,3985581,23718
94746382,25.0,25.0,180000,132000,48000,27,180000,Null,Null,94746382,173547,15320
94778000,1063.0,1063.0,196000,196000,0,0,196000,Null,Null,94778000,837855,5995
94801128,147.0,147.0,649000,507000,142000,22,649000,Null,Null,94801128,21651,4593
94801597,1.0,1.0,55000,55000,0,0,55000,Null,Null,94801597,111461,2
94835144,4.0,4.0,10400,10400,0,0,10400,Null,Null,94835144,111461,15320
94837549,0.0,0.0,15600,15600,0,0,15600,Null,Null,94837549,111461,15320
94837621,14.0,14.0,13000,13000,0,0,13000,Null,Null,94837621,111461,15320
94838436,23.0,23.0,15600,15600,0,0,15600,Null,Null,94838436,111461,15320
94838472,0.0,0.0,13000,13000,0,0,13000,Null,Null,94838472,111461,15320
94838499,2.0,2.0,13000,13000,0,0,13000,Null,Null,94838499,111461,15320
94846978,48.0,48.0,240000,210000,30000,13,240000,Null,Null,94846978,173547,15320
94847014,642.0,642.0,180000,180000,0,0,180000,Null,Null,94847014,4777435,23800
94888985,6.0,6.0,65000,65000,0,0,65000,Null,Null,94888985,111461,23040
94891198,1372.0,1372.0,500000,281000,219000,44,500000,Null,Null,94891198,4224691,1883
94904921,4.0,4.0,1719000,1117350,601650,35,1719000,Null,Null,94904921,150522,15250
94955843,62.0,62.0,61500,60000,1500,2,61500,Null,Null,94955843,111461,23622
94956477,0.0,0.0,1500,1500,0,0,1500,Null,Null,94956477,111461,2
94956933,0.0,0.0,19000,19000,0,0,19000,Null,Null,94956933,111461,2
94996979,0.0,0.0,130000,130000,0,0,130000,Null,Null,94996979,111461,3177
94997356,722.0,722.0,220000,150000,70000,32,220000,Null,Null,94997356,4224691,49722
94997893,10.0,10.0,6000,6000,0,0,6000,Null,Null,94997893,111461,8189
95002589,0.0,0.0,11770000,11770000,0,0,11770000,Null,Null,95002589,4610513,8073
95002625,0.0,0.0,13380000,13380000,0,0,13380000,Null,Null,95002625,4610513,8073
95002671,0.0,0.0,16410000,16410000,0,0,16410000,Null,Null,95002671,4610513,7079
95008880,28.0,28.0,689000,689000,0,0,689000,Null,Null,95008880,46363,5384
95011377,33.0,33.0,220000,220000,0,0,220000,Null,Null,95011377,171459,8513
95014508,199.0,199.0,370000,370000,0,0,370000,Null,Null,95014508,3216013,20492
95043563,2076.0,2076.0,65000,49000,16000,25,65000,Null,Null,95043563,4430657,2685
95050178,11.0,11.0,5700000,4190000,1510000,26,5700000,Null,Null,95050178,157347,2340
95050790,10.0,10.0,5700000,4190000,1510000,26,5700000,Null,Null,95050790,157347,2340
95053995,3.0,3.0,132000,118800,13200,10,132000,Null,Null,95053995,111461,15320
95067213,1661.0,1661.0,76700,32000,44700,58,76700,Null,Null,95067213,272829,8308
95075089,0.0,0.0,5370000,4510800,859200,16,5370000,Null,Null,95075089,412709,11847
95075103,5.0,5.0,4300000,3655000,645000,15,4300000,Null,Null,95075103,412709,11847
95075111,3.0,3.0,6450000,5418000,1032000,16,6450000,Null,Null,95075111,412709,11847
95085073,520.0,520.0,590000,369000,221000,37,590000,Null,Null,95085073,246045,4593
95085487,30.0,30.0,74395,70000,4395,6,74395,Null,Null,95085487,111461,28480
95096305,72.0,72.0,309900,309900,0,0,309900,Null,Null,95096305,111461,28682
95098206,45.0,45.0,69000,69000,0,0,69000,Null,Null,95098206,111461,15318
95127369,0.0,0.0,30000,18000,12000,40,30000,Null,Null,95127369,4647777,15318
95141759,7.0,7.0,32500,17000,15500,48,32500,Null,Null,95141759,111461,15236
95141843,5.0,5.0,32500,17000,15500,48,32500,Null,Null,95141843,111461,2
95141859,8.0,8.0,32500,17000,15500,48,32500,Null,Null,95141859,111461,15236
95142744,89.0,89.0,150000,150000,0,0,150000,Null,Null,95142744,858145,11735
95150406,353.0,353.0,160000,160000,0,0,160000,Null,Null,95150406,858145,11735
95180851,1.0,1.0,1168700,1168700,0,0,1168700,Null,Null,95180851,48865,2
95186446,0.0,0.0,5200,5200,0,0,5200,Null,Null,95186446,111461,28472
95187977,238.0,238.0,23000,23000,0,0,23000,Null,Null,95187977,257333,28594
95189404,7.0,7.0,69000,69000,0,0,69000,Null,Null,95189404,257333,28484
95189859,57.0,57.0,19000,19000,0,0,19000,Null,Null,95189859,111461,28594
95217901,0.0,0.0,0,14990000,0,0,14990000,Null,Null,95217901,144779,0
95218548,0.0,0.0,22500000,12499998,10000002,44,22500000,Null,Null,95218548,144779,2324
95252945,92.0,92.0,139000,139000,0,0,139000,Null,Null,95252945,111461,2340
95253531,3903.0,3903.0,533700,380000,153700,29,533700,Null,Null,95253531,27918,8223
95253798,343.0,343.0,1579000,699000,880000,56,1579000,Null,Null,95253798,19813,1883
95274033,141.0,141.0,45000,39000,6000,13,45000,Null,Null,95274033,149797,8305
95285230,28.0,28.0,350000,179000,171000,49,350000,Null,Null,95285230,4647777,15236
95294058,10.0,10.0,860000,599000,261000,30,860000,Null,Null,95294058,4647777,15250
95297317,0.0,0.0,1000,990,10,1,1000,Null,Null,95297317,111461,2
95316540,2.0,2.0,10500,10000,500,5,10500,Null,Null,95316540,111461,28480
95335291,5.0,5.0,34900,34900,0,0,34900,Null,Null,95335291,111461,2363
95336889,45.0,45.0,228000,228000,0,0,228000,Null,Null,95336889,151948,1636
95466055,297.0,297.0,45000,40000,5000,11,45000,Null,Null,95466055,4783951,8199
95472225,0.0,0.0,73000000,73000000,0,0,73000000,Null,Null,95472225,433227,2340
95510657,0.0,0.0,13000,13000,0,0,13000,Null,Null,95510657,111461,2
95520132,19.0,19.0,229000,229000,0,0,229000,Null,Null,95520132,680981,49722
95547219,0.0,0.0,6900000,6900000,0,0,6900000,Null,Null,95547219,526683,15318
95573135,35.0,35.0,1400000,1400000,0,0,1400000,Null,Null,95573135,50629,28454
95681214,82.0,82.0,1200000,966000,234000,20,1200000,Null,Null,95681214,50629,12908
95681232,300.0,300.0,750000,685000,65000,9,750000,Null,Null,95681232,50629,12908
95682864,60.0,60.0,165000,89000,76000,46,165000,Null,Null,95682864,53195,20244
95735629,581.0,581.0,145000,145000,0,0,145000,Null,Null,95735629,21274,8217
95735940,1.0,1.0,537350,488500,48850,9,537350,Null,Null,95735940,20954,26652
95766439,1.0,1.0,2500,2500,0,0,2500,Null,Null,95766439,111461,2
95766632,16.0,16.0,4000,4000,0,0,4000,Null,Null,95766632,111461,2
95766771,100.0,100.0,1000,1000,0,0,1000,Null,Null,95766771,111461,2
95768212,0.0,0.0,1500,1500,0,0,1500,Null,Null,95768212,111461,11856
95768759,20.0,20.0,2500,2500,0,0,2500,Null,Null,95768759,111461,2
95859401,13.0,13.0,226000,203400,22600,10,226000,Null,Null,95859401,111461,15250
95875948,100.0,100.0,53200,52000,1200,2,53200,Null,Null,95875948,230983,2154
95890377,1.0,1.0,750000,750000,0,0,750000,Null,Null,95890377,111461,49724
95892055,5.0,5.0,9000,9000,0,0,9000,Null,Null,95892055,111461,28470
95892691,5.0,5.0,6500,6500,0,0,6500,Null,Null,95892691,111461,11935
95892692,0.0,0.0,6500,6500,0,0,6500,Null,Null,95892692,111461,11935
95892770,0.0,0.0,4550,4550,0,0,4550,Null,Null,95892770,111461,11935
95892807,0.0,0.0,6500,6500,0,0,6500,Null,Null,95892807,111461,11935
95893138,40.0,40.0,899000,899000,0,0,899000,Null,Null,95893138,111461,49724
95975019,764.0,764.0,300000,270000,30000,10,300000,Null,Null,95975019,199801,1520
95986590,15.0,15.0,199000,199000,0,0,199000,Null,Null,95986590,111461,49722
95995721,0.0,0.0,9799999,9799999,0,0,9799999,Null,Null,95995721,111461,2340
96000885,0.0,0.0,10299000,10299000,0,0,10299000,Null,Null,96000885,111461,2340
96002828,25.0,25.0,1490000,749000,741000,50,1490000,Null,Null,96002828,19312,28454
96013786,10.0,10.0,680000,680000,0,0,680000,Null,Null,96013786,469547,15320
96015276,0.0,0.0,17399000,17399000,0,0,17399000,Null,Null,96015276,111461,2340
96020845,0.0,0.0,17273000,17273000,0,0,17273000,Null,Null,96020845,4797695,20248
96026904,28.0,28.0,265000,265000,0,0,265000,Null,Null,96026904,4784973,1623
96037364,53.0,53.0,499000,290000,209000,42,499000,Null,Null,96037364,20271,4880
96082428,29.0,29.0,1100,1100,0,0,1100,Null,Null,96082428,111461,2
96097649,2.0,2.0,9100,8869,231,3,9100,Null,Null,96097649,111461,2
96112517,1.0,1.0,13400000,13400000,0,0,13400000,Null,Null,96112517,167287,2324
96112869,129.0,129.0,60000,37000,23000,38,60000,Null,Null,96112869,3970517,28480
96129134,75.0,75.0,329000,329000,0,0,329000,Null,Null,96129134,111461,27170
96147097,44.0,44.0,12000,12000,0,0,12000,Null,Null,96147097,111461,23456
96175682,577.0,577.0,2680000,2680000,0,0,2680000,Null,Null,96175682,254939,23634
96183241,626.0,626.0,300000,200000,100000,33,300000,Null,Null,96183241,4664555,23528
96199726,580.0,580.0,349000,299000,50000,14,349000,Null,Null,96199726,626253,8226
96205020,0.0,0.0,890000,890000,0,0,890000,Null,Null,96205020,254939,23634
96209890,7.0,7.0,115000,115000,0,0,115000,Null,Null,96209890,185015,23022
96224276,1704.0,1704.0,99000,75000,24000,24,99000,Null,Null,96224276,4691869,1804
96230011,260.0,260.0,15000,9900,5100,34,15000,Null,Null,96230011,474145,8305
96230088,885.0,885.0,9000,8000,1000,11,9000,Null,Null,96230088,4691869,1831
96246379,0.0,0.0,999000,635000,364000,36,999000,Null,Null,96246379,3955813,23362
96271704,907.0,907.0,199000,169000,30000,15,199000,Null,Null,96271704,4691869,53190
96285521,6.0,6.0,12950000,12950000,0,0,12950000,Null,Null,96285521,167287,8067
96285663,4.0,4.0,21450000,21450000,0,0,21450000,Null,Null,96285663,167287,8067
96300589,0.0,0.0,10293000,7719750,2573250,25,10293000,Null,Null,96300589,26150,8513
96324568,0.0,0.0,469000,469000,0,0,469000,Null,Null,96324568,111461,2
96347354,0.0,0.0,230000,115000,115000,50,230000,Null,Null,96347354,111461,2
96376601,11.0,11.0,3600,3600,0,0,3600,Null,Null,96376601,111461,1634
96403049,192.0,192.0,89000,89000,0,0,89000,Null,Null,96403049,4269901,23030
96460129,264.0,264.0,449000,449000,0,0,449000,Null,Null,96460129,111461,11943
96461937,79.0,79.0,49000,49000,0,0,49000,Null,Null,96461937,111461,15318
96466997,13.0,13.0,154900,154900,0,0,154900,Null,Null,96466997,4691869,3428
96471953,11.0,11.0,99000,99000,0,0,99000,Null,Null,96471953,111461,15318
96476261,15.0,15.0,1500,1500,0,0,1500,Null,Null,96476261,111461,2337
96533463,47.0,47.0,1256000,628000,628000,50,1256000,Null,Null,96533463,200189,11847
96556071,1.0,1.0,56000,56000,0,0,56000,Null,Null,96556071,111461,28596
96557203,71.0,71.0,108900,108900,0,0,108900,Null,Null,96557203,111461,28430
96593702,3161.0,3161.0,59000,4000,55000,93,59000,Null,Null,96593702,4246951,8602
96595575,191.0,191.0,22000,22000,0,0,22000,Null,Null,96595575,111461,2
96596367,0.0,0.0,4999,4999,0,0,4999,Null,Null,96596367,111461,2
96621859,0.0,0.0,11590000,11590000,0,0,11590000,Null,Null,96621859,4811511,8066
96630969,52.0,52.0,500000,216000,284000,57,500000,Null,Null,96630969,500047,5531
96637664,367.0,367.0,433000,433000,0,0,433000,Null,Null,96637664,21278,1613
96661748,17.0,17.0,645000,632100,12900,2,645000,Null,Null,96661748,111461,8061
96776861,0.0,0.0,3900000,1950000,1950000,50,3900000,Null,Null,96776861,111461,15318
96806548,1007.0,1007.0,227000,199000,28000,12,227000,Null,Null,96806548,4401579,23362
96811310,840.0,840.0,269000,215000,54000,20,269000,Null,Null,96811310,4691869,2971
96826251,487.0,487.0,97000,62000,35000,36,97000,Null,Null,96826251,273971,8300
96868878,664.0,664.0,89000,89000,0,0,89000,Null,Null,96868878,213569,17170
96874266,0.0,0.0,51170000,51170000,0,0,51170000,Null,Null,96874266,167287,8064
96874537,0.0,0.0,36770000,36770000,0,0,36770000,Null,Null,96874537,167287,8064
96900407,0.0,0.0,41570000,41570000,0,0,41570000,Null,Null,96900407,167287,8064
96900973,0.0,0.0,15970000,15970000,0,0,15970000,Null,Null,96900973,167287,6653
96901005,0.0,0.0,19170000,19170000,0,0,19170000,Null,Null,96901005,167287,8064
96989070,49.0,49.0,450000,369000,81000,18,450000,Null,Null,96989070,4816869,17170
96989078,116.0,116.0,450000,279000,171000,38,450000,Null,Null,96989078,4816869,3422
97002952,1702.0,1702.0,940000,799000,141000,15,940000,Null,Null,97002952,33203,1520
97030109,38.0,38.0,153067,153067,0,0,153067,Null,Null,97030109,4691869,4428
97034068,197.0,197.0,140160,98112,42048,30,140160,Null,Null,97034068,4691869,1804
97042698,43.0,43.0,12000,12000,0,0,12000,Null,Null,97042698,111461,2
97043002,9.0,9.0,12000,12000,0,0,12000,Null,Null,97043002,111461,2
97049607,612.0,612.0,99000,79000,20000,20,99000,Null,Null,97049607,32909,17184
97049695,262.0,262.0,98000,69000,29000,30,98000,Null,Null,97049695,32909,2347
97049754,1229.0,1229.0,34000,29000,5000,15,34000,Null,Null,97049754,32909,1641
97056905,107.0,107.0,70000,70000,0,0,70000,Null,Null,97056905,111625,1820
97057089,156.0,156.0,155000,155000,0,0,155000,Null,Null,97057089,111454,28454
97057251,48.0,48.0,129000,129000,0,0,129000,Null,Null,97057251,111454,5531
97057290,130.0,130.0,249000,249000,0,0,249000,Null,Null,97057290,111454,28454
97057371,130.0,130.0,135000,135000,0,0,135000,Null,Null,97057371,21653,28454
97079398,225.0,225.0,599000,599000,0,0,599000,Null,Null,97079398,3812995,11689
97251063,143.0,143.0,250000,229000,21000,8,250000,Null,Null,97251063,625265,28574
97340085,73.0,73.0,145920,102144,43776,30,145920,Null,Null,97340085,4691869,4428
97360465,0.0,0.0,6000,6000,0,0,6000,Null,Null,97360465,111461,11935
97363070,0.0,0.0,63700,63700,0,0,63700,Null,Null,97363070,111461,2
97435337,740.0,740.0,175000,175000,0,0,175000,Null,Null,97435337,4424515,11833
97547734,908.0,908.0,450000,374000,76000,17,450000,Null,Null,97547734,4244853,28480
97550074,260.0,260.0,45000,29000,16000,36,45000,Null,Null,97550074,709163,23276
97550937,1.0,1.0,9799999,9799999,0,0,9799999,Null,Null,97550937,111461,2340
97553032,1.0,1.0,9799999,9799999,0,0,9799999,Null,Null,97553032,111461,2340
97557723,6.0,6.0,180000,180000,0,0,180000,Null,Null,97557723,4528657,5385
97598665,2.0,2.0,3800000,3800000,0,0,3800000,Null,Null,97598665,538513,1634
97631694,1.0,1.0,20000,15000,5000,25,20000,Null,Null,97631694,111461,15320
97683711,198.0,198.0,499000,499000,0,0,499000,Null,Null,97683711,4691869,1813
97708858,0.0,0.0,6200000,4428000,1772000,29,6200000,Null,Null,97708858,4435757,11847
97723644,258.0,258.0,139000,139000,0,0,139000,Null,Null,97723644,577695,13878
97817455,454.0,454.0,316000,280000,36000,11,316000,Null,Null,97817455,4514729,2225
97827363,103.0,103.0,32499,32499,0,0,32499,Null,Null,97827363,111461,2
97833136,53.0,53.0,500000,232000,268000,54,500000,Null,Null,97833136,500047,5531
97843510,21.0,21.0,7999,7999,0,0,7999,Null,Null,97843510,111461,2
97875130,0.0,0.0,28000000,28000000,0,0,28000000,Null,Null,97875130,144527,11518
97875196,0.0,0.0,28000000,28000000,0,0,28000000,Null,Null,97875196,144527,11518
97890678,0.0,0.0,20500000,20500000,0,0,20500000,Null,Null,97890678,433227,2340
97894870,111.0,111.0,239000,239000,0,0,239000,Null,Null,97894870,111461,49724
97902261,1.0,1.0,250000,250000,0,0,250000,Null,Null,97902261,111461,49724
97902336,127.0,127.0,489000,489000,0,0,489000,Null,Null,97902336,111461,49724
97902357,0.0,0.0,2689000,2689000,0,0,2689000,Null,Null,97902357,111461,49724
97903859,0.0,0.0,1500000,1188000,312000,21,1500000,Null,Null,97903859,111461,49724
97904206,3.0,3.0,6500,6500,0,0,6500,Null,Null,97904206,111461,15318
97924113,483.0,483.0,304200,169000,135200,44,304200,Null,Null,97924113,46703,2140
97926074,714.0,714.0,5000,5000,0,0,5000,Null,Null,97926074,111461,2
97933907,0.0,0.0,77000,77000,0,0,77000,Null,Null,97933907,111461,2513
97976395,21.0,21.0,2600,2392,208,8,2600,Null,Null,97976395,111461,2
97980822,115.0,115.0,12600,9000,3600,29,12600,Null,Null,97980822,111461,2
97985745,7.0,7.0,32640,32640,0,0,32640,Null,Null,97985745,111461,2
97992487,0.0,0.0,1750000,1750000,0,0,1750000,Null,Null,97992487,184409,15250
97992593,164.0,164.0,32000,32000,0,0,32000,Null,Null,97992593,111461,1622
98006253,0.0,0.0,35100000,35100000,0,0,35100000,Null,Null,98006253,167287,2324
98009305,0.0,0.0,84000000,84000000,0,0,84000000,Null,Null,98009305,167287,2324
98025758,0.0,0.0,60000,60000,0,0,60000,Null,Null,98025758,111461,23244
98025873,13.0,13.0,9000,9000,0,0,9000,Null,Null,98025873,111461,28574
98046919,1.0,1.0,18860000,13279000,5581000,30,18860000,Null,Null,98046919,144538,2324
98067018,17.0,17.0,500000,250000,250000,50,500000,Null,Null,98067018,500047,5531
98071355,28.0,28.0,750000,299000,451000,60,750000,Null,Null,98071355,111461,28576
98072140,0.0,0.0,115000000,115000000,0,0,115000000,Null,Null,98072140,4827409,8165
98073814,82.0,82.0,500000,243000,257000,51,500000,Null,Null,98073814,500047,1811
98075461,68.0,68.0,1200000,299000,901000,75,1200000,Null,Null,98075461,535885,28576
98078281,66.0,66.0,499000,231000,268000,54,499000,Null,Null,98078281,500047,8400
98086015,349.0,349.0,165000,165000,0,0,165000,Null,Null,98086015,208677,8308
98115905,1.0,1.0,439000,439000,0,0,439000,Null,Null,98115905,167853,15250
98116109,794.0,794.0,260000,163000,97000,37,260000,Null,Null,98116109,4224691,2016
98118383,2.0,2.0,110000,110000,0,0,110000,Null,Null,98118383,111461,15320
98120016,0.0,0.0,18800000,17860000,940000,5,18800000,Null,Null,98120016,167287,20170
98120035,0.0,0.0,19900000,19900000,0,0,19900000,Null,Null,98120035,217953,7079
98120128,0.0,0.0,14950000,14202500,747500,5,14950000,Null,Null,98120128,167287,20170
98121730,0.0,0.0,20250000,18630000,1620000,8,20250000,Null,Null,98121730,167287,20170
98121822,0.0,0.0,17150000,15778000,1372000,8,17150000,Null,Null,98121822,167287,20170
98122120,54.0,54.0,88000,88000,0,0,88000,Null,Null,98122120,111461,15318
98135360,0.0,0.0,8285000,8285000,0,0,8285000,Null,Null,98135360,25502,5385
98148578,0.0,0.0,11700,10000,1700,15,11700,Null,Null,98148578,111461,2
98150508,35.0,35.0,690000,690000,0,0,690000,Null,Null,98150508,189445,28596
98153708,767.0,767.0,350000,225000,125000,36,350000,Null,Null,98153708,4011099,23834
98155769,10.0,10.0,55000,55000,0,0,55000,Null,Null,98155769,111461,15320
98160051,0.0,0.0,9000,9000,0,0,9000,Null,Null,98160051,111461,11935
98160868,41.0,41.0,6000,6000,0,0,6000,Null,Null,98160868,111461,2
98162993,1.0,1.0,17900000,17542000,358000,2,17900000,Null,Null,98162993,167287,2324
98179022,2.0,2.0,193000,193000,0,0,193000,Null,Null,98179022,111461,15318
98179312,5.0,5.0,215000,215000,0,0,215000,Null,Null,98179312,111461,15318
98185800,57.0,57.0,2190000,1094000,1096000,50,2190000,Null,Null,98185800,500047,7081
98187493,1.0,1.0,7500000,7500000,0,0,7500000,Null,Null,98187493,26273,10228
98240744,26.0,26.0,29500,29500,0,0,29500,Null,Null,98240744,111461,15318
98261433,5.0,5.0,13000,13000,0,0,13000,Null,Null,98261433,111461,2
98262037,28.0,28.0,65000,65000,0,0,65000,Null,Null,98262037,111461,1815
98262110,5.0,5.0,2600,2600,0,0,2600,Null,Null,98262110,111461,2
98297248,6.0,6.0,6500,6500,0,0,6500,Null,Null,98297248,111461,2
98335515,7.0,7.0,145000,145000,0,0,145000,Null,Null,98335515,111461,27546
98540417,1971.0,1971.0,92000,60000,32000,35,92000,Null,Null,98540417,47664,17162
98562149,998.0,998.0,28989,28989,0,0,28989,Null,Null,98562149,111461,1883
98562216,0.0,0.0,1000,1000,0,0,1000,Null,Null,98562216,111461,2
98562450,0.0,0.0,999,999,0,0,999,Null,Null,98562450,111461,2
98563015,0.0,0.0,2373,2373,0,0,2373,Null,Null,98563015,111461,2
98605258,400.0,400.0,490000,268000,222000,45,490000,Null,Null,98605258,21261,1630
98634086,0.0,0.0,15600,15600,0,0,15600,Null,Null,98634086,111461,2
98634117,1.0,1.0,13000,13000,0,0,13000,Null,Null,98634117,111461,2
98634122,1.0,1.0,16900,16900,0,0,16900,Null,Null,98634122,111461,2
98634148,0.0,0.0,13000,13000,0,0,13000,Null,Null,98634148,111461,2
98634166,0.0,0.0,16900,16900,0,0,16900,Null,Null,98634166,111461,2
98634171,0.0,0.0,16900,16900,0,0,16900,Null,Null,98634171,111461,2
98634176,0.0,0.0,15600,15600,0,0,15600,Null,Null,98634176,111461,2
98634178,0.0,0.0,15600,15600,0,0,15600,Null,Null,98634178,111461,2
98634208,0.0,0.0,15600,15600,0,0,15600,Null,Null,98634208,111461,2
98634220,0.0,0.0,16900,16900,0,0,16900,Null,Null,98634220,111461,2
98634222,0.0,0.0,16900,16900,0,0,16900,Null,Null,98634222,111461,2
98634226,1.0,1.0,14300,14300,0,0,14300,Null,Null,98634226,111461,2
98634246,0.0,0.0,16900,16900,0,0,16900,Null,Null,98634246,111461,2
98634247,3.0,3.0,15600,15600,0,0,15600,Null,Null,98634247,111461,2
98634253,0.0,0.0,15600,15600,0,0,15600,Null,Null,98634253,111461,2
98634268,0.0,0.0,16900,16900,0,0,16900,Null,Null,98634268,111461,2
98634287,0.0,0.0,15600,15600,0,0,15600,Null,Null,98634287,111461,2
98634298,0.0,0.0,16900,16900,0,0,16900,Null,Null,98634298,111461,2
98634312,0.0,0.0,16900,16900,0,0,16900,Null,Null,98634312,111461,2
98634313,0.0,0.0,16900,16900,0,0,16900,Null,Null,98634313,111461,2
98634323,0.0,0.0,15600,15600,0,0,15600,Null,Null,98634323,111461,2
98634326,0.0,0.0,13000,13000,0,0,13000,Null,Null,98634326,111461,2
98634341,3.0,3.0,7800,7800,0,0,7800,Null,Null,98634341,111461,2
98634352,44.0,44.0,29900,29900,0,0,29900,Null,Null,98634352,111461,2
98634369,0.0,0.0,15600,15600,0,0,15600,Null,Null,98634369,111461,2
98634376,0.0,0.0,16900,16900,0,0,16900,Null,Null,98634376,111461,2
98634391,1.0,1.0,10400,10400,0,0,10400,Null,Null,98634391,111461,2
98634398,0.0,0.0,16900,16900,0,0,16900,Null,Null,98634398,111461,2
98634442,6.0,6.0,6500,6500,0,0,6500,Null,Null,98634442,111461,2
98634449,7.0,7.0,5200,5200,0,0,5200,Null,Null,98634449,111461,2
98634472,0.0,0.0,15600,15600,0,0,15600,Null,Null,98634472,111461,2
98634489,0.0,0.0,16900,16900,0,0,16900,Null,Null,98634489,111461,2
98634498,0.0,0.0,16900,16900,0,0,16900,Null,Null,98634498,111461,2
98634499,0.0,0.0,16900,16900,0,0,16900,Null,Null,98634499,111461,2
98634529,0.0,0.0,16900,16900,0,0,16900,Null,Null,98634529,111461,2
98634559,0.0,0.0,16900,16900,0,0,16900,Null,Null,98634559,111461,2
98634581,0.0,0.0,16900,16900,0,0,16900,Null,Null,98634581,111461,2
98634600,0.0,0.0,16900,16900,0,0,16900,Null,Null,98634600,111461,2
98634626,0.0,0.0,16900,16900,0,0,16900,Null,Null,98634626,111461,2
98634630,0.0,0.0,15600,15600,0,0,15600,Null,Null,98634630,111461,2
98634632,0.0,0.0,16900,16900,0,0,16900,Null,Null,98634632,111461,2
98634636,0.0,0.0,16900,16900,0,0,16900,Null,Null,98634636,111461,2
98634653,1.0,1.0,13000,13000,0,0,13000,Null,Null,98634653,111461,2
98634700,13.0,13.0,16900,16900,0,0,16900,Null,Null,98634700,111461,2
98634712,2.0,2.0,10400,10400,0,0,10400,Null,Null,98634712,111461,2
98634732,0.0,0.0,10400,10400,0,0,10400,Null,Null,98634732,111461,2
98634743,0.0,0.0,16900,16900,0,0,16900,Null,Null,98634743,111461,2
98634752,0.0,0.0,16900,16900,0,0,16900,Null,Null,98634752,111461,2
98634783,29.0,29.0,45500,45500,0,0,45500,Null,Null,98634783,111461,2
98634813,2.0,2.0,16900,16900,0,0,16900,Null,Null,98634813,111461,2
98634827,39.0,39.0,52000,52000,0,0,52000,Null,Null,98634827,111461,2
98634891,0.0,0.0,16900,16900,0,0,16900,Null,Null,98634891,111461,2
98634893,0.0,0.0,16900,16900,0,0,16900,Null,Null,98634893,111461,2
98634916,0.0,0.0,18200,18200,0,0,18200,Null,Null,98634916,111461,2
98634932,2.0,2.0,16900,16900,0,0,16900,Null,Null,98634932,111461,2
98634934,0.0,0.0,16900,16900,0,0,16900,Null,Null,98634934,111461,2
98634943,0.0,0.0,16900,16900,0,0,16900,Null,Null,98634943,111461,2
98634944,2.0,2.0,16900,16900,0,0,16900,Null,Null,98634944,111461,2
98634953,0.0,0.0,10400,10400,0,0,10400,Null,Null,98634953,111461,2
98634960,0.0,0.0,15600,15600,0,0,15600,Null,Null,98634960,111461,2
98634980,0.0,0.0,15600,15600,0,0,15600,Null,Null,98634980,111461,2
98634985,0.0,0.0,16900,16900,0,0,16900,Null,Null,98634985,111461,2
98634988,1.0,1.0,45000,45000,0,0,45000,Null,Null,98634988,111461,2
98634991,1.0,1.0,15600,15600,0,0,15600,Null,Null,98634991,111461,2
98635076,0.0,0.0,15600,15600,0,0,15600,Null,Null,98635076,111461,2
98635092,0.0,0.0,16900,16900,0,0,16900,Null,Null,98635092,111461,2
98635102,0.0,0.0,16900,16900,0,0,16900,Null,Null,98635102,111461,2
98635105,14.0,14.0,13000,13000,0,0,13000,Null,Null,98635105,111461,2
98635106,0.0,0.0,16900,16900,0,0,16900,Null,Null,98635106,111461,2
98635126,0.0,0.0,19500,19500,0,0,19500,Null,Null,98635126,111461,2
98635137,0.0,0.0,7800,7800,0,0,7800,Null,Null,98635137,111461,2
98635146,1.0,1.0,16900,16900,0,0,16900,Null,Null,98635146,111461,2
98635161,4.0,4.0,15600,15600,0,0,15600,Null,Null,98635161,111461,2
98635164,0.0,0.0,16900,16900,0,0,16900,Null,Null,98635164,111461,2
98635204,0.0,0.0,13000,13000,0,0,13000,Null,Null,98635204,111461,2
98635206,53.0,53.0,29900,29900,0,0,29900,Null,Null,98635206,111461,2
98635207,1.0,1.0,15600,15600,0,0,15600,Null,Null,98635207,111461,2
98635209,0.0,0.0,15600,15600,0,0,15600,Null,Null,98635209,111461,2
98635227,0.0,0.0,16900,16900,0,0,16900,Null,Null,98635227,111461,2
98635430,34.0,34.0,220000,220000,0,0,220000,Null,Null,98635430,171459,8513
98640275,14.0,14.0,36000,36000,0,0,36000,Null,Null,98640275,111461,2
98640658,1.0,1.0,106000,106000,0,0,106000,Null,Null,98640658,111461,15250
98641696,9.0,9.0,36000,18000,18000,50,36000,Null,Null,98641696,111461,15320
98641768,5.0,5.0,36000,18000,18000,50,36000,Null,Null,98641768,111461,15320
98647687,0.0,0.0,17799000,17799000,0,0,17799000,Null,Null,98647687,111461,2340
98650585,160.0,160.0,229000,209000,20000,9,229000,Null,Null,98650585,697923,23346
98678067,677.0,677.0,162000,162000,0,0,162000,Null,Null,98678067,4635339,23622
98686680,13.0,13.0,8950,8950,0,0,8950,Null,Null,98686680,111461,28480
98687501,660.0,660.0,52000,26586,25414,49,52000,Null,Null,98687501,111461,28484
98688842,0.0,0.0,7800,7800,0,0,7800,Null,Null,98688842,111461,28484
98747851,0.0,0.0,28739000,28739000,0,0,28739000,Null,Null,98747851,112888,11516
98761008,4.0,4.0,35000,35000,0,0,35000,Null,Null,98761008,111461,2
98761012,1.0,1.0,18000,18000,0,0,18000,Null,Null,98761012,111461,2
98761037,3.0,3.0,15000,15000,0,0,15000,Null,Null,98761037,111461,2
98761059,0.0,0.0,15000,15000,0,0,15000,Null,Null,98761059,111461,2
98761145,1.0,1.0,15000,15000,0,0,15000,Null,Null,98761145,111461,2
98761179,1.0,1.0,9000,9000,0,0,9000,Null,Null,98761179,111461,2
98761194,5.0,5.0,14300,14300,0,0,14300,Null,Null,98761194,111461,2
98761245,5.0,5.0,14000,14000,0,0,14000,Null,Null,98761245,111461,2
98761518,2.0,2.0,15000,15000,0,0,15000,Null,Null,98761518,111461,2
98761539,0.0,0.0,18000,18000,0,0,18000,Null,Null,98761539,111461,2
98761582,0.0,0.0,12000,12000,0,0,12000,Null,Null,98761582,111461,2
98761631,0.0,0.0,15600,15600,0,0,15600,Null,Null,98761631,111461,2
98762015,2.0,2.0,12000,12000,0,0,12000,Null,Null,98762015,111461,2
98762154,1.0,1.0,9000,9000,0,0,9000,Null,Null,98762154,111461,2
98762628,1.0,1.0,15000,15000,0,0,15000,Null,Null,98762628,111461,2
98766082,0.0,0.0,22943000,22943000,0,0,22943000,Null,Null,98766082,112888,11516
98779133,134.0,134.0,20000,10000,10000,50,20000,Null,Null,98779133,4647777,15318
98799817,0.0,0.0,20951000,20951000,0,0,20951000,Null,Null,98799817,112888,11516
98804083,75.0,75.0,229000,229000,0,0,229000,Null,Null,98804083,27464,1883
98807921,0.0,0.0,15758000,15758000,0,0,15758000,Null,Null,98807921,112888,11516
98814587,0.0,0.0,12558000,12558000,0,0,12558000,Null,Null,98814587,112888,11516
98821530,0.0,0.0,11780000,11780000,0,0,11780000,Null,Null,98821530,112888,11516
98837517,0.0,0.0,23667000,23667000,0,0,23667000,Null,Null,98837517,112888,11516
98846937,0.0,0.0,15638000,15638000,0,0,15638000,Null,Null,98846937,112888,11516
98848497,0.0,0.0,21434000,21434000,0,0,21434000,Null,Null,98848497,112888,11516
98857606,0.0,0.0,25237000,25237000,0,0,25237000,Null,Null,98857606,112888,11516
98862650,0.0,0.0,5000,5000,0,0,5000,Null,Null,98862650,111461,7064
98863674,12.0,12.0,5200,5200,0,0,5200,Null,Null,98863674,111461,7064
98863903,1.0,1.0,5000,5000,0,0,5000,Null,Null,98863903,111461,8205
98865248,13.0,13.0,5000,5000,0,0,5000,Null,Null,98865248,111461,7064
98869300,17.0,17.0,10000,10000,0,0,10000,Null,Null,98869300,111461,11831
98872338,2013.0,2013.0,1850000,1200000,650000,35,1850000,Null,Null,98872338,631569,2340
98879533,64.0,64.0,289000,289000,0,0,289000,Null,Null,98879533,21278,1613
98902719,4431.0,4431.0,154000,108000,46000,30,154000,Null,Null,98902719,86206,1583
98919584,273.0,273.0,139000,99000,40000,29,139000,Null,Null,98919584,4430657,23352
98954310,15.0,15.0,26000,26000,0,0,26000,Null,Null,98954310,111461,15318
98969544,28.0,28.0,6500,6500,0,0,6500,Null,Null,98969544,111461,2
98969619,30.0,30.0,32500,32500,0,0,32500,Null,Null,98969619,111461,2
98974042,0.0,0.0,21011000,21011000,0,0,21011000,Null,Null,98974042,112888,11516
98983749,5.0,5.0,151000,135900,15100,10,151000,Null,Null,98983749,111461,15250
99055446,1.0,1.0,1000,990,10,1,1000,Null,Null,99055446,111461,2363
99055649,3.0,3.0,47000,47000,0,0,47000,Null,Null,99055649,111461,15250
99055734,1.0,1.0,175000,175000,0,0,175000,Null,Null,99055734,111461,15250
99055862,1.0,1.0,37050,37050,0,0,37050,Null,Null,99055862,111461,15250
99081519,32.0,32.0,18000,18000,0,0,18000,Null,Null,99081519,111461,28574
99081621,0.0,0.0,28900000,28900000,0,0,28900000,Null,Null,99081621,939519,28870
99093232,11.0,11.0,65000,65000,0,0,65000,Null,Null,99093232,111461,15236
99093233,10.0,10.0,63650,63650,0,0,63650,Null,Null,99093233,111461,15236
99110647,6352.0,6352.0,418000,418000,0,0,418000,Null,Null,99110647,238861,8223
99156219,134.0,134.0,5690000,3600000,2090000,37,5690000,Null,Null,99156219,688177,23450
99158007,64.0,64.0,4000,4000,0,0,4000,Null,Null,99158007,111461,8073
99206422,40.0,40.0,42090000,42000000,90000,0,42090000,Null,Null,99206422,4664555,23450
99237618,75.0,75.0,180000,115000,65000,36,180000,Null,Null,99237618,470301,8305
99247951,140.0,140.0,1349000,1349000,0,0,1349000,Null,Null,99247951,156529,12876
99269577,105.0,105.0,42000,42000,0,0,42000,Null,Null,99269577,111461,2225
99317930,0.0,0.0,4150000,4150000,0,0,4150000,Null,Null,99317930,111461,11937
99324639,5.0,5.0,65000,61750,3250,5,65000,Null,Null,99324639,4269901,23336
99324909,237.0,237.0,119000,85000,34000,29,119000,Null,Null,99324909,230607,27128
99328685,25.0,25.0,139000,104250,34750,25,139000,Null,Null,99328685,4740303,23336
99380493,79.0,79.0,72000,72000,0,0,72000,Null,Null,99380493,111461,1634
99395822,85.0,85.0,33000,33000,0,0,33000,Null,Null,99395822,111461,2
99399042,1.0,1.0,6499,6499,0,0,6499,Null,Null,99399042,111461,2
99417582,0.0,0.0,5000,5000,0,0,5000,Null,Null,99417582,111461,8202
99421753,0.0,0.0,19058000,19058000,0,0,19058000,Null,Null,99421753,112888,11516
99425241,0.0,0.0,15330000,15330000,0,0,15330000,Null,Null,99425241,112888,11516
99425478,0.0,0.0,12679000,12679000,0,0,12679000,Null,Null,99425478,112888,11516
99427349,0.0,0.0,12915000,12915000,0,0,12915000,Null,Null,99427349,112888,26652
99492575,0.0,0.0,165000,165000,0,0,165000,Null,Null,99492575,111461,2
99493721,0.0,0.0,10000,10000,0,0,10000,Null,Null,99493721,111461,2
99495234,0.0,0.0,6000,6000,0,0,6000,Null,Null,99495234,111461,2
99495727,2.0,2.0,275000,275000,0,0,275000,Null,Null,99495727,111461,2
99496638,0.0,0.0,5000,5000,0,0,5000,Null,Null,99496638,111461,2
99502388,13.0,13.0,284800,284800,0,0,284800,Null,Null,99502388,111461,11935
99524045,0.0,0.0,97500000,97500000,0,0,97500000,Null,Null,99524045,111461,23576
99540878,94.0,94.0,175000,149000,26000,15,175000,Null,Null,99540878,32909,3426
99614537,71.0,71.0,25000,25000,0,0,25000,Null,Null,99614537,4269901,23258
99621372,6367.0,6367.0,473000,243000,230000,49,473000,Null,Null,99621372,48077,2
99624968,0.0,0.0,27900000,27900000,0,0,27900000,Null,Null,99624968,939519,28868
99627509,0.0,0.0,10815000,10815000,0,0,10815000,Null,Null,99627509,111461,15318
99658714,56.0,56.0,8900,8900,0,0,8900,Null,Null,99658714,63747,8305
99717128,842.0,842.0,250000,250000,0,0,250000,Null,Null,99717128,208071,1613
99837448,0.0,0.0,18885,18885,0,0,18885,Null,Null,99837448,453147,15320
99837888,46.0,46.0,30000,30000,0,0,30000,Null,Null,99837888,111461,28578
99845587,467.0,467.0,95000,95000,0,0,95000,Null,Null,99845587,4698745,23352
99854989,32.0,32.0,305700,305700,0,0,305700,Null,Null,99854989,111461,1936
99862142,155.0,155.0,9990000,6790000,3200000,32,9990000,Null,Null,99862142,25422,1795
99868980,11390.0,11390.0,473000,235000,238000,50,473000,Null,Null,99868980,48077,1936
99870574,43.0,43.0,85000,85000,0,0,85000,Null,Null,99870574,111461,15250
99870851,0.0,0.0,16900000,13390000,3510000,21,16900000,Null,Null,99870851,20215,2324
99906056,1.0,1.0,145000,145000,0,0,145000,Null,Null,99906056,111461,15250
99906569,20.0,20.0,147000,132300,14700,10,147000,Null,Null,99906569,111461,15250
99910978,11.0,11.0,94000,84600,9400,10,94000,Null,Null,99910978,111461,15236
99958445,43.0,43.0,2000,2000,0,0,2000,Null,Null,99958445,111461,2
99959423,0.0,0.0,2000,2000,0,0,2000,Null,Null,99959423,111461,3805
99961551,0.0,0.0,12900,12900,0,0,12900,Null,Null,99961551,111461,2
99962523,28.0,28.0,9000,9000,0,0,9000,Null,Null,99962523,111461,28484
99974714,250.0,250.0,1102000,551000,551000,50,1102000,Null,Null,99974714,259827,11845
99994000,6161.0,6161.0,473000,239000,234000,49,473000,Null,Null,99994000,48077,2
100000389,0.0,0.0,7150000,5362500,1787500,25,7150000,Null,Null,100000389,416127,8227
100018204,2.0,2.0,726000,580800,145200,20,726000,Null,Null,100018204,26150,8513
100018515,20.0,20.0,500000,400000,100000,20,500000,Null,Null,100018515,111461,2019
100083467,129.0,129.0,500000,216000,284000,57,500000,Null,Null,100083467,500047,5531
100152303,0.0,0.0,8490000,8490000,0,0,8490000,Null,Null,100152303,111461,15318
100158366,271.0,271.0,260000,260000,0,0,260000,Null,Null,100158366,4678387,3422
100168740,0.0,0.0,13850000,13850000,0,0,13850000,Null,Null,100168740,885749,8511
100186562,29.0,29.0,8900,8900,0,0,8900,Null,Null,100186562,111461,2
100186581,1.0,1.0,148999,148999,0,0,148999,Null,Null,100186581,111461,2
100253759,180.0,180.0,399000,399000,0,0,399000,Null,Null,100253759,298989,17162
100256064,11.0,11.0,58000,23000,35000,60,58000,Null,Null,100256064,111461,15236
100256125,4.0,4.0,142000,142000,0,0,142000,Null,Null,100256125,111461,15250
100282290,1.0,1.0,350000,240000,110000,31,350000,Null,Null,100282290,111461,23622
100286976,0.0,0.0,9798000,9798000,0,0,9798000,Null,Null,100286976,111461,2340
100317137,110.0,110.0,9500,9500,0,0,9500,Null,Null,100317137,111461,23134
100319459,29.0,29.0,19000,19000,0,0,19000,Null,Null,100319459,111461,15236
100321662,189.0,189.0,125000,74000,51000,41,125000,Null,Null,100321662,557917,11767
100328390,41.0,41.0,174080,121856,52224,30,174080,Null,Null,100328390,111461,28674
100382494,9.0,9.0,16500,16500,0,0,16500,Null,Null,100382494,111461,2
100446785,0.0,0.0,5998000,5998000,0,0,5998000,Null,Null,100446785,111461,15318
100459078,27.0,27.0,95000,95000,0,0,95000,Null,Null,100459078,111461,2
100462360,9.0,9.0,120000,120000,0,0,120000,Null,Null,100462360,111461,2
100462774,2.0,2.0,65000,65000,0,0,65000,Null,Null,100462774,111461,2
100462832,0.0,0.0,15000,15000,0,0,15000,Null,Null,100462832,111461,2
100463114,13.0,13.0,80000,80000,0,0,80000,Null,Null,100463114,111461,2
100463233,3.0,3.0,260000,260000,0,0,260000,Null,Null,100463233,111461,2
100463281,0.0,0.0,143000,143000,0,0,143000,Null,Null,100463281,111461,2
100464006,0.0,0.0,10000,10000,0,0,10000,Null,Null,100464006,111461,2
100464533,25.0,25.0,15000,15000,0,0,15000,Null,Null,100464533,111461,2
100464575,1.0,1.0,34000,34000,0,0,34000,Null,Null,100464575,111461,2
100464750,4.0,4.0,228000,228000,0,0,228000,Null,Null,100464750,111461,2
100464796,0.0,0.0,15000,15000,0,0,15000,Null,Null,100464796,111461,2
100465357,0.0,0.0,15000,15000,0,0,15000,Null,Null,100465357,111461,2
100465865,2.0,2.0,32000,32000,0,0,32000,Null,Null,100465865,111461,2
100466014,11.0,11.0,13000,13000,0,0,13000,Null,Null,100466014,111461,2
100522012,744.0,744.0,269000,269000,0,0,269000,Null,Null,100522012,746615,1883
100525606,0.0,0.0,9400,9400,0,0,9400,Null,Null,100525606,111461,2
100611493,1.0,1.0,187000,187000,0,0,187000,Null,Null,100611493,111461,15318
100796375,64.0,64.0,18500,18500,0,0,18500,Null,Null,100796375,111461,15318
100858954,2.0,2.0,204000,204000,0,0,204000,Null,Null,100858954,111461,15318
100867278,96.0,96.0,60000,60000,0,0,60000,Null,Null,100867278,111461,2512
100867621,110.0,110.0,137500,136125,1375,1,137500,Null,Null,100867621,197767,6305
100868879,110.0,110.0,110000,110000,0,0,110000,Null,Null,100868879,111461,28428
100894541,686.0,686.0,25000,19000,6000,24,25000,Null,Null,100894541,836453,53074
100900134,43.0,43.0,2500,2500,0,0,2500,Null,Null,100900134,111461,2
100900609,8.0,8.0,2500,2500,0,0,2500,Null,Null,100900609,111461,2
100916878,3.0,3.0,320000,320000,0,0,320000,Null,Null,100916878,111461,15250
100924356,1.0,1.0,6850000,6850000,0,0,6850000,Null,Null,100924356,287433,11871
100974605,0.0,0.0,12500000,12500000,0,0,12500000,Null,Null,100974605,111461,2
100974635,0.0,0.0,6850000,6850000,0,0,6850000,Null,Null,100974635,111461,2
100974694,1.0,1.0,330000,330000,0,0,330000,Null,Null,100974694,111461,2
100999544,0.0,0.0,32500000,32500000,0,0,32500000,Null,Null,100999544,167287,2324
101004746,18.0,18.0,111000,111000,0,0,111000,Null,Null,101004746,111461,15318
101018297,1730.0,1730.0,15000,12900,2100,14,15000,Null,Null,101018297,276745,3426
101018339,0.0,0.0,3912000,3912000,0,0,3912000,Null,Null,101018339,25643,1795
101034119,274.0,274.0,299000,267000,32000,11,299000,Null,Null,101034119,166383,1752
101043898,43.0,43.0,15000,15000,0,0,15000,Null,Null,101043898,111461,2
101058186,6.0,6.0,252000,252000,0,0,252000,Null,Null,101058186,111461,2
101079933,738.0,738.0,449000,373000,76000,17,449000,Null,Null,101079933,79682,11833
101087080,296.0,296.0,249000,229000,20000,8,249000,Null,Null,101087080,79682,11833
101137475,0.0,0.0,6500000,6500000,0,0,6500000,Null,Null,101137475,496841,8170
101150441,2.0,2.0,143000,143000,0,0,143000,Null,Null,101150441,111461,15318
101183279,0.0,0.0,5950000,5950000,0,0,5950000,Null,Null,101183279,496841,8170
101184307,0.0,0.0,3550000,3550000,0,0,3550000,Null,Null,101184307,260977,11885
101229145,347.0,347.0,7000,7000,0,0,7000,Null,Null,101229145,111461,11935
101246951,7.0,7.0,145000,145000,0,0,145000,Null,Null,101246951,111461,15318
101252699,11.0,11.0,2000,2000,0,0,2000,Null,Null,101252699,111461,5905
101253192,0.0,0.0,3000,3000,0,0,3000,Null,Null,101253192,111461,5905
101253242,7.0,7.0,2400,2400,0,0,2400,Null,Null,101253242,111461,2
101256328,7.0,7.0,24000,17000,7000,29,24000,Null,Null,101256328,111461,15250
101256331,8.0,8.0,24000,12000,12000,50,24000,Null,Null,101256331,111461,15236
101256337,0.0,0.0,30000,15000,15000,50,30000,Null,Null,101256337,111461,15320
101256339,17.0,17.0,24000,14000,10000,42,24000,Null,Null,101256339,111461,15320
101256342,8.0,8.0,30000,18000,12000,40,30000,Null,Null,101256342,111461,15250
101258778,27.0,27.0,136000,136000,0,0,136000,Null,Null,101258778,111461,8205
101261237,56.0,56.0,5000,5000,0,0,5000,Null,Null,101261237,111461,8602
101269880,1.0,1.0,105000,105000,0,0,105000,Null,Null,101269880,111461,15318
101284469,64.0,64.0,333760,233632,100128,30,333760,Null,Null,101284469,192495,1838
101288592,2.0,2.0,5800000,5800000,0,0,5800000,Null,Null,101288592,496841,8170
101297109,3.0,3.0,63000,63000,0,0,63000,Null,Null,101297109,111461,15318
101349721,9.0,9.0,7900,7900,0,0,7900,Null,Null,101349721,111461,28732
101360455,19.0,19.0,24900,24900,0,0,24900,Null,Null,101360455,111461,2363
101361110,9.0,9.0,560610,560610,0,0,560610,Null,Null,101361110,21651,12908
101368015,6.0,6.0,4090000,4090000,0,0,4090000,Null,Null,101368015,27398,8165
101454090,500.0,500.0,216000,183000,33000,15,216000,Null,Null,101454090,548147,17162
101484875,34.0,34.0,300000,300000,0,0,300000,Null,Null,101484875,111461,2
101530842,138.0,138.0,580000,550000,30000,5,580000,Null,Null,101530842,25422,28454
101552499,408.0,408.0,600000,379000,221000,37,600000,Null,Null,101552499,430445,3422
101591480,0.0,0.0,36400000,36400000,0,0,36400000,Null,Null,101591480,167287,6653
101613553,71.0,71.0,2000,2000,0,0,2000,Null,Null,101613553,111461,2
101613574,21.0,21.0,2000,2000,0,0,2000,Null,Null,101613574,111461,53054
101613725,301.0,301.0,2000,2000,0,0,2000,Null,Null,101613725,111461,2
101613772,2.0,2.0,2000,2000,0,0,2000,Null,Null,101613772,111461,2
101613998,73.0,73.0,1000,1000,0,0,1000,Null,Null,101613998,111461,2
101614035,50.0,50.0,2000,2000,0,0,2000,Null,Null,101614035,111461,2
101616968,0.0,0.0,5000,5000,0,0,5000,Null,Null,101616968,111461,2
101617072,9.0,9.0,1000,1000,0,0,1000,Null,Null,101617072,111461,2
101617410,2.0,2.0,7000,7000,0,0,7000,Null,Null,101617410,111461,2
101617454,0.0,0.0,3000,3000,0,0,3000,Null,Null,101617454,111461,2
101617774,1.0,1.0,1200,1200,0,0,1200,Null,Null,101617774,111461,2
101635486,1.0,1.0,3389000,3389000,0,0,3389000,Null,Null,101635486,111461,28856
101641108,1.0,1.0,15000,15000,0,0,15000,Null,Null,101641108,111461,2
101660139,1.0,1.0,151000,135900,15100,10,151000,Null,Null,101660139,111461,15250
101660316,291.0,291.0,21000,18900,2100,10,21000,Null,Null,101660316,111461,15318
101687136,16.0,16.0,105102,105102,0,0,105102,Null,Null,101687136,111461,2140
101687650,0.0,0.0,10000,10000,0,0,10000,Null,Null,101687650,111461,15320
101687718,0.0,0.0,15000,15000,0,0,15000,Null,Null,101687718,111461,15320
101688585,7.0,7.0,10000,10000,0,0,10000,Null,Null,101688585,111461,2
101692240,12.0,12.0,15000,15000,0,0,15000,Null,Null,101692240,111461,2
101692982,7.0,7.0,15000,15000,0,0,15000,Null,Null,101692982,111461,15320
101696331,0.0,0.0,12000,12000,0,0,12000,Null,Null,101696331,111461,15320
101697019,6.0,6.0,12000,12000,0,0,12000,Null,Null,101697019,111461,2
101697613,0.0,0.0,12000,12000,0,0,12000,Null,Null,101697613,111461,2
101705223,29.0,29.0,12000,7000,5000,42,12000,Null,Null,101705223,4647777,15318
101745715,11.0,11.0,289000,289000,0,0,289000,Null,Null,101745715,21278,1613
101758165,0.0,0.0,29500000,29500000,0,0,29500000,Null,Null,101758165,167287,20170
101763317,1.0,1.0,19800000,19800000,0,0,19800000,Null,Null,101763317,167287,20170
101782594,0.0,0.0,15800000,15800000,0,0,15800000,Null,Null,101782594,167287,20170
101787478,0.0,0.0,29500000,29500000,0,0,29500000,Null,Null,101787478,167287,20170
101800359,0.0,0.0,37500000,37500000,0,0,37500000,Null,Null,101800359,167287,20170
101806479,0.0,0.0,98500000,98500000,0,0,98500000,Null,Null,101806479,167287,20170
101806919,192.0,192.0,600000,389000,211000,35,600000,Null,Null,101806919,430445,3422
101809686,0.0,0.0,78500000,78500000,0,0,78500000,Null,Null,101809686,167287,20170
101817918,0.0,0.0,96200000,96200000,0,0,96200000,Null,Null,101817918,167287,20170
101824909,0.0,0.0,85200000,85200000,0,0,85200000,Null,Null,101824909,167287,20170
101826181,0.0,0.0,87500000,87500000,0,0,87500000,Null,Null,101826181,167287,20170
101831968,0.0,0.0,74500000,74500000,0,0,74500000,Null,Null,101831968,167287,20170
101847035,334.0,334.0,199000,178000,21000,11,199000,Null,Null,101847035,4691869,2324
101847478,5.0,5.0,1200,1200,0,0,1200,Null,Null,101847478,111461,1622
101860397,0.0,0.0,7500000,7500000,0,0,7500000,Null,Null,101860397,111461,15318
101866290,49.0,49.0,290000,290000,0,0,290000,Null,Null,101866290,3216013,20492
101891086,16.0,16.0,190000,129000,61000,32,190000,Null,Null,101891086,21651,4428
101893893,17.0,17.0,9999,9999,0,0,9999,Null,Null,101893893,111461,2514
101894104,18.0,18.0,6000,6000,0,0,6000,Null,Null,101894104,111461,8197
101894776,952.0,952.0,180000,63100,116900,65,180000,Null,Null,101894776,19018,2488
101920965,2.0,2.0,1090000,874000,216000,20,1090000,Null,Null,101920965,47489,1520
101929643,22.0,22.0,18400,18000,400,2,18400,Null,Null,101929643,111461,28480
101942090,0.0,0.0,55000000,55000000,0,0,55000000,Null,Null,101942090,4729191,23290
101947483,0.0,0.0,3600000,3600000,0,0,3600000,Null,Null,101947483,18804,1626
101976026,0.0,0.0,26500000,26500000,0,0,26500000,Null,Null,101976026,4440139,11935
101999827,0.0,0.0,3519000,3519000,0,0,3519000,Null,Null,101999827,19018,1634
102006095,1.0,1.0,8000,8000,0,0,8000,Null,Null,102006095,111461,15320
102006450,0.0,0.0,12000,12000,0,0,12000,Null,Null,102006450,111461,15320
102006609,0.0,0.0,2500,2500,0,0,2500,Null,Null,102006609,111461,2
102006931,2.0,2.0,4800,4800,0,0,4800,Null,Null,102006931,111461,1520
102012652,49.0,49.0,18000,18000,0,0,18000,Null,Null,102012652,111461,15236
102015118,1217.0,1217.0,35000,29000,6000,17,35000,Null,Null,102015118,216511,1630
102015244,567.0,567.0,35000,29000,6000,17,35000,Null,Null,102015244,216511,1630
102015292,884.0,884.0,125000,72000,53000,42,125000,Null,Null,102015292,216511,1630
102017002,32.0,32.0,11000,8000,3000,27,11000,Null,Null,102017002,154443,2342
102017666,20.0,20.0,600000,455000,145000,24,600000,Null,Null,102017666,4284249,11857
102017707,33.0,33.0,16000,8000,8000,50,16000,Null,Null,102017707,165279,11921
102017801,96.0,96.0,14000,8000,6000,43,14000,Null,Null,102017801,162841,11929
102017884,94.0,94.0,50000,30000,20000,40,50000,Null,Null,102017884,4880003,11857
102017943,591.0,591.0,190000,99000,91000,48,190000,Null,Null,102017943,5272043,11857
102017957,42.0,42.0,70000,45000,25000,36,70000,Null,Null,102017957,198785,1752
102017988,15.0,15.0,9000,8000,1000,11,9000,Null,Null,102017988,47959,11921
102018918,188.0,188.0,14000,9000,5000,36,14000,Null,Null,102018918,162841,11929
102019481,75.0,75.0,5000,3500,1500,30,5000,Null,Null,102019481,840773,8309
102050246,63.0,63.0,14500,14500,0,0,14500,Null,Null,102050246,111461,2
102050886,173.0,173.0,155000,155000,0,0,155000,Null,Null,102050886,290071,23042
102070507,1.0,1.0,4533000,4533000,0,0,4533000,Null,Null,102070507,111643,8511
102070516,2.0,2.0,5195000,5195000,0,0,5195000,Null,Null,102070516,111643,8511
102070524,1.0,1.0,6468000,6468000,0,0,6468000,Null,Null,102070524,111643,8511
102070561,10.0,10.0,4940000,4940000,0,0,4940000,Null,Null,102070561,111643,8516
102084195,17.0,17.0,4278000,4278000,0,0,4278000,Null,Null,102084195,111643,8516
102084263,5.0,5.0,4075000,4075000,0,0,4075000,Null,Null,102084263,111643,8516
102084376,16.0,16.0,4075000,4075000,0,0,4075000,Null,Null,102084376,111643,8516
102085806,0.0,0.0,4100000,4100000,0,0,4100000,Null,Null,102085806,47803,11873
102093510,9.0,9.0,139999,139999,0,0,139999,Null,Null,102093510,111461,2
102098776,67.0,67.0,199000,199000,0,0,199000,Null,Null,102098776,312323,2324
102099585,0.0,0.0,1999,1999,0,0,1999,Null,Null,102099585,111461,2363
102101012,0.0,0.0,79000000,79000000,0,0,79000000,Null,Null,102101012,111461,23576
102103822,12.0,12.0,7990,7990,0,0,7990,Null,Null,102103822,111461,2
102103835,0.0,0.0,7000,7000,0,0,7000,Null,Null,102103835,111461,2
102103887,14.0,14.0,6000,6000,0,0,6000,Null,Null,102103887,111461,26658
102104229,0.0,0.0,7760,7760,0,0,7760,Null,Null,102104229,111461,2
102104234,2.0,2.0,5820,5820,0,0,5820,Null,Null,102104234,111461,2
102104303,0.0,0.0,1500,1500,0,0,1500,Null,Null,102104303,111461,2
102104453,0.0,0.0,9000,9000,0,0,9000,Null,Null,102104453,111461,2
102104475,0.0,0.0,7000,7000,0,0,7000,Null,Null,102104475,111461,2
102104499,2.0,2.0,1800,1800,0,0,1800,Null,Null,102104499,111461,2
102104663,14.0,14.0,4000,4000,0,0,4000,Null,Null,102104663,111461,2
102104736,0.0,0.0,1999,1999,0,0,1999,Null,Null,102104736,111461,2
102104900,1.0,1.0,3000,3000,0,0,3000,Null,Null,102104900,111461,2
102104929,0.0,0.0,6000,6000,0,0,6000,Null,Null,102104929,111461,2
102104952,0.0,0.0,4627,4627,0,0,4627,Null,Null,102104952,111461,2
102104990,0.0,0.0,1900,1900,0,0,1900,Null,Null,102104990,111461,2
102104993,56.0,56.0,3999,3999,0,0,3999,Null,Null,102104993,111461,2
102105050,5.0,5.0,9000,9000,0,0,9000,Null,Null,102105050,111461,2
102105103,3.0,3.0,8999,8999,0,0,8999,Null,Null,102105103,111461,2
102105180,0.0,0.0,2290,2290,0,0,2290,Null,Null,102105180,111461,2
102105931,0.0,0.0,6175,6175,0,0,6175,Null,Null,102105931,111461,2
102106006,0.0,0.0,2999,2999,0,0,2999,Null,Null,102106006,111461,2
102106136,3.0,3.0,7000,7000,0,0,7000,Null,Null,102106136,111461,2
102106198,0.0,0.0,7751,7751,0,0,7751,Null,Null,102106198,111461,2
102106212,0.0,0.0,6999,6999,0,0,6999,Null,Null,102106212,111461,2
102106219,0.0,0.0,1000,1000,0,0,1000,Null,Null,102106219,111461,2
102106423,2.0,2.0,8000,8000,0,0,8000,Null,Null,102106423,111461,2
102106522,0.0,0.0,7000,7000,0,0,7000,Null,Null,102106522,111461,2
102106533,0.0,0.0,1990,1990,0,0,1990,Null,Null,102106533,111461,2
102106728,0.0,0.0,8730,8730,0,0,8730,Null,Null,102106728,111461,2
102106862,0.0,0.0,4000,4000,0,0,4000,Null,Null,102106862,111461,2
102106916,0.0,0.0,4000,4000,0,0,4000,Null,Null,102106916,111461,2
102106982,5.0,5.0,7000,7000,0,0,7000,Null,Null,102106982,111461,2
102107089,1.0,1.0,9000,9000,0,0,9000,Null,Null,102107089,111461,2
102107188,5.0,5.0,1200,1200,0,0,1200,Null,Null,102107188,111461,2
102107237,0.0,0.0,1999,1999,0,0,1999,Null,Null,102107237,111461,2
102107245,0.0,0.0,2200,2200,0,0,2200,Null,Null,102107245,111461,2
102107282,2.0,2.0,1500,1500,0,0,1500,Null,Null,102107282,111461,2
102107400,0.0,0.0,5000,5000,0,0,5000,Null,Null,102107400,111461,2
102108970,588.0,588.0,179000,179000,0,0,179000,Null,Null,102108970,4877037,11889
102112069,1.0,1.0,30000,15000,15000,50,30000,Null,Null,102112069,4647777,15318
102116743,12.0,12.0,90000,90000,0,0,90000,Null,Null,102116743,111461,15936
102122063,24.0,24.0,79000,79000,0,0,79000,Null,Null,102122063,111461,15236
102123768,0.0,0.0,12900000,12900000,0,0,12900000,Null,Null,102123768,167287,6653
102125220,1.0,1.0,17850000,17850000,0,0,17850000,Null,Null,102125220,167287,8067
102131367,157.0,157.0,650000,550000,100000,15,650000,Null,Null,102131367,199801,11885
102132055,3.0,3.0,17400000,17400000,0,0,17400000,Null,Null,102132055,167287,2324
102132164,1.0,1.0,18200000,18200000,0,0,18200000,Null,Null,102132164,167287,2324
102142443,14.0,14.0,203000,182700,20300,10,203000,Null,Null,102142443,111461,15318
102143192,14.0,14.0,51000,45900,5100,10,51000,Null,Null,102143192,111461,15236
102156411,33.0,33.0,46000,35000,11000,24,46000,Null,Null,102156411,4743605,15250
102156487,565.0,565.0,349000,349000,0,0,349000,Null,Null,102156487,192495,1838
102262015,2.0,2.0,5000,5000,0,0,5000,Null,Null,102262015,4408565,1831
102262345,1.0,1.0,5000,5000,0,0,5000,Null,Null,102262345,4408565,1831
102375075,30.0,30.0,4590000,3490000,1100000,24,4590000,Null,Null,102375075,4885445,2340
102391960,778.0,778.0,500000,459000,41000,8,500000,Null,Null,102391960,4244853,28682
102408712,133.0,133.0,199000,199000,0,0,199000,Null,Null,102408712,203985,1752
102424124,4.0,4.0,9000,9000,0,0,9000,Null,Null,102424124,111461,2
102424216,0.0,0.0,9000,9000,0,0,9000,Null,Null,102424216,111461,2
102429227,0.0,0.0,6500,6500,0,0,6500,Null,Null,102429227,111461,2
102430688,0.0,0.0,2000,2000,0,0,2000,Null,Null,102430688,111461,2
102431856,14.0,14.0,9000,9000,0,0,9000,Null,Null,102431856,111461,11935
102482082,7.0,7.0,5990000,5990000,0,0,5990000,Null,Null,102482082,4885471,2340
102485064,81.0,81.0,408500,365000,43500,11,408500,Null,Null,102485064,19018,23238
102488853,1860.0,1860.0,343500,196000,147500,43,343500,Null,Null,102488853,868633,23136
102504360,0.0,0.0,7300000,7300000,0,0,7300000,Null,Null,102504360,111461,11935
102513190,477.0,477.0,850000,850000,0,0,850000,Null,Null,102513190,449693,11861
102520945,200.0,200.0,850000,850000,0,0,850000,Null,Null,102520945,449693,11861
102532257,161.0,161.0,5900,5900,0,0,5900,Null,Null,102532257,111461,17186
102576061,2.0,2.0,280000,280000,0,0,280000,Null,Null,102576061,111461,2340
102577333,21.0,21.0,790000,750500,39500,5,790000,Null,Null,102577333,560095,11871
102600970,2772.0,2772.0,300000,229000,71000,24,300000,Null,Null,102600970,111454,12908
102601343,388.0,388.0,2000,2000,0,0,2000,Null,Null,102601343,111461,2
102620086,0.0,0.0,1200000,1200000,0,0,1200000,Null,Null,102620086,472079,8061
102629384,112.0,112.0,349000,349000,0,0,349000,Null,Null,102629384,5196303,53054
102726668,0.0,0.0,145000000,145000000,0,0,145000000,Null,Null,102726668,4886617,11935
102734013,0.0,0.0,75000000,75000000,0,0,75000000,Null,Null,102734013,4509065,11935
102739210,797.0,797.0,279000,279000,0,0,279000,Null,Null,102739210,4784973,1623
102740926,62.0,62.0,77000,65000,12000,16,77000,Null,Null,102740926,18804,2153
102743238,255.0,255.0,440000,430000,10000,2,440000,Null,Null,102743238,18804,2153
102743247,58.0,58.0,97998,48999,48999,50,97998,Null,Null,102743247,155563,28484
102743418,0.0,0.0,11900000,11900000,0,0,11900000,Null,Null,102743418,167287,8064
102743492,0.0,0.0,15900000,15900000,0,0,15900000,Null,Null,102743492,167287,8064
102750721,61.0,61.0,159000,159000,0,0,159000,Null,Null,102750721,373635,28576
102751945,155.0,155.0,349000,349000,0,0,349000,Null,Null,102751945,21278,1613
102758347,17.0,17.0,95000,85000,10000,11,95000,Null,Null,102758347,111461,15320
102769677,134.0,134.0,648000,389000,259000,40,648000,Null,Null,102769677,154910,2324
102782859,1936.0,1936.0,250000,220000,30000,12,250000,Null,Null,102782859,111454,4428
102796692,3.0,3.0,159000,159000,0,0,159000,Null,Null,102796692,111461,2
102802039,6.0,6.0,9000,9000,0,0,9000,Null,Null,102802039,111461,28574
102808021,0.0,0.0,12490000,12490000,0,0,12490000,Null,Null,102808021,114527,28444
102862202,0.0,0.0,6900,6900,0,0,6900,Null,Null,102862202,111461,2
102863051,2.0,2.0,2500,2500,0,0,2500,Null,Null,102863051,111461,2
102866615,117.0,117.0,399000,290000,109000,27,399000,Null,Null,102866615,4886143,3426
102868297,0.0,0.0,16530000,16530000,0,0,16530000,Null,Null,102868297,4830357,20258
103027016,18.0,18.0,10000,10000,0,0,10000,Null,Null,103027016,111461,15320
103085366,4.0,4.0,1500,1000,500,33,1500,Null,Null,103085366,111461,1883
103087919,0.0,0.0,26500000,26500000,0,0,26500000,Null,Null,103087919,167287,8064
103088358,0.0,0.0,19000000,19000000,0,0,19000000,Null,Null,103088358,167287,8064
103092354,0.0,0.0,24100000,24100000,0,0,24100000,Null,Null,103092354,111461,11518
103092361,389.0,389.0,978000,978000,0,0,978000,Null,Null,103092361,145335,11859
103092548,5.0,5.0,10000,10000,0,0,10000,Null,Null,103092548,111461,2340
103100379,0.0,0.0,10299000,10299000,0,0,10299000,Null,Null,103100379,111461,2340
103100489,0.0,0.0,17990000,17990000,0,0,17990000,Null,Null,103100489,111461,2340
103110329,128.0,128.0,120000,86000,34000,28,120000,Null,Null,103110329,111461,1820
103110461,28.0,28.0,99000,71000,28000,28,99000,Null,Null,103110461,111461,2
103118758,15.0,15.0,830000,830000,0,0,830000,Null,Null,103118758,111461,23236
103128359,6.0,6.0,30000,30000,0,0,30000,Null,Null,103128359,111461,15320
103168071,158.0,158.0,4490000,2789000,1701000,38,4490000,Null,Null,103168071,18802,1789
103168844,667.0,667.0,4990000,2780000,2210000,44,4990000,Null,Null,103168844,18802,1794
103210073,62.0,62.0,120000,120000,0,0,120000,Null,Null,103210073,111461,5566
103222773,15.0,15.0,19000,19000,0,0,19000,Null,Null,103222773,111461,2
103235281,0.0,0.0,8800,8800,0,0,8800,Null,Null,103235281,111461,11935
103297850,47.0,47.0,219000,219000,0,0,219000,Null,Null,103297850,21651,12294
103309598,0.0,0.0,59900000,59900000,0,0,59900000,Null,Null,103309598,4913653,11935
103341055,5933.0,5933.0,225000,149000,76000,34,225000,Null,Null,103341055,493435,8602
103343517,0.0,0.0,99000000,99000000,0,0,99000000,Null,Null,103343517,4919467,8165
103347296,0.0,0.0,59900000,59900000,0,0,59900000,Null,Null,103347296,4919477,11935
103376023,4855.0,4855.0,79000,59000,20000,25,79000,Null,Null,103376023,493435,8602
103378379,0.0,0.0,45000000,45000000,0,0,45000000,Null,Null,103378379,4884469,23270
103378518,0.0,0.0,41400000,41400000,0,0,41400000,Null,Null,103378518,4884469,23276
103383454,0.0,0.0,9680000,9680000,0,0,9680000,Null,Null,103383454,111461,2340
103388285,0.0,0.0,44900000,44900000,0,0,44900000,Null,Null,103388285,4278291,11935
103397965,0.0,0.0,17699000,17699000,0,0,17699000,Null,Null,103397965,111461,2340
103400756,0.0,0.0,43200000,43200000,0,0,43200000,Null,Null,103400756,4920899,11935
103401134,0.0,0.0,12990000,12990000,0,0,12990000,Null,Null,103401134,114527,2657
103401552,0.0,0.0,250000,250000,0,0,250000,Null,Null,103401552,165313,3990
103418962,0.0,0.0,49900000,49900000,0,0,49900000,Null,Null,103418962,4921049,11935
103419257,8.0,8.0,153000,153000,0,0,153000,Null,Null,103419257,111461,15236
103427536,0.0,0.0,2280,2280,0,0,2280,Null,Null,103427536,111461,23112
103456514,17.0,17.0,349000,349000,0,0,349000,Null,Null,103456514,632589,1602
103472114,0.0,0.0,7900,7900,0,0,7900,Null,Null,103472114,111461,11935
103472191,0.0,0.0,1000,1000,0,0,1000,Null,Null,103472191,111461,11935
103472214,0.0,0.0,1000,1000,0,0,1000,Null,Null,103472214,111461,11935
103472229,21.0,21.0,1000,1000,0,0,1000,Null,Null,103472229,111461,11935
103472292,0.0,0.0,6500,6500,0,0,6500,Null,Null,103472292,111461,11935
103472391,5.0,5.0,1000,1000,0,0,1000,Null,Null,103472391,111461,11935
103472394,0.0,0.0,1000,1000,0,0,1000,Null,Null,103472394,111461,11935
103472471,2.0,2.0,1000,1000,0,0,1000,Null,Null,103472471,111461,11935
103472588,0.0,0.0,2500,2500,0,0,2500,Null,Null,103472588,111461,11935
103472606,0.0,0.0,1000,1000,0,0,1000,Null,Null,103472606,111461,11935
103472628,0.0,0.0,1000,1000,0,0,1000,Null,Null,103472628,111461,11935
103472672,0.0,0.0,7000,7000,0,0,7000,Null,Null,103472672,111461,2
103472789,0.0,0.0,3500,3500,0,0,3500,Null,Null,103472789,111461,11935
103472791,0.0,0.0,2500,2500,0,0,2500,Null,Null,103472791,111461,11935
103472793,2.0,2.0,7000,7000,0,0,7000,Null,Null,103472793,111461,2
103472813,2.0,2.0,3900,3900,0,0,3900,Null,Null,103472813,111461,11935
103472829,0.0,0.0,7000,7000,0,0,7000,Null,Null,103472829,111461,11935
103472837,1.0,1.0,5000,5000,0,0,5000,Null,Null,103472837,111461,11935
103472840,0.0,0.0,5900,5900,0,0,5900,Null,Null,103472840,111461,11935
103472874,15.0,15.0,1699,1699,0,0,1699,Null,Null,103472874,111461,2
103472875,0.0,0.0,1000,1000,0,0,1000,Null,Null,103472875,111461,11935
103472879,0.0,0.0,1000,1000,0,0,1000,Null,Null,103472879,111461,11935
103472932,0.0,0.0,1000,1000,0,0,1000,Null,Null,103472932,111461,11935
103472961,1.0,1.0,8000,8000,0,0,8000,Null,Null,103472961,111461,11935
103472971,0.0,0.0,7000,7000,0,0,7000,Null,Null,103472971,111461,11935
103473003,1.0,1.0,5000,5000,0,0,5000,Null,Null,103473003,111461,11935
103473020,0.0,0.0,5000,5000,0,0,5000,Null,Null,103473020,111461,11935
103473027,0.0,0.0,1000,1000,0,0,1000,Null,Null,103473027,111461,11935
103473057,1.0,1.0,5500,5500,0,0,5500,Null,Null,103473057,111461,11935
103473148,0.0,0.0,6000,6000,0,0,6000,Null,Null,103473148,111461,11935
103473180,0.0,0.0,1000,1000,0,0,1000,Null,Null,103473180,111461,11935
103473187,40.0,40.0,6900,6900,0,0,6900,Null,Null,103473187,111461,11935
103473232,0.0,0.0,3900,3900,0,0,3900,Null,Null,103473232,111461,11935
103473268,0.0,0.0,7000,7000,0,0,7000,Null,Null,103473268,111461,11935
103473272,0.0,0.0,1000,1000,0,0,1000,Null,Null,103473272,111461,11935
103473289,0.0,0.0,3500,3500,0,0,3500,Null,Null,103473289,111461,11935
103473294,1.0,1.0,1000,1000,0,0,1000,Null,Null,103473294,111461,2
103473315,0.0,0.0,6000,6000,0,0,6000,Null,Null,103473315,111461,11935
103473376,0.0,0.0,7900,7900,0,0,7900,Null,Null,103473376,111461,11935
103473448,10.0,10.0,2500,2500,0,0,2500,Null,Null,103473448,111461,6948
103473469,0.0,0.0,2500,2500,0,0,2500,Null,Null,103473469,111461,6948
103473473,1.0,1.0,2500,2500,0,0,2500,Null,Null,103473473,111461,2
103473549,15.0,15.0,9000,9000,0,0,9000,Null,Null,103473549,111461,11935
103473593,0.0,0.0,7900,7900,0,0,7900,Null,Null,103473593,111461,11935
103473666,0.0,0.0,1000,1000,0,0,1000,Null,Null,103473666,111461,11935
103473692,0.0,0.0,1000,1000,0,0,1000,Null,Null,103473692,111461,11935
103473697,0.0,0.0,1000,1000,0,0,1000,Null,Null,103473697,111461,11935
103473718,0.0,0.0,5000,5000,0,0,5000,Null,Null,103473718,111461,11935
103473730,3.0,3.0,1000,1000,0,0,1000,Null,Null,103473730,111461,11935
103473781,0.0,0.0,5000,5000,0,0,5000,Null,Null,103473781,111461,11935
103473786,2.0,2.0,10000,10000,0,0,10000,Null,Null,103473786,111461,11935
103473802,0.0,0.0,2500,2500,0,0,2500,Null,Null,103473802,111461,6948
103473806,0.0,0.0,1000,1000,0,0,1000,Null,Null,103473806,111461,11935
103473867,78.0,78.0,5000,5000,0,0,5000,Null,Null,103473867,111461,2
103473882,5.0,5.0,6900,6900,0,0,6900,Null,Null,103473882,111461,11935
103497051,2.0,2.0,10000,10000,0,0,10000,Null,Null,103497051,111461,1634
103508184,47.0,47.0,225750,225750,0,0,225750,Null,Null,103508184,193677,23246
103509164,0.0,0.0,29500000,29500000,0,0,29500000,Null,Null,103509164,433227,2340
103511474,0.0,0.0,3598000,3598000,0,0,3598000,Null,Null,103511474,4897651,53350
103513001,0.0,0.0,54500000,54500000,0,0,54500000,Null,Null,103513001,433227,2340
103513501,4.0,4.0,567000,510300,56700,10,567000,Null,Null,103513501,111461,15250
103514085,1.0,1.0,3598000,3598000,0,0,3598000,Null,Null,103514085,4897651,53350
103514146,0.0,0.0,16850000,16850000,0,0,16850000,Null,Null,103514146,167287,8064
103524119,0.0,0.0,3598000,3598000,0,0,3598000,Null,Null,103524119,4897651,3426
103525187,1.0,1.0,3598000,3598000,0,0,3598000,Null,Null,103525187,4897651,53350
103534217,0.0,0.0,3598000,3598000,0,0,3598000,Null,Null,103534217,4897651,5893
103564000,423.0,423.0,39000,39000,0,0,39000,Null,Null,103564000,111461,53190
103564402,219.0,219.0,99000,69000,30000,30,99000,Null,Null,103564402,230607,27128
103577157,8.0,8.0,23112000,17459000,5653000,24,23112000,Null,Null,103577157,242001,11935
103635800,10493.0,10493.0,172000,146000,26000,15,172000,Null,Null,103635800,548147,17162
103637245,608.0,608.0,100000,79000,21000,21,100000,Null,Null,103637245,33036,12294
103640595,13.0,13.0,4000,4000,0,0,4000,Null,Null,103640595,111461,8205
103640638,0.0,0.0,8000,8000,0,0,8000,Null,Null,103640638,111461,8205
103640921,2.0,2.0,10000,10000,0,0,10000,Null,Null,103640921,111461,1622
103640939,0.0,0.0,6000,6000,0,0,6000,Null,Null,103640939,111461,1622
103640948,30.0,30.0,4000,4000,0,0,4000,Null,Null,103640948,111461,8205
103640966,0.0,0.0,6000,6000,0,0,6000,Null,Null,103640966,111461,1622
103641013,0.0,0.0,5000,5000,0,0,5000,Null,Null,103641013,111461,1622
103641100,7.0,7.0,3200,3200,0,0,3200,Null,Null,103641100,111461,8205
103641154,1.0,1.0,10000,10000,0,0,10000,Null,Null,103641154,111461,8205
103660293,320.0,320.0,110000,75000,35000,32,110000,Null,Null,103660293,33036,12294
103662920,133.0,133.0,350000,259000,91000,26,350000,Null,Null,103662920,33036,5006
103665110,232.0,232.0,1781,1781,0,0,1781,Null,Null,103665110,111461,6742
103670110,116.0,116.0,818000,818000,0,0,818000,Null,Null,103670110,20271,4880
103697818,262.0,262.0,349000,349000,0,0,349000,Null,Null,103697818,4842743,2512
103727810,88.0,88.0,116800,81760,35040,30,116800,Null,Null,103727810,111461,2173
103738623,10.0,10.0,47000,42300,4700,10,47000,Null,Null,103738623,111461,15320
103744078,0.0,0.0,49990000,49990000,0,0,49990000,Null,Null,103744078,114527,2657
103755737,0.0,0.0,37990000,37990000,0,0,37990000,Null,Null,103755737,114527,2657
103757642,241.0,241.0,409000,376000,33000,8,409000,Null,Null,103757642,3985581,23048
103758906,925.0,925.0,96000,89000,7000,7,96000,Null,Null,103758906,216511,1630
103780888,21.0,21.0,59000,59000,0,0,59000,Null,Null,103780888,144845,53190
103783532,0.0,0.0,4000,4000,0,0,4000,Null,Null,103783532,111461,7064
103784067,0.0,0.0,10000,10000,0,0,10000,Null,Null,103784067,111461,7064
103786410,0.0,0.0,7850000,7850000,0,0,7850000,Null,Null,103786410,496841,8170
103786421,1.0,1.0,39000,18000,21000,54,39000,Null,Null,103786421,111461,15320
103789765,94.0,94.0,150000,89000,61000,41,150000,Null,Null,103789765,212575,27128
103797681,194.0,194.0,120000,105000,15000,13,120000,Null,Null,103797681,252399,23352
103817333,125.0,125.0,1049000,1049000,0,0,1049000,Null,Null,103817333,24876,28454
103888905,2.0,2.0,23450000,23215500,234500,1,23450000,Null,Null,103888905,167287,7079
103891519,0.0,0.0,19150000,19150000,0,0,19150000,Null,Null,103891519,167287,7079
103892439,0.0,0.0,15300000,15147000,153000,1,15300000,Null,Null,103892439,167287,7079
103894786,0.0,0.0,13500000,13500000,0,0,13500000,Null,Null,103894786,167287,7079
103899446,1.0,1.0,450000,450000,0,0,450000,Null,Null,103899446,184409,15250
103901609,14.0,14.0,9798000,9798000,0,0,9798000,Null,Null,103901609,111461,2340
103941261,28.0,28.0,159000,159000,0,0,159000,Null,Null,103941261,704815,15936
103950461,16.0,16.0,9000,9000,0,0,9000,Null,Null,103950461,111461,28574
103950630,1396.0,1396.0,99000,79000,20000,20,99000,Null,Null,103950630,216511,1630
103998343,745.0,745.0,79000,71000,8000,10,79000,Null,Null,103998343,216511,1630
104009118,2420.0,2420.0,105000,63000,42000,40,105000,Null,Null,104009118,216511,1630
104025848,41.0,41.0,350000,350000,0,0,350000,Null,Null,104025848,111461,23136
104027916,390.0,390.0,660000,330000,330000,50,660000,Null,Null,104027916,3955813,23362
104051298,108.0,108.0,399000,399000,0,0,399000,Null,Null,104051298,493985,8223
104051529,0.0,0.0,4500,4500,0,0,4500,Null,Null,104051529,111461,2
104069956,233.0,233.0,5970,5850,120,2,5970,Null,Null,104069956,111461,2
104102589,2.0,2.0,48000,48000,0,0,48000,Null,Null,104102589,111461,2
104102817,8.0,8.0,150900,135000,15900,11,150900,Null,Null,104102817,111461,1984
104103519,9.0,9.0,14999,14999,0,0,14999,Null,Null,104103519,111461,2
104110135,2840.0,2840.0,99000,99000,0,0,99000,Null,Null,104110135,746615,1883
104127350,1.0,1.0,234000,234000,0,0,234000,Null,Null,104127350,111461,2
104129770,4.0,4.0,216000,216000,0,0,216000,Null,Null,104129770,111461,2
104132193,0.0,0.0,15000,15000,0,0,15000,Null,Null,104132193,111461,2
104155532,15.0,15.0,16800,16800,0,0,16800,Null,Null,104155532,111461,2
104190749,292.0,292.0,108900,100000,8900,8,108900,Null,Null,104190749,200189,11857
104247684,0.0,0.0,1300000,1300000,0,0,1300000,Null,Null,104247684,4878479,15318
104268199,435.0,435.0,599000,349000,250000,42,599000,Null,Null,104268199,302375,1838
104269505,0.0,0.0,15450000,15450000,0,0,15450000,Null,Null,104269505,111461,11941
104269511,0.0,0.0,10300000,10300000,0,0,10300000,Null,Null,104269511,111461,2334
104270135,3307.0,3307.0,517000,268000,249000,48,517000,Null,Null,104270135,48077,1936
104288859,204.0,204.0,108000,89000,19000,18,108000,Null,Null,104288859,198555,8223
104294679,1.0,1.0,180000,180000,0,0,180000,Null,Null,104294679,111461,2
104297758,217.0,217.0,7200,7000,200,3,7200,Null,Null,104297758,111461,28480
104303892,189.0,189.0,135000,110000,25000,19,135000,Null,Null,104303892,198555,8223
104311523,1082.0,1082.0,42200,40000,2200,5,42200,Null,Null,104311523,50693,3449
104342431,53.0,53.0,1350000,849000,501000,37,1350000,Null,Null,104342431,725993,12908
104354891,0.0,0.0,954000,516937,437063,46,954000,Null,Null,104354891,111461,2
104355008,0.0,0.0,7800,7644,156,2,7800,Null,Null,104355008,111461,2
104361568,1.0,1.0,10000,8000,2000,20,10000,Null,Null,104361568,111461,8205
104397632,1867.0,1867.0,70100,63000,7100,10,70100,Null,Null,104397632,50693,3449
104397933,487.0,487.0,140200,122000,18200,13,140200,Null,Null,104397933,50693,3449
104398857,556.0,556.0,70100,63000,7100,10,70100,Null,Null,104398857,50693,3449
104414606,32.0,32.0,350000,350000,0,0,350000,Null,Null,104414606,4524885,13878
104414862,3.0,3.0,89000,89000,0,0,89000,Null,Null,104414862,111461,15320
104441370,419.0,419.0,395000,395000,0,0,395000,Null,Null,104441370,111461,2
104441420,98.0,98.0,259000,259000,0,0,259000,Null,Null,104441420,111461,2
104447063,0.0,0.0,16290000,16290000,0,0,16290000,Null,Null,104447063,239655,8066
104466147,59.0,59.0,38000,38000,0,0,38000,Null,Null,104466147,111461,23658
104520365,18.0,18.0,68000,68000,0,0,68000,Null,Null,104520365,111461,2
104521414,3.0,3.0,10800,10800,0,0,10800,Null,Null,104521414,111461,8371
104523383,0.0,0.0,30000,18000,12000,40,30000,Null,Null,104523383,111461,2
104527224,4.0,4.0,1200,1200,0,0,1200,Null,Null,104527224,111461,2
104527276,0.0,0.0,1800,1800,0,0,1800,Null,Null,104527276,111461,2
104527526,3.0,3.0,10800,10800,0,0,10800,Null,Null,104527526,111461,2
104531444,0.0,0.0,10800,10800,0,0,10800,Null,Null,104531444,111461,2
104556810,93.0,93.0,950000,950000,0,0,950000,Null,Null,104556810,19034,28574
104637476,102.0,102.0,218790,195000,23790,11,218790,Null,Null,104637476,200189,11853
104641489,0.0,0.0,6500,6500,0,0,6500,Null,Null,104641489,111461,28468
104655988,62.0,62.0,340000,340000,0,0,340000,Null,Null,104655988,200189,11847
104726492,0.0,0.0,360000,360000,0,0,360000,Null,Null,104726492,111461,15318
104726704,1.0,1.0,160000,160000,0,0,160000,Null,Null,104726704,111461,15320
104738355,8.0,8.0,11150000,8850000,2300000,21,11150000,Null,Null,104738355,27398,2340
104739184,0.0,0.0,11500000,11500000,0,0,11500000,Null,Null,104739184,111461,15318
104740886,0.0,0.0,19900000,19900000,0,0,19900000,Null,Null,104740886,111461,15318
104741781,0.0,0.0,6600000,6600000,0,0,6600000,Null,Null,104741781,111461,15318
104743605,0.0,0.0,9900000,9900000,0,0,9900000,Null,Null,104743605,111461,15318
104744292,70.0,70.0,140000,140000,0,0,140000,Null,Null,104744292,1099817,8305
104745477,132.0,132.0,790000,758400,31600,4,790000,Null,Null,104745477,560095,11879
104755963,6.0,6.0,55000,55000,0,0,55000,Null,Null,104755963,111461,2
104769754,0.0,0.0,20000,20000,0,0,20000,Null,Null,104769754,111461,2
104805376,328.0,328.0,85000,85000,0,0,85000,Null,Null,104805376,520061,53058
104844190,8.0,8.0,73000,73000,0,0,73000,Null,Null,104844190,111461,2
104844599,7.0,7.0,67000,67000,0,0,67000,Null,Null,104844599,111461,2
104847986,0.0,0.0,22067000,22067000,0,0,22067000,Null,Null,104847986,153444,7079
104847988,15.0,15.0,205000,205000,0,0,205000,Null,Null,104847988,111461,5566
104849983,0.0,0.0,34765000,34765000,0,0,34765000,Null,Null,104849983,153444,7079
104850707,0.0,0.0,40600000,40600000,0,0,40600000,Null,Null,104850707,153444,7079
104850969,17.0,17.0,59000,59000,0,0,59000,Null,Null,104850969,21651,5006
104851125,0.0,0.0,13299000,13299000,0,0,13299000,Null,Null,104851125,313739,2
104852335,0.0,0.0,15915000,15915000,0,0,15915000,Null,Null,104852335,662957,7079
104852589,0.0,0.0,21385000,21385000,0,0,21385000,Null,Null,104852589,153444,7079
104854216,2.0,2.0,1430000,999000,431000,30,1430000,Null,Null,104854216,4647777,15250
104906661,0.0,0.0,73347950,73347950,0,0,73347950,Null,Null,104906661,111461,23238
104909320,94.0,94.0,822000,366000,456000,55,822000,Null,Null,104909320,449693,11845
104909711,10.0,10.0,350000,350000,0,0,350000,Null,Null,104909711,110996,20170
104918357,21.0,21.0,289000,260100,28900,10,289000,Null,Null,104918357,4058421,2
104922383,37.0,37.0,15000,15000,0,0,15000,Null,Null,104922383,111461,15320
104954746,7.0,7.0,179998,89999,89999,50,179998,Null,Null,104954746,111461,28574
104991715,4230.0,4230.0,929000,349000,580000,62,929000,Null,Null,104991715,19813,1984
105026602,255.0,255.0,249000,249000,0,0,249000,Null,Null,105026602,505925,23048
105027855,88.0,88.0,98000,98000,0,0,98000,Null,Null,105027855,111461,23304
105028691,0.0,0.0,20599920,20599920,0,0,20599920,Null,Null,105028691,261521,2324
105028717,0.0,0.0,17500000,17500000,0,0,17500000,Null,Null,105028717,261521,2324
105029255,0.0,0.0,17641800,17641800,0,0,17641800,Null,Null,105029255,261521,2324
105029298,0.0,0.0,16162740,16162740,0,0,16162740,Null,Null,105029298,261521,2324
105029334,67.0,67.0,27000,27000,0,0,27000,Null,Null,105029334,111461,2
105029394,0.0,0.0,23531310,23531310,0,0,23531310,Null,Null,105029394,261521,2324
105029403,0.0,0.0,19120860,19120860,0,0,19120860,Null,Null,105029403,261521,2324
105029430,0.0,0.0,16162740,16162740,0,0,16162740,Null,Null,105029430,261521,2324
105035769,0.0,0.0,27193320,27193320,0,0,27193320,Null,Null,105035769,261521,7081
105035778,0.0,0.0,27193320,27193320,0,0,27193320,Null,Null,105035778,261521,7081
105035794,0.0,0.0,27193320,27193320,0,0,27193320,Null,Null,105035794,261521,7081
105036556,0.0,0.0,27193320,27193320,0,0,27193320,Null,Null,105036556,261521,7081
105042319,0.0,0.0,27193320,27193320,0,0,27193320,Null,Null,105042319,261521,7081
105042335,0.0,0.0,27193320,27193320,0,0,27193320,Null,Null,105042335,261521,7081
105042380,0.0,0.0,27193320,27193320,0,0,27193320,Null,Null,105042380,261521,7081
105044482,0.0,0.0,23225101,23225101,0,0,23225101,Null,Null,105044482,261521,7081
105051458,0.0,0.0,23225100,23225100,0,0,23225100,Null,Null,105051458,261521,7081
105051783,0.0,0.0,23255100,23255100,0,0,23255100,Null,Null,105051783,261521,7081
105052129,0.0,0.0,23255100,23255100,0,0,23255100,Null,Null,105052129,261521,7081
105052564,0.0,0.0,21749310,21749310,0,0,21749310,Null,Null,105052564,261521,7081
105053369,0.0,0.0,21749310,21749310,0,0,21749310,Null,Null,105053369,261521,7081
105053852,0.0,0.0,21749310,21749310,0,0,21749310,Null,Null,105053852,261521,7081
105071630,4799.0,4799.0,16800,16800,0,0,16800,Null,Null,105071630,112493,1520
105100168,0.0,0.0,309000,309000,0,0,309000,Null,Null,105100168,111461,2
105112646,0.0,0.0,21749310,21749310,0,0,21749310,Null,Null,105112646,261521,26652
105137438,279.0,279.0,690000,690000,0,0,690000,Null,Null,105137438,849905,4381
105138625,0.0,0.0,15000,15000,0,0,15000,Null,Null,105138625,111461,2
105139193,21.0,21.0,1200,1200,0,0,1200,Null,Null,105139193,111461,2363
105152544,4.0,4.0,9000,9000,0,0,9000,Null,Null,105152544,111461,2
105153330,0.0,0.0,25500000,25500000,0,0,25500000,Null,Null,105153330,111461,2
105153335,0.0,0.0,9000,9000,0,0,9000,Null,Null,105153335,111461,2
105159888,0.0,0.0,4000,4000,0,0,4000,Null,Null,105159888,111461,2
105170899,778.0,778.0,33600,17000,16600,49,33600,Null,Null,105170899,111461,23416
105196223,3.0,3.0,3000,3000,0,0,3000,Null,Null,105196223,111461,28484
105209267,6.0,6.0,149000,149000,0,0,149000,Null,Null,105209267,111461,28460
105212253,5.0,5.0,10000,10000,0,0,10000,Null,Null,105212253,111461,49726
105225694,0.0,0.0,2500,2500,0,0,2500,Null,Null,105225694,111461,23042
105230905,3.0,3.0,15000,15000,0,0,15000,Null,Null,105230905,111461,15320
105278673,528.0,528.0,460000,289000,171000,37,460000,Null,Null,105278673,4429985,11879
105295203,0.0,0.0,17690000,17690000,0,0,17690000,Null,Null,105295203,400077,20258
105326644,9.0,9.0,98000,95000,3000,3,98000,Null,Null,105326644,111461,28454
105345265,355.0,355.0,204000,174000,30000,15,204000,Null,Null,105345265,21271,1627
105357330,0.0,0.0,41345850,41345850,0,0,41345850,Null,Null,105357330,111461,23238
105361877,0.0,0.0,11500000,11500000,0,0,11500000,Null,Null,105361877,111461,15318
105513634,256.0,256.0,500000,221000,279000,56,500000,Null,Null,105513634,500047,5531
105531585,719.0,719.0,215000,199000,16000,7,215000,Null,Null,105531585,224359,8171
105591849,16.0,16.0,39000,39000,0,0,39000,Null,Null,105591849,111461,15318
105605965,7.0,7.0,15000,15000,0,0,15000,Null,Null,105605965,111461,15236
105618884,1257.0,1257.0,298000,178000,120000,40,298000,Null,Null,105618884,4246951,8602
105621214,121.0,121.0,588000,319000,269000,46,588000,Null,Null,105621214,21261,1630
105626002,319.0,319.0,204000,180000,24000,12,204000,Null,Null,105626002,21261,1630
105629582,16.0,16.0,388000,318000,70000,18,388000,Null,Null,105629582,21261,1631
105629974,532.0,532.0,180000,170000,10000,6,180000,Null,Null,105629974,21261,1631
105632361,720.0,720.0,584000,418000,166000,28,584000,Null,Null,105632361,21261,1630
105632400,51.0,51.0,147000,108000,39000,27,147000,Null,Null,105632400,21261,1630
105633403,0.0,0.0,159999000,99999999,59999001,37,159999000,Null,Null,105633403,542569,2340
105633409,0.0,0.0,159999000,89999999,69999001,44,159999000,Null,Null,105633409,542569,2340
105655319,0.0,0.0,5500000,5500000,0,0,5500000,Null,Null,105655319,111461,11831
105657875,1052.0,1052.0,1136000,757000,379000,33,1136000,Null,Null,105657875,204895,23254
105674466,0.0,0.0,15700000,15700000,0,0,15700000,Null,Null,105674466,167287,8064
105686182,92.0,92.0,880000,880000,0,0,880000,Null,Null,105686182,4409909,28482
105687627,0.0,0.0,5555000,5555000,0,0,5555000,Null,Null,105687627,4959121,11885
105691696,618.0,618.0,85000,85000,0,0,85000,Null,Null,105691696,578915,17186
105727238,31.0,31.0,10000,10000,0,0,10000,Null,Null,105727238,111461,2
105729637,0.0,0.0,9899,9899,0,0,9899,Null,Null,105729637,111461,2
105737570,87.0,87.0,140000,140000,0,0,140000,Null,Null,105737570,111461,28598
105737607,80.0,80.0,145800,142884,2916,2,145800,Null,Null,105737607,111461,28598
105738501,559.0,559.0,14000,11000,3000,21,14000,Null,Null,105738501,4246951,8602
105740488,3.0,3.0,188000,188000,0,0,188000,Null,Null,105740488,111461,28482
105788342,141.0,141.0,550000,399000,151000,27,550000,Null,Null,105788342,47489,3422
105793935,314.0,314.0,105000,103950,1050,1,105000,Null,Null,105793935,189593,1630
105795059,0.0,0.0,6525000,6525000,0,0,6525000,Null,Null,105795059,691055,8511
105795105,0.0,0.0,6525000,6525000,0,0,6525000,Null,Null,105795105,691055,8511
105795113,0.0,0.0,7065000,7065000,0,0,7065000,Null,Null,105795113,691055,8511
105795114,0.0,0.0,7875000,7875000,0,0,7875000,Null,Null,105795114,691055,8511
105795147,0.0,0.0,7065000,7065000,0,0,7065000,Null,Null,105795147,691055,8511
105795149,0.0,0.0,6525000,6525000,0,0,6525000,Null,Null,105795149,691055,8511
105795161,0.0,0.0,7875000,7875000,0,0,7875000,Null,Null,105795161,691055,8511
105795173,0.0,0.0,6525000,6525000,0,0,6525000,Null,Null,105795173,691055,8511
105795175,0.0,0.0,17010000,17010000,0,0,17010000,Null,Null,105795175,691055,8511
105795186,0.0,0.0,7065000,7065000,0,0,7065000,Null,Null,105795186,691055,8511
105795188,0.0,0.0,17550000,17550000,0,0,17550000,Null,Null,105795188,691055,8511
105795190,0.0,0.0,7065000,7065000,0,0,7065000,Null,Null,105795190,691055,8511
105795196,0.0,0.0,7065000,7065000,0,0,7065000,Null,Null,105795196,691055,8511
105798604,7.0,7.0,3985000,3546650,438350,11,3985000,Null,Null,105798604,205847,11873
105802274,23.0,23.0,229000,199000,30000,13,229000,Null,Null,105802274,111461,15318
105803053,42.0,42.0,264000,234000,30000,11,264000,Null,Null,105803053,111461,15318
105812596,47.0,47.0,209000,209000,0,0,209000,Null,Null,105812596,111461,2
105812707,212.0,212.0,185000,185000,0,0,185000,Null,Null,105812707,111461,2
105821192,0.0,0.0,19190000,19190000,0,0,19190000,Null,Null,105821192,153444,20170
105821195,0.0,0.0,25175000,25175000,0,0,25175000,Null,Null,105821195,153444,20170
105821201,0.0,0.0,12160000,12160000,0,0,12160000,Null,Null,105821201,153444,20170
105821231,0.0,0.0,19030000,19030000,0,0,19030000,Null,Null,105821231,153444,20170
105821501,0.0,0.0,17050000,17050000,0,0,17050000,Null,Null,105821501,153444,20170
105821662,50.0,50.0,600000,479000,121000,20,600000,Null,Null,105821662,18802,28460
105821698,0.0,0.0,109630000,109630000,0,0,109630000,Null,Null,105821698,153444,20170
105821752,0.0,0.0,67450000,67450000,0,0,67450000,Null,Null,105821752,153444,20170
105821808,0.0,0.0,75145000,75145000,0,0,75145000,Null,Null,105821808,153444,20170
105821846,1684.0,1684.0,110000,110000,0,0,110000,Null,Null,105821846,493435,8602
105821876,0.0,0.0,47025000,47025000,0,0,47025000,Null,Null,105821876,153444,20170
105821908,0.0,0.0,26410000,26410000,0,0,26410000,Null,Null,105821908,153444,20170
105821941,0.0,0.0,21850000,21850000,0,0,21850000,Null,Null,105821941,153444,20170
105821960,0.0,0.0,19285000,19285000,0,0,19285000,Null,Null,105821960,153444,20170
105821979,0.0,0.0,16720000,16720000,0,0,16720000,Null,Null,105821979,153444,20170
105822045,0.0,0.0,22210000,22210000,0,0,22210000,Null,Null,105822045,153444,7079
105822060,0.0,0.0,17985000,17985000,0,0,17985000,Null,Null,105822060,153444,7079
105829753,2.0,2.0,299000,299000,0,0,299000,Null,Null,105829753,21651,12908
105830021,54.0,54.0,4290000,2706000,1584000,37,4290000,Null,Null,105830021,18802,1794
105891141,0.0,0.0,11210000,11210000,0,0,11210000,Null,Null,105891141,837259,2
105894563,174.0,174.0,2500,2500,0,0,2500,Null,Null,105894563,111461,28472
105985711,113.0,113.0,61000,36000,25000,41,61000,Null,Null,105985711,111461,15236
106003526,0.0,0.0,2999000,2999000,0,0,2999000,Null,Null,106003526,111461,7449
106032438,12.0,12.0,980000,980000,0,0,980000,Null,Null,106032438,114328,53350
106032929,180.0,180.0,18000,9900,8100,45,18000,Null,Null,106032929,474145,8305
106043948,949.0,949.0,242400,242400,0,0,242400,Null,Null,106043948,48249,11605
106045771,0.0,0.0,45300000,45300000,0,0,45300000,Null,Null,106045771,167287,11518
106046426,173.0,173.0,60000,41000,19000,32,60000,Null,Null,106046426,215437,28470
106062055,292.0,292.0,49900,49900,0,0,49900,Null,Null,106062055,111461,23416
106064043,1.0,1.0,149999,149999,0,0,149999,Null,Null,106064043,111461,2
106064103,109.0,109.0,152000,152000,0,0,152000,Null,Null,106064103,111461,2
106064996,0.0,0.0,149999,149999,0,0,149999,Null,Null,106064996,111461,2
106068398,0.0,0.0,26120000,26120000,0,0,26120000,Null,Null,106068398,25229,5566
106074482,148.0,148.0,90720,79000,11720,13,90720,Null,Null,106074482,200189,11857
106078420,19.0,19.0,76000,55000,21000,28,76000,Null,Null,106078420,111461,15236
106082135,264.0,264.0,141750,121000,20750,15,141750,Null,Null,106082135,200189,11857
106107764,50.0,50.0,32000,15000,17000,53,32000,Null,Null,106107764,111461,15236
106118216,2.0,2.0,1800,1800,0,0,1800,Null,Null,106118216,111461,2
106149876,9.0,9.0,90000,32000,58000,64,90000,Null,Null,106149876,111461,15236
106183222,0.0,0.0,38000,19000,19000,50,38000,Null,Null,106183222,111461,15320
106188383,22.0,22.0,66400,66400,0,0,66400,Null,Null,106188383,111461,28480
106208918,303.0,303.0,249000,149000,100000,40,249000,Null,Null,106208918,254939,5995
106228134,0.0,0.0,57000000,57000000,0,0,57000000,Null,Null,106228134,111461,23596
106234914,0.0,0.0,11894850,11894850,0,0,11894850,Null,Null,106234914,261521,2324
106242054,0.0,0.0,346000,346000,0,0,346000,Null,Null,106242054,111461,2
106242061,2.0,2.0,985000,985000,0,0,985000,Null,Null,106242061,111461,15250
106242131,8.0,8.0,399000,399000,0,0,399000,Null,Null,106242131,111461,15250
106242207,9.0,9.0,355000,355000,0,0,355000,Null,Null,106242207,111461,2
106242221,2.0,2.0,568000,568000,0,0,568000,Null,Null,106242221,111461,2
106242300,1.0,1.0,415000,415000,0,0,415000,Null,Null,106242300,111461,2
106242328,2.0,2.0,525000,525000,0,0,525000,Null,Null,106242328,111461,15250
106242655,1.0,1.0,479000,479000,0,0,479000,Null,Null,106242655,111461,2
106280895,550.0,550.0,190000,113000,77000,41,190000,Null,Null,106280895,33652,2
106281034,302.0,302.0,205000,122000,83000,40,205000,Null,Null,106281034,33652,3990
106281136,207.0,207.0,152000,98800,53200,35,152000,Null,Null,106281136,33652,3177
106290203,0.0,0.0,3699000,3699000,0,0,3699000,Null,Null,106290203,111461,5385
106303018,0.0,0.0,17125000,17125000,0,0,17125000,Null,Null,106303018,261521,2324
106338289,1187.0,1187.0,155000,95000,60000,39,155000,Null,Null,106338289,4554495,27118
106353327,1098.0,1098.0,90000,90000,0,0,90000,Null,Null,106353327,4898665,8602
106360094,15.0,15.0,18995000,18995000,0,0,18995000,Null,Null,106360094,4899179,2340
106361829,1.0,1.0,280000,266000,14000,5,280000,Null,Null,106361829,111461,15236
106361840,36.0,36.0,80000,80000,0,0,80000,Null,Null,106361840,111461,15236
106362015,2.0,2.0,20000,19000,1000,5,20000,Null,Null,106362015,111461,2
106373997,0.0,0.0,8000,8000,0,0,8000,Null,Null,106373997,111461,2
106374786,15.0,15.0,5500,5500,0,0,5500,Null,Null,106374786,111461,5566
106374965,5.0,5.0,5000,5000,0,0,5000,Null,Null,106374965,111461,5566
106375151,0.0,0.0,5000,5000,0,0,5000,Null,Null,106375151,111461,20254
106376925,0.0,0.0,27193320,27193320,0,0,27193320,Null,Null,106376925,261521,7081
106389991,3.0,3.0,264000,264000,0,0,264000,Null,Null,106389991,111461,2
106390113,49.0,49.0,230000,230000,0,0,230000,Null,Null,106390113,111461,2
106390136,12.0,12.0,274000,274000,0,0,274000,Null,Null,106390136,111461,2
106390176,81.0,81.0,65000,65000,0,0,65000,Null,Null,106390176,111461,2
106390188,5.0,5.0,44999,44999,0,0,44999,Null,Null,106390188,111461,2
106390205,11.0,11.0,115000,115000,0,0,115000,Null,Null,106390205,111461,2
106390460,21.0,21.0,47500,47500,0,0,47500,Null,Null,106390460,111461,2
106390567,15.0,15.0,20000,20000,0,0,20000,Null,Null,106390567,111461,2
106390639,9.0,9.0,45000,45000,0,0,45000,Null,Null,106390639,111461,2
106390658,2.0,2.0,169999,169999,0,0,169999,Null,Null,106390658,111461,2
106390688,3.0,3.0,63699,63699,0,0,63699,Null,Null,106390688,111461,2
106390719,9.0,9.0,10000,10000,0,0,10000,Null,Null,106390719,111461,2
106390748,7.0,7.0,18000,18000,0,0,18000,Null,Null,106390748,111461,2
106390917,28.0,28.0,127500,127500,0,0,127500,Null,Null,106390917,111461,2
106391044,11.0,11.0,150000,150000,0,0,150000,Null,Null,106391044,111461,2
106391055,10.0,10.0,135000,135000,0,0,135000,Null,Null,106391055,111461,2
106391123,14.0,14.0,50000,50000,0,0,50000,Null,Null,106391123,111461,2
106391138,16.0,16.0,49000,49000,0,0,49000,Null,Null,106391138,111461,2
106391147,8.0,8.0,50000,50000,0,0,50000,Null,Null,106391147,111461,2
106391253,1.0,1.0,35000,35000,0,0,35000,Null,Null,106391253,111461,2
106391381,10.0,10.0,150000,150000,0,0,150000,Null,Null,106391381,111461,2
106391491,7.0,7.0,580000,580000,0,0,580000,Null,Null,106391491,111461,2
106391733,3.0,3.0,228000,228000,0,0,228000,Null,Null,106391733,111461,2
106391774,21.0,21.0,150000,150000,0,0,150000,Null,Null,106391774,111461,2
106391798,75.0,75.0,50000,50000,0,0,50000,Null,Null,106391798,111461,2
106391847,7.0,7.0,45000,45000,0,0,45000,Null,Null,106391847,111461,2
106391875,0.0,0.0,18000,18000,0,0,18000,Null,Null,106391875,111461,2
106391964,3.0,3.0,12000,12000,0,0,12000,Null,Null,106391964,111461,2
106391987,10.0,10.0,15000,15000,0,0,15000,Null,Null,106391987,111461,2
106391999,6.0,6.0,7000,7000,0,0,7000,Null,Null,106391999,111461,2
106392036,7.0,7.0,150000,150000,0,0,150000,Null,Null,106392036,111461,2
106392062,11.0,11.0,14250,14250,0,0,14250,Null,Null,106392062,111461,2
106392561,6.0,6.0,304000,304000,0,0,304000,Null,Null,106392561,111461,2
106392676,10.0,10.0,160000,160000,0,0,160000,Null,Null,106392676,111461,2
106392758,3.0,3.0,11999,11999,0,0,11999,Null,Null,106392758,111461,2
106392768,4.0,4.0,25000,25000,0,0,25000,Null,Null,106392768,111461,2
106393026,15.0,15.0,25000,25000,0,0,25000,Null,Null,106393026,111461,2
106393058,5.0,5.0,100000,100000,0,0,100000,Null,Null,106393058,111461,2
106393082,3.0,3.0,100000,100000,0,0,100000,Null,Null,106393082,111461,2
106393246,2.0,2.0,120000,120000,0,0,120000,Null,Null,106393246,111461,2
106393307,7.0,7.0,220000,220000,0,0,220000,Null,Null,106393307,111461,2
106393324,23.0,23.0,150000,150000,0,0,150000,Null,Null,106393324,111461,2
106393370,0.0,0.0,179999,179999,0,0,179999,Null,Null,106393370,111461,2
106393508,3.0,3.0,18000,18000,0,0,18000,Null,Null,106393508,111461,2
106393524,8.0,8.0,150000,150000,0,0,150000,Null,Null,106393524,111461,2
106393572,0.0,0.0,29999,29999,0,0,29999,Null,Null,106393572,111461,2
106393593,21.0,21.0,150000,150000,0,0,150000,Null,Null,106393593,111461,2
106393714,20.0,20.0,100000,100000,0,0,100000,Null,Null,106393714,111461,2
106393742,10.0,10.0,5000,5000,0,0,5000,Null,Null,106393742,111461,2
106393753,10.0,10.0,150000,150000,0,0,150000,Null,Null,106393753,111461,2
106393775,7.0,7.0,115000,115000,0,0,115000,Null,Null,106393775,111461,2
106393917,0.0,0.0,5000,5000,0,0,5000,Null,Null,106393917,111461,2
106393955,0.0,0.0,14999,14999,0,0,14999,Null,Null,106393955,111461,2
106394081,23.0,23.0,199500,199500,0,0,199500,Null,Null,106394081,111461,2
106394091,1.0,1.0,74999,74999,0,0,74999,Null,Null,106394091,111461,2
106394244,3.0,3.0,100000,100000,0,0,100000,Null,Null,106394244,111461,2
106394487,5.0,5.0,315000,315000,0,0,315000,Null,Null,106394487,111461,2
106395561,2.0,2.0,250000,185000,65000,26,250000,Null,Null,106395561,486875,1752
106396243,67.0,67.0,45000,45000,0,0,45000,Null,Null,106396243,111461,15318
106409910,0.0,0.0,5000,5000,0,0,5000,Null,Null,106409910,111461,2
106418570,0.0,0.0,2200,2200,0,0,2200,Null,Null,106418570,111461,20254
106418863,0.0,0.0,3500,3500,0,0,3500,Null,Null,106418863,111461,2
106419059,0.0,0.0,5000,5000,0,0,5000,Null,Null,106419059,111461,2
106419141,2.0,2.0,6900,6900,0,0,6900,Null,Null,106419141,111461,5566
106419210,0.0,0.0,4000,4000,0,0,4000,Null,Null,106419210,111461,2
106419235,20.0,20.0,2500,2500,0,0,2500,Null,Null,106419235,111461,20254
106419427,0.0,0.0,9000,9000,0,0,9000,Null,Null,106419427,111461,2
106419428,0.0,0.0,7999,7999,0,0,7999,Null,Null,106419428,111461,20174
106419489,19.0,19.0,6500,6500,0,0,6500,Null,Null,106419489,111461,26658
106419653,0.0,0.0,1200,1200,0,0,1200,Null,Null,106419653,111461,2
106419841,1.0,1.0,2500,2500,0,0,2500,Null,Null,106419841,111461,2
106419885,0.0,0.0,8500,8500,0,0,8500,Null,Null,106419885,111461,2
106419956,0.0,0.0,2200,2200,0,0,2200,Null,Null,106419956,111461,20254
106420216,4.0,4.0,6999,6999,0,0,6999,Null,Null,106420216,111461,20254
106420319,0.0,0.0,5700,5700,0,0,5700,Null,Null,106420319,111461,20254
106420682,12.0,12.0,1990,1990,0,0,1990,Null,Null,106420682,111461,2
106420841,110.0,110.0,1000,1000,0,0,1000,Null,Null,106420841,111461,20254
106421160,0.0,0.0,7500,7500,0,0,7500,Null,Null,106421160,111461,20254
106421198,0.0,0.0,7000,7000,0,0,7000,Null,Null,106421198,111461,20254
106421285,31.0,31.0,5900,5900,0,0,5900,Null,Null,106421285,111461,20254
106421327,8.0,8.0,2000,2000,0,0,2000,Null,Null,106421327,111461,28434
106421433,17.0,17.0,1800,1800,0,0,1800,Null,Null,106421433,111461,28434
106421655,0.0,0.0,7275,7275,0,0,7275,Null,Null,106421655,111461,20254
106421684,0.0,0.0,4990,4990,0,0,4990,Null,Null,106421684,111461,20254
106421759,0.0,0.0,4788,4788,0,0,4788,Null,Null,106421759,111461,20254
106421798,0.0,0.0,7500,7500,0,0,7500,Null,Null,106421798,111461,20254
106421802,1.0,1.0,2000,2000,0,0,2000,Null,Null,106421802,111461,2
106421955,0.0,0.0,8000,8000,0,0,8000,Null,Null,106421955,111461,20254
106422339,0.0,0.0,4500,4500,0,0,4500,Null,Null,106422339,111461,20254
106422484,0.0,0.0,6000,6000,0,0,6000,Null,Null,106422484,111461,20254
106422597,0.0,0.0,7500,7500,0,0,7500,Null,Null,106422597,111461,20254
106422641,2.0,2.0,9000,9000,0,0,9000,Null,Null,106422641,111461,2
106422841,0.0,0.0,7500,7500,0,0,7500,Null,Null,106422841,111461,2
106422844,0.0,0.0,2200,2200,0,0,2200,Null,Null,106422844,111461,2
106422882,0.0,0.0,7500,7500,0,0,7500,Null,Null,106422882,111461,2
106422890,3.0,3.0,1940,1940,0,0,1940,Null,Null,106422890,111461,20254
106422992,0.0,0.0,6999,6999,0,0,6999,Null,Null,106422992,111461,20254
106423003,0.0,0.0,9598,9598,0,0,9598,Null,Null,106423003,111461,2
106423050,4.0,4.0,5500,5500,0,0,5500,Null,Null,106423050,111461,28434
106423173,127.0,127.0,7000,7000,0,0,7000,Null,Null,106423173,111461,20254
106423333,0.0,0.0,3000,3000,0,0,3000,Null,Null,106423333,111461,20254
106423335,14.0,14.0,3899,3899,0,0,3899,Null,Null,106423335,111461,2
106423354,4.0,4.0,9000,9000,0,0,9000,Null,Null,106423354,111461,2
106423473,0.0,0.0,6000,6000,0,0,6000,Null,Null,106423473,111461,2
106423747,0.0,0.0,5990,5990,0,0,5990,Null,Null,106423747,111461,2
106423850,1.0,1.0,1455,1455,0,0,1455,Null,Null,106423850,111461,2
106423887,98.0,98.0,3900,3900,0,0,3900,Null,Null,106423887,111461,20254
106423915,3.0,3.0,9000,9000,0,0,9000,Null,Null,106423915,111461,20254
106424006,0.0,0.0,19000,19000,0,0,19000,Null,Null,106424006,111461,20254
106424008,0.0,0.0,3990,3990,0,0,3990,Null,Null,106424008,111461,20254
106424044,4.0,4.0,1931,1931,0,0,1931,Null,Null,106424044,111461,5566
106424075,0.0,0.0,6500,6500,0,0,6500,Null,Null,106424075,111461,2
106424092,0.0,0.0,3990,3990,0,0,3990,Null,Null,106424092,111461,20254
106424191,0.0,0.0,9000,9000,0,0,9000,Null,Null,106424191,111461,20250
106424329,0.0,0.0,2500,2500,0,0,2500,Null,Null,106424329,111461,20254
106424429,1.0,1.0,3000,3000,0,0,3000,Null,Null,106424429,111461,20254
106424468,0.0,0.0,7000,7000,0,0,7000,Null,Null,106424468,111461,2
106424511,0.0,0.0,2290,2290,0,0,2290,Null,Null,106424511,111461,23244
106424764,0.0,0.0,3999,3999,0,0,3999,Null,Null,106424764,111461,20254
106424932,3.0,3.0,1000,1000,0,0,1000,Null,Null,106424932,111461,53070
106425229,0.0,0.0,2450,2450,0,0,2450,Null,Null,106425229,111461,20254
106426445,0.0,0.0,7000,7000,0,0,7000,Null,Null,106426445,111461,20250
106426580,0.0,0.0,2790,2790,0,0,2790,Null,Null,106426580,111461,28434
106426771,3.0,3.0,3500,3500,0,0,3500,Null,Null,106426771,111461,20254
106426802,0.0,0.0,1200,1200,0,0,1200,Null,Null,106426802,111461,2
106427119,0.0,0.0,3900,3900,0,0,3900,Null,Null,106427119,111461,20254
106427282,0.0,0.0,5000,5000,0,0,5000,Null,Null,106427282,111461,2
106427643,3.0,3.0,4990,4990,0,0,4990,Null,Null,106427643,111461,20252
106429843,0.0,0.0,1990,1990,0,0,1990,Null,Null,106429843,111461,20254
106430040,0.0,0.0,3500,3500,0,0,3500,Null,Null,106430040,111461,2
106432295,0.0,0.0,6790,6790,0,0,6790,Null,Null,106432295,111461,28434
106432545,1.0,1.0,4999,4999,0,0,4999,Null,Null,106432545,111461,20254
106435335,0.0,0.0,9000,9000,0,0,9000,Null,Null,106435335,111461,2
106438578,0.0,0.0,8900,8900,0,0,8900,Null,Null,106438578,111461,2
106441026,0.0,0.0,8200,8200,0,0,8200,Null,Null,106441026,111461,2
106441386,0.0,0.0,2500,2500,0,0,2500,Null,Null,106441386,111461,20254
106443776,616.0,616.0,118000,85000,33000,28,118000,Null,Null,106443776,198555,8223
106452539,0.0,0.0,27193320,27193320,0,0,27193320,Null,Null,106452539,261521,7081
106457363,902.0,902.0,60000,33000,27000,45,60000,Null,Null,106457363,245945,2514
106457399,192.0,192.0,78000,39000,39000,50,78000,Null,Null,106457399,625265,28574
106458692,0.0,0.0,27193320,27193320,0,0,27193320,Null,Null,106458692,261521,7081
106460419,430.0,430.0,85000,62000,23000,27,85000,Null,Null,106460419,198557,11835
106460426,2432.0,2432.0,142000,117000,25000,18,142000,Null,Null,106460426,198555,8223
106460427,615.0,615.0,132000,109000,23000,17,132000,Null,Null,106460427,198555,8223
106460448,937.0,937.0,165000,135000,30000,18,165000,Null,Null,106460448,198555,11821
106502252,0.0,0.0,18700000,18700000,0,0,18700000,Null,Null,106502252,191611,12876
106502964,203.0,203.0,279000,279000,0,0,279000,Null,Null,106502964,245945,1883
106503541,363.0,363.0,155000,155000,0,0,155000,Null,Null,106503541,111461,1520
106541887,313.0,313.0,1000,1000,0,0,1000,Null,Null,106541887,111461,27240
106563599,1135.0,1135.0,89500,63000,26500,30,89500,Null,Null,106563599,19018,2488
106610513,344.0,344.0,370000,185000,185000,50,370000,Null,Null,106610513,3955813,23362
106633540,296.0,296.0,170000,170000,0,0,170000,Null,Null,106633540,4307205,23048
106660851,16.0,16.0,2500,2500,0,0,2500,Null,Null,106660851,111461,2
106677643,111.0,111.0,149000,74500,74500,50,149000,Null,Null,106677643,197767,2
106677814,912.0,912.0,58000,42340,15660,27,58000,Null,Null,106677814,197767,2
106685187,57.0,57.0,500000,239000,261000,52,500000,Null,Null,106685187,500047,2324
106693673,35.0,35.0,85000,85000,0,0,85000,Null,Null,106693673,111461,53190
106707718,249.0,249.0,59000,45000,14000,24,59000,Null,Null,106707718,230607,23052
106750551,44.0,44.0,300000,216000,84000,28,300000,Null,Null,106750551,3977923,1601
106750860,0.0,0.0,1806000,1806000,0,0,1806000,Null,Null,106750860,111461,2
106751688,1.0,1.0,2436000,2436000,0,0,2436000,Null,Null,106751688,111461,2
106751861,0.0,0.0,6000,6000,0,0,6000,Null,Null,106751861,111461,2
106806859,191.0,191.0,90000,90000,0,0,90000,Null,Null,106806859,111461,2
106887397,0.0,0.0,4000,4000,0,0,4000,Null,Null,106887397,111461,2
106887981,0.0,0.0,7000,7000,0,0,7000,Null,Null,106887981,111461,2
106888108,1.0,1.0,8000,8000,0,0,8000,Null,Null,106888108,111461,2
106897631,0.0,0.0,11290000,11290000,0,0,11290000,Null,Null,106897631,239655,8066
106944371,175.0,175.0,119000,65000,54000,45,119000,Null,Null,106944371,111461,2
106948536,0.0,0.0,16400000,16400000,0,0,16400000,Null,Null,106948536,217953,8073
106948794,1465.0,1465.0,15000,14250,750,5,15000,Null,Null,106948794,4269901,2363
106966720,18.0,18.0,999000,978000,21000,2,999000,Null,Null,106966720,841705,49722
106967507,0.0,0.0,14500000,14500000,0,0,14500000,Null,Null,106967507,111461,11935
106967509,0.0,0.0,29500000,29500000,0,0,29500000,Null,Null,106967509,111461,5905
106986071,0.0,0.0,13950000,13950000,0,0,13950000,Null,Null,106986071,111461,4429
106996271,295.0,295.0,120000,60000,60000,50,120000,Null,Null,106996271,111461,23228
107001648,1306.0,1306.0,18000,11000,7000,39,18000,Null,Null,107001648,360931,1601
107010419,104.0,104.0,375000,375000,0,0,375000,Null,Null,107010419,111461,27196
107016474,76.0,76.0,268200,149000,119200,44,268200,Null,Null,107016474,46703,2140
107017090,0.0,0.0,38500,38500,0,0,38500,Null,Null,107017090,111461,3428
107018677,6.0,6.0,560000,560000,0,0,560000,Null,Null,107018677,4987049,26652
107034286,122.0,122.0,44000,44000,0,0,44000,Null,Null,107034286,111461,27128
107034732,92.0,92.0,55000,53900,1100,2,55000,Null,Null,107034732,21653,12294
107048058,5.0,5.0,399000,399000,0,0,399000,Null,Null,107048058,111461,15318
107063648,494.0,494.0,227000,227000,0,0,227000,Null,Null,107063648,48077,3177
107066821,61.0,61.0,150000,86000,64000,43,150000,Null,Null,107066821,21653,28458
107067035,140.0,140.0,118000,118000,0,0,118000,Null,Null,107067035,18845,1820
107071890,1005.0,1005.0,144045,144045,0,0,144045,Null,Null,107071890,111461,1831
107076506,0.0,0.0,19000,19000,0,0,19000,Null,Null,107076506,111461,2
107125590,0.0,0.0,58391450,58391450,0,0,58391450,Null,Null,107125590,111461,23238
107126696,565.0,565.0,309000,283000,26000,8,309000,Null,Null,107126696,46335,1634
107144886,754.0,754.0,15000,9000,6000,40,15000,Null,Null,107144886,886923,8305
107145017,639.0,639.0,245000,225000,20000,8,245000,Null,Null,107145017,46335,1634
107181651,187.0,187.0,399000,399000,0,0,399000,Null,Null,107181651,4988569,8170
107182623,6.0,6.0,1199999,1199999,0,0,1199999,Null,Null,107182623,276247,8066
107182863,0.0,0.0,48122750,48122750,0,0,48122750,Null,Null,107182863,111461,23238
107195030,42.0,42.0,199000,199000,0,0,199000,Null,Null,107195030,111461,4428
107212113,0.0,0.0,12590000,12590000,0,0,12590000,Null,Null,107212113,74999,11516
107212387,0.0,0.0,6000,6000,0,0,6000,Null,Null,107212387,111461,2
107212415,0.0,0.0,5000,5000,0,0,5000,Null,Null,107212415,111461,2
107212510,0.0,0.0,14399,14399,0,0,14399,Null,Null,107212510,111461,2
107212654,0.0,0.0,2000,2000,0,0,2000,Null,Null,107212654,111461,2
107212841,7.0,7.0,9000,9000,0,0,9000,Null,Null,107212841,111461,2
107223590,210.0,210.0,139000,139000,0,0,139000,Null,Null,107223590,25422,1634
107247345,10.0,10.0,75000,55000,20000,27,75000,Null,Null,107247345,232807,5566
107250585,0.0,0.0,31290000,19990000,11300000,36,31290000,Null,Null,107250585,634871,2340
107323260,225.0,225.0,132800,132800,0,0,132800,Null,Null,107323260,199937,8223
107327260,0.0,0.0,31030000,31030000,0,0,31030000,Null,Null,107327260,180151,28860
107330873,0.0,0.0,56000000,56000000,0,0,56000000,Null,Null,107330873,111461,2324
107330957,3.0,3.0,40000,40000,0,0,40000,Null,Null,107330957,111461,15320
107332431,0.0,0.0,12499,12499,0,0,12499,Null,Null,107332431,111461,15318
107338360,25.0,25.0,122000,122000,0,0,122000,Null,Null,107338360,4958627,1831
107338468,4141.0,4141.0,2500,2500,0,0,2500,Null,Null,107338468,111461,53074
107338668,8.0,8.0,1360000,1360000,0,0,1360000,Null,Null,107338668,111461,49724
107348050,58.0,58.0,565000,350000,215000,38,565000,Null,Null,107348050,111461,7449
107351106,814.0,814.0,50000,30000,20000,40,50000,Null,Null,107351106,4971657,4428
107352978,20.0,20.0,10000,10000,0,0,10000,Null,Null,107352978,111461,49726
107355310,49.0,49.0,1500000,970000,530000,35,1500000,Null,Null,107355310,160667,28596
107361498,3.0,3.0,13500,13500,0,0,13500,Null,Null,107361498,111461,49726
107361617,2.0,2.0,10000,10000,0,0,10000,Null,Null,107361617,111461,49726
107362350,256.0,256.0,238000,195000,43000,18,238000,Null,Null,107362350,21651,12908
107370384,26.0,26.0,69000,62000,7000,10,69000,Null,Null,107370384,21653,12908
107371000,11.0,11.0,28000,17000,11000,39,28000,Null,Null,107371000,111461,15320
107391832,271.0,271.0,30000,23000,7000,23,30000,Null,Null,107391832,836453,1819
107392773,75.0,75.0,25000,25000,0,0,25000,Null,Null,107392773,288231,5450
107407481,6.0,6.0,10882000,7773000,3109000,29,10882000,Null,Null,107407481,26150,8513
107426395,245.0,245.0,13900,13900,0,0,13900,Null,Null,107426395,288231,5450
107449847,42.0,42.0,59000,59000,0,0,59000,Null,Null,107449847,257333,28484
107471516,10.0,10.0,230450,209500,20950,9,230450,Null,Null,107471516,20954,26652
107480536,7.0,7.0,13999,13999,0,0,13999,Null,Null,107480536,111461,49726
107493533,5.0,5.0,9000,9000,0,0,9000,Null,Null,107493533,111461,2
107530440,17.0,17.0,1140000,849000,291000,26,1140000,Null,Null,107530440,26150,8513
107542998,4.0,4.0,28000,28000,0,0,28000,Null,Null,107542998,111461,15250
107543006,24.0,24.0,32000,32000,0,0,32000,Null,Null,107543006,111461,15236
107543097,3.0,3.0,14000,14000,0,0,14000,Null,Null,107543097,111461,15236
107543099,13.0,13.0,15000,15000,0,0,15000,Null,Null,107543099,111461,2
107543133,5.0,5.0,15000,15000,0,0,15000,Null,Null,107543133,111461,2
107543192,323.0,323.0,15000,15000,0,0,15000,Null,Null,107543192,111461,15236
107543345,31.0,31.0,21000,21000,0,0,21000,Null,Null,107543345,111461,15250
107543454,1.0,1.0,35000,35000,0,0,35000,Null,Null,107543454,111461,15236
107543475,129.0,129.0,28000,28000,0,0,28000,Null,Null,107543475,111461,15236
107556458,8.0,8.0,99000,99000,0,0,99000,Null,Null,107556458,111461,2
107570883,0.0,0.0,18000,18000,0,0,18000,Null,Null,107570883,111461,2
107582973,0.0,0.0,13000,13000,0,0,13000,Null,Null,107582973,111461,2
107583335,0.0,0.0,11000,11000,0,0,11000,Null,Null,107583335,111461,2
107583412,0.0,0.0,13000,13000,0,0,13000,Null,Null,107583412,111461,2
107583424,0.0,0.0,17000,17000,0,0,17000,Null,Null,107583424,111461,2
107605659,0.0,0.0,2200,2200,0,0,2200,Null,Null,107605659,111461,23082
107613922,4.0,4.0,6000,6000,0,0,6000,Null,Null,107613922,111461,2
107616006,13.0,13.0,9000,9000,0,0,9000,Null,Null,107616006,111461,2
107616160,25.0,25.0,5000,5000,0,0,5000,Null,Null,107616160,111461,2
107713002,311.0,311.0,53000,42400,10600,20,53000,Null,Null,107713002,4433917,53074
107723929,0.0,0.0,9000000,9000000,0,0,9000000,Null,Null,107723929,4973085,11939
107761837,1.0,1.0,12785714,8950000,3835714,30,12785714,Null,Null,107761837,405211,8511
107761995,0.0,0.0,12785714,8950000,3835714,30,12785714,Null,Null,107761995,405211,8511
107780600,102.0,102.0,249000,199000,50000,20,249000,Null,Null,107780600,21651,12294
107791749,557.0,557.0,2000,2000,0,0,2000,Null,Null,107791749,111461,49728
107884349,35.0,35.0,4000,4000,0,0,4000,Null,Null,107884349,111461,7064
107886300,105.0,105.0,565000,350000,215000,38,565000,Null,Null,107886300,111461,7449
107892763,0.0,0.0,2000,2000,0,0,2000,Null,Null,107892763,111461,23042
107959904,3.0,3.0,1999000,1980000,19000,1,1999000,Null,Null,107959904,841705,49722
107961495,1500.0,1500.0,263000,162000,101000,38,263000,Null,Null,107961495,48077,3177
107961500,5482.0,5482.0,217000,117000,100000,46,217000,Null,Null,107961500,48077,3177
107970675,472.0,472.0,35000,35000,0,0,35000,Null,Null,107970675,208677,8308
107985508,693.0,693.0,687000,515000,172000,25,687000,Null,Null,107985508,238861,7061
108042666,42.0,42.0,17000,17000,0,0,17000,Null,Null,108042666,111461,2
108043024,4.0,4.0,19000,19000,0,0,19000,Null,Null,108043024,111461,2
108043550,0.0,0.0,15000,15000,0,0,15000,Null,Null,108043550,111461,2
108043633,4.0,4.0,14000,14000,0,0,14000,Null,Null,108043633,111461,2
108043736,1.0,1.0,12000,12000,0,0,12000,Null,Null,108043736,111461,2
108043864,0.0,0.0,14000,14000,0,0,14000,Null,Null,108043864,111461,2
108044022,1.0,1.0,10000,10000,0,0,10000,Null,Null,108044022,111461,2
108044023,5.0,5.0,15000,15000,0,0,15000,Null,Null,108044023,111461,2
108044058,0.0,0.0,12000,12000,0,0,12000,Null,Null,108044058,111461,2
108044539,0.0,0.0,99000,99000,0,0,99000,Null,Null,108044539,111461,2
108044830,1.0,1.0,18000,18000,0,0,18000,Null,Null,108044830,111461,2
108045121,0.0,0.0,12000,12000,0,0,12000,Null,Null,108045121,111461,2
108045156,7.0,7.0,12000,12000,0,0,12000,Null,Null,108045156,111461,2
108045270,0.0,0.0,18000,18000,0,0,18000,Null,Null,108045270,111461,2
108045718,0.0,0.0,140000,140000,0,0,140000,Null,Null,108045718,111461,2
108045847,1.0,1.0,120000,120000,0,0,120000,Null,Null,108045847,111461,2
108046548,2.0,2.0,75000,75000,0,0,75000,Null,Null,108046548,111461,2
108046784,0.0,0.0,16000,16000,0,0,16000,Null,Null,108046784,111461,2
108046877,0.0,0.0,12000,12000,0,0,12000,Null,Null,108046877,111461,2
108047371,0.0,0.0,16000,16000,0,0,16000,Null,Null,108047371,111461,2
108047528,0.0,0.0,7000,7000,0,0,7000,Null,Null,108047528,111461,2
108048216,27.0,27.0,49500,49500,0,0,49500,Null,Null,108048216,111461,2
108048319,0.0,0.0,15000,15000,0,0,15000,Null,Null,108048319,111461,2
108048619,1.0,1.0,14000,14000,0,0,14000,Null,Null,108048619,111461,2
108072274,111.0,111.0,1000,1000,0,0,1000,Null,Null,108072274,111461,2
108072566,25.0,25.0,13000,6500,6500,50,13000,Null,Null,108072566,111461,2
108072657,76.0,76.0,1000,1000,0,0,1000,Null,Null,108072657,111461,2
108091670,112.0,112.0,99000,69000,30000,30,99000,Null,Null,108091670,4884089,23340
108131005,4.0,4.0,35000,35000,0,0,35000,Null,Null,108131005,111461,15250
108131479,5.0,5.0,28000,28000,0,0,28000,Null,Null,108131479,111461,15250
108131613,12.0,12.0,59000,59000,0,0,59000,Null,Null,108131613,111461,15250
108133038,83.0,83.0,19000,19000,0,0,19000,Null,Null,108133038,111461,15250
108175157,23.0,23.0,2000,2000,0,0,2000,Null,Null,108175157,111461,53074
108179037,1.0,1.0,385000,385000,0,0,385000,Null,Null,108179037,111443,1815
108179794,419.0,419.0,740000,740000,0,0,740000,Null,Null,108179794,64932,17170
108183516,53.0,53.0,390000,390000,0,0,390000,Null,Null,108183516,111461,23436
108207076,134.0,134.0,260000,170000,90000,35,260000,Null,Null,108207076,243693,3805
108207178,47.0,47.0,285000,187000,98000,34,285000,Null,Null,108207178,243693,3804
108213211,0.0,0.0,14400,14400,0,0,14400,Null,Null,108213211,4417079,2
108213875,0.0,0.0,11999998,11999998,0,0,11999998,Null,Null,108213875,4417079,2
108214163,0.0,0.0,11999998,11999998,0,0,11999998,Null,Null,108214163,4417079,15250
108214731,0.0,0.0,11999998,11999998,0,0,11999998,Null,Null,108214731,4417079,15250
108215068,0.0,0.0,11999998,11999998,0,0,11999998,Null,Null,108215068,4417079,15250
108215326,5.0,5.0,2400,2400,0,0,2400,Null,Null,108215326,4417079,2
108220448,232.0,232.0,6400,6400,0,0,6400,Null,Null,108220448,111461,8167
108223225,0.0,0.0,12999000,12999000,0,0,12999000,Null,Null,108223225,4729325,15320
108226993,0.0,0.0,31599000,31599000,0,0,31599000,Null,Null,108226993,4729325,15320
108229718,0.0,0.0,20799000,20799000,0,0,20799000,Null,Null,108229718,4729325,15320
108229793,0.0,0.0,35999000,35999000,0,0,35999000,Null,Null,108229793,4729325,15320
108233467,0.0,0.0,74900000,74900000,0,0,74900000,Null,Null,108233467,111461,23678
108237810,0.0,0.0,54900000,54900000,0,0,54900000,Null,Null,108237810,111461,27214
108243510,475.0,475.0,370000,311000,59000,16,370000,Null,Null,108243510,41048,1984
108249851,0.0,0.0,20000000,20000000,0,0,20000000,Null,Null,108249851,433227,2340
108351269,118.0,118.0,198000,129000,69000,35,198000,Null,Null,108351269,625265,28574
108432888,1.0,1.0,45000,45000,0,0,45000,Null,Null,108432888,505165,15318
108517547,0.0,0.0,3706000,3706000,0,0,3706000,Null,Null,108517547,5000771,8172
108535034,1.0,1.0,8990000,6999000,1991000,22,8990000,Null,Null,108535034,204665,2340
108535195,273.0,273.0,120000,78000,42000,35,120000,Null,Null,108535195,22095,1630
108535196,671.0,671.0,135000,69000,66000,49,135000,Null,Null,108535196,22095,1630
108535197,238.0,238.0,85000,85000,0,0,85000,Null,Null,108535197,22095,1630
108535200,114.0,114.0,120000,85000,35000,29,120000,Null,Null,108535200,22095,1630
108535201,88.0,88.0,120000,69000,51000,43,120000,Null,Null,108535201,22095,1630
108535211,338.0,338.0,120000,73000,47000,39,120000,Null,Null,108535211,22095,1630
108535212,93.0,93.0,150000,85000,65000,43,150000,Null,Null,108535212,22095,1630
108535216,1006.0,1006.0,35000,29000,6000,17,35000,Null,Null,108535216,22095,1630
108535222,89.0,89.0,100000,75000,25000,25,100000,Null,Null,108535222,22095,1630
108535223,553.0,553.0,120000,78000,42000,35,120000,Null,Null,108535223,22095,1630
108535228,17.0,17.0,167978,167978,0,0,167978,Null,Null,108535228,22095,1631
108535241,97.0,97.0,120000,76000,44000,37,120000,Null,Null,108535241,22095,1630
108535251,1385.0,1385.0,300000,218000,82000,27,300000,Null,Null,108535251,22095,1630
108535259,122.0,122.0,120000,85000,35000,29,120000,Null,Null,108535259,22095,1630
108564654,24.0,24.0,3600000,3600000,0,0,3600000,Null,Null,108564654,111461,8172
108585358,428.0,428.0,85000,85000,0,0,85000,Null,Null,108585358,309775,1627
108605078,800.0,800.0,30600,17000,13600,44,30600,Null,Null,108605078,46703,2153
108632794,0.0,0.0,9000,9000,0,0,9000,Null,Null,108632794,111461,2
108633882,67.0,67.0,319000,239000,80000,25,319000,Null,Null,108633882,21651,1815
108675965,0.0,0.0,23062000,23062000,0,0,23062000,Null,Null,108675965,112888,7079
108685236,0.0,0.0,4999000,3499000,1500000,30,4999000,Null,Null,108685236,204665,2340
108695061,0.0,0.0,24999000,14999000,10000000,40,24999000,Null,Null,108695061,204665,2340
108695128,0.0,0.0,21187500,21187500,0,0,21187500,Null,Null,108695128,112888,11516
108695215,206.0,206.0,49000,39000,10000,20,49000,Null,Null,108695215,111461,20910
108712213,0.0,0.0,120000,105000,15000,13,120000,Null,Null,108712213,21653,5006
108732479,8.0,8.0,405000,405000,0,0,405000,Null,Null,108732479,111461,6305
108753341,243.0,243.0,219000,195000,24000,11,219000,Null,Null,108753341,21651,12908
108771828,263.0,263.0,99000,59000,40000,40,99000,Null,Null,108771828,4698843,8602
108777387,0.0,0.0,1017000,957000,60000,6,1017000,Null,Null,108777387,150215,8227
108830964,446.0,446.0,135000,126000,9000,7,135000,Null,Null,108830964,21271,11835
108843853,7.0,7.0,8000,8000,0,0,8000,Null,Null,108843853,111461,2
108843896,29.0,29.0,5000,5000,0,0,5000,Null,Null,108843896,111461,20254
108843982,0.0,0.0,4999,4999,0,0,4999,Null,Null,108843982,111461,2
108844006,22.0,22.0,5000,5000,0,0,5000,Null,Null,108844006,111461,28434
108844017,6.0,6.0,7500,7500,0,0,7500,Null,Null,108844017,111461,20254
108844042,0.0,0.0,8000,8000,0,0,8000,Null,Null,108844042,111461,2
108844043,0.0,0.0,8000,8000,0,0,8000,Null,Null,108844043,111461,20254
108844063,0.0,0.0,6199,6199,0,0,6199,Null,Null,108844063,111461,2
108844172,0.0,0.0,5000,5000,0,0,5000,Null,Null,108844172,111461,20254
108844214,0.0,0.0,8000,8000,0,0,8000,Null,Null,108844214,111461,2
108844557,10.0,10.0,8999,8999,0,0,8999,Null,Null,108844557,111461,2
108844629,3.0,3.0,8000,8000,0,0,8000,Null,Null,108844629,111461,20254
108844670,0.0,0.0,8000,8000,0,0,8000,Null,Null,108844670,111461,20254
108844754,8.0,8.0,8000,8000,0,0,8000,Null,Null,108844754,111461,2
108844797,5.0,5.0,8000,8000,0,0,8000,Null,Null,108844797,111461,20254
108845043,6.0,6.0,6000,6000,0,0,6000,Null,Null,108845043,111461,20254
108845055,0.0,0.0,8000,8000,0,0,8000,Null,Null,108845055,111461,2
108845065,0.0,0.0,8000,8000,0,0,8000,Null,Null,108845065,111461,20254
108845293,0.0,0.0,2500,2500,0,0,2500,Null,Null,108845293,111461,2
108845492,0.0,0.0,8000,8000,0,0,8000,Null,Null,108845492,111461,20254
108845507,1.0,1.0,4999,4999,0,0,4999,Null,Null,108845507,111461,2
108845514,0.0,0.0,6000,6000,0,0,6000,Null,Null,108845514,111461,20254
108845518,117.0,117.0,8000,8000,0,0,8000,Null,Null,108845518,111461,20254
108845524,28.0,28.0,8000,8000,0,0,8000,Null,Null,108845524,111461,20254
108845532,37.0,37.0,65000,65000,0,0,65000,Null,Null,108845532,111461,20258
108845547,3.0,3.0,5000,5000,0,0,5000,Null,Null,108845547,111461,20252
108845565,13.0,13.0,5000,5000,0,0,5000,Null,Null,108845565,111461,2
108845605,5.0,5.0,8000,8000,0,0,8000,Null,Null,108845605,111461,2
108879823,366.0,366.0,300000,198000,102000,34,300000,Null,Null,108879823,4011099,53054
108880372,0.0,0.0,308000,308000,0,0,308000,Null,Null,108880372,111461,1815
108883219,0.0,0.0,29700000,29700000,0,0,29700000,Null,Null,108883219,111461,8171
108885038,0.0,0.0,16290000,16290000,0,0,16290000,Null,Null,108885038,239655,8066
108888644,0.0,0.0,11390000,11390000,0,0,11390000,Null,Null,108888644,239655,8066
108895758,0.0,0.0,16752000,16752000,0,0,16752000,Null,Null,108895758,153444,7079
108905156,0.0,0.0,22509000,22509000,0,0,22509000,Null,Null,108905156,153444,7079
108907881,3.0,3.0,220000,220000,0,0,220000,Null,Null,108907881,111461,15318
108911757,0.0,0.0,6840000,6840000,0,0,6840000,Null,Null,108911757,112921,5385
108918404,443.0,443.0,100000,100000,0,0,100000,Null,Null,108918404,111461,23346
108918875,3.0,3.0,18000,9000,9000,50,18000,Null,Null,108918875,4647777,15318
108930132,29.0,29.0,2790000,2790000,0,0,2790000,Null,Null,108930132,18802,8400
108937844,8.0,8.0,2500,2500,0,0,2500,Null,Null,108937844,111461,23082
108938147,9.0,9.0,17000,17000,0,0,17000,Null,Null,108938147,111461,15318
108938503,0.0,0.0,11699000,11699000,0,0,11699000,Null,Null,108938503,298899,28862
108939230,2.0,2.0,80000,72000,8000,10,80000,Null,Null,108939230,111461,15320
108945309,0.0,0.0,578998,578998,0,0,578998,Null,Null,108945309,21651,28460
108945995,497.0,497.0,1781,1781,0,0,1781,Null,Null,108945995,111461,6742
108946565,33.0,33.0,29000,29000,0,0,29000,Null,Null,108946565,111461,8194
108952534,438.0,438.0,549000,253000,296000,54,549000,Null,Null,108952534,302375,28454
108952839,35.0,35.0,44300,44300,0,0,44300,Null,Null,108952839,111461,2
108952873,57.0,57.0,3000,3000,0,0,3000,Null,Null,108952873,111461,20222
108952905,0.0,0.0,4000,4000,0,0,4000,Null,Null,108952905,111461,1819
108952963,9.0,9.0,3000,3000,0,0,3000,Null,Null,108952963,111461,1819
108953353,2.0,2.0,8000,8000,0,0,8000,Null,Null,108953353,111461,2
108953457,10.0,10.0,9000,9000,0,0,9000,Null,Null,108953457,111461,2
108953782,15.0,15.0,9000,9000,0,0,9000,Null,Null,108953782,111461,2
108953825,0.0,0.0,6000,6000,0,0,6000,Null,Null,108953825,111461,2
108953999,2.0,2.0,6000,6000,0,0,6000,Null,Null,108953999,111461,2
108954069,30.0,30.0,7000,7000,0,0,7000,Null,Null,108954069,111461,2
108954136,1.0,1.0,6000,6000,0,0,6000,Null,Null,108954136,111461,2
108954162,1.0,1.0,7000,7000,0,0,7000,Null,Null,108954162,111461,20244
108954452,7.0,7.0,9000,9000,0,0,9000,Null,Null,108954452,111461,28736
108954467,7.0,7.0,6000,6000,0,0,6000,Null,Null,108954467,111461,2
108954471,0.0,0.0,8000,8000,0,0,8000,Null,Null,108954471,111461,2
108954500,1.0,1.0,6000,6000,0,0,6000,Null,Null,108954500,111461,2
108954696,1.0,1.0,7000,7000,0,0,7000,Null,Null,108954696,111461,2
108954810,0.0,0.0,3000,3000,0,0,3000,Null,Null,108954810,111461,2
108954840,2.0,2.0,9000,9000,0,0,9000,Null,Null,108954840,111461,2
108964574,0.0,0.0,2000,2000,0,0,2000,Null,Null,108964574,111461,23168
108966360,1.0,1.0,7566,6582,984,13,7566,Null,Null,108966360,111461,13878
108988982,0.0,0.0,0,768000,512000,0,768000,Null,Null,108988982,4246951,0
108999256,0.0,0.0,17599000,17599000,0,0,17599000,Null,Null,108999256,111461,2340
108999637,394.0,394.0,250000,230000,20000,8,250000,Null,Null,108999637,407203,23246
109026622,7.0,7.0,2550,2550,0,0,2550,Null,Null,109026622,111461,2
109062324,0.0,0.0,8500000,8500000,0,0,8500000,Null,Null,109062324,17856,8172
109062368,0.0,0.0,13900000,13900000,0,0,13900000,Null,Null,109062368,197443,8172
109062423,0.0,0.0,9050000,9050000,0,0,9050000,Null,Null,109062423,197443,8172
109062484,1.0,1.0,13500000,13500000,0,0,13500000,Null,Null,109062484,197443,8172
109062487,0.0,0.0,19990000,19990000,0,0,19990000,Null,Null,109062487,85871,2
109062525,0.0,0.0,19800000,19800000,0,0,19800000,Null,Null,109062525,5160035,2
109062527,0.0,0.0,13950000,13950000,0,0,13950000,Null,Null,109062527,197443,2
109069267,235.0,235.0,1200000,999000,201000,17,1200000,Null,Null,109069267,33203,2340
109070194,357.0,357.0,700000,590000,110000,16,700000,Null,Null,109070194,33203,8170
109070200,0.0,0.0,21230000,21230000,0,0,21230000,Null,Null,109070200,4507657,7079
109070253,292.0,292.0,1020000,879000,141000,14,1020000,Null,Null,109070253,33203,8171
109074666,4.0,4.0,2000,2000,0,0,2000,Null,Null,109074666,111461,53058
109088549,51.0,51.0,389000,389000,0,0,389000,Null,Null,109088549,18984,3428
109110176,55.0,55.0,599000,599000,0,0,599000,Null,Null,109110176,162007,2324
109135965,8.0,8.0,99000,97000,2000,2,99000,Null,Null,109135965,21653,20174
109160181,53.0,53.0,25600,25600,0,0,25600,Null,Null,109160181,111461,2
109161342,57.0,57.0,429000,429000,0,0,429000,Null,Null,109161342,111461,23282
109177065,0.0,0.0,5750000,5750000,0,0,5750000,Null,Null,109177065,5009361,11869
109177267,0.0,0.0,5500000,5500000,0,0,5500000,Null,Null,109177267,5009361,11871
109214551,1036.0,1036.0,45000,37000,8000,18,45000,Null,Null,109214551,111461,1831
109226629,800.0,800.0,75000,75000,0,0,75000,Null,Null,109226629,111461,5454
109230528,20.0,20.0,2500,2000,500,20,2500,Null,Null,109230528,111461,2
109260690,115.0,115.0,7000,7000,0,0,7000,Null,Null,109260690,111461,2153
109266409,17.0,17.0,49000,45000,4000,8,49000,Null,Null,109266409,159173,8206
109266735,165.0,165.0,180000,90000,90000,50,180000,Null,Null,109266735,111461,1752
109266761,225.0,225.0,160000,80000,80000,50,160000,Null,Null,109266761,208105,13878
109267785,594.0,594.0,6490000,5350000,1140000,18,6490000,Null,Null,109267785,18641,8400
109269135,8.0,8.0,8900,8900,0,0,8900,Null,Null,109269135,111461,1831
109296367,417.0,417.0,1219000,802000,417000,34,1219000,Null,Null,109296367,238861,7061
109297988,609.0,609.0,138000,125000,13000,9,138000,Null,Null,109297988,354595,17162
109299276,55.0,55.0,3778950,2855000,923950,24,3778950,Null,Null,109299276,112614,2657
109302015,759.0,759.0,138000,125000,13000,9,138000,Null,Null,109302015,46335,17162
109331371,0.0,0.0,5900000,5900000,0,0,5900000,Null,Null,109331371,5012865,8172
109351669,283.0,283.0,2190000,1089000,1101000,50,2190000,Null,Null,109351669,851519,23658
109358289,0.0,0.0,225000,215000,10000,4,225000,Null,Null,109358289,111461,23588
109393113,3676.0,3676.0,500000,280000,220000,44,500000,Null,Null,109393113,500047,5531
109393382,35.0,35.0,150000,75000,75000,50,150000,Null,Null,109393382,21653,5006
109396735,270.0,270.0,4900,4900,0,0,4900,Null,Null,109396735,111461,28434
109403886,59.0,59.0,250000,188000,62000,25,250000,Null,Null,109403886,500047,28458
109434830,23.0,23.0,45000,45000,0,0,45000,Null,Null,109434830,21653,5007
109439430,173.0,173.0,1999000,1419000,580000,29,1999000,Null,Null,109439430,18984,2324
109454357,211.0,211.0,550000,349000,201000,37,550000,Null,Null,109454357,201773,11853
109455098,216.0,216.0,129000,129000,0,0,129000,Null,Null,109455098,21651,5006
109468955,278.0,278.0,29000,29000,0,0,29000,Null,Null,109468955,549763,3877
109487942,5.0,5.0,907000,678000,229000,25,907000,Null,Null,109487942,26150,8511
109492015,61.0,61.0,9000,9000,0,0,9000,Null,Null,109492015,111461,2
109521493,2.0,2.0,3000000,3000000,0,0,3000000,Null,Null,109521493,450333,7079
109573179,74.0,74.0,491200,343840,147360,30,491200,Null,Null,109573179,111461,1836
109573808,19.0,19.0,190000,190000,0,0,190000,Null,Null,109573808,21653,28738
109573950,0.0,0.0,13000,13000,0,0,13000,Null,Null,109573950,111461,1819
109580084,0.0,0.0,8200000,8200000,0,0,8200000,Null,Null,109580084,5017349,8172
109601744,14.0,14.0,169000,169000,0,0,169000,Null,Null,109601744,111461,1815
109602493,0.0,0.0,9000,9000,0,0,9000,Null,Null,109602493,111461,2
109652081,424.0,424.0,165000,135000,30000,18,165000,Null,Null,109652081,79682,11835
109654810,1021.0,1021.0,169000,169000,0,0,169000,Null,Null,109654810,520061,1883
109661901,0.0,0.0,21200000,21200000,0,0,21200000,Null,Null,109661901,5023565,15236
109662694,16.0,16.0,1000,1000,0,0,1000,Null,Null,109662694,111461,2
109691576,185.0,185.0,590000,370000,220000,37,590000,Null,Null,109691576,853799,5905
109788575,199.0,199.0,266400,266400,0,0,266400,Null,Null,109788575,4603561,2153
109792185,30.0,30.0,38416,38416,0,0,38416,Null,Null,109792185,111461,27128
109816878,76.0,76.0,775000,399000,376000,49,775000,Null,Null,109816878,454327,1583
109847479,2.0,2.0,42900,42900,0,0,42900,Null,Null,109847479,111461,2234
109853422,15.0,15.0,7900,7900,0,0,7900,Null,Null,109853422,111461,49724
109853462,0.0,0.0,4900,4900,0,0,4900,Null,Null,109853462,111461,28480
109853741,250.0,250.0,9900,9900,0,0,9900,Null,Null,109853741,111461,2
109854689,317.0,317.0,520000,260000,260000,50,520000,Null,Null,109854689,3955813,23362
109860479,0.0,0.0,15899000,15899000,0,0,15899000,Null,Null,109860479,20215,28862
109888350,146.0,146.0,300000,199000,101000,34,300000,Null,Null,109888350,21653,28460
109889031,20.0,20.0,224900,219000,5900,3,224900,Null,Null,109889031,111461,1815
109889147,0.0,0.0,137000,137000,0,0,137000,Null,Null,109889147,111461,2
109889661,207.0,207.0,149000,149000,0,0,149000,Null,Null,109889661,111461,1815
109889972,33.0,33.0,79000,79000,0,0,79000,Null,Null,109889972,111461,2
109924300,0.0,0.0,12000000,12000000,0,0,12000000,Null,Null,109924300,111461,8073
109924334,0.0,0.0,19530000,19530000,0,0,19530000,Null,Null,109924334,111461,2
109924450,0.0,0.0,14490000,14490000,0,0,14490000,Null,Null,109924450,111461,2
109954438,266.0,266.0,189000,168000,21000,11,189000,Null,Null,109954438,238407,8217
109955439,20.0,20.0,3899,3899,0,0,3899,Null,Null,109955439,111461,6742
109961411,347.0,347.0,80000,39000,41000,51,80000,Null,Null,109961411,500047,28428
109974650,0.0,0.0,1582,1582,0,0,1582,Null,Null,109974650,111461,2
109991873,5.0,5.0,2000,2000,0,0,2000,Null,Null,109991873,111461,2
109991914,2.0,2.0,1300,1300,0,0,1300,Null,Null,109991914,111461,23282
110001215,30.0,30.0,11410,11410,0,0,11410,Null,Null,110001215,111461,2
110050758,0.0,0.0,92800000,92800000,0,0,92800000,Null,Null,110050758,111461,23576
110053631,0.0,0.0,17990000,17990000,0,0,17990000,Null,Null,110053631,111461,2340
110056427,0.0,0.0,175500000,175500000,0,0,175500000,Null,Null,110056427,111461,23576
110057190,0.0,0.0,101500000,101500000,0,0,101500000,Null,Null,110057190,111461,23576
110058312,0.0,0.0,101500000,101500000,0,0,101500000,Null,Null,110058312,111461,23576
110059125,0.0,0.0,134500000,134500000,0,0,134500000,Null,Null,110059125,111461,23576
110069156,0.0,0.0,18680000,18680000,0,0,18680000,Null,Null,110069156,111461,2340
110091973,74.0,74.0,1399000,1399000,0,0,1399000,Null,Null,110091973,154910,2324
110113411,252.0,252.0,149000,149000,0,0,149000,Null,Null,110113411,111461,1883
110152488,264.0,264.0,179000,179000,0,0,179000,Null,Null,110152488,111461,28598
110153980,63.0,63.0,139000,139000,0,0,139000,Null,Null,110153980,21651,5006
110169574,621.0,621.0,99000,70000,29000,29,99000,Null,Null,110169574,4958627,1831
110179459,0.0,0.0,898000,898000,0,0,898000,Null,Null,110179459,111461,23622
110186079,467.0,467.0,289000,139000,150000,52,289000,Null,Null,110186079,505907,12294
110197819,3.0,3.0,2500,2500,0,0,2500,Null,Null,110197819,111461,2
110199541,0.0,0.0,16500000,16500000,0,0,16500000,Null,Null,110199541,167287,20170
110200605,84.0,84.0,1799,1799,0,0,1799,Null,Null,110200605,111461,2
110200611,22.0,22.0,1499,1499,0,0,1499,Null,Null,110200611,111461,2
110255019,671.0,671.0,858500,545000,313500,37,858500,Null,Null,110255019,505907,28616
110264899,0.0,0.0,9680000,9680000,0,0,9680000,Null,Null,110264899,111461,2340
110317052,0.0,0.0,60000,36000,24000,40,60000,Null,Null,110317052,111461,3179
110317221,0.0,0.0,20000000,20000000,0,0,20000000,Null,Null,110317221,111461,2340
110368218,237.0,237.0,379000,289000,90000,24,379000,Null,Null,110368218,4629801,2971
110377780,65.0,65.0,9900,9900,0,0,9900,Null,Null,110377780,561415,10218
110378189,0.0,0.0,47000,47000,0,0,47000,Null,Null,110378189,111461,2
110378685,64.0,64.0,24150,24150,0,0,24150,Null,Null,110378685,561415,8167
110378994,7.0,7.0,4444,4444,0,0,4444,Null,Null,110378994,111461,2
110444299,21.0,21.0,1566,1566,0,0,1566,Null,Null,110444299,111461,28470
110444501,5.0,5.0,3132,3132,0,0,3132,Null,Null,110444501,111461,2
110444731,1.0,1.0,8352,8352,0,0,8352,Null,Null,110444731,111461,28484
110446025,0.0,0.0,12530000,8950000,3580000,29,12530000,Null,Null,110446025,405211,8512
110447417,0.0,0.0,12530000,8950000,3580000,29,12530000,Null,Null,110447417,405211,8512
110462470,4.0,4.0,19000,19000,0,0,19000,Null,Null,110462470,111461,23322
110465849,2.0,2.0,4740000,3950000,790000,17,4740000,Null,Null,110465849,405211,8512
110564196,296.0,296.0,70000,55000,15000,21,70000,Null,Null,110564196,836453,2514
110593554,0.0,0.0,52500000,52500000,0,0,52500000,Null,Null,110593554,167287,20170
110594106,0.0,0.0,57500000,57500000,0,0,57500000,Null,Null,110594106,167287,20170
110778585,0.0,0.0,15000,15000,0,0,15000,Null,Null,110778585,111461,15318
110779104,12.0,12.0,2000,2000,0,0,2000,Null,Null,110779104,111461,2
110782903,24.0,24.0,192000,192000,0,0,192000,Null,Null,110782903,111461,2234
110786512,0.0,0.0,1398000,1398000,0,0,1398000,Null,Null,110786512,111461,2
110793119,0.0,0.0,9690000,9690000,0,0,9690000,Null,Null,110793119,111461,2340
110801494,0.0,0.0,8890000,6350000,2540000,29,8890000,Null,Null,110801494,732431,8511
110816413,13.0,13.0,149000,149000,0,0,149000,Null,Null,110816413,111461,49722
110850007,95.0,95.0,96000,96000,0,0,96000,Null,Null,110850007,111454,4428
110868875,61.0,61.0,190000,190000,0,0,190000,Null,Null,110868875,111461,49722
110874880,0.0,0.0,90000000,90000000,0,0,90000000,Null,Null,110874880,111461,23576
110881729,0.0,0.0,10290000,7350000,2940000,29,10290000,Null,Null,110881729,405211,8511
110881975,0.0,0.0,10290000,7350000,2940000,29,10290000,Null,Null,110881975,405211,8512
110884480,0.0,0.0,10290000,7350000,2940000,29,10290000,Null,Null,110884480,405211,8512
110885132,0.0,0.0,8190000,5850000,2340000,29,8190000,Null,Null,110885132,405211,8512
110927664,188.0,188.0,105000,105000,0,0,105000,Null,Null,110927664,111461,11803
110948021,489.0,489.0,330000,249000,81000,25,330000,Null,Null,110948021,111454,4428
110953681,0.0,0.0,15000,15000,0,0,15000,Null,Null,110953681,111461,15318
110960236,0.0,0.0,1999,1999,0,0,1999,Null,Null,110960236,111461,1883
110962399,0.0,0.0,499000,499000,0,0,499000,Null,Null,110962399,111461,23658
110964465,157.0,157.0,478000,478000,0,0,478000,Null,Null,110964465,215231,9013
110970420,1.0,1.0,39000,39000,0,0,39000,Null,Null,110970420,111461,2
110978753,0.0,0.0,1190000,1190000,0,0,1190000,Null,Null,110978753,149913,2
110978776,0.0,0.0,1550000,1550000,0,0,1550000,Null,Null,110978776,149913,2
110978852,1.0,1.0,1450000,1450000,0,0,1450000,Null,Null,110978852,149913,5385
110978883,0.0,0.0,970000,970000,0,0,970000,Null,Null,110978883,149913,5385
110978972,1.0,1.0,575000,575000,0,0,575000,Null,Null,110978972,149913,2
110979005,3.0,3.0,975000,975000,0,0,975000,Null,Null,110979005,149913,2
110979145,0.0,0.0,2250000,2250000,0,0,2250000,Null,Null,110979145,149913,2
110979207,4.0,4.0,655000,655000,0,0,655000,Null,Null,110979207,149913,2
110979316,1.0,1.0,6500000,6500000,0,0,6500000,Null,Null,110979316,149913,2
110979317,1.0,1.0,930000,930000,0,0,930000,Null,Null,110979317,149913,5385
110979371,0.0,0.0,6500000,6500000,0,0,6500000,Null,Null,110979371,149913,2
110979406,2.0,2.0,675000,675000,0,0,675000,Null,Null,110979406,149913,2
110979509,0.0,0.0,965000,965000,0,0,965000,Null,Null,110979509,149913,2
110979557,5.0,5.0,965000,965000,0,0,965000,Null,Null,110979557,149913,2
110979573,0.0,0.0,6500000,6500000,0,0,6500000,Null,Null,110979573,149913,2
110982026,40.0,40.0,390000,299000,91000,23,390000,Null,Null,110982026,25422,2334
111031533,3.0,3.0,200000,118999,81001,41,200000,Null,Null,111031533,111454,12294
111034200,1.0,1.0,129000,129000,0,0,129000,Null,Null,111034200,111461,2
111034814,1.0,1.0,35000,35000,0,0,35000,Null,Null,111034814,111461,2
111035328,3.0,3.0,69000,69000,0,0,69000,Null,Null,111035328,111461,2
111037565,0.0,0.0,15000,15000,0,0,15000,Null,Null,111037565,111461,15250
111039158,2.0,2.0,19000,19000,0,0,19000,Null,Null,111039158,111461,15236
111039388,8.0,8.0,29000,29000,0,0,29000,Null,Null,111039388,111461,15236
111039665,1.0,1.0,99000,99000,0,0,99000,Null,Null,111039665,111461,15250
111050867,0.0,0.0,118999,118999,0,0,118999,Null,Null,111050867,111454,5007
111092524,11.0,11.0,6000,6000,0,0,6000,Null,Null,111092524,111461,8202
111095503,8.0,8.0,169000,121000,48000,28,169000,Null,Null,111095503,111461,28472
111105888,5.0,5.0,9799999,9799999,0,0,9799999,Null,Null,111105888,111461,2340
111110711,519.0,519.0,5000,5000,0,0,5000,Null,Null,111110711,224735,28478
111121959,2.0,2.0,850000,765000,85000,10,850000,Null,Null,111121959,704815,15320
111145123,78.0,78.0,235000,235000,0,0,235000,Null,Null,111145123,111461,8512
111145190,52.0,52.0,235000,235000,0,0,235000,Null,Null,111145190,111461,8512
111152487,7.0,7.0,89000,76000,13000,15,89000,Null,Null,111152487,21653,2
111152947,78.0,78.0,47500,47500,0,0,47500,Null,Null,111152947,834577,8305
111156743,537.0,537.0,300000,169000,131000,44,300000,Null,Null,111156743,111454,28458
111171405,1.0,1.0,9000,9000,0,0,9000,Null,Null,111171405,111461,28486
111172966,148.0,148.0,123000,123000,0,0,123000,Null,Null,111172966,111461,2
111176687,0.0,0.0,36799000,36799000,0,0,36799000,Null,Null,111176687,111461,23642
111178573,6.0,6.0,645000,645000,0,0,645000,Null,Null,111178573,4958627,3216
111189582,133.0,133.0,89000,49000,40000,45,89000,Null,Null,111189582,625853,12294
111198319,0.0,0.0,6050000,6050000,0,0,6050000,Null,Null,111198319,111461,15318
111231135,158.0,158.0,2611000,1942000,669000,26,2611000,Null,Null,111231135,25229,1978
111231184,14.0,14.0,6500,6500,0,0,6500,Null,Null,111231184,197473,17186
111234151,12.0,12.0,9000,9000,0,0,9000,Null,Null,111234151,197473,17186
111286078,4.0,4.0,10000,10000,0,0,10000,Null,Null,111286078,111461,11831
111286198,0.0,0.0,7000,7000,0,0,7000,Null,Null,111286198,111461,2
111292323,3901.0,3901.0,168500,151000,17500,10,168500,Null,Null,111292323,21266,13878
111294174,34.0,34.0,1760000,1760000,0,0,1760000,Null,Null,111294174,111461,23588
111295350,0.0,0.0,4780000,4780000,0,0,4780000,Null,Null,111295350,402287,2340
111301187,4.0,4.0,29000,29000,0,0,29000,Null,Null,111301187,111461,28484
111306433,21.0,21.0,899000,879000,20000,2,899000,Null,Null,111306433,841705,49722
111316128,544.0,544.0,117300,109000,8300,7,117300,Null,Null,111316128,21271,11833
111385521,4.0,4.0,365000,365000,0,0,365000,Null,Null,111385521,150522,2
111385586,1.0,1.0,1940000,1940000,0,0,1940000,Null,Null,111385586,150522,15250
111410468,48.0,48.0,4500,4500,0,0,4500,Null,Null,111410468,193683,8305
111410597,16.0,16.0,65000,65000,0,0,65000,Null,Null,111410597,143398,4452
111444951,104.0,104.0,7000,7000,0,0,7000,Null,Null,111444951,111461,8167
111445139,0.0,0.0,55000000,55000000,0,0,55000000,Null,Null,111445139,111461,2
111449367,9.0,9.0,199000,199000,0,0,199000,Null,Null,111449367,111461,49722
111451428,29.0,29.0,79000,79000,0,0,79000,Null,Null,111451428,111461,23246
111452209,0.0,0.0,18000,18000,0,0,18000,Null,Null,111452209,111461,2
111452233,0.0,0.0,17000,17000,0,0,17000,Null,Null,111452233,111461,2
111484548,707.0,707.0,63000,63000,0,0,63000,Null,Null,111484548,111461,28724
111487291,0.0,0.0,8350000,8350000,0,0,8350000,Null,Null,111487291,402287,2340
111506324,15.0,15.0,105000,105000,0,0,105000,Null,Null,111506324,111461,2
111510721,0.0,0.0,55000000,55000000,0,0,55000000,Null,Null,111510721,111461,2
111510725,0.0,0.0,39000000,39000000,0,0,39000000,Null,Null,111510725,111461,2
111510759,0.0,0.0,50000000,50000000,0,0,50000000,Null,Null,111510759,111461,1979
111510763,0.0,0.0,64000000,64000000,0,0,64000000,Null,Null,111510763,111461,1979
111510815,0.0,0.0,48000000,48000000,0,0,48000000,Null,Null,111510815,111461,2
111510851,0.0,0.0,99999999,99999999,0,0,99999999,Null,Null,111510851,111461,2
111510945,0.0,0.0,70000000,70000000,0,0,70000000,Null,Null,111510945,111461,23544
111510947,0.0,0.0,62000000,62000000,0,0,62000000,Null,Null,111510947,111461,23708
111510967,0.0,0.0,42000000,42000000,0,0,42000000,Null,Null,111510967,111461,2
111510979,0.0,0.0,67000000,67000000,0,0,67000000,Null,Null,111510979,111461,2
111510983,0.0,0.0,99999999,99999999,0,0,99999999,Null,Null,111510983,111461,2392
111510998,0.0,0.0,99999999,99999999,0,0,99999999,Null,Null,111510998,111461,1978
111511006,0.0,0.0,65000000,65000000,0,0,65000000,Null,Null,111511006,111461,2392
111511013,0.0,0.0,90000000,90000000,0,0,90000000,Null,Null,111511013,111461,23544
111511362,8.0,8.0,25000,25000,0,0,25000,Null,Null,111511362,111461,1883
111515404,12.0,12.0,10887,10887,0,0,10887,Null,Null,111515404,111461,2514
111521047,0.0,0.0,145000,145000,0,0,145000,Null,Null,111521047,111461,2
111521462,0.0,0.0,17800,17800,0,0,17800,Null,Null,111521462,111461,2
111522111,0.0,0.0,121000,104000,17000,14,121000,Null,Null,111522111,111461,2
111536020,0.0,0.0,15111000,15111000,0,0,15111000,Null,Null,111536020,152553,2340
111553909,200.0,200.0,1300000,1199000,101000,8,1300000,Null,Null,111553909,218061,11833
111553980,435.0,435.0,80000,80000,0,0,80000,Null,Null,111553980,4440457,2347
111555693,0.0,0.0,12810000,9150000,3660000,29,12810000,Null,Null,111555693,405211,8511
111560043,0.0,0.0,11970000,8550000,3420000,29,11970000,Null,Null,111560043,405211,8512
111579637,0.0,0.0,9100000,6500000,2600000,29,9100000,Null,Null,111579637,405211,8512
111636598,0.0,0.0,46000000,46000000,0,0,46000000,Null,Null,111636598,879235,2340
111636623,0.0,0.0,22500000,22500000,0,0,22500000,Null,Null,111636623,879235,2
111636663,0.0,0.0,55000000,55000000,0,0,55000000,Null,Null,111636663,879235,2340
111655126,2.0,2.0,132000,132000,0,0,132000,Null,Null,111655126,111461,15250
111682934,88.0,88.0,832000,832000,0,0,832000,Null,Null,111682934,449693,11859
111695681,0.0,0.0,165000,165000,0,0,165000,Null,Null,111695681,111461,15250
111695904,61.0,61.0,274000,246600,27400,10,274000,Null,Null,111695904,111461,15318
111696288,1.0,1.0,14500000,14355000,145000,1,14500000,Null,Null,111696288,167287,20170
111696638,8.0,8.0,1899000,1878000,21000,1,1899000,Null,Null,111696638,841705,49722
111697143,0.0,0.0,27200000,27200000,0,0,27200000,Null,Null,111697143,167287,20170
111702889,25.0,25.0,215000,215000,0,0,215000,Null,Null,111702889,111461,8512
111702899,0.0,0.0,16500000,16500000,0,0,16500000,Null,Null,111702899,167287,20170
111705204,5.0,5.0,215000,215000,0,0,215000,Null,Null,111705204,111461,15250
111707555,3.0,3.0,99000,99000,0,0,99000,Null,Null,111707555,111461,15250
111713172,8.0,8.0,39000,39000,0,0,39000,Null,Null,111713172,252345,15320
111726388,312.0,312.0,64000,64000,0,0,64000,Null,Null,111726388,4973949,28616
111748361,3.0,3.0,78000,78000,0,0,78000,Null,Null,111748361,549763,1831
111751475,0.0,0.0,9800000,9800000,0,0,9800000,Null,Null,111751475,5009361,11873
111820956,11.0,11.0,4000,2000,2000,50,4000,Null,Null,111820956,111461,2
111821306,474.0,474.0,2500,2500,0,0,2500,Null,Null,111821306,111461,23052
111821383,23.0,23.0,2500,2000,500,20,2500,Null,Null,111821383,111461,2
111857937,6.0,6.0,155000,155000,0,0,155000,Null,Null,111857937,111461,2
111867061,3.0,3.0,1000,1000,0,0,1000,Null,Null,111867061,111461,2
111873613,0.0,0.0,57500000,57500000,0,0,57500000,Null,Null,111873613,5012865,2342
111874128,1754.0,1754.0,263000,219000,44000,17,263000,Null,Null,111874128,79682,11835
111874233,410.0,410.0,126000,88000,38000,30,126000,Null,Null,111874233,79682,11835
111885604,337.0,337.0,492000,383760,108240,22,492000,Null,Null,111885604,26150,8511
111919160,18.0,18.0,492000,418200,73800,15,492000,Null,Null,111919160,26150,8513
111924932,24.0,24.0,466000,396100,69900,15,466000,Null,Null,111924932,26150,8511
111937779,0.0,0.0,4890000,4890000,0,0,4890000,Null,Null,111937779,402287,8165
111937830,112.0,112.0,299000,299000,0,0,299000,Null,Null,111937830,111461,28658
111938814,0.0,0.0,4890000,4890000,0,0,4890000,Null,Null,111938814,402287,8165
111945323,562.0,562.0,549000,428000,121000,22,549000,Null,Null,111945323,21279,17170
111945700,6.0,6.0,125000,125000,0,0,125000,Null,Null,111945700,111461,5385
111947615,286.0,286.0,549000,428000,121000,22,549000,Null,Null,111947615,21279,53350
111953051,10.0,10.0,200000,200000,0,0,200000,Null,Null,111953051,111461,5385
111977579,5.0,5.0,2300,2300,0,0,2300,Null,Null,111977579,111461,2
111978854,937.0,937.0,590000,299000,291000,49,590000,Null,Null,111978854,246045,1815
111982297,120.0,120.0,1090000,699000,391000,36,1090000,Null,Null,111982297,246045,28720
111983048,634.0,634.0,260000,179000,81000,31,260000,Null,Null,111983048,246045,3804
112019899,1.0,1.0,178000,178000,0,0,178000,Null,Null,112019899,18802,28598
112047012,121.0,121.0,55000,55000,0,0,55000,Null,Null,112047012,111461,2
112051189,61.0,61.0,43000,43000,0,0,43000,Null,Null,112051189,111461,2153
112051536,1.0,1.0,27800000,27800000,0,0,27800000,Null,Null,112051536,167287,11518
112051921,111.0,111.0,88000,88000,0,0,88000,Null,Null,112051921,111461,20492
112052091,3.0,3.0,239000,239000,0,0,239000,Null,Null,112052091,111461,20492
112052191,104.0,104.0,58000,58000,0,0,58000,Null,Null,112052191,111461,20492
112055976,0.0,0.0,18680000,18680000,0,0,18680000,Null,Null,112055976,111461,2340
112056174,49.0,49.0,549000,549000,0,0,549000,Null,Null,112056174,857199,2324
112068381,196.0,196.0,249000,230000,19000,8,249000,Null,Null,112068381,523789,23588
112084937,10.0,10.0,899000,879000,20000,2,899000,Null,Null,112084937,841705,49722
112087792,94.0,94.0,136000,68000,68000,50,136000,Null,Null,112087792,174069,1820
112099225,0.0,0.0,18150000,18150000,0,0,18150000,Null,Null,112099225,4973087,11881
112100935,0.0,0.0,8750000,6250000,2500000,29,8750000,Null,Null,112100935,405211,8512
112101674,0.0,0.0,8750000,6250000,2500000,29,8750000,Null,Null,112101674,405211,8512
112101903,0.0,0.0,9030000,6450000,2580000,29,9030000,Null,Null,112101903,405211,8512
112102330,0.0,0.0,9030000,6450000,2580000,29,9030000,Null,Null,112102330,405211,8512
112169170,152.0,152.0,240000,218400,21600,9,240000,Null,Null,112169170,4440205,8305
112175409,56.0,56.0,180000,110000,70000,39,180000,Null,Null,112175409,111461,28598
112190913,61.0,61.0,43470,43470,0,0,43470,Null,Null,112190913,111461,1815
112192970,8.0,8.0,9000,8910,90,1,9000,Null,Null,112192970,209871,20254
112212881,0.0,0.0,680000,680000,0,0,680000,Null,Null,112212881,111461,15318
112243496,0.0,0.0,20000000,20000000,0,0,20000000,Null,Null,112243496,111461,8064
112251499,112.0,112.0,155000,147000,8000,5,155000,Null,Null,112251499,5043271,12928
112287571,764.0,764.0,577001,577001,0,0,577001,Null,Null,112287571,2630119,2657
112289302,839.0,839.0,450000,415000,35000,8,450000,Null,Null,112289302,64932,1601
112309736,5.0,5.0,3550000,3443500,106500,3,3550000,Null,Null,112309736,402287,8225
112321595,1465.0,1465.0,250000,158000,92000,37,250000,Null,Null,112321595,4224691,2016
112321690,0.0,0.0,6600000,6402000,198000,3,6600000,Null,Null,112321690,402287,11935
112328018,0.0,0.0,10750000,10427500,322500,3,10750000,Null,Null,112328018,402287,11935
112331233,75.0,75.0,2500,2500,0,0,2500,Null,Null,112331233,111461,2
112331483,20.0,20.0,7350,7350,0,0,7350,Null,Null,112331483,111461,2
112331542,10.0,10.0,6900,6900,0,0,6900,Null,Null,112331542,111461,28718
112331838,0.0,0.0,3990000,3870300,119700,3,3990000,Null,Null,112331838,402287,11935
112332904,475.0,475.0,525000,345000,180000,34,525000,Null,Null,112332904,713343,11767
112347946,1.0,1.0,153000,153000,0,0,153000,Null,Null,112347946,111461,15250
112350234,63.0,63.0,255000,255000,0,0,255000,Null,Null,112350234,20271,28638
112547762,2.0,2.0,4970000,3550000,1420000,29,4970000,Null,Null,112547762,405211,5384
112550031,13.0,13.0,1200,1200,0,0,1200,Null,Null,112550031,111461,2363
112550111,81.0,81.0,2000,2000,0,0,2000,Null,Null,112550111,111461,53074
112574564,706.0,706.0,1000,1000,0,0,1000,Null,Null,112574564,111461,2337
112603042,56.0,56.0,2000,2000,0,0,2000,Null,Null,112603042,111461,53074
112603174,0.0,0.0,1199,1199,0,0,1199,Null,Null,112603174,111461,2
112686555,0.0,0.0,3000,3000,0,0,3000,Null,Null,112686555,111461,20254
112686882,0.0,0.0,3000,3000,0,0,3000,Null,Null,112686882,111461,20254
112687598,14.0,14.0,10000,10000,0,0,10000,Null,Null,112687598,111461,2
112692520,0.0,0.0,15000,15000,0,0,15000,Null,Null,112692520,111461,2
112694295,0.0,0.0,3000,3000,0,0,3000,Null,Null,112694295,111461,20258
112695200,0.0,0.0,13500000,9487000,4013000,30,13500000,Null,Null,112695200,18802,1794
112696648,0.0,0.0,3000,3000,0,0,3000,Null,Null,112696648,111461,20254
112716670,0.0,0.0,8000,8000,0,0,8000,Null,Null,112716670,111461,2
112724801,0.0,0.0,9999,9999,0,0,9999,Null,Null,112724801,111461,49726
112728673,2483.0,2483.0,120000,120000,0,0,120000,Null,Null,112728673,5026491,1752
112732067,1.0,1.0,15000,15000,0,0,15000,Null,Null,112732067,111461,15318
112732750,0.0,0.0,10000,10000,0,0,10000,Null,Null,112732750,111461,2
112734786,575.0,575.0,399000,349000,50000,13,399000,Null,Null,112734786,4244853,28480
112760355,5.0,5.0,1980000,1980000,0,0,1980000,Null,Null,112760355,111461,15318
112821872,0.0,0.0,2508000,2508000,0,0,2508000,Null,Null,112821872,25422,1795
112867188,1.0,1.0,4000000,4000000,0,0,4000000,Null,Null,112867188,260977,11885
112928338,1.0,1.0,349000,349000,0,0,349000,Null,Null,112928338,111461,2
112928485,4.0,4.0,169000,169000,0,0,169000,Null,Null,112928485,111461,2
112928751,0.0,0.0,9860000,9860000,0,0,9860000,Null,Null,112928751,885749,8511
112929054,0.0,0.0,9860000,9860000,0,0,9860000,Null,Null,112929054,885749,8511
112929298,1.0,1.0,61000,61000,0,0,61000,Null,Null,112929298,111461,15936
112929938,0.0,0.0,9860000,9860000,0,0,9860000,Null,Null,112929938,885749,8511
112936978,0.0,0.0,5784800,5784800,0,0,5784800,Null,Null,112936978,885749,8511
112937714,0.0,0.0,4600000,4600000,0,0,4600000,Null,Null,112937714,734429,1627
112946538,405.0,405.0,395000,395000,0,0,395000,Null,Null,112946538,204301,23388
112979641,0.0,0.0,75000000,75000000,0,0,75000000,Null,Null,112979641,111461,23112
112984330,153.0,153.0,278000,278000,0,0,278000,Null,Null,112984330,885047,28682
112984896,280.0,280.0,850000,850000,0,0,850000,Null,Null,112984896,449693,11861
112998207,433.0,433.0,299000,284050,14950,5,299000,Null,Null,112998207,183251,8192
113011938,127.0,127.0,43000,42000,1000,2,43000,Null,Null,113011938,111461,28482
113020197,51.0,51.0,99000,95000,4000,4,99000,Null,Null,113020197,111461,20244
113035212,1.0,1.0,2000,2000,0,0,2000,Null,Null,113035212,111461,20254
113035538,0.0,0.0,2000,2000,0,0,2000,Null,Null,113035538,111461,20254
113035654,0.0,0.0,2000,2000,0,0,2000,Null,Null,113035654,111461,20254
113040022,0.0,0.0,9000,9000,0,0,9000,Null,Null,113040022,111461,20254
113041088,0.0,0.0,3000,3000,0,0,3000,Null,Null,113041088,111461,20254
113041512,0.0,0.0,5000,5000,0,0,5000,Null,Null,113041512,111461,20254
113042674,0.0,0.0,8500,8500,0,0,8500,Null,Null,113042674,111461,20254
113045559,0.0,0.0,6636000,6636000,0,0,6636000,Null,Null,113045559,805165,8511
113046087,0.0,0.0,5000,5000,0,0,5000,Null,Null,113046087,111461,20254
113048125,0.0,0.0,5000,5000,0,0,5000,Null,Null,113048125,111461,20254
113048339,68.0,68.0,8500,8500,0,0,8500,Null,Null,113048339,111461,20254
113048595,0.0,0.0,6500,6500,0,0,6500,Null,Null,113048595,111461,8068
113048664,53.0,53.0,6900,6900,0,0,6900,Null,Null,113048664,111461,20254
113048845,72.0,72.0,2900,2900,0,0,2900,Null,Null,113048845,111461,26658
113060183,357.0,357.0,550000,449000,101000,18,550000,Null,Null,113060183,111461,4381
113063452,767.0,767.0,199000,129000,70000,35,199000,Null,Null,113063452,625265,28574
113073321,10.0,10.0,3000,3000,0,0,3000,Null,Null,113073321,111461,12294
113086239,4.0,4.0,1500,1500,0,0,1500,Null,Null,113086239,111461,20254
113086840,82.0,82.0,3300000,2280000,1020000,31,3300000,Null,Null,113086840,50629,8400
113087413,798.0,798.0,530000,500000,30000,6,530000,Null,Null,113087413,50629,5006
113095517,0.0,0.0,7000000,7000000,0,0,7000000,Null,Null,113095517,885749,8511
113095616,1.0,1.0,7000000,7000000,0,0,7000000,Null,Null,113095616,885749,8511
113097934,0.0,0.0,7000000,7000000,0,0,7000000,Null,Null,113097934,885749,8511
113098301,0.0,0.0,7000000,7000000,0,0,7000000,Null,Null,113098301,885749,8511
113098354,0.0,0.0,7000000,7000000,0,0,7000000,Null,Null,113098354,885749,5385
113098552,0.0,0.0,10500000,10500000,0,0,10500000,Null,Null,113098552,885749,8511
113099491,28.0,28.0,79000,79000,0,0,79000,Null,Null,113099491,111461,2
113099543,103.0,103.0,99000,99000,0,0,99000,Null,Null,113099543,111461,2
113100577,0.0,0.0,6000,6000,0,0,6000,Null,Null,113100577,111461,20254
113103076,0.0,0.0,7000000,7000000,0,0,7000000,Null,Null,113103076,885749,8511
113103170,0.0,0.0,7000000,7000000,0,0,7000000,Null,Null,113103170,885749,8511
113104429,0.0,0.0,7000000,7000000,0,0,7000000,Null,Null,113104429,885749,8511
113104709,0.0,0.0,7000000,7000000,0,0,7000000,Null,Null,113104709,885749,8511
113116866,0.0,0.0,7350000,7350000,0,0,7350000,Null,Null,113116866,885749,8511
113125233,0.0,0.0,7350000,7350000,0,0,7350000,Null,Null,113125233,885749,8511
113125339,166.0,166.0,209000,169000,40000,19,209000,Null,Null,113125339,3985581,23048
113125437,0.0,0.0,7350000,7350000,0,0,7350000,Null,Null,113125437,885749,8511
113126311,0.0,0.0,6990000,6990000,0,0,6990000,Null,Null,113126311,885749,8511
113127483,0.0,0.0,6990000,6990000,0,0,6990000,Null,Null,113127483,885749,8511
113141058,0.0,0.0,6990000,6990000,0,0,6990000,Null,Null,113141058,885749,8511
113157125,75.0,75.0,459000,459000,0,0,459000,Null,Null,113157125,4691869,2971
113157214,0.0,0.0,7000000,7000000,0,0,7000000,Null,Null,113157214,885749,8511
113157299,0.0,0.0,7000000,7000000,0,0,7000000,Null,Null,113157299,885749,8511
113159489,0.0,0.0,9000,9000,0,0,9000,Null,Null,113159489,111461,20254
113161212,0.0,0.0,7000000,7000000,0,0,7000000,Null,Null,113161212,885749,8511
113162692,0.0,0.0,7000000,7000000,0,0,7000000,Null,Null,113162692,885749,5385
113165028,94.0,94.0,1400000,950000,450000,32,1400000,Null,Null,113165028,631569,2340
113170663,0.0,0.0,6850000,6850000,0,0,6850000,Null,Null,113170663,885749,8511
113171564,0.0,0.0,6850000,6850000,0,0,6850000,Null,Null,113171564,885749,8511
113171818,0.0,0.0,8000,8000,0,0,8000,Null,Null,113171818,111461,20254
113173096,0.0,0.0,19111,19111,0,0,19111,Null,Null,113173096,111461,2
113174560,0.0,0.0,16500,16500,0,0,16500,Null,Null,113174560,111461,2
113189875,0.0,0.0,6850000,6850000,0,0,6850000,Null,Null,113189875,885749,8511
113190145,0.0,0.0,6850000,6850000,0,0,6850000,Null,Null,113190145,885749,8511
113190247,0.0,0.0,6850000,6850000,0,0,6850000,Null,Null,113190247,885749,8511
113202842,10.0,10.0,8500,8500,0,0,8500,Null,Null,113202842,111461,20254
113206608,0.0,0.0,24900,24900,0,0,24900,Null,Null,113206608,111461,53074
113224702,207.0,207.0,65000,55000,10000,15,65000,Null,Null,113224702,4554495,2238
113230259,0.0,0.0,6000,6000,0,0,6000,Null,Null,113230259,111461,20254
113230502,0.0,0.0,7000,7000,0,0,7000,Null,Null,113230502,111461,20254
113233589,0.0,0.0,5000,5000,0,0,5000,Null,Null,113233589,111461,20254
113235690,0.0,0.0,9000,9000,0,0,9000,Null,Null,113235690,111461,20254
113245352,80.0,80.0,199000,189000,10000,5,199000,Null,Null,113245352,4973949,20244
113249311,0.0,0.0,6500,6500,0,0,6500,Null,Null,113249311,111461,20254
113251978,0.0,0.0,5000,5000,0,0,5000,Null,Null,113251978,111461,20254
113260394,0.0,0.0,2000,2000,0,0,2000,Null,Null,113260394,111461,20258
113274374,0.0,0.0,5900,5900,0,0,5900,Null,Null,113274374,111461,20254
113283980,0.0,0.0,5500,5500,0,0,5500,Null,Null,113283980,111461,20254
113304252,15.0,15.0,3000,3000,0,0,3000,Null,Null,113304252,111461,2
113304331,0.0,0.0,2425,2425,0,0,2425,Null,Null,113304331,111461,2685
113307253,3.0,3.0,190000,190000,0,0,190000,Null,Null,113307253,111461,15318
113307302,1.0,1.0,410000,410000,0,0,410000,Null,Null,113307302,111461,15318
113334235,1.0,1.0,550000,550000,0,0,550000,Null,Null,113334235,169461,15936
113335686,32.0,32.0,2500,2500,0,0,2500,Null,Null,113335686,111461,2
113337165,20.0,20.0,3990,3990,0,0,3990,Null,Null,113337165,111461,20254
113341035,0.0,0.0,7000,7000,0,0,7000,Null,Null,113341035,111461,20254
113341553,0.0,0.0,5000,5000,0,0,5000,Null,Null,113341553,111461,20254
113345433,0.0,0.0,6500,6500,0,0,6500,Null,Null,113345433,111461,20254
113359379,0.0,0.0,3000,3000,0,0,3000,Null,Null,113359379,111461,20254
113373656,0.0,0.0,2000,2000,0,0,2000,Null,Null,113373656,111461,20254
113380368,0.0,0.0,2771,2771,0,0,2771,Null,Null,113380368,111461,6742
113395597,0.0,0.0,3500,3500,0,0,3500,Null,Null,113395597,111461,20254
113396208,11.0,11.0,7800,7800,0,0,7800,Null,Null,113396208,111461,20254
113403111,301.0,301.0,99000,99000,0,0,99000,Null,Null,113403111,4878479,15318
113407767,0.0,0.0,2998000,2998000,0,0,2998000,Null,Null,113407767,111461,15318
113443835,0.0,0.0,8000,8000,0,0,8000,Null,Null,113443835,111461,20254
113444511,0.0,0.0,3990,3990,0,0,3990,Null,Null,113444511,111461,20254
113445186,0.0,0.0,1500,1500,0,0,1500,Null,Null,113445186,111461,23246
113451517,29.0,29.0,7000,7000,0,0,7000,Null,Null,113451517,111461,20254
113475741,8.0,8.0,450000,450000,0,0,450000,Null,Null,113475741,18804,8061
113476531,0.0,0.0,3500,3500,0,0,3500,Null,Null,113476531,111461,20254
113476758,266.0,266.0,59000,59000,0,0,59000,Null,Null,113476758,623493,17162
113480621,187.0,187.0,59000,59000,0,0,59000,Null,Null,113480621,623493,17162
113481228,0.0,0.0,3000,3000,0,0,3000,Null,Null,113481228,111461,20254
113483725,0.0,0.0,9000,9000,0,0,9000,Null,Null,113483725,111461,2
113483896,2.0,2.0,7000,7000,0,0,7000,Null,Null,113483896,111461,2
113484552,2.0,2.0,5000,5000,0,0,5000,Null,Null,113484552,111461,2
113485086,0.0,0.0,5490,5490,0,0,5490,Null,Null,113485086,111461,20254
113496962,86.0,86.0,1200,1200,0,0,1200,Null,Null,113496962,111461,2
113497510,14.0,14.0,2000,2000,0,0,2000,Null,Null,113497510,111461,2
113500064,0.0,0.0,6490,6490,0,0,6490,Null,Null,113500064,111461,20254
113517884,0.0,0.0,1025000,860000,165000,16,1025000,Null,Null,113517884,47489,8227
113518166,0.0,0.0,12899000,12899000,0,0,12899000,Null,Null,113518166,20215,28862
113530289,35.0,35.0,3490,3490,0,0,3490,Null,Null,113530289,111461,20254
113543161,417.0,417.0,112000,96000,16000,14,112000,Null,Null,113543161,21285,11747
113547471,387.0,387.0,108000,96000,12000,11,108000,Null,Null,113547471,21285,11747
113547472,428.0,428.0,112000,96000,16000,14,112000,Null,Null,113547472,21285,11747
113547480,1617.0,1617.0,109000,97000,12000,11,109000,Null,Null,113547480,21285,1520
113554171,8.0,8.0,4990,4990,0,0,4990,Null,Null,113554171,111461,20254
113556584,8.0,8.0,7990,7990,0,0,7990,Null,Null,113556584,111461,28480
113556804,246.0,246.0,3800,3800,0,0,3800,Null,Null,113556804,111461,1520
113558783,1.0,1.0,1000,900,100,10,1000,Null,Null,113558783,111461,2
113568856,672.0,672.0,700000,590000,110000,16,700000,Null,Null,113568856,111454,1811
113569143,86.0,86.0,1000000,649000,351000,35,1000000,Null,Null,113569143,111454,28640
113577693,6.0,6.0,3990,3990,0,0,3990,Null,Null,113577693,111461,20254
113617065,26.0,26.0,31800,31800,0,0,31800,Null,Null,113617065,111461,23282
113639136,22.0,22.0,2000,2000,0,0,2000,Null,Null,113639136,111461,53074
113655378,14.0,14.0,245229,245229,0,0,245229,Null,Null,113655378,21651,28688
113656471,1.0,1.0,3900,3900,0,0,3900,Null,Null,113656471,111461,20254
113658871,0.0,0.0,1000,1000,0,0,1000,Null,Null,113658871,111461,20254
113662467,11.0,11.0,129000,129000,0,0,129000,Null,Null,113662467,149308,1832
113663073,7.0,7.0,1999,1999,0,0,1999,Null,Null,113663073,111461,23246
113670679,0.0,0.0,4800,4800,0,0,4800,Null,Null,113670679,111461,20254
113671562,135.0,135.0,119700,119700,0,0,119700,Null,Null,113671562,847277,5872
113673819,0.0,0.0,1749000,1705000,44000,3,1749000,Null,Null,113673819,20271,4880
113674505,298.0,298.0,85900,77310,8590,10,85900,Null,Null,113674505,111461,2685
113706563,14.0,14.0,57000,44000,13000,23,57000,Null,Null,113706563,111461,26652
113769207,5.0,5.0,15000,15000,0,0,15000,Null,Null,113769207,111461,49722
113773790,556.0,556.0,129000,109000,20000,16,129000,Null,Null,113773790,4958627,3990
113778345,81.0,81.0,199000,124000,75000,38,199000,Null,Null,113778345,4698843,8602
113835505,688.0,688.0,450000,399000,51000,11,450000,Null,Null,113835505,4244853,28480
113899477,232.0,232.0,150000,150000,0,0,150000,Null,Null,113899477,883511,2016
113902978,1.0,1.0,1200,1200,0,0,1200,Null,Null,113902978,111461,23112
113903431,33.0,33.0,6900,4000,2900,42,6900,Null,Null,113903431,425641,11905
113906898,0.0,0.0,46800000,46800000,0,0,46800000,Null,Null,113906898,261521,2324
113914785,62.0,62.0,1000,1000,0,0,1000,Null,Null,113914785,111461,2363
113915022,100.0,100.0,750000,750000,0,0,750000,Null,Null,113915022,5068881,23588
113919185,268.0,268.0,390000,249000,141000,36,390000,Null,Null,113919185,205953,5006
113919373,0.0,0.0,6999,6999,0,0,6999,Null,Null,113919373,111461,20254
113920073,40.0,40.0,13990000,9450000,4540000,32,13990000,Null,Null,113920073,18802,1794
113920312,0.0,0.0,12941000,9487000,3454000,27,12941000,Null,Null,113920312,18802,1794
113925825,0.0,0.0,3000,3000,0,0,3000,Null,Null,113925825,111461,20254
113929913,0.0,0.0,2900,2900,0,0,2900,Null,Null,113929913,111461,20254
113932671,146.0,146.0,50000,30860,19140,38,50000,Null,Null,113932671,111461,23834
113935328,5.0,5.0,2500,2500,0,0,2500,Null,Null,113935328,111461,23246
113953642,0.0,0.0,2000,2000,0,0,2000,Null,Null,113953642,111461,20254
113953666,42.0,42.0,132000,70974,61026,46,132000,Null,Null,113953666,111461,2
113955041,0.0,0.0,3200,3200,0,0,3200,Null,Null,113955041,111461,20258
113955640,22.0,22.0,1788,1788,0,0,1788,Null,Null,113955640,111461,23156
113955945,0.0,0.0,6800,6800,0,0,6800,Null,Null,113955945,111461,20254
113956747,55.0,55.0,2190,2190,0,0,2190,Null,Null,113956747,111461,2
113957408,157.0,157.0,569000,350000,219000,38,569000,Null,Null,113957408,423053,5385
113957423,439.0,439.0,479000,325000,154000,32,479000,Null,Null,113957423,423053,8512
113957465,30.0,30.0,799000,495000,304000,38,799000,Null,Null,113957465,423053,5385
113957500,57.0,57.0,479000,325000,154000,32,479000,Null,Null,113957500,423053,5384
113957568,42.0,42.0,675000,350000,325000,48,675000,Null,Null,113957568,423053,5385
113958913,10.0,10.0,565000,350000,215000,38,565000,Null,Null,113958913,423053,8512
113965262,0.0,0.0,84000,84000,0,0,84000,Null,Null,113965262,111461,2
113965300,0.0,0.0,2400,2400,0,0,2400,Null,Null,113965300,111461,2
113966899,2.0,2.0,1800,1800,0,0,1800,Null,Null,113966899,111461,2
113994331,0.0,0.0,7751,7751,0,0,7751,Null,Null,113994331,111461,5566
114028279,790.0,790.0,449000,373000,76000,17,449000,Null,Null,114028279,86206,53350
114036756,0.0,0.0,2425,2425,0,0,2425,Null,Null,114036756,111461,20254
114050512,0.0,0.0,3000,3000,0,0,3000,Null,Null,114050512,111461,2
114056241,365.0,365.0,169000,169000,0,0,169000,Null,Null,114056241,4877037,11889
114058641,13.0,13.0,1200,1200,0,0,1200,Null,Null,114058641,111461,20254
114065967,0.0,0.0,9200,9200,0,0,9200,Null,Null,114065967,111461,20254
114071740,5.0,5.0,11990000,11990000,0,0,11990000,Null,Null,114071740,111461,2340
114073802,0.0,0.0,3685000,3685000,0,0,3685000,Null,Null,114073802,259989,5893
114079775,172.0,172.0,252160,252160,0,0,252160,Null,Null,114079775,111461,1626
114084520,0.0,0.0,30000,17000,13000,43,30000,Null,Null,114084520,111461,2
114100979,317.0,317.0,60000,60000,0,0,60000,Null,Null,114100979,215231,1838
114119131,0.0,0.0,12500000,12500000,0,0,12500000,Null,Null,114119131,253893,20190
114140841,8.0,8.0,5700000,5700000,0,0,5700000,Null,Null,114140841,5069951,8172
114144966,66.0,66.0,890000,569000,321000,36,890000,Null,Null,114144966,865157,1626
114150656,19.0,19.0,330000,330000,0,0,330000,Null,Null,114150656,4987269,5566
114150789,25.0,25.0,620000,620000,0,0,620000,Null,Null,114150789,191419,5566
114152859,17.0,17.0,150000,150000,0,0,150000,Null,Null,114152859,19072,12928
114174025,0.0,0.0,195000,195000,0,0,195000,Null,Null,114174025,111461,15250
114187626,741.0,741.0,610000,427000,183000,30,610000,Null,Null,114187626,86206,8227
114195068,0.0,0.0,3000,3000,0,0,3000,Null,Null,114195068,111461,8193
114204740,11.0,11.0,149000,149000,0,0,149000,Null,Null,114204740,41048,1936
114204741,6.0,6.0,99000,99000,0,0,99000,Null,Null,114204741,41048,1936
114243462,315.0,315.0,599000,499000,100000,17,599000,Null,Null,114243462,4244853,28682
114266665,39.0,39.0,182000,182000,0,0,182000,Null,Null,114266665,5074055,10228
114271269,3919.0,3919.0,1430000,929000,501000,35,1430000,Null,Null,114271269,160211,3422
114271326,75.0,75.0,99000,74000,25000,25,99000,Null,Null,114271326,111461,8400
114271441,3554.0,3554.0,1430000,929000,501000,35,1430000,Null,Null,114271441,160211,3422
114271806,215.0,215.0,794000,331000,463000,58,794000,Null,Null,114271806,27396,11875
114300180,49.0,49.0,255000,227000,28000,11,255000,Null,Null,114300180,111461,2
114343281,0.0,0.0,3500000,3500000,0,0,3500000,Null,Null,114343281,4282483,11893
114356028,4.0,4.0,5200000,5200000,0,0,5200000,Null,Null,114356028,193691,11899
114399322,2.0,2.0,66000,66000,0,0,66000,Null,Null,114399322,111461,15236
114414501,428.0,428.0,199000,189050,9950,5,199000,Null,Null,114414501,25403,1623
114416931,15.0,15.0,55000,55000,0,0,55000,Null,Null,114416931,111461,15236
114427445,0.0,0.0,11510000,11510000,0,0,11510000,Null,Null,114427445,4610513,7079
114431906,0.0,0.0,58580000,58580000,0,0,58580000,Null,Null,114431906,180151,28860
114440166,42.0,42.0,149000,149000,0,0,149000,Null,Null,114440166,111461,20174
114441343,1.0,1.0,10890000,10890000,0,0,10890000,Null,Null,114441343,111461,2340
114445165,502.0,502.0,495000,495000,0,0,495000,Null,Null,114445165,4515995,28454
114457949,4.0,4.0,83000,83000,0,0,83000,Null,Null,114457949,111461,15236
114458751,59.0,59.0,509000,503910,5090,1,509000,Null,Null,114458751,111461,11933
114458769,17.0,17.0,499000,499000,0,0,499000,Null,Null,114458769,111461,11935
114459245,4.0,4.0,550000,550000,0,0,550000,Null,Null,114459245,248191,1616
114465510,17.0,17.0,77000,77000,0,0,77000,Null,Null,114465510,111461,15236
114465611,115.0,115.0,2200000,1450000,750000,34,2200000,Null,Null,114465611,631569,2340
114467131,676.0,676.0,80000,49000,31000,39,80000,Null,Null,114467131,4884089,20922
114467688,0.0,0.0,11350000,11350000,0,0,11350000,Null,Null,114467688,885749,8511
114532904,345.0,345.0,35000,23000,12000,34,35000,Null,Null,114532904,886923,8305
114539839,3.0,3.0,50000,50000,0,0,50000,Null,Null,114539839,111461,15236
114540959,1.0,1.0,95000,95000,0,0,95000,Null,Null,114540959,111461,15236
114569833,0.0,0.0,61600000,49280000,12320000,20,61600000,Null,Null,114569833,5046787,23576
114569875,1.0,1.0,50600000,50600000,0,0,50600000,Null,Null,114569875,5046787,23642
114569884,0.0,0.0,43100000,36635000,6465000,15,43100000,Null,Null,114569884,5046787,23576
114569892,0.0,0.0,70500000,49350000,21150000,30,70500000,Null,Null,114569892,5046787,23642
114569939,0.0,0.0,55200000,46920000,8280000,15,55200000,Null,Null,114569939,5046787,23576
114569967,0.0,0.0,0,36600000,0,0,36600000,Null,Null,114569967,5046787,0
114569993,0.0,0.0,55100000,49590000,5510000,10,55100000,Null,Null,114569993,5046787,23588
114570115,0.0,0.0,60400000,42280000,18120000,30,60400000,Null,Null,114570115,5046787,23642
114570242,0.0,0.0,54100000,37870000,16230000,30,54100000,Null,Null,114570242,5046787,23642
114570283,0.0,0.0,47500000,38000000,9500000,20,47500000,Null,Null,114570283,5046787,23576
114570336,0.0,0.0,55200000,46920000,8280000,15,55200000,Null,Null,114570336,5046787,23576
114570414,0.0,0.0,59600000,53640000,5960000,10,59600000,Null,Null,114570414,5046787,23622
114570639,0.0,0.0,72300000,57840000,14460000,20,72300000,Null,Null,114570639,5046787,23576
114570676,0.0,0.0,99999999,99999999,0,0,99999999,Null,Null,114570676,561415,23526
114572066,278.0,278.0,36000,20000,16000,44,36000,Null,Null,114572066,46703,2363
114572376,1.0,1.0,5000,5000,0,0,5000,Null,Null,114572376,111461,8193
114572435,30.0,30.0,8000,8000,0,0,8000,Null,Null,114572435,111461,8167
114572558,9.0,9.0,10000,10000,0,0,10000,Null,Null,114572558,111461,8167
114572910,76.0,76.0,5500,5500,0,0,5500,Null,Null,114572910,111461,10218
114573387,0.0,0.0,5500000,5500000,0,0,5500000,Null,Null,114573387,865167,17174
114586754,39.0,39.0,1799000,990000,809000,45,1799000,Null,Null,114586754,18776,5531
114587197,0.0,0.0,5500000,5500000,0,0,5500000,Null,Null,114587197,865167,17174
114594357,0.0,0.0,5500000,5500000,0,0,5500000,Null,Null,114594357,865167,3426
114619842,1.0,1.0,120000,91000,29000,24,120000,Null,Null,114619842,111461,4428
114621700,354.0,354.0,171000,141000,30000,18,171000,Null,Null,114621700,111461,23658
114644909,0.0,0.0,2000,2000,0,0,2000,Null,Null,114644909,111461,2
114649757,0.0,0.0,7150000,7150000,0,0,7150000,Null,Null,114649757,885749,8511
114651186,0.0,0.0,44500000,44500000,0,0,44500000,Null,Null,114651186,261521,2324
114672797,0.0,0.0,13850000,13850000,0,0,13850000,Null,Null,114672797,885749,8511
114673118,15.0,15.0,249000,249000,0,0,249000,Null,Null,114673118,111461,49722
114673201,0.0,0.0,8246000,5850000,2396000,29,8246000,Null,Null,114673201,885749,8511
114674407,12.0,12.0,165000,165000,0,0,165000,Null,Null,114674407,111461,15236
114674432,0.0,0.0,11220000,11220000,0,0,11220000,Null,Null,114674432,180151,8064
114675539,0.0,0.0,11220000,11220000,0,0,11220000,Null,Null,114675539,180151,8064
114680946,115.0,115.0,5999000,5399000,600000,10,5999000,Null,Null,114680946,18984,28618
114682649,115.0,115.0,180000,180000,0,0,180000,Null,Null,114682649,111461,18876
114682962,0.0,0.0,17100000,17100000,0,0,17100000,Null,Null,114682962,111461,11518
114683912,0.0,0.0,9799999,9799999,0,0,9799999,Null,Null,114683912,111461,2340
114685319,2.0,2.0,7299,7299,0,0,7299,Null,Null,114685319,111461,2
114685539,5.0,5.0,8180,8180,0,0,8180,Null,Null,114685539,111461,2
114685837,0.0,0.0,2000,2000,0,0,2000,Null,Null,114685837,111461,2
114685885,1.0,1.0,7574,7574,0,0,7574,Null,Null,114685885,111461,2
114685937,5.0,5.0,5900,5900,0,0,5900,Null,Null,114685937,111461,10218
114686057,3.0,3.0,7299,7299,0,0,7299,Null,Null,114686057,111461,2
114686402,0.0,0.0,6999,6999,0,0,6999,Null,Null,114686402,111461,2
114686463,29.0,29.0,1754,1754,0,0,1754,Null,Null,114686463,111461,2
114686516,2.0,2.0,3599,3599,0,0,3599,Null,Null,114686516,111461,2
114686555,2.0,2.0,1899,1899,0,0,1899,Null,Null,114686555,111461,23042
114686583,3.0,3.0,6000,6000,0,0,6000,Null,Null,114686583,111461,2
114686727,7.0,7.0,16499,16499,0,0,16499,Null,Null,114686727,111461,10218
114687047,2.0,2.0,2423,2423,0,0,2423,Null,Null,114687047,111461,1819
114687164,0.0,0.0,15000,15000,0,0,15000,Null,Null,114687164,111461,2
114687870,5.0,5.0,9089,9089,0,0,9089,Null,Null,114687870,111461,2
114687961,4.0,4.0,7500,7500,0,0,7500,Null,Null,114687961,111461,2
114688021,0.0,0.0,100000,100000,0,0,100000,Null,Null,114688021,111461,2
114688047,3.0,3.0,7898,7898,0,0,7898,Null,Null,114688047,111461,2
114688303,5.0,5.0,1499,1000,499,33,1499,Null,Null,114688303,111461,2
114688453,0.0,0.0,5399,5399,0,0,5399,Null,Null,114688453,111461,2363
114688638,0.0,0.0,5800,5800,0,0,5800,Null,Null,114688638,111461,10218
114688803,0.0,0.0,7400,7400,0,0,7400,Null,Null,114688803,111461,2
114689107,196.0,196.0,1000,1000,0,0,1000,Null,Null,114689107,111461,2
114689119,115.0,115.0,2899,2899,0,0,2899,Null,Null,114689119,111461,2
114689156,0.0,0.0,8999,8999,0,0,8999,Null,Null,114689156,111461,2
114689253,8.0,8.0,7499,7499,0,0,7499,Null,Null,114689253,111461,8220
114689256,122.0,122.0,1000,1000,0,0,1000,Null,Null,114689256,111461,2
114689303,0.0,0.0,1699,1699,0,0,1699,Null,Null,114689303,111461,2
114689359,1.0,1.0,3635,3635,0,0,3635,Null,Null,114689359,111461,2
114689505,9.0,9.0,3999,3999,0,0,3999,Null,Null,114689505,111461,2
114689579,19.0,19.0,6599,6599,0,0,6599,Null,Null,114689579,111461,2
114689859,318.0,318.0,716000,716000,0,0,716000,Null,Null,114689859,273321,1520
114691730,0.0,0.0,38000000,38000000,0,0,38000000,Null,Null,114691730,111461,12590
114694166,0.0,0.0,43000000,41710000,1290000,3,43000000,Null,Null,114694166,111461,12590
114699896,342.0,342.0,260000,234000,26000,10,260000,Null,Null,114699896,5073869,28694
114738040,5.0,5.0,210000,101000,109000,52,210000,Null,Null,114738040,111461,2
114742366,332.0,332.0,49000,49000,0,0,49000,Null,Null,114742366,111461,2
114742871,36.0,36.0,59000,59000,0,0,59000,Null,Null,114742871,111461,2
114759761,0.0,0.0,7700,7700,0,0,7700,Null,Null,114759761,111461,2
114760534,10.0,10.0,6600,6600,0,0,6600,Null,Null,114760534,111461,2
114762652,0.0,0.0,2000,2000,0,0,2000,Null,Null,114762652,111461,2363
114789036,135.0,135.0,85000,85000,0,0,85000,Null,Null,114789036,111461,2
114861600,19.0,19.0,4250000,3772000,478000,11,4250000,Null,Null,114861600,4093985,2340
114893169,0.0,0.0,9798000,9798000,0,0,9798000,Null,Null,114893169,111461,2340
114901727,108.0,108.0,249000,249000,0,0,249000,Null,Null,114901727,111461,28682
114907448,2.0,2.0,750000,750000,0,0,750000,Null,Null,114907448,111461,23236
114912009,17.0,17.0,35000,35000,0,0,35000,Null,Null,114912009,885693,15320
114918242,61.0,61.0,990000,890000,100000,10,990000,Null,Null,114918242,282263,2340
114921906,0.0,0.0,15000000,15000000,0,0,15000000,Null,Null,114921906,254733,28860
114921908,0.0,0.0,14500000,14500000,0,0,14500000,Null,Null,114921908,254733,7079
114963857,62.0,62.0,710000,450000,260000,37,710000,Null,Null,114963857,853809,26652
114976767,1533.0,1533.0,4290000,1929000,2361000,55,4290000,Null,Null,114976767,509711,23376
114987068,0.0,0.0,9000,4900,4100,46,9000,Null,Null,114987068,111461,15318
114987949,0.0,0.0,35000,35000,0,0,35000,Null,Null,114987949,111461,2363
115092053,3004.0,3004.0,74000,74000,0,0,74000,Null,Null,115092053,697923,23346
115094731,4.0,4.0,29000,29000,0,0,29000,Null,Null,115094731,212647,2363
115095546,0.0,0.0,36000000,36000000,0,0,36000000,Null,Null,115095546,111461,23596
115095763,0.0,0.0,36000000,36000000,0,0,36000000,Null,Null,115095763,111461,23678
115098760,132.0,132.0,1310000,1310000,0,0,1310000,Null,Null,115098760,254939,23540
115099251,1.0,1.0,7860000,6550000,1310000,17,7860000,Null,Null,115099251,405211,5384
115100012,0.0,0.0,39000000,39000000,0,0,39000000,Null,Null,115100012,111461,23576
115100274,0.0,0.0,23990000,23990000,0,0,23990000,Null,Null,115100274,18984,4880
115101205,0.0,0.0,25990000,25990000,0,0,25990000,Null,Null,115101205,18984,4880
115102410,0.0,0.0,9170000,6550000,2620000,29,9170000,Null,Null,115102410,405211,5384
115102771,0.0,0.0,9170000,6550000,2620000,29,9170000,Null,Null,115102771,405211,5384
115105450,534.0,534.0,109000,101479,7521,7,109000,Null,Null,115105450,314675,28732
115111316,16.0,16.0,148500,148500,0,0,148500,Null,Null,115111316,294365,13878
115125682,0.0,0.0,6000,6000,0,0,6000,Null,Null,115125682,111461,2
115129397,71.0,71.0,396000,383000,13000,3,396000,Null,Null,115129397,312329,20182
115152485,106.0,106.0,2275,2275,0,0,2275,Null,Null,115152485,111461,2
115152520,0.0,0.0,1582,1582,0,0,1582,Null,Null,115152520,111461,2
115161210,489.0,489.0,1000,1000,0,0,1000,Null,Null,115161210,368715,1819
115201070,1.0,1.0,9699000,9699000,0,0,9699000,Null,Null,115201070,111461,2340
115222600,19.0,19.0,6900,6900,0,0,6900,Null,Null,115222600,111461,2
115223343,0.0,0.0,10000,10000,0,0,10000,Null,Null,115223343,111461,2
115224937,6.0,6.0,5000,5000,0,0,5000,Null,Null,115224937,111461,2
115225872,0.0,0.0,9690000,9690000,0,0,9690000,Null,Null,115225872,111461,2340
115241323,0.0,0.0,42000000,42000000,0,0,42000000,Null,Null,115241323,182341,27240
115254647,0.0,0.0,2000,2000,0,0,2000,Null,Null,115254647,111461,2392
115255604,635.0,635.0,210000,145000,65000,31,210000,Null,Null,115255604,5010125,1613
115266252,438.0,438.0,46000,46000,0,0,46000,Null,Null,115266252,111461,20244
115268103,0.0,0.0,500000,500000,0,0,500000,Null,Null,115268103,111461,5531
115268523,0.0,0.0,13990000,13990000,0,0,13990000,Null,Null,115268523,111461,2324
115270925,0.0,0.0,82999000,79249000,3750000,5,82999000,Null,Null,115270925,183111,23376
115280938,167.0,167.0,98000,96000,2000,2,98000,Null,Null,115280938,111461,20244
115290327,13.0,13.0,35000,18000,17000,49,35000,Null,Null,115290327,111461,15236
115323618,115.0,115.0,590000,590000,0,0,590000,Null,Null,115323618,885047,2016
115325419,18.0,18.0,92000,92000,0,0,92000,Null,Null,115325419,165897,2659
115325466,1.0,1.0,4000,4000,0,0,4000,Null,Null,115325466,111461,28478
115325618,0.0,0.0,9000,8000,1000,11,9000,Null,Null,115325618,111461,1831
115334461,0.0,0.0,13760,13760,0,0,13760,Null,Null,115334461,111461,23036
115482843,407.0,407.0,370000,179000,191000,52,370000,Null,Null,115482843,464405,23388
115495457,0.0,0.0,5850000,5850000,0,0,5850000,Null,Null,115495457,732431,8511
115495473,5.0,5.0,9000,9000,0,0,9000,Null,Null,115495473,111461,2
115495500,6.0,6.0,4000,4000,0,0,4000,Null,Null,115495500,111461,2
115495537,21.0,21.0,4000,4000,0,0,4000,Null,Null,115495537,111461,2
115495727,143.0,143.0,6000,6000,0,0,6000,Null,Null,115495727,111461,2
115495944,18.0,18.0,24000,24000,0,0,24000,Null,Null,115495944,111461,15320
115498677,0.0,0.0,5850000,5850000,0,0,5850000,Null,Null,115498677,732431,8511
115498919,0.0,0.0,5850000,5850000,0,0,5850000,Null,Null,115498919,732431,8511
115501607,0.0,0.0,8610000,6150000,2460000,29,8610000,Null,Null,115501607,732431,8511
115518964,10.0,10.0,159000,159000,0,0,159000,Null,Null,115518964,111461,2
115519291,0.0,0.0,9000,9000,0,0,9000,Null,Null,115519291,111461,2
115520157,0.0,0.0,8610000,6150000,2460000,29,8610000,Null,Null,115520157,732431,8511
115520394,0.0,0.0,6150000,6150000,0,0,6150000,Null,Null,115520394,732431,8511
115522836,103.0,103.0,2000,2000,0,0,2000,Null,Null,115522836,111461,27180
115522846,39.0,39.0,2000,2000,0,0,2000,Null,Null,115522846,111461,27180
115523542,35.0,35.0,40886,40886,0,0,40886,Null,Null,115523542,111461,1883
115524506,0.0,0.0,55000,55000,0,0,55000,Null,Null,115524506,111461,1883
115525485,0.0,0.0,14800000,14800000,0,0,14800000,Null,Null,115525485,254733,8064
115525699,0.0,0.0,14000000,14000000,0,0,14000000,Null,Null,115525699,254733,28870
115525715,0.0,0.0,20000000,20000000,0,0,20000000,Null,Null,115525715,254733,11516
115532506,1387.0,1387.0,190000,145000,45000,24,190000,Null,Null,115532506,883511,2225
115546576,0.0,0.0,292000,292000,0,0,292000,Null,Null,115546576,167853,15318
115551714,84.0,84.0,699000,520000,179000,26,699000,Null,Null,115551714,885047,8400
115551777,0.0,0.0,32000000,32000000,0,0,32000000,Null,Null,115551777,4235555,2
115551783,0.0,0.0,70000000,70000000,0,0,70000000,Null,Null,115551783,4235555,2
115551812,0.0,0.0,37000000,37000000,0,0,37000000,Null,Null,115551812,4235555,2
115551823,0.0,0.0,25000000,25000000,0,0,25000000,Null,Null,115551823,4235555,2
115559649,0.0,0.0,9699000,9699000,0,0,9699000,Null,Null,115559649,111461,2340
115573127,0.0,0.0,10000000,10000000,0,0,10000000,Null,Null,115573127,5088109,8227
115575766,3.0,3.0,16000,16000,0,0,16000,Null,Null,115575766,111461,15250
115575824,1.0,1.0,15000,15000,0,0,15000,Null,Null,115575824,111461,15250
115575952,0.0,0.0,13000,13000,0,0,13000,Null,Null,115575952,111461,15320
115576027,0.0,0.0,15000,15000,0,0,15000,Null,Null,115576027,111461,15236
115576084,0.0,0.0,15000,15000,0,0,15000,Null,Null,115576084,111461,15320
115576128,5.0,5.0,40000,40000,0,0,40000,Null,Null,115576128,111461,15236
115576136,2.0,2.0,17000,17000,0,0,17000,Null,Null,115576136,111461,15250
115576148,3.0,3.0,20000,20000,0,0,20000,Null,Null,115576148,111461,2
115576205,5.0,5.0,16000,16000,0,0,16000,Null,Null,115576205,111461,15236
115576209,41.0,41.0,32000,32000,0,0,32000,Null,Null,115576209,111461,15318
115576211,0.0,0.0,17000,17000,0,0,17000,Null,Null,115576211,111461,15320
115576248,2.0,2.0,25000,25000,0,0,25000,Null,Null,115576248,111461,15250
115576250,1.0,1.0,15000,15000,0,0,15000,Null,Null,115576250,111461,15236
115576277,0.0,0.0,7000,7000,0,0,7000,Null,Null,115576277,111461,2
115576282,4.0,4.0,10000,10000,0,0,10000,Null,Null,115576282,111461,15236
115576293,0.0,0.0,16000,16000,0,0,16000,Null,Null,115576293,111461,15250
115576298,0.0,0.0,14000,14000,0,0,14000,Null,Null,115576298,111461,15320
115621816,0.0,0.0,2400,2400,0,0,2400,Null,Null,115621816,111461,23446
115644981,2.0,2.0,10500,10500,0,0,10500,Null,Null,115644981,111461,15236
115662019,20.0,20.0,419000,406000,13000,3,419000,Null,Null,115662019,111461,5531
115665175,7.0,7.0,6000,6000,0,0,6000,Null,Null,115665175,111461,28574
115673330,3.0,3.0,44699,44699,0,0,44699,Null,Null,115673330,111461,2363
115677920,52.0,52.0,9000,4810,4190,47,9000,Null,Null,115677920,111461,11605
115700417,8.0,8.0,2500,2500,0,0,2500,Null,Null,115700417,111461,2
115720301,50.0,50.0,40000,40000,0,0,40000,Null,Null,115720301,111461,28574
115723041,0.0,0.0,687000,687000,0,0,687000,Null,Null,115723041,111461,2514
115765556,0.0,0.0,20000000,11880000,8120000,41,20000000,Null,Null,115765556,18802,1795
115765559,0.0,0.0,20000000,11880000,8120000,41,20000000,Null,Null,115765559,18802,1795
115784907,0.0,0.0,48000000,48000000,0,0,48000000,Null,Null,115784907,111461,2
115785215,10.0,10.0,250000,250000,0,0,250000,Null,Null,115785215,111461,23588
115786359,472.0,472.0,250000,219000,31000,12,250000,Null,Null,115786359,4244853,28682
115789953,8.0,8.0,198272,198272,0,0,198272,Null,Null,115789953,111461,1936
115790063,0.0,0.0,2450000,2450000,0,0,2450000,Null,Null,115790063,218151,15318
115824773,0.0,0.0,6580000,6580000,0,0,6580000,Null,Null,115824773,218151,15318
115829472,40.0,40.0,450000,450000,0,0,450000,Null,Null,115829472,21653,5531
115830124,0.0,0.0,2088000,2088000,0,0,2088000,Null,Null,115830124,25422,1795
115840385,7.0,7.0,12990000,12990000,0,0,12990000,Null,Null,115840385,217727,8172
115847303,250.0,250.0,199000,119000,80000,40,199000,Null,Null,115847303,4244853,28480
115872882,5.0,5.0,65000,65000,0,0,65000,Null,Null,115872882,885693,15320
115892551,173.0,173.0,338000,270000,68000,20,338000,Null,Null,115892551,53040,13878
115896393,1025.0,1025.0,680000,499000,181000,27,680000,Null,Null,115896393,454561,1623
115896469,2.0,2.0,10000,10000,0,0,10000,Null,Null,115896469,111461,2
115896476,0.0,0.0,5500,5500,0,0,5500,Null,Null,115896476,561415,8167
115896834,1.0,1.0,8000,8000,0,0,8000,Null,Null,115896834,111461,8167
115896915,149.0,149.0,5500,5500,0,0,5500,Null,Null,115896915,111461,8167
115896951,4.0,4.0,4400,4400,0,0,4400,Null,Null,115896951,111461,8167
115905175,0.0,0.0,13462000,13462000,0,0,13462000,Null,Null,115905175,156529,12876
115927016,140.0,140.0,382000,199000,183000,48,382000,Null,Null,115927016,48077,2225
115945200,0.0,0.0,7000,7000,0,0,7000,Null,Null,115945200,111461,8202
115945382,0.0,0.0,9000,9000,0,0,9000,Null,Null,115945382,111461,2
115945518,1.0,1.0,2000,2000,0,0,2000,Null,Null,115945518,111461,8202
115945612,1.0,1.0,5000,5000,0,0,5000,Null,Null,115945612,111461,8205
115945711,1.0,1.0,2000,2000,0,0,2000,Null,Null,115945711,111461,2
115945846,0.0,0.0,2000,2000,0,0,2000,Null,Null,115945846,111461,2
115945868,2.0,2.0,5000,5000,0,0,5000,Null,Null,115945868,111461,2
115946052,8.0,8.0,5000,5000,0,0,5000,Null,Null,115946052,111461,8205
115946069,0.0,0.0,10000,10000,0,0,10000,Null,Null,115946069,111461,8202
115946182,0.0,0.0,3000,3000,0,0,3000,Null,Null,115946182,111461,2
115946223,3.0,3.0,7000,7000,0,0,7000,Null,Null,115946223,111461,2
115946272,8.0,8.0,6600,6600,0,0,6600,Null,Null,115946272,111461,2
115946350,0.0,0.0,7000,7000,0,0,7000,Null,Null,115946350,111461,2
115946374,10.0,10.0,8000,8000,0,0,8000,Null,Null,115946374,111461,8205
115946405,0.0,0.0,10000,10000,0,0,10000,Null,Null,115946405,111461,2
115946552,0.0,0.0,2000,2000,0,0,2000,Null,Null,115946552,111461,2
115946728,2.0,2.0,10000,10000,0,0,10000,Null,Null,115946728,111461,1622
115946749,0.0,0.0,2000,2000,0,0,2000,Null,Null,115946749,111461,2
115946857,0.0,0.0,7000,7000,0,0,7000,Null,Null,115946857,111461,2
115947000,0.0,0.0,2000,2000,0,0,2000,Null,Null,115947000,111461,2
115947045,0.0,0.0,8000,8000,0,0,8000,Null,Null,115947045,111461,2
115947147,0.0,0.0,9000,9000,0,0,9000,Null,Null,115947147,111461,8205
115947154,8.0,8.0,4000,4000,0,0,4000,Null,Null,115947154,111461,2
115947156,0.0,0.0,3000,3000,0,0,3000,Null,Null,115947156,111461,8205
115947160,0.0,0.0,8000,8000,0,0,8000,Null,Null,115947160,111461,2
115947223,0.0,0.0,8000,8000,0,0,8000,Null,Null,115947223,111461,2
115947291,0.0,0.0,2000,2000,0,0,2000,Null,Null,115947291,111461,2
115947301,0.0,0.0,3300,3300,0,0,3300,Null,Null,115947301,111461,8202
115947410,0.0,0.0,5000,5000,0,0,5000,Null,Null,115947410,111461,2
115947471,5.0,5.0,3300,3300,0,0,3300,Null,Null,115947471,111461,2
115947635,102.0,102.0,4000,4000,0,0,4000,Null,Null,115947635,111461,2
115947641,0.0,0.0,5000,5000,0,0,5000,Null,Null,115947641,111461,2
115947647,0.0,0.0,10000,10000,0,0,10000,Null,Null,115947647,111461,2
115947665,1.0,1.0,8000,8000,0,0,8000,Null,Null,115947665,111461,8205
115947670,47.0,47.0,7000,7000,0,0,7000,Null,Null,115947670,111461,2
115947862,0.0,0.0,6600,6600,0,0,6600,Null,Null,115947862,111461,8202
115947877,0.0,0.0,7000,7000,0,0,7000,Null,Null,115947877,111461,2
115947953,0.0,0.0,5000,5000,0,0,5000,Null,Null,115947953,111461,2
115947992,0.0,0.0,3300,3300,0,0,3300,Null,Null,115947992,111461,2
115948015,5.0,5.0,3000,3000,0,0,3000,Null,Null,115948015,111461,2
115948022,0.0,0.0,8000,8000,0,0,8000,Null,Null,115948022,111461,1520
115948041,0.0,0.0,8000,8000,0,0,8000,Null,Null,115948041,111461,8190
115948114,0.0,0.0,8000,8000,0,0,8000,Null,Null,115948114,111461,2
115948152,0.0,0.0,2000,2000,0,0,2000,Null,Null,115948152,111461,2
115948289,0.0,0.0,9000,9000,0,0,9000,Null,Null,115948289,111461,8202
115948310,1.0,1.0,3000,3000,0,0,3000,Null,Null,115948310,111461,8205
115948323,0.0,0.0,2000,2000,0,0,2000,Null,Null,115948323,111461,2306
115948350,1.0,1.0,6000,6000,0,0,6000,Null,Null,115948350,111461,1622
115948433,1.0,1.0,2000,2000,0,0,2000,Null,Null,115948433,111461,2
115948586,0.0,0.0,9000,9000,0,0,9000,Null,Null,115948586,111461,8202
115948754,0.0,0.0,3000,3000,0,0,3000,Null,Null,115948754,111461,2
115948832,0.0,0.0,7000,7000,0,0,7000,Null,Null,115948832,111461,2
115948953,0.0,0.0,3000,3000,0,0,3000,Null,Null,115948953,111461,2
115948968,0.0,0.0,8000,8000,0,0,8000,Null,Null,115948968,111461,8205
115949101,0.0,0.0,8000,8000,0,0,8000,Null,Null,115949101,111461,2
115949107,0.0,0.0,10000,10000,0,0,10000,Null,Null,115949107,111461,2
115949140,0.0,0.0,10000,10000,0,0,10000,Null,Null,115949140,111461,2
115949148,1.0,1.0,7000,7000,0,0,7000,Null,Null,115949148,111461,1520
115949156,0.0,0.0,9999,9999,0,0,9999,Null,Null,115949156,111461,8205
115949179,4.0,4.0,2000,2000,0,0,2000,Null,Null,115949179,111461,2
115949202,0.0,0.0,8000,8000,0,0,8000,Null,Null,115949202,111461,2
115949285,2.0,2.0,5000,5000,0,0,5000,Null,Null,115949285,111461,8205
115949307,1.0,1.0,10000,10000,0,0,10000,Null,Null,115949307,111461,11939
115949314,0.0,0.0,3300,3300,0,0,3300,Null,Null,115949314,111461,2
115949319,0.0,0.0,2000,2000,0,0,2000,Null,Null,115949319,111461,8205
115949428,0.0,0.0,8000,8000,0,0,8000,Null,Null,115949428,111461,2
115949433,21.0,21.0,2000,2000,0,0,2000,Null,Null,115949433,111461,8205
115949450,0.0,0.0,5000,5000,0,0,5000,Null,Null,115949450,111461,1520
115949471,5.0,5.0,2000,2000,0,0,2000,Null,Null,115949471,111461,2
115949526,0.0,0.0,10000,10000,0,0,10000,Null,Null,115949526,111461,2
115949573,103.0,103.0,4000,4000,0,0,4000,Null,Null,115949573,111461,8202
115949578,2.0,2.0,8000,8000,0,0,8000,Null,Null,115949578,111461,2
115949596,1.0,1.0,8000,8000,0,0,8000,Null,Null,115949596,111461,8201
115949690,12.0,12.0,2000,2000,0,0,2000,Null,Null,115949690,111461,2
115949922,1.0,1.0,7000,7000,0,0,7000,Null,Null,115949922,111461,2
115949960,0.0,0.0,7000,7000,0,0,7000,Null,Null,115949960,111461,8172
115949990,5.0,5.0,4000,4000,0,0,4000,Null,Null,115949990,111461,2
115950008,0.0,0.0,5000,5000,0,0,5000,Null,Null,115950008,111461,2
115950062,0.0,0.0,5000,5000,0,0,5000,Null,Null,115950062,111461,8202
115950155,0.0,0.0,6000,6000,0,0,6000,Null,Null,115950155,111461,8205
115950185,9.0,9.0,5000,5000,0,0,5000,Null,Null,115950185,111461,8205
115950237,0.0,0.0,7000,7000,0,0,7000,Null,Null,115950237,111461,8205
115950249,2.0,2.0,7000,7000,0,0,7000,Null,Null,115950249,111461,8205
115950261,0.0,0.0,5000,5000,0,0,5000,Null,Null,115950261,111461,8205
115950301,0.0,0.0,5000,5000,0,0,5000,Null,Null,115950301,111461,8205
115955778,196.0,196.0,93000,93000,0,0,93000,Null,Null,115955778,111461,27214
115960176,457.0,457.0,319000,319000,0,0,319000,Null,Null,115960176,4877037,11889
115966800,495.0,495.0,800000,800000,0,0,800000,Null,Null,115966800,204301,23346
115968317,36.0,36.0,150000,150000,0,0,150000,Null,Null,115968317,111461,49722
115968406,2.0,2.0,38000,38000,0,0,38000,Null,Null,115968406,162313,28574
115971260,180.0,180.0,569000,289000,280000,49,569000,Null,Null,115971260,111461,8512
115980516,32.0,32.0,399000,225000,174000,44,399000,Null,Null,115980516,21651,12918
115980611,45.0,45.0,459000,296000,163000,36,459000,Null,Null,115980611,21651,12918
115986066,8.0,8.0,11000,11000,0,0,11000,Null,Null,115986066,111461,23052
115986994,24.0,24.0,18000,18000,0,0,18000,Null,Null,115986994,111461,2363
115999380,134.0,134.0,98000,70000,28000,29,98000,Null,Null,115999380,243693,12294
116021608,109.0,109.0,120000,115000,5000,4,120000,Null,Null,116021608,5097509,23416
116024554,26.0,26.0,285000,230000,55000,19,285000,Null,Null,116024554,243693,8519
116033353,1.0,1.0,105000000,53750000,51250000,49,105000000,Null,Null,116033353,891455,23376
116048764,2953.0,2953.0,130000,119000,11000,8,130000,Null,Null,116048764,523789,23658
116075742,32.0,32.0,150000,88000,62000,41,150000,Null,Null,116075742,238407,1752
116086592,600.0,600.0,135000,94500,40500,30,135000,Null,Null,116086592,111461,23660
116096713,2.0,2.0,230000,115000,115000,50,230000,Null,Null,116096713,111461,49724
116096779,2.0,2.0,150000,135000,15000,10,150000,Null,Null,116096779,111461,15320
116100574,67.0,67.0,143000,100000,43000,30,143000,Null,Null,116100574,243693,20174
116100653,2.0,2.0,390000,195000,195000,50,390000,Null,Null,116100653,111461,49724
116115756,47.0,47.0,199000,69000,130000,65,199000,Null,Null,116115756,314675,1820
116119833,100.0,100.0,133000,95000,38000,29,133000,Null,Null,116119833,243693,12294
116125939,630.0,630.0,150000,138000,12000,8,150000,Null,Null,116125939,111461,28486
116141038,142.0,142.0,20000,20000,0,0,20000,Null,Null,116141038,111461,23042
116141253,88.0,88.0,260000,199000,61000,23,260000,Null,Null,116141253,243693,12294
116148184,7.0,7.0,5000,5000,0,0,5000,Null,Null,116148184,111461,20240
116161777,0.0,0.0,18000,18000,0,0,18000,Null,Null,116161777,111461,15320
116176657,0.0,0.0,2000,2000,0,0,2000,Null,Null,116176657,111461,2
116189274,107.0,107.0,79000,79000,0,0,79000,Null,Null,116189274,864561,1622
116191376,405.0,405.0,150000,89000,61000,41,150000,Null,Null,116191376,207367,23078
116194000,249.0,249.0,250000,199000,51000,20,250000,Null,Null,116194000,883511,2225
116196696,0.0,0.0,2000,2000,0,0,2000,Null,Null,116196696,111461,2
116244839,101.0,101.0,3350000,2300000,1050000,31,3350000,Null,Null,116244839,631569,2340
116244976,591.0,591.0,149000,149000,0,0,149000,Null,Null,116244976,5076287,2514
116245693,1.0,1.0,46000,46000,0,0,46000,Null,Null,116245693,885693,15320
116250359,0.0,0.0,2500,2500,0,0,2500,Null,Null,116250359,111461,23678
116254763,0.0,0.0,3000,3000,0,0,3000,Null,Null,116254763,111461,2363
116254794,36.0,36.0,136000,136000,0,0,136000,Null,Null,116254794,475611,1634
116255525,6.0,6.0,6200000,6200000,0,0,6200000,Null,Null,116255525,111461,11873
116267779,0.0,0.0,3800000,3800000,0,0,3800000,Null,Null,116267779,111461,8170
116269358,11.0,11.0,6090000,3897000,2193000,36,6090000,Null,Null,116269358,148535,23376
116270289,170.0,170.0,49000,49000,0,0,49000,Null,Null,116270289,5076287,2514
116300329,0.0,0.0,189996,189996,0,0,189996,Null,Null,116300329,111461,2
116330790,0.0,0.0,124000,124000,0,0,124000,Null,Null,116330790,738407,15236
116350517,0.0,0.0,45900000,34500000,11400000,25,45900000,Null,Null,116350517,184543,2340
116369227,1392.0,1392.0,65000,45000,20000,31,65000,Null,Null,116369227,153450,8305
116379274,0.0,0.0,18499,18499,0,0,18499,Null,Null,116379274,111461,15318
116379360,1.0,1.0,19000,19000,0,0,19000,Null,Null,116379360,111461,15250
116380839,4.0,4.0,19000,19000,0,0,19000,Null,Null,116380839,111461,2
116381906,8.0,8.0,48000,48000,0,0,48000,Null,Null,116381906,111461,8202
116382077,0.0,0.0,7650000,7650000,0,0,7650000,Null,Null,116382077,417653,8172
116382556,650.0,650.0,299000,99000,200000,67,299000,Null,Null,116382556,302375,1838
116387760,0.0,0.0,18000,18000,0,0,18000,Null,Null,116387760,111461,15320
116416531,2331.0,2331.0,295000,222000,73000,25,295000,Null,Null,116416531,212149,1613
116418824,391.0,391.0,120000,105000,15000,13,120000,Null,Null,116418824,225363,3426
116424117,368.0,368.0,89000,59000,30000,34,89000,Null,Null,116424117,32909,1601
116426405,2192.0,2192.0,590000,423000,167000,28,590000,Null,Null,116426405,212149,8223
116438272,11712.0,11712.0,110000,90000,20000,18,110000,Null,Null,116438272,41660,17170
116444500,17.0,17.0,990000,800000,190000,19,990000,Null,Null,116444500,885047,2016
116446788,5425.0,5425.0,171000,128000,43000,25,171000,Null,Null,116446788,41660,13878
116452389,7.0,7.0,150000,150000,0,0,150000,Null,Null,116452389,111461,49722
116455410,348.0,348.0,38000,29000,9000,24,38000,Null,Null,116455410,32909,1583
116455546,1.0,1.0,378000,189000,189000,50,378000,Null,Null,116455546,111461,49724
116458841,587.0,587.0,200000,100000,100000,50,200000,Null,Null,116458841,5097407,1623
116481669,573.0,573.0,60000,36000,24000,40,60000,Null,Null,116481669,5097407,1623
116491059,208.0,208.0,60000,36000,24000,40,60000,Null,Null,116491059,5097407,1623
116499333,282.0,282.0,189000,189000,0,0,189000,Null,Null,116499333,32909,1601
116525425,10.0,10.0,7300,7300,0,0,7300,Null,Null,116525425,111461,2
116525918,41.0,41.0,47000,47000,0,0,47000,Null,Null,116525918,111461,2
116565404,238.0,238.0,25000,25000,0,0,25000,Null,Null,116565404,739589,2685
116566083,333.0,333.0,199000,119000,80000,40,199000,Null,Null,116566083,302375,1838
116582335,3.0,3.0,30000,30000,0,0,30000,Null,Null,116582335,111461,28484
116583246,1.0,1.0,6800000,6800000,0,0,6800000,Null,Null,116583246,111461,1789
116583413,1.0,1.0,5999000,5999000,0,0,5999000,Null,Null,116583413,111461,1789
116583499,147.0,147.0,15000,9000,6000,40,15000,Null,Null,116583499,4249979,11883
116583922,11.0,11.0,1960,1960,0,0,1960,Null,Null,116583922,111461,2
116595554,169.0,169.0,11200,8000,3200,29,11200,Null,Null,116595554,111461,8305
116598902,476.0,476.0,199000,149000,50000,25,199000,Null,Null,116598902,4430657,27194
116616703,3.0,3.0,358000,179000,179000,50,358000,Null,Null,116616703,111461,49724
116617893,81.0,81.0,300000,240000,60000,20,300000,Null,Null,116617893,3977923,3422
116618707,47.0,47.0,7900,7900,0,0,7900,Null,Null,116618707,111461,2
116631452,24.0,24.0,350000,178000,172000,49,350000,Null,Null,116631452,111461,2977
116638376,0.0,0.0,8000,8000,0,0,8000,Null,Null,116638376,111461,2
116638640,66.0,66.0,129000,115000,14000,11,129000,Null,Null,116638640,26209,1832
116638896,0.0,0.0,15000,15000,0,0,15000,Null,Null,116638896,111461,15936
116639537,15.0,15.0,9000,9000,0,0,9000,Null,Null,116639537,111461,2
116653013,3.0,3.0,398000,398000,0,0,398000,Null,Null,116653013,111461,2971
116667583,454.0,454.0,6473,6000,473,7,6473,Null,Null,116667583,111461,2234
116670105,217.0,217.0,275000,275000,0,0,275000,Null,Null,116670105,111461,53074
116721676,0.0,0.0,6650000,6650000,0,0,6650000,Null,Null,116721676,226667,11873
116725239,209.0,209.0,249000,161000,88000,35,249000,Null,Null,116725239,302375,1838
116726951,1664.0,1664.0,918000,459000,459000,50,918000,Null,Null,116726951,3955813,23362
116754406,338.0,338.0,8000,8000,0,0,8000,Null,Null,116754406,549763,20222
116759055,148.0,148.0,550000,545000,5000,1,550000,Null,Null,116759055,148535,23362
116766480,264.0,264.0,59000,59000,0,0,59000,Null,Null,116766480,5076287,23340
116775606,11.0,11.0,2000,2000,0,0,2000,Null,Null,116775606,111461,2
116775674,4.0,4.0,3000,3000,0,0,3000,Null,Null,116775674,111461,8167
116783441,193.0,193.0,235200,235200,0,0,235200,Null,Null,116783441,261973,28674
116785186,82.0,82.0,98000,79000,19000,19,98000,Null,Null,116785186,32909,2347
116812152,1.0,1.0,5999000,5099150,899850,15,5999000,Null,Null,116812152,31670,8225
116812638,67.0,67.0,360000,185000,175000,49,360000,Null,Null,116812638,148534,1641
116841515,67.0,67.0,16000,16000,0,0,16000,Null,Null,116841515,561415,15320
116863869,59.0,59.0,14000,14000,0,0,14000,Null,Null,116863869,561415,15320
116864472,6.0,6.0,19000,19000,0,0,19000,Null,Null,116864472,561415,15320
116864611,92.0,92.0,19000,19000,0,0,19000,Null,Null,116864611,561415,15320
116864657,16.0,16.0,16000,16000,0,0,16000,Null,Null,116864657,561415,15320
116874223,0.0,0.0,3900000,3900000,0,0,3900000,Null,Null,116874223,252285,8225
116881780,1.0,1.0,4999000,4999000,0,0,4999000,Null,Null,116881780,111461,2340
116962541,138.0,138.0,99000,93060,5940,6,99000,Null,Null,116962541,21651,12294
116966601,470.0,470.0,275000,235000,40000,15,275000,Null,Null,116966601,5063093,3179
117002182,143.0,143.0,50000,26000,24000,48,50000,Null,Null,117002182,111461,23416
117002224,959.0,959.0,45000,24000,21000,47,45000,Null,Null,117002224,204893,23416
117002314,2170.0,2170.0,25000,14000,11000,44,25000,Null,Null,117002314,204893,23416
117002351,19.0,19.0,40150,40150,0,0,40150,Null,Null,117002351,111461,23416
117002371,194.0,194.0,33000,16000,17000,52,33000,Null,Null,117002371,111461,23416
117002376,50.0,50.0,19200,9000,10200,53,19200,Null,Null,117002376,48567,2
117002624,38.0,38.0,1036000,739000,297000,29,1036000,Null,Null,117002624,26150,8516
117024412,0.0,0.0,2000,2000,0,0,2000,Null,Null,117024412,111461,2363
117031899,38.0,38.0,389000,320000,69000,18,389000,Null,Null,117031899,243693,12294
117032369,40.0,40.0,260000,170000,90000,35,260000,Null,Null,117032369,243693,28732
117032381,35.0,35.0,43000,43000,0,0,43000,Null,Null,117032381,111461,23022
117032461,780.0,780.0,275000,137500,137500,50,275000,Null,Null,117032461,892751,1936
117036056,0.0,0.0,3980000,3980000,0,0,3980000,Null,Null,117036056,27398,8205
117036596,0.0,0.0,12250000,12250000,0,0,12250000,Null,Null,117036596,4729325,15236
117036599,0.0,0.0,10500000,10500000,0,0,10500000,Null,Null,117036599,27398,11935
117042354,0.0,0.0,8560000,8560000,0,0,8560000,Null,Null,117042354,218151,15318
117042528,0.0,0.0,6550000,6550000,0,0,6550000,Null,Null,117042528,27398,8167
117046537,148.0,148.0,91000,91000,0,0,91000,Null,Null,117046537,243693,28480
117048668,0.0,0.0,2000,2000,0,0,2000,Null,Null,117048668,111461,2363
117057206,40.0,40.0,350000,350000,0,0,350000,Null,Null,117057206,454787,23416
117073999,5.0,5.0,51000,35000,16000,31,51000,Null,Null,117073999,111461,15250
117074094,3.0,3.0,46000,25000,21000,46,46000,Null,Null,117074094,111461,15250
117074205,5.0,5.0,59000,39000,20000,34,59000,Null,Null,117074205,111461,15250
117076504,102.0,102.0,560000,280000,280000,50,560000,Null,Null,117076504,4514729,2225
117084256,10.0,10.0,7500,7500,0,0,7500,Null,Null,117084256,111461,8167
117084890,255.0,255.0,7000000,3700000,3300000,47,7000000,Null,Null,117084890,213611,8172
117089875,0.0,0.0,4577000,4577000,0,0,4577000,Null,Null,117089875,27449,8165
117132490,566.0,566.0,50000,50000,0,0,50000,Null,Null,117132490,323847,11873
117138914,0.0,0.0,38760000,38760000,0,0,38760000,Null,Null,117138914,148826,2154
117144696,1.0,1.0,16500000,16500000,0,0,16500000,Null,Null,117144696,18641,28392
117147635,26573.0,26573.0,112200,100000,12200,11,112200,Null,Null,117147635,185075,1520
117147637,5734.0,5734.0,112200,105000,7200,6,112200,Null,Null,117147637,185075,1520
117161148,119.0,119.0,138000,138000,0,0,138000,Null,Null,117161148,25422,1634
117170051,8851.0,8851.0,414000,218000,196000,47,414000,Null,Null,117170051,185075,1520
117170053,899.0,899.0,136400,129000,7400,5,136400,Null,Null,117170053,185075,1520
117172675,466.0,466.0,20500,20500,0,0,20500,Null,Null,117172675,111461,2
117175571,185.0,185.0,3350000,1995000,1355000,40,3350000,Null,Null,117175571,631569,2340
117195930,781.0,781.0,94360,94360,0,0,94360,Null,Null,117195930,21437,1883
117196166,112.0,112.0,45000,45000,0,0,45000,Null,Null,117196166,21437,2
117197110,0.0,0.0,6500000,6500000,0,0,6500000,Null,Null,117197110,4683951,8511
117198035,290.0,290.0,11000,11000,0,0,11000,Null,Null,117198035,111461,2
117207768,20.0,20.0,495000,495000,0,0,495000,Null,Null,117207768,144845,53190
117212183,43.0,43.0,19570,19570,0,0,19570,Null,Null,117212183,144845,53190
117220904,38.0,38.0,75000,75000,0,0,75000,Null,Null,117220904,111454,5006
117221300,0.0,0.0,16960000,16960000,0,0,16960000,Null,Null,117221300,156529,12876
117222715,83.0,83.0,3549000,2799000,750000,21,3549000,Null,Null,117222715,218061,8165
117256464,6.0,6.0,28000,28000,0,0,28000,Null,Null,117256464,111461,15320
117257499,462.0,462.0,236000,199000,37000,16,236000,Null,Null,117257499,79688,8223
117260689,144.0,144.0,236000,199000,37000,16,236000,Null,Null,117260689,79688,8223
117266281,0.0,0.0,5000,5000,0,0,5000,Null,Null,117266281,111461,2
117266528,1.0,1.0,10000,10000,0,0,10000,Null,Null,117266528,111461,2
117282871,0.0,0.0,3540000,3540000,0,0,3540000,Null,Null,117282871,27398,2340
117297919,1233.0,1233.0,186000,154000,32000,17,186000,Null,Null,117297919,198555,1613
117300155,341.0,341.0,350000,210000,140000,40,350000,Null,Null,117300155,5075559,28684
117318253,929.0,929.0,570000,409000,161000,28,570000,Null,Null,117318253,509711,23376
117347869,0.0,0.0,15230000,15230000,0,0,15230000,Null,Null,117347869,472079,8061
117348004,0.0,0.0,11500000,11500000,0,0,11500000,Null,Null,117348004,111461,2
117348287,16.0,16.0,250000,250000,0,0,250000,Null,Null,117348287,111461,2
117348392,0.0,0.0,250000,250000,0,0,250000,Null,Null,117348392,111461,2
117348514,0.0,0.0,250000,250000,0,0,250000,Null,Null,117348514,111461,2
117348652,1.0,1.0,14999,14999,0,0,14999,Null,Null,117348652,111461,49726
117348666,2.0,2.0,320000,320000,0,0,320000,Null,Null,117348666,111461,2
117348878,1.0,1.0,290000,290000,0,0,290000,Null,Null,117348878,111461,2
117353723,2345.0,2345.0,29000,29000,0,0,29000,Null,Null,117353723,293033,23392
117370391,0.0,0.0,5885000,5885000,0,0,5885000,Null,Null,117370391,25502,8511
117370665,683.0,683.0,46000,46000,0,0,46000,Null,Null,117370665,293033,23392
117371096,17.0,17.0,9000,9000,0,0,9000,Null,Null,117371096,111461,8194
117374617,0.0,0.0,11890000,11890000,0,0,11890000,Null,Null,117374617,111461,11925
117390058,60.0,60.0,350000,238000,112000,32,350000,Null,Null,117390058,5075559,28684
117445027,184.0,184.0,149000,89000,60000,40,149000,Null,Null,117445027,625853,4428
117463306,89.0,89.0,229000,99000,130000,57,229000,Null,Null,117463306,625853,12908
117490054,8.0,8.0,15000,15000,0,0,15000,Null,Null,117490054,111461,15318
117490679,17.0,17.0,165000,165000,0,0,165000,Null,Null,117490679,111461,8371
117498670,41.0,41.0,459000,459000,0,0,459000,Null,Null,117498670,151077,1984
117557699,3.0,3.0,3800,2000,1800,47,3800,Null,Null,117557699,111461,3178
117557862,61.0,61.0,1400,1400,0,0,1400,Null,Null,117557862,111461,2
117559127,43.0,43.0,1000,1000,0,0,1000,Null,Null,117559127,111461,2
117564189,0.0,0.0,1000,1000,0,0,1000,Null,Null,117564189,111461,2363
117570362,222.0,222.0,96000,70000,26000,27,96000,Null,Null,117570362,355795,11857
117576458,4.0,4.0,46000,35000,11000,24,46000,Null,Null,117576458,111461,15318
117578317,46.0,46.0,33000,25000,8000,24,33000,Null,Null,117578317,111461,15318
117594408,4.0,4.0,46000,39000,7000,15,46000,Null,Null,117594408,111461,15318
117595050,5.0,5.0,175000,129000,46000,26,175000,Null,Null,117595050,4743605,15318
117597661,4.0,4.0,25000,19000,6000,24,25000,Null,Null,117597661,111461,15318
117598994,1.0,1.0,90000,90000,0,0,90000,Null,Null,117598994,4743605,15318
117599148,2.0,2.0,18000000,15000000,3000000,17,18000000,Null,Null,117599148,53189,2342
117599628,1.0,1.0,51000,39000,12000,24,51000,Null,Null,117599628,4743605,15318
117599795,4.0,4.0,51000,35000,16000,31,51000,Null,Null,117599795,111461,15318
117599948,1.0,1.0,8990000,8990000,0,0,8990000,Null,Null,117599948,47424,2
117635957,0.0,0.0,250000,129999,120001,48,250000,Null,Null,117635957,111454,12294
117640382,3.0,3.0,38000,25000,13000,34,38000,Null,Null,117640382,111461,15236
117645437,17.0,17.0,81000,81000,0,0,81000,Null,Null,117645437,144845,53190
117646710,6.0,6.0,52000,39000,13000,25,52000,Null,Null,117646710,111461,15236
117656718,210.0,210.0,30000,30000,0,0,30000,Null,Null,117656718,111461,2
117661969,31.0,31.0,33000,25000,8000,24,33000,Null,Null,117661969,111461,15236
117681068,5.0,5.0,35000,25000,10000,29,35000,Null,Null,117681068,111461,15236
117686247,6.0,6.0,4950000,4207500,742500,15,4950000,Null,Null,117686247,111461,2340
117686256,12.0,12.0,4090000,3640100,449900,11,4090000,Null,Null,117686256,111461,2340
117692735,2.0,2.0,1000,1000,0,0,1000,Null,Null,117692735,111461,2
117694592,1384.0,1384.0,1290000,1050000,240000,19,1290000,Null,Null,117694592,18641,2324
117719927,8.0,8.0,30000,25000,5000,17,30000,Null,Null,117719927,111461,15236
117735026,4.0,4.0,75000,55000,20000,27,75000,Null,Null,117735026,111461,15320
117737738,11.0,11.0,68999,68999,0,0,68999,Null,Null,117737738,111461,23246
117791367,1.0,1.0,125896,125896,0,0,125896,Null,Null,117791367,111461,2
117791386,40.0,40.0,150000,150000,0,0,150000,Null,Null,117791386,561415,23282
117793708,0.0,0.0,75000000,75000000,0,0,75000000,Null,Null,117793708,231867,27240
117793839,1469.0,1469.0,1200000,669000,531000,44,1200000,Null,Null,117793839,234665,1626
117794005,0.0,0.0,27000,19000,8000,30,27000,Null,Null,117794005,111461,15320
117805147,0.0,0.0,5000000,5000000,0,0,5000000,Null,Null,117805147,144695,11877
117819575,1.0,1.0,26000,19000,7000,27,26000,Null,Null,117819575,111461,15320
117819868,0.0,0.0,750000,750000,0,0,750000,Null,Null,117819868,5043913,6305
117894383,509.0,509.0,45000,39000,6000,13,45000,Null,Null,117894383,53040,13878
117894564,14.0,14.0,19900,19900,0,0,19900,Null,Null,117894564,111461,15250
117894573,0.0,0.0,18000,18000,0,0,18000,Null,Null,117894573,111461,15250
117900327,0.0,0.0,6500000,6500000,0,0,6500000,Null,Null,117900327,4683951,8511
117926455,3.0,3.0,14750000,11500000,3250000,22,14750000,Null,Null,117926455,53189,2342
117926982,696.0,696.0,1100000,599000,501000,46,1100000,Null,Null,117926982,234665,1626
117927305,189.0,189.0,1000000,534000,466000,47,1000000,Null,Null,117927305,234665,1626
117927643,5.0,5.0,499000,499000,0,0,499000,Null,Null,117927643,18804,8061
117927658,85.0,85.0,990000,620000,370000,37,990000,Null,Null,117927658,111461,28398
117929342,1.0,1.0,575000,575000,0,0,575000,Null,Null,117929342,18804,8061
117929538,6.0,6.0,675000,675000,0,0,675000,Null,Null,117929538,18804,8061
117929550,0.0,0.0,8785714,8785714,0,0,8785714,Null,Null,117929550,4683951,8511
117929676,0.0,0.0,9642857,9642857,0,0,9642857,Null,Null,117929676,4683951,8511
117970799,0.0,0.0,46000000,46000000,0,0,46000000,Null,Null,117970799,231867,7713
117971804,1233.0,1233.0,99000,56000,43000,43,99000,Null,Null,117971804,523789,23588
117973899,1.0,1.0,89000,80100,8900,10,89000,Null,Null,117973899,561415,15320
117974558,171.0,171.0,69000,55000,14000,20,69000,Null,Null,117974558,314675,1837
117974701,51.0,51.0,249000,149000,100000,40,249000,Null,Null,117974701,314675,1838
117975283,0.0,0.0,9642857,6750000,2892857,30,9642857,Null,Null,117975283,4683951,8511
117987260,574.0,574.0,240000,220000,20000,8,240000,Null,Null,117987260,4958627,1813
118013604,222.0,222.0,400000,265000,135000,34,400000,Null,Null,118013604,201089,23588
118053841,69.0,69.0,788000,398000,390000,49,788000,Null,Null,118053841,4246951,8225
118084791,2.0,2.0,10900000,10900000,0,0,10900000,Null,Null,118084791,5069951,11925
118100164,52.0,52.0,709000,709000,0,0,709000,Null,Null,118100164,18804,8061
118100268,0.0,0.0,1199000,1199000,0,0,1199000,Null,Null,118100268,18804,8061
118102419,95.0,95.0,350000,189000,161000,46,350000,Null,Null,118102419,201089,23588
118103703,0.0,0.0,1529000,1529000,0,0,1529000,Null,Null,118103703,18804,8061
118124185,92.0,92.0,300000,300000,0,0,300000,Null,Null,118124185,5173699,11871
118124189,58.0,58.0,740000,740000,0,0,740000,Null,Null,118124189,5181029,11879
118124199,1.0,1.0,1949000,1949000,0,0,1949000,Null,Null,118124199,18804,8061
118130919,17.0,17.0,1099000,1099000,0,0,1099000,Null,Null,118130919,18804,8061
118136024,0.0,0.0,2400,2400,0,0,2400,Null,Null,118136024,111461,2
118136089,10.0,10.0,1320,1320,0,0,1320,Null,Null,118136089,111461,2
118136229,2.0,2.0,1749000,1749000,0,0,1749000,Null,Null,118136229,18804,8061
118139108,26.0,26.0,2059000,2059000,0,0,2059000,Null,Null,118139108,18804,8061
118146255,6.0,6.0,2189000,2189000,0,0,2189000,Null,Null,118146255,18804,8061
118175149,10.0,10.0,3500000,3445000,55000,2,3500000,Null,Null,118175149,5175723,8172
118180563,0.0,0.0,12785714,12785714,0,0,12785714,Null,Null,118180563,405211,8511
118182554,15.0,15.0,3000,3000,0,0,3000,Null,Null,118182554,111461,2
118191823,0.0,0.0,12785714,8950000,3835714,30,12785714,Null,Null,118191823,405211,8511
118199336,7.0,7.0,7000,7000,0,0,7000,Null,Null,118199336,111461,2
118199378,46.0,46.0,9000,9000,0,0,9000,Null,Null,118199378,111461,8197
118201248,27.0,27.0,5990000,3590000,2400000,40,5990000,Null,Null,118201248,25643,2657
118208273,0.0,0.0,6357143,6357143,0,0,6357143,Null,Null,118208273,405211,8511
118208939,0.0,0.0,6357143,6357143,0,0,6357143,Null,Null,118208939,405211,8511
118226310,0.0,0.0,260000,260000,0,0,260000,Null,Null,118226310,111461,2805
118275020,365.0,365.0,50000,50000,0,0,50000,Null,Null,118275020,549763,1831
118275176,20.0,20.0,2000,1000,1000,50,2000,Null,Null,118275176,111461,2
118280432,0.0,0.0,5800000,5800000,0,0,5800000,Null,Null,118280432,622483,17170
118280494,40.0,40.0,238000,119000,119000,50,238000,Null,Null,118280494,111461,23162
118338106,5.0,5.0,7000,7000,0,0,7000,Null,Null,118338106,111461,2
118420767,1006.0,1006.0,21000,21000,0,0,21000,Null,Null,118420767,549763,28674
118424390,39.0,39.0,141000,141000,0,0,141000,Null,Null,118424390,150002,1838
118429716,213.0,213.0,107999,107999,0,0,107999,Null,Null,118429716,111461,2784
118433132,4.0,4.0,121000,117000,4000,3,121000,Null,Null,118433132,111461,1984
118451214,11.0,11.0,127720,127720,0,0,127720,Null,Null,118451214,144845,53190
118486668,2.0,2.0,12000000,12000000,0,0,12000000,Null,Null,118486668,183625,28856
118487992,0.0,0.0,5499000,5499000,0,0,5499000,Null,Null,118487992,5144693,11925
118494020,79.0,79.0,1852,1852,0,0,1852,Null,Null,118494020,111461,2363
118510845,0.0,0.0,52000000,52000000,0,0,52000000,Null,Null,118510845,111461,23708
118510848,0.0,0.0,52000000,52000000,0,0,52000000,Null,Null,118510848,111461,23708
118510857,0.0,0.0,56500000,56500000,0,0,56500000,Null,Null,118510857,111461,23708
118510864,0.0,0.0,85000000,85000000,0,0,85000000,Null,Null,118510864,111461,23544
118510879,0.0,0.0,62000000,62000000,0,0,62000000,Null,Null,118510879,111461,23708
118510911,0.0,0.0,66000000,66000000,0,0,66000000,Null,Null,118510911,111461,23708
118511001,0.0,0.0,50000000,50000000,0,0,50000000,Null,Null,118511001,111461,27186
118511012,0.0,0.0,44000000,44000000,0,0,44000000,Null,Null,118511012,111461,27186
118511027,0.0,0.0,60000000,60000000,0,0,60000000,Null,Null,118511027,111461,23708
118511057,0.0,0.0,51000000,51000000,0,0,51000000,Null,Null,118511057,111461,23708
118511110,0.0,0.0,68000000,68000000,0,0,68000000,Null,Null,118511110,111461,23708
118520851,42.0,42.0,320000,320000,0,0,320000,Null,Null,118520851,111461,12590
118532880,0.0,0.0,2500,2500,0,0,2500,Null,Null,118532880,5144097,23340
118535555,63.0,63.0,1888,1888,0,0,1888,Null,Null,118535555,111461,20222
118575537,92.0,92.0,16000,16000,0,0,16000,Null,Null,118575537,111461,23048
118578527,0.0,0.0,17900000,17900000,0,0,17900000,Null,Null,118578527,632211,5566
118585192,26.0,26.0,165000,165000,0,0,165000,Null,Null,118585192,111461,2
118586201,3.0,3.0,99000,99000,0,0,99000,Null,Null,118586201,111461,2
118680983,0.0,0.0,37796000,37796000,0,0,37796000,Null,Null,118680983,5132429,27196
118687498,0.0,0.0,2400,2400,0,0,2400,Null,Null,118687498,111461,2685
118687960,0.0,0.0,1800,1800,0,0,1800,Null,Null,118687960,111461,2
118688787,0.0,0.0,3000,3000,0,0,3000,Null,Null,118688787,111461,2
118693226,0.0,0.0,42834000,42834000,0,0,42834000,Null,Null,118693226,5132429,27196
118708687,6061.0,6061.0,495000,250000,245000,49,495000,Null,Null,118708687,631569,11907
118722616,240.0,240.0,66000,66000,0,0,66000,Null,Null,118722616,18984,1837
118781325,37.0,37.0,3900000,3900000,0,0,3900000,Null,Null,118781325,5069951,8172
118788259,718.0,718.0,1150000,713000,437000,38,1150000,Null,Null,118788259,160211,3422
118795959,549.0,549.0,149000,129000,20000,13,149000,Null,Null,118795959,5147565,28480
118797341,188.0,188.0,1750000,1715000,35000,2,1750000,Null,Null,118797341,199801,11885
118805673,226.0,226.0,30000,30000,0,0,30000,Null,Null,118805673,5063093,2337
118858137,2035.0,2035.0,70000,25000,45000,64,70000,Null,Null,118858137,5063093,3216
118881107,0.0,0.0,9000,9000,0,0,9000,Null,Null,118881107,111461,2
118896584,143.0,143.0,114000,114000,0,0,114000,Null,Null,118896584,873101,8224
118896594,84.0,84.0,209000,209000,0,0,209000,Null,Null,118896594,873101,8224
118896600,744.0,744.0,114000,114000,0,0,114000,Null,Null,118896600,873101,8224
118897157,410.0,410.0,13000,10000,3000,23,13000,Null,Null,118897157,111461,23024
118898224,652.0,652.0,75000,75000,0,0,75000,Null,Null,118898224,517665,23304
118960590,2387.0,2387.0,20000,20000,0,0,20000,Null,Null,118960590,746615,2363
118966833,4849.0,4849.0,42000,42000,0,0,42000,Null,Null,118966833,746615,2363
118979559,33.0,33.0,159000,154000,5000,3,159000,Null,Null,118979559,111461,28480
118997870,656.0,656.0,129000,129000,0,0,129000,Null,Null,118997870,561415,23006
118997954,0.0,0.0,19900,19900,0,0,19900,Null,Null,118997954,111461,2
119030223,27.0,27.0,8990,8990,0,0,8990,Null,Null,119030223,46703,53074
119054075,60.0,60.0,255000,255000,0,0,255000,Null,Null,119054075,508185,12294
119054540,0.0,0.0,11500000,11500000,0,0,11500000,Null,Null,119054540,5082963,8172
119068085,164.0,164.0,159000,159000,0,0,159000,Null,Null,119068085,18805,5263
119068215,8.0,8.0,175000,175000,0,0,175000,Null,Null,119068215,27397,8170
119088127,117.0,117.0,11500,11500,0,0,11500,Null,Null,119088127,111461,2
119090631,667.0,667.0,1150000,759000,391000,34,1150000,Null,Null,119090631,160211,3422
119108082,2.0,2.0,37499000,37499000,0,0,37499000,Null,Null,119108082,616035,4381
119111659,104.0,104.0,169000,169000,0,0,169000,Null,Null,119111659,111461,23436
119195755,2690.0,2690.0,849000,849000,0,0,849000,Null,Null,119195755,746615,23832
119220427,683.0,683.0,340000,170000,170000,50,340000,Null,Null,119220427,892751,1936
119242259,50.0,50.0,9000,9000,0,0,9000,Null,Null,119242259,111461,15236
119251217,109.0,109.0,150000,144000,6000,4,150000,Null,Null,119251217,149699,1583
119251241,44.0,44.0,256000,244000,12000,5,256000,Null,Null,119251241,149699,1583
119251243,117.0,117.0,366000,352000,14000,4,366000,Null,Null,119251243,149699,1583
119252665,38.0,38.0,256000,240000,16000,6,256000,Null,Null,119252665,149699,17170
119253262,193.0,193.0,649000,499000,150000,23,649000,Null,Null,119253262,174389,11905
119254247,74.0,74.0,65000,57000,8000,12,65000,Null,Null,119254247,217777,5900
119256243,7.0,7.0,2000,2000,0,0,2000,Null,Null,119256243,111461,23340
119257142,166.0,166.0,1490,1490,0,0,1490,Null,Null,119257142,111461,53054
119257365,529.0,529.0,19000,12001,6999,37,19000,Null,Null,119257365,848485,28616
119261360,79.0,79.0,29000,29000,0,0,29000,Null,Null,119261360,111461,2019
119285508,479.0,479.0,185000,175000,10000,5,185000,Null,Null,119285508,4928543,11853
119286990,0.0,0.0,11500000,11500000,0,0,11500000,Null,Null,119286990,443897,7079
119308869,65.0,65.0,168000,168000,0,0,168000,Null,Null,119308869,111461,2019
119309533,2081.0,2081.0,738000,369000,369000,50,738000,Null,Null,119309533,3955813,23362
119324944,0.0,0.0,28500000,27930000,570000,2,28500000,Null,Null,119324944,167287,28860
119329526,0.0,0.0,2000,1000,1000,50,2000,Null,Null,119329526,111461,15936
119329694,0.0,0.0,15000,10000,5000,33,15000,Null,Null,119329694,111461,15320
119329868,78.0,78.0,50000,50000,0,0,50000,Null,Null,119329868,111461,2685
119364142,0.0,0.0,25000000,25000000,0,0,25000000,Null,Null,119364142,212667,28862
119366471,45.0,45.0,473000,473000,0,0,473000,Null,Null,119366471,4888937,5267
119369098,1.0,1.0,10000,10000,0,0,10000,Null,Null,119369098,111461,15320
119369167,0.0,0.0,19000,19000,0,0,19000,Null,Null,119369167,111461,15936
119369188,8.0,8.0,45000,45000,0,0,45000,Null,Null,119369188,111461,15250
119369198,1.0,1.0,199000,199000,0,0,199000,Null,Null,119369198,111461,15250
119374088,250.0,250.0,2699000,1349000,1350000,50,2699000,Null,Null,119374088,19813,1984
119384909,0.0,0.0,28500000,27930000,570000,2,28500000,Null,Null,119384909,167287,28860
119404695,52.0,52.0,550000,550000,0,0,550000,Null,Null,119404695,111461,2
119439800,0.0,0.0,6000,6000,0,0,6000,Null,Null,119439800,111461,28486
119445387,23.0,23.0,50060,45054,5006,10,50060,Null,Null,119445387,829199,3177
119446279,15.0,15.0,1650,1650,0,0,1650,Null,Null,119446279,579813,2514
119448019,2.0,2.0,2000,2000,0,0,2000,Null,Null,119448019,111461,2
119449900,508.0,508.0,215000,215000,0,0,215000,Null,Null,119449900,27397,3515
119450018,37.0,37.0,129184,129184,0,0,129184,Null,Null,119450018,111461,1634
119450718,0.0,0.0,4900,4802,98,2,4900,Null,Null,119450718,111461,28480
119461456,0.0,0.0,4150000,4150000,0,0,4150000,Null,Null,119461456,52232,1795
119464777,97.0,97.0,1879000,1344000,535000,28,1879000,Null,Null,119464777,19673,1795
119478160,0.0,0.0,24500000,24500000,0,0,24500000,Null,Null,119478160,217727,2342
119535129,57.0,57.0,135000,72000,63000,47,135000,Null,Null,119535129,217777,1583
119639312,0.0,0.0,8500,8500,0,0,8500,Null,Null,119639312,111461,2
119699175,177.0,177.0,432000,349000,83000,19,432000,Null,Null,119699175,79688,13878
119706866,152.0,152.0,480000,480000,0,0,480000,Null,Null,119706866,149699,13878
119790624,136.0,136.0,64000,64000,0,0,64000,Null,Null,119790624,111461,23010
119927504,38.0,38.0,29000,27000,2000,7,29000,Null,Null,119927504,5160827,7064
119960795,268.0,268.0,390000,371000,19000,5,390000,Null,Null,119960795,202607,2347
119960797,935.0,935.0,520000,494000,26000,5,520000,Null,Null,119960797,202607,17170
120034962,1086.0,1086.0,35000,35000,0,0,35000,Null,Null,120034962,5147565,28480
120035595,0.0,0.0,209000,209000,0,0,209000,Null,Null,120035595,46679,2
120035991,7.0,7.0,279000,279000,0,0,279000,Null,Null,120035991,46679,2
120047098,1.0,1.0,19500000,19500000,0,0,19500000,Null,Null,120047098,50331,8067
120144633,0.0,0.0,16150,16150,0,0,16150,Null,Null,120144633,111461,15318
120155794,83.0,83.0,189000,159000,30000,16,189000,Null,Null,120155794,22653,8216
120168695,5.0,5.0,228000,197000,31000,14,228000,Null,Null,120168695,5160827,15318
120169134,0.0,0.0,79000,70000,9000,11,79000,Null,Null,120169134,5160827,15318
120170791,90.0,90.0,2000,2000,0,0,2000,Null,Null,120170791,111461,2685
120170899,72.0,72.0,33988,33988,0,0,33988,Null,Null,120170899,111461,27256
120273991,390.0,390.0,129500,89000,40500,31,129500,Null,Null,120273991,851519,23658
120291481,5.0,5.0,2497,2497,0,0,2497,Null,Null,120291481,111461,2363
120293943,147.0,147.0,96900,96900,0,0,96900,Null,Null,120293943,111461,5531
120294515,308.0,308.0,129000,129000,0,0,129000,Null,Null,120294515,63747,53074
120295859,472.0,472.0,1990000,1650000,340000,17,1990000,Null,Null,120295859,19673,1795
120318503,2737.0,2737.0,9900,9900,0,0,9900,Null,Null,120318503,886923,8305
120339854,29.0,29.0,348000,348000,0,0,348000,Null,Null,120339854,111461,23436
120340757,529.0,529.0,120000,99000,21000,18,120000,Null,Null,120340757,5147565,28480
120348071,1.0,1.0,169000,139000,30000,18,169000,Null,Null,120348071,4888937,6742
120427731,19.0,19.0,6600,6600,0,0,6600,Null,Null,120427731,111461,8305
120444747,0.0,0.0,2000,2000,0,0,2000,Null,Null,120444747,111461,20258
120450155,19.0,19.0,1190000,1190000,0,0,1190000,Null,Null,120450155,5083533,1838
120450825,0.0,0.0,8650000,8650000,0,0,8650000,Null,Null,120450825,885749,8511
120450840,0.0,0.0,8650000,8650000,0,0,8650000,Null,Null,120450840,885749,8511
120450881,0.0,0.0,8650000,8650000,0,0,8650000,Null,Null,120450881,885749,8511
120453021,22.0,22.0,36000,36000,0,0,36000,Null,Null,120453021,111461,11937
120460014,40.0,40.0,2600,1690,910,35,2600,Null,Null,120460014,111461,2363
120462219,0.0,0.0,10000,10000,0,0,10000,Null,Null,120462219,111461,2
120462234,0.0,0.0,2000,2000,0,0,2000,Null,Null,120462234,111461,2
120462312,0.0,0.0,2990,2990,0,0,2990,Null,Null,120462312,111461,28470
120462495,164.0,164.0,96000,94080,1920,2,96000,Null,Null,120462495,111461,2
120462537,44.0,44.0,10000,10000,0,0,10000,Null,Null,120462537,111461,2
120462772,25.0,25.0,95200,95200,0,0,95200,Null,Null,120462772,111461,2
120463358,0.0,0.0,29000,29000,0,0,29000,Null,Null,120463358,111461,2
120463675,9.0,9.0,9000,9000,0,0,9000,Null,Null,120463675,111461,2
120463952,2.0,2.0,9000,8000,1000,11,9000,Null,Null,120463952,111461,2
120464311,4.0,4.0,8460,8000,460,5,8460,Null,Null,120464311,111461,2
120464618,0.0,0.0,34900,8000,26900,77,34900,Null,Null,120464618,111461,28736
120464859,0.0,0.0,9800,9800,0,0,9800,Null,Null,120464859,111461,2
120464961,10.0,10.0,2990,2990,0,0,2990,Null,Null,120464961,111461,2
120465346,8.0,8.0,9570,9570,0,0,9570,Null,Null,120465346,111461,2
120465691,0.0,0.0,20000,20000,0,0,20000,Null,Null,120465691,111461,15250
120468918,0.0,0.0,79000000,43900000,35100000,44,79000000,Null,Null,120468918,184543,2340
120469556,73.0,73.0,15000,6500,8500,57,15000,Null,Null,120469556,886923,8305
120470959,348.0,348.0,122000,79300,42700,35,122000,Null,Null,120470959,33652,23282
120481094,418.0,418.0,218000,109000,109000,50,218000,Null,Null,120481094,3955813,23362
120484431,0.0,0.0,8976800,6750000,2226800,25,8976800,Null,Null,120484431,885749,5384
120484481,0.0,0.0,8976800,6750000,2226800,25,8976800,Null,Null,120484481,885749,5384
120484508,0.0,0.0,8976800,6750000,2226800,25,8976800,Null,Null,120484508,885749,5384
120492492,3.0,3.0,3800000,3800000,0,0,3800000,Null,Null,120492492,5112675,11907
120513009,3.0,3.0,5000,5000,0,0,5000,Null,Null,120513009,111461,1520
120513991,1.0,1.0,4000,4000,0,0,4000,Null,Null,120513991,111461,2
120514249,181.0,181.0,65000,65000,0,0,65000,Null,Null,120514249,111461,17186
120514397,14.0,14.0,5000,5000,0,0,5000,Null,Null,120514397,111461,2
120518402,0.0,0.0,6000,6000,0,0,6000,Null,Null,120518402,111461,1622
120523047,0.0,0.0,2500,2500,0,0,2500,Null,Null,120523047,111461,2685
120523622,94.0,94.0,70000,68000,2000,3,70000,Null,Null,120523622,111461,23446
120533397,387.0,387.0,219000,197000,22000,10,219000,Null,Null,120533397,22653,17170
120534441,0.0,0.0,4200000,2520000,1680000,40,4200000,Null,Null,120534441,169015,5384
120534775,0.0,0.0,9100000,7280000,1820000,20,9100000,Null,Null,120534775,45898,5385
120534965,0.0,0.0,7100000,7100000,0,0,7100000,Null,Null,120534965,214183,8512
120549157,0.0,0.0,13790000,9850000,3940000,29,13790000,Null,Null,120549157,732431,8511
120549484,0.0,0.0,13790000,9850000,3940000,29,13790000,Null,Null,120549484,732431,8511
120550130,0.0,0.0,9850000,9850000,0,0,9850000,Null,Null,120550130,732431,8511
120550491,0.0,0.0,9850000,9850000,0,0,9850000,Null,Null,120550491,732431,8511
120569104,8.0,8.0,169000,169000,0,0,169000,Null,Null,120569104,65071,13878
120674939,16.0,16.0,18000,9900,8100,45,18000,Null,Null,120674939,886923,8305
120755842,0.0,0.0,38507000,38507000,0,0,38507000,Null,Null,120755842,412629,4381
120759154,137.0,137.0,20000,20000,0,0,20000,Null,Null,120759154,111461,2
120760546,48.0,48.0,7880000,3890000,3990000,51,7880000,Null,Null,120760546,18802,2324
120762457,0.0,0.0,128000,128000,0,0,128000,Null,Null,120762457,21733,13878
120763064,76.0,76.0,39000,39000,0,0,39000,Null,Null,120763064,111461,23528
120765867,13.0,13.0,128000,77000,51000,40,128000,Null,Null,120765867,111461,4880
120766388,36.0,36.0,3250000,2925000,325000,10,3250000,Null,Null,120766388,183625,28856
120782084,0.0,0.0,3552000,3552000,0,0,3552000,Null,Null,120782084,25422,1795
120782190,45.0,45.0,69540,67000,2540,4,69540,Null,Null,120782190,5147565,1832
120783709,44.0,44.0,18000,9900,8100,45,18000,Null,Null,120783709,886923,8305
120788312,0.0,0.0,34769,34769,0,0,34769,Null,Null,120788312,111461,5566
120788420,28.0,28.0,5500,5500,0,0,5500,Null,Null,120788420,111461,20244
120788432,7.0,7.0,8900,8900,0,0,8900,Null,Null,120788432,111461,2
120788828,121.0,121.0,9900,4000,5900,60,9900,Null,Null,120788828,111461,2
120789117,6.0,6.0,1781,1781,0,0,1781,Null,Null,120789117,111461,6742
120789299,5.0,5.0,9900,9900,0,0,9900,Null,Null,120789299,111461,2
120794355,1471.0,1471.0,180000,159000,21000,12,180000,Null,Null,120794355,5147565,28480
120800316,0.0,0.0,70290000,70290000,0,0,70290000,Null,Null,120800316,111461,23576
121009850,103.0,103.0,8499000,4499000,4000000,47,8499000,Null,Null,121009850,432537,8165
121009852,406.0,406.0,11000000,6799000,4201000,38,11000000,Null,Null,121009852,432537,8165
121024289,0.0,0.0,990000,990000,0,0,990000,Null,Null,121024289,469547,15318
121024454,0.0,0.0,620000,620000,0,0,620000,Null,Null,121024454,469547,15318
121033672,0.0,0.0,299000,299000,0,0,299000,Null,Null,121033672,111461,6305
121033999,1.0,1.0,660000,660000,0,0,660000,Null,Null,121033999,469547,15318
121040449,0.0,0.0,4510000,4510000,0,0,4510000,Null,Null,121040449,857523,11821
121040670,0.0,0.0,4510000,4510000,0,0,4510000,Null,Null,121040670,857523,17170
121059239,51.0,51.0,4290000,2678000,1612000,38,4290000,Null,Null,121059239,18802,1794
121073612,6.0,6.0,199000,199000,0,0,199000,Null,Null,121073612,111461,2
121073614,5.0,5.0,199000,199000,0,0,199000,Null,Null,121073614,111461,2
121080669,0.0,0.0,28285000,27436450,848550,3,28285000,Null,Null,121080669,167287,28860
121087245,0.0,0.0,36500000,35405000,1095000,3,36500000,Null,Null,121087245,167287,28860
121089335,0.0,0.0,52800000,51216000,1584000,3,52800000,Null,Null,121089335,167287,28860
121095173,0.0,0.0,16300000,15811000,489000,3,16300000,Null,Null,121095173,167287,28860
121095205,285.0,285.0,42000,42000,0,0,42000,Null,Null,121095205,821321,2225
121098400,0.0,0.0,61500000,59655000,1845000,3,61500000,Null,Null,121098400,167287,28860
121099520,0.0,0.0,25400000,24638000,762000,3,25400000,Null,Null,121099520,167287,28860
121101471,0.0,0.0,32860000,31874200,985800,3,32860000,Null,Null,121101471,167287,28860
121103137,76.0,76.0,299000,195000,104000,35,299000,Null,Null,121103137,500047,4428
121107346,0.0,0.0,11600000,11252000,348000,3,11600000,Null,Null,121107346,167287,28860
121107885,0.0,0.0,18000,9900,8100,45,18000,Null,Null,121107885,886923,8305
121109936,181.0,181.0,149000,109000,40000,27,149000,Null,Null,121109936,508185,2173
121154009,15.0,15.0,550000,539000,11000,2,550000,Null,Null,121154009,111461,8061
121162213,1448.0,1448.0,150000,150000,0,0,150000,Null,Null,121162213,5063093,2337
121163617,0.0,0.0,11650000,11300500,349500,3,11650000,Null,Null,121163617,167287,11518
121166776,0.0,0.0,18500000,17945000,555000,3,18500000,Null,Null,121166776,167287,28860
121167639,0.0,0.0,21900000,21462000,438000,2,21900000,Null,Null,121167639,167287,28860
121169235,104.0,104.0,299000,160000,139000,46,299000,Null,Null,121169235,302375,1837
121174272,1.0,1.0,6600,6600,0,0,6600,Null,Null,121174272,111461,1622
121176488,0.0,0.0,6600,6600,0,0,6600,Null,Null,121176488,111461,1622
121202007,3.0,3.0,1150000,1150000,0,0,1150000,Null,Null,121202007,111461,2
121205085,0.0,0.0,15000,15000,0,0,15000,Null,Null,121205085,111461,2
121206416,0.0,0.0,200000,200000,0,0,200000,Null,Null,121206416,561415,15250
121207936,0.0,0.0,450000,450000,0,0,450000,Null,Null,121207936,111461,2
121208665,2.0,2.0,450000,450000,0,0,450000,Null,Null,121208665,111461,2
121209511,0.0,0.0,15000,15000,0,0,15000,Null,Null,121209511,111461,15250
121209523,0.0,0.0,15000,15000,0,0,15000,Null,Null,121209523,111461,15250
121209530,0.0,0.0,15000,15000,0,0,15000,Null,Null,121209530,111461,15250
121209674,0.0,0.0,15000,15000,0,0,15000,Null,Null,121209674,111461,15250
121209780,0.0,0.0,15000,15000,0,0,15000,Null,Null,121209780,111461,8371
121209918,10.0,10.0,15000,15000,0,0,15000,Null,Null,121209918,111461,15250
121209926,0.0,0.0,15000,15000,0,0,15000,Null,Null,121209926,111461,8371
121228874,173.0,173.0,59000,53100,5900,10,59000,Null,Null,121228874,686325,2225
121231485,8.0,8.0,100000,100000,0,0,100000,Null,Null,121231485,111461,15250
121232000,0.0,0.0,9200,9200,0,0,9200,Null,Null,121232000,111441,11803
121240046,0.0,0.0,17020000,17020000,0,0,17020000,Null,Null,121240046,217953,7079
121242522,57.0,57.0,119000,119000,0,0,119000,Null,Null,121242522,49128,4593
121242713,12.0,12.0,219000,219000,0,0,219000,Null,Null,121242713,18984,1838
121242752,98.0,98.0,136000,136000,0,0,136000,Null,Null,121242752,18984,5263
121243524,201.0,201.0,319000,319000,0,0,319000,Null,Null,121243524,111461,23346
121256533,618.0,618.0,400000,209000,191000,48,400000,Null,Null,121256533,454561,1623
121258022,0.0,0.0,17500000,12500000,5000000,29,17500000,Null,Null,121258022,405211,8511
121258024,0.0,0.0,17500000,12500000,5000000,29,17500000,Null,Null,121258024,405211,8511
121262728,61.0,61.0,250000,142000,108000,43,250000,Null,Null,121262728,5085219,2514
121264423,0.0,0.0,11970000,8550000,3420000,29,11970000,Null,Null,121264423,732431,8511
121266133,0.0,0.0,29600000,29600000,0,0,29600000,Null,Null,121266133,167287,20170
121266347,3.0,3.0,3000,3000,0,0,3000,Null,Null,121266347,111454,28484
121268576,952.0,952.0,165000,165000,0,0,165000,Null,Null,121268576,41391,53190
121308783,364.0,364.0,120000,63000,57000,48,120000,Null,Null,121308783,454561,1623
121308832,6.0,6.0,35000,35000,0,0,35000,Null,Null,121308832,111461,15318
121309121,4.0,4.0,80000,80000,0,0,80000,Null,Null,121309121,111461,15318
121311845,0.0,0.0,19000,19000,0,0,19000,Null,Null,121311845,111461,2
121329528,24.0,24.0,8500,8500,0,0,8500,Null,Null,121329528,111461,2
121329706,0.0,0.0,2000,2000,0,0,2000,Null,Null,121329706,111461,2
121330037,13.0,13.0,8000,8000,0,0,8000,Null,Null,121330037,111461,5566
121330066,1.0,1.0,10000,6000,4000,40,10000,Null,Null,121330066,111461,2
121330221,0.0,0.0,3500,3500,0,0,3500,Null,Null,121330221,111461,2
121330304,0.0,0.0,2000,2000,0,0,2000,Null,Null,121330304,111461,2
121330560,11.0,11.0,2500,2500,0,0,2500,Null,Null,121330560,111461,23246
121330921,0.0,0.0,5000,5000,0,0,5000,Null,Null,121330921,111461,20222
121330968,0.0,0.0,8000,8000,0,0,8000,Null,Null,121330968,111461,2
121330974,0.0,0.0,4000,4000,0,0,4000,Null,Null,121330974,111461,2
121331151,23.0,23.0,9000,9000,0,0,9000,Null,Null,121331151,111461,2
121331236,53.0,53.0,2500,2500,0,0,2500,Null,Null,121331236,111461,23246
121331380,2.0,2.0,7500,7500,0,0,7500,Null,Null,121331380,111461,20254
121331613,214.0,214.0,9000,9000,0,0,9000,Null,Null,121331613,111461,2
121331640,4.0,4.0,1500,1500,0,0,1500,Null,Null,121331640,111461,2
121331709,7.0,7.0,6500,6500,0,0,6500,Null,Null,121331709,111461,2
121331710,131.0,131.0,2500,2500,0,0,2500,Null,Null,121331710,111461,2
121332027,3.0,3.0,3000,3000,0,0,3000,Null,Null,121332027,111461,2
121332030,12.0,12.0,7500,7500,0,0,7500,Null,Null,121332030,111461,2
121332102,94.0,94.0,8000,8000,0,0,8000,Null,Null,121332102,111461,20258
121332106,131.0,131.0,2000,2000,0,0,2000,Null,Null,121332106,111461,2
121332182,0.0,0.0,7500,7500,0,0,7500,Null,Null,121332182,111461,2
121332995,0.0,0.0,11000,11000,0,0,11000,Null,Null,121332995,111461,2
121334261,3.0,3.0,3000,3000,0,0,3000,Null,Null,121334261,111461,2
121353509,0.0,0.0,4600000,4600000,0,0,4600000,Null,Null,121353509,199801,11885
121377052,21.0,21.0,149000,149000,0,0,149000,Null,Null,121377052,111461,2
121396300,85.0,85.0,6700,6700,0,0,6700,Null,Null,121396300,111461,53074
121399041,0.0,0.0,28180000,28180000,0,0,28180000,Null,Null,121399041,218967,7079
121485345,1032.0,1032.0,1105000,698000,407000,37,1105000,Null,Null,121485345,21273,1520
121485346,7242.0,7242.0,1110437,805000,305437,28,1110437,Null,Null,121485346,21271,1520
121485349,3840.0,3840.0,1110437,805000,305437,28,1110437,Null,Null,121485349,21271,1520
121485363,3641.0,3641.0,1110437,805000,305437,28,1110437,Null,Null,121485363,21271,1520
121490288,2.0,2.0,210000,105000,105000,50,210000,Null,Null,121490288,111461,49724
121494115,1.0,1.0,390000,195000,195000,50,390000,Null,Null,121494115,111461,49724
121602582,9.0,9.0,88000,88000,0,0,88000,Null,Null,121602582,111461,2
121605249,15.0,15.0,350000,350000,0,0,350000,Null,Null,121605249,111461,23394
121635464,120.0,120.0,128000,68000,60000,47,128000,Null,Null,121635464,4246951,8602
121684347,133.0,133.0,199000,199000,0,0,199000,Null,Null,121684347,361293,28480
121693088,0.0,0.0,8720,8546,174,2,8720,Null,Null,121693088,111461,2
121693093,2.0,2.0,2288994,2288994,0,0,2288994,Null,Null,121693093,276247,8066
121741414,63.0,63.0,268000,268000,0,0,268000,Null,Null,121741414,111461,23376
121744434,128.0,128.0,4290000,3569000,721000,17,4290000,Null,Null,121744434,25422,1795
121969842,265.0,265.0,35000,35000,0,0,35000,Null,Null,121969842,4819981,3179
121970809,179.0,179.0,73000,69000,4000,5,73000,Null,Null,121970809,4819981,3179
122086556,155.0,155.0,23250,23250,0,0,23250,Null,Null,122086556,111461,15318
122086646,2.0,2.0,13500,13500,0,0,13500,Null,Null,122086646,111461,2
122086854,2.0,2.0,13500,13500,0,0,13500,Null,Null,122086854,111461,2
122086856,0.0,0.0,13500,13500,0,0,13500,Null,Null,122086856,111461,2
122086962,0.0,0.0,13500,13500,0,0,13500,Null,Null,122086962,111461,2
122087096,1.0,1.0,14250,14250,0,0,14250,Null,Null,122087096,111461,2
122087176,0.0,0.0,13500,13500,0,0,13500,Null,Null,122087176,111461,2
122087351,0.0,0.0,13500,13500,0,0,13500,Null,Null,122087351,111461,2
122087388,0.0,0.0,13500,13500,0,0,13500,Null,Null,122087388,111461,2
122087480,0.0,0.0,16500,16500,0,0,16500,Null,Null,122087480,111461,2
122087570,0.0,0.0,13500,13500,0,0,13500,Null,Null,122087570,111461,2
122087661,0.0,0.0,14250,14250,0,0,14250,Null,Null,122087661,111461,2
122087699,0.0,0.0,15000,15000,0,0,15000,Null,Null,122087699,111461,2
122087753,2.0,2.0,15000,15000,0,0,15000,Null,Null,122087753,111461,2
122087968,1.0,1.0,13500,13500,0,0,13500,Null,Null,122087968,111461,2
122088112,0.0,0.0,13500,13500,0,0,13500,Null,Null,122088112,111461,2
122088216,0.0,0.0,16500,16500,0,0,16500,Null,Null,122088216,111461,2
122088219,0.0,0.0,16500,16500,0,0,16500,Null,Null,122088219,111461,2
122088266,0.0,0.0,13500,13500,0,0,13500,Null,Null,122088266,111461,2
122088342,6.0,6.0,15750,15750,0,0,15750,Null,Null,122088342,111461,2
122088391,1.0,1.0,16500,16500,0,0,16500,Null,Null,122088391,111461,2
122088402,0.0,0.0,13500,13500,0,0,13500,Null,Null,122088402,111461,2
122088449,0.0,0.0,16500,16500,0,0,16500,Null,Null,122088449,111461,2
122088626,103.0,103.0,27750,27750,0,0,27750,Null,Null,122088626,111461,15318
122088694,4.0,4.0,13500,13500,0,0,13500,Null,Null,122088694,111461,2
122088772,0.0,0.0,13500,13500,0,0,13500,Null,Null,122088772,111461,2
122088804,1.0,1.0,7500,7500,0,0,7500,Null,Null,122088804,111461,2
122089001,5.0,5.0,11625,11625,0,0,11625,Null,Null,122089001,111461,2
122089126,1.0,1.0,13875,13875,0,0,13875,Null,Null,122089126,111461,2
122089157,0.0,0.0,15000,15000,0,0,15000,Null,Null,122089157,111461,2
122089159,3.0,3.0,15000,15000,0,0,15000,Null,Null,122089159,111461,2
122089445,2.0,2.0,12750,12750,0,0,12750,Null,Null,122089445,111461,2
122089447,0.0,0.0,16500,16500,0,0,16500,Null,Null,122089447,111461,2
122089540,0.0,0.0,18750,18750,0,0,18750,Null,Null,122089540,111461,15320
122089556,2.0,2.0,16500,16500,0,0,16500,Null,Null,122089556,111461,2
122089562,0.0,0.0,10875,10875,0,0,10875,Null,Null,122089562,111461,2
122089639,0.0,0.0,13500,13500,0,0,13500,Null,Null,122089639,111461,2
122089703,0.0,0.0,18000,18000,0,0,18000,Null,Null,122089703,111461,2
122089748,12.0,12.0,12750,12750,0,0,12750,Null,Null,122089748,111461,2
122089753,0.0,0.0,13500,13500,0,0,13500,Null,Null,122089753,111461,2
122089989,0.0,0.0,13125,13125,0,0,13125,Null,Null,122089989,111461,2
122089991,0.0,0.0,22500,22500,0,0,22500,Null,Null,122089991,111461,2
122090049,6.0,6.0,9750,9750,0,0,9750,Null,Null,122090049,111461,2
122090065,5.0,5.0,16500,16500,0,0,16500,Null,Null,122090065,111461,2
122090146,0.0,0.0,7500,7500,0,0,7500,Null,Null,122090146,111461,2
122090226,0.0,0.0,13500,13500,0,0,13500,Null,Null,122090226,111461,2
122090274,2.0,2.0,13500,13500,0,0,13500,Null,Null,122090274,111461,2
122090382,1.0,1.0,13500,13500,0,0,13500,Null,Null,122090382,111461,2
122092238,157.0,157.0,330000,186000,144000,44,330000,Null,Null,122092238,4011099,2513
122158068,146.0,146.0,149000,134100,14900,10,149000,Null,Null,122158068,21653,12918
122162563,34.0,34.0,50000,49000,1000,2,50000,Null,Null,122162563,21653,5006
122171765,3.0,3.0,378000,189000,189000,50,378000,Null,Null,122171765,111461,49724
122194744,0.0,0.0,3500000,3500000,0,0,3500000,Null,Null,122194744,478399,11859
122202527,0.0,0.0,27000000,27000000,0,0,27000000,Null,Null,122202527,31701,2340
122219428,5.0,5.0,358000,179000,179000,50,358000,Null,Null,122219428,111461,49724
122222064,0.0,0.0,200000,158000,42000,21,200000,Null,Null,122222064,111461,49724
122226456,1.0,1.0,258000,129000,129000,50,258000,Null,Null,122226456,111461,49724
122226900,1.0,1.0,450000,235000,215000,48,450000,Null,Null,122226900,111461,49724
122226908,0.0,0.0,49900000,49900000,0,0,49900000,Null,Null,122226908,31701,2340
122229409,58.0,58.0,950000,595000,355000,37,950000,Null,Null,122229409,5085219,23228
122234202,0.0,0.0,115000000,115000000,0,0,115000000,Null,Null,122234202,31701,2340
122235906,0.0,0.0,139000000,139000000,0,0,139000000,Null,Null,122235906,31701,2340
122237087,0.0,0.0,139000000,139000000,0,0,139000000,Null,Null,122237087,31701,2340
122240374,0.0,0.0,199000000,199000000,0,0,199000000,Null,Null,122240374,31701,2340
122243031,23.0,23.0,69000,63000,6000,9,69000,Null,Null,122243031,5160827,7064
122256875,10.0,10.0,2390000,2151000,239000,10,2390000,Null,Null,122256875,207367,15318
122277622,476.0,476.0,420000,210000,210000,50,420000,Null,Null,122277622,3955813,23362
122310530,54.0,54.0,990000,980000,10000,1,990000,Null,Null,122310530,207367,15318
122311276,8.0,8.0,1790000,1690000,100000,6,1790000,Null,Null,122311276,207367,15318
122311338,328.0,328.0,350000,274000,76000,22,350000,Null,Null,122311338,207367,23078
122353725,5.0,5.0,15700,15700,0,0,15700,Null,Null,122353725,111461,15318
122373613,4.0,4.0,100000,100000,0,0,100000,Null,Null,122373613,111461,15318
122379433,25.0,25.0,104950,104950,0,0,104950,Null,Null,122379433,273691,5263
122384582,548.0,548.0,229000,189000,40000,17,229000,Null,Null,122384582,273691,2971
122393354,1016.0,1016.0,499000,297000,202000,40,499000,Null,Null,122393354,5048343,4593
122399861,33.0,33.0,675000,675000,0,0,675000,Null,Null,122399861,688391,11879
122408425,7.0,7.0,600000,600000,0,0,600000,Null,Null,122408425,688391,11881
122436952,62.0,62.0,350000,237000,113000,32,350000,Null,Null,122436952,207367,15318
122443312,0.0,0.0,6850000,6850000,0,0,6850000,Null,Null,122443312,885749,8511
122445952,0.0,0.0,6500000,6500000,0,0,6500000,Null,Null,122445952,885749,8511
122446129,31.0,31.0,132764,132764,0,0,132764,Null,Null,122446129,111461,2140
122446209,2.0,2.0,1390000,1251000,139000,10,1390000,Null,Null,122446209,207367,15318
122469550,2.0,2.0,390000,195000,195000,50,390000,Null,Null,122469550,111461,49724
122470763,0.0,0.0,95000,95000,0,0,95000,Null,Null,122470763,111461,49724
122473937,2.0,2.0,518000,259000,259000,50,518000,Null,Null,122473937,111461,49724
122474823,189.0,189.0,109000,109000,0,0,109000,Null,Null,122474823,167099,23304
122474839,2.0,2.0,1590000,1490000,100000,6,1590000,Null,Null,122474839,207367,15318
122489011,40.0,40.0,159000,141000,18000,11,159000,Null,Null,122489011,5160827,1520
122490033,149.0,149.0,1990000,1250000,740000,37,1990000,Null,Null,122490033,18802,8400
122490403,4.0,4.0,1590000,1431000,159000,10,1590000,Null,Null,122490403,207367,15318
122493949,0.0,0.0,13071429,9150000,3921429,30,13071429,Null,Null,122493949,405211,8511
122510536,2.0,2.0,75000,67500,7500,10,75000,Null,Null,122510536,561415,15320
122560357,3.0,3.0,16800,16800,0,0,16800,Null,Null,122560357,111461,15236
122584942,0.0,0.0,35600000,31328000,4272000,12,35600000,Null,Null,122584942,167287,6653
122590572,0.0,0.0,12000000,12000000,0,0,12000000,Null,Null,122590572,885749,8511
122590584,0.0,0.0,17400000,15312000,2088000,12,17400000,Null,Null,122590584,167287,6653
122590663,0.0,0.0,12000000,12000000,0,0,12000000,Null,Null,122590663,885749,8511
122590825,0.0,0.0,19500000,19500000,0,0,19500000,Null,Null,122590825,167287,6653
122592579,56.0,56.0,180000,177000,3000,2,180000,Null,Null,122592579,5183619,11817
122592763,0.0,0.0,12300000,12300000,0,0,12300000,Null,Null,122592763,167287,28638
122641621,15.0,15.0,199000,130000,69000,35,199000,Null,Null,122641621,20271,5263
122650000,117.0,117.0,159000,159000,0,0,159000,Null,Null,122650000,373635,28574
122692850,4189.0,4189.0,199000,199000,0,0,199000,Null,Null,122692850,746615,23022
122700651,2860.0,2860.0,199000,199000,0,0,199000,Null,Null,122700651,746615,1883
122706113,4.0,4.0,1590000,1393000,197000,12,1590000,Null,Null,122706113,207367,15318
122755113,112.0,112.0,4400,4400,0,0,4400,Null,Null,122755113,111461,1819
122774148,12.0,12.0,9000,9000,0,0,9000,Null,Null,122774148,111461,28574
122799754,6.0,6.0,7000,7000,0,0,7000,Null,Null,122799754,111461,2342
122832385,12.0,12.0,3000,2130,870,29,3000,Null,Null,122832385,111461,53074
122841832,0.0,0.0,16300000,16300000,0,0,16300000,Null,Null,122841832,471845,1813
122841938,0.0,0.0,19800000,19800000,0,0,19800000,Null,Null,122841938,471845,6653
122841961,0.0,0.0,12800000,12800000,0,0,12800000,Null,Null,122841961,471845,1813
122871345,0.0,0.0,18000,18000,0,0,18000,Null,Null,122871345,111461,15320
122872431,1.0,1.0,7000,7000,0,0,7000,Null,Null,122872431,111461,2
122872653,0.0,0.0,18000,18000,0,0,18000,Null,Null,122872653,111461,2
122872786,10.0,10.0,6000,6000,0,0,6000,Null,Null,122872786,111461,2
122872957,0.0,0.0,6000,6000,0,0,6000,Null,Null,122872957,111461,2
122872961,0.0,0.0,11000,11000,0,0,11000,Null,Null,122872961,111461,2
122873516,0.0,0.0,18000,18000,0,0,18000,Null,Null,122873516,111461,15320
122909686,9.0,9.0,600000,300000,300000,50,600000,Null,Null,122909686,211603,11851
122939123,624.0,624.0,300000,150000,150000,50,300000,Null,Null,122939123,3955813,23362
122949142,137.0,137.0,2990000,1500000,1490000,50,2990000,Null,Null,122949142,18802,8400
123140731,1.0,1.0,210000,105000,105000,50,210000,Null,Null,123140731,111461,49724
123153692,16.0,16.0,1990000,1890009,99991,5,1990000,Null,Null,123153692,207367,15318
123202361,39.0,39.0,157000,157000,0,0,157000,Null,Null,123202361,143476,1607
123231301,9.0,9.0,1990000,1890000,100000,5,1990000,Null,Null,123231301,207367,15318
123234201,346.0,346.0,472000,435000,37000,8,472000,Null,Null,123234201,523789,23658
123345348,2711.0,2711.0,18990000,15950000,3040000,16,18990000,Null,Null,123345348,17827,1795
123353290,79.0,79.0,350000,273000,77000,22,350000,Null,Null,123353290,25501,8170
123430211,1.0,1.0,2100,2100,0,0,2100,Null,Null,123430211,111461,53074
123430215,7.0,7.0,1500,1500,0,0,1500,Null,Null,123430215,111461,27180
123430888,174.0,174.0,1200,1200,0,0,1200,Null,Null,123430888,111461,2806
123431213,6.0,6.0,2100,2100,0,0,2100,Null,Null,123431213,111461,53074
123431395,1.0,1.0,2000,2000,0,0,2000,Null,Null,123431395,111461,23712
123431911,24.0,24.0,1500,1500,0,0,1500,Null,Null,123431911,111461,2363
123431918,0.0,0.0,1890,1890,0,0,1890,Null,Null,123431918,111461,53074
123431942,32.0,32.0,2500,2500,0,0,2500,Null,Null,123431942,111461,53074
123432793,20.0,20.0,1500,1500,0,0,1500,Null,Null,123432793,111461,2363
123433694,16.0,16.0,1890,1890,0,0,1890,Null,Null,123433694,111461,2
123434267,0.0,0.0,2100,2100,0,0,2100,Null,Null,123434267,111461,2
123434302,11.0,11.0,1680,1680,0,0,1680,Null,Null,123434302,111461,2
123434407,0.0,0.0,1576,1576,0,0,1576,Null,Null,123434407,111461,2392
123434496,14.0,14.0,1500,1500,0,0,1500,Null,Null,123434496,111461,2363
123434921,16.0,16.0,2000,2000,0,0,2000,Null,Null,123434921,111461,53074
123435175,0.0,0.0,4100000,4100000,0,0,4100000,Null,Null,123435175,561415,11935
123446721,307.0,307.0,28000,28000,0,0,28000,Null,Null,123446721,144845,53190
123447210,284.0,284.0,2500,2500,0,0,2500,Null,Null,123447210,144845,53190
123512012,2.0,2.0,6218000,4663500,1554500,25,6218000,Null,Null,123512012,26150,8512
123512014,8.0,8.0,4812000,3598000,1214000,25,4812000,Null,Null,123512014,26150,8512
123512018,6.0,6.0,3356000,2515000,841000,25,3356000,Null,Null,123512018,26150,8512
123514019,122.0,122.0,44400,44400,0,0,44400,Null,Null,123514019,523885,3990
123518348,1026.0,1026.0,150000,109000,41000,27,150000,Null,Null,123518348,111454,4428
123565891,0.0,0.0,4990000,4990000,0,0,4990000,Null,Null,123565891,52232,1795
123582725,306.0,306.0,595000,380000,215000,36,595000,Null,Null,123582725,4228599,53350
123779650,395.0,395.0,79000,79000,0,0,79000,Null,Null,123779650,111461,1815
123779680,131.0,131.0,59000,57820,1180,2,59000,Null,Null,123779680,111461,5566
123781482,0.0,0.0,7900,7900,0,0,7900,Null,Null,123781482,111461,15318
123834128,2.0,2.0,73395,73395,0,0,73395,Null,Null,123834128,111461,28596
123836523,9763.0,9763.0,790000,490000,300000,38,790000,Null,Null,123836523,17827,12908
123838761,9814.0,9814.0,5390000,2750000,2640000,49,5390000,Null,Null,123838761,17827,8400
123840212,1414.0,1414.0,6990000,4790000,2200000,31,6990000,Null,Null,123840212,17827,2657
123843835,790.0,790.0,6000,4000,2000,33,6000,Null,Null,123843835,111461,2
123847933,3416.0,3416.0,4890000,2990000,1900000,39,4890000,Null,Null,123847933,17827,28616
123850440,1718.0,1718.0,890000,790000,100000,11,890000,Null,Null,123850440,17827,1819
123897454,0.0,0.0,27490000,27490000,0,0,27490000,Null,Null,123897454,114527,2657
123929359,3.0,3.0,3360000,3360000,0,0,3360000,Null,Null,123929359,33203,11925
123946181,3.0,3.0,11599000,11599000,0,0,11599000,Null,Null,123946181,217727,8172
123985225,27.0,27.0,52100,52100,0,0,52100,Null,Null,123985225,111461,2514
124015047,1350.0,1350.0,109000,89000,20000,18,109000,Null,Null,124015047,86206,1520
124015247,737.0,737.0,109000,82000,27000,25,109000,Null,Null,124015247,86206,17184
124035819,0.0,0.0,43500000,43500000,0,0,43500000,Null,Null,124035819,111461,23430
124065338,826.0,826.0,169000,154000,15000,9,169000,Null,Null,124065338,354595,17162
124069690,115.0,115.0,85000,85000,0,0,85000,Null,Null,124069690,111461,23010
124088710,404.0,404.0,9900,9000,900,9,9900,Null,Null,124088710,111461,28428
124088716,20.0,20.0,8500,8000,500,6,8500,Null,Null,124088716,111461,28426
124088786,19.0,19.0,12999,12000,999,8,12999,Null,Null,124088786,111461,28574
124088818,4.0,4.0,29000,29000,0,0,29000,Null,Null,124088818,21653,12908
124088885,62.0,62.0,23000,18000,5000,22,23000,Null,Null,124088885,111461,28428
124088937,8.0,8.0,60000,60000,0,0,60000,Null,Null,124088937,21653,12294
124089090,22.0,22.0,5500,5500,0,0,5500,Null,Null,124089090,111461,49726
124089106,194.0,194.0,12000,11000,1000,8,12000,Null,Null,124089106,111461,28428
124107849,1.0,1.0,65000000,65000000,0,0,65000000,Null,Null,124107849,4712171,2340
124107851,66.0,66.0,32000000,32000000,0,0,32000000,Null,Null,124107851,4712171,2340
124107866,2.0,2.0,35000000,35000000,0,0,35000000,Null,Null,124107866,4712171,2340
124107883,100.0,100.0,25990000,13990000,12000000,46,25990000,Null,Null,124107883,4712171,2340
124146992,26.0,26.0,2000,2000,0,0,2000,Null,Null,124146992,111461,2
124147136,1.0,1.0,12696000,9068250,3627750,29,12696000,Null,Null,124147136,26150,8513
124147165,1.0,1.0,21385000,16038750,5346250,25,21385000,Null,Null,124147165,26150,8513
124161218,615.0,615.0,168000,153000,15000,9,168000,Null,Null,124161218,354595,13878
124163391,314.0,314.0,168000,153000,15000,9,168000,Null,Null,124163391,354595,13878
124180560,4.0,4.0,2000,1000,1000,50,2000,Null,Null,124180560,111461,2
124183377,3.0,3.0,4000000,4000000,0,0,4000000,Null,Null,124183377,5040313,2342
124197201,13.0,13.0,25990000,13990000,12000000,46,25990000,Null,Null,124197201,4712171,2340
124197206,11.0,11.0,27000000,27000000,0,0,27000000,Null,Null,124197206,4712171,2340
124208855,0.0,0.0,10000,9900,100,1,10000,Null,Null,124208855,113680,8193
124208900,4.0,4.0,5000,4950,50,1,5000,Null,Null,124208900,113680,8197
124262541,3.0,3.0,390000,195000,195000,50,390000,Null,Null,124262541,111461,49724
124273002,4.0,4.0,39100,39100,0,0,39100,Null,Null,124273002,111461,2
124273003,20.0,20.0,6000,5940,60,1,6000,Null,Null,124273003,111461,2
124273086,6.0,6.0,45000,45000,0,0,45000,Null,Null,124273086,111461,2
124273101,0.0,0.0,45000,45000,0,0,45000,Null,Null,124273101,111461,2
124273206,13.0,13.0,10000,9000,1000,10,10000,Null,Null,124273206,111461,2
124273550,1.0,1.0,9602,9602,0,0,9602,Null,Null,124273550,111461,2
124273626,0.0,0.0,8720,8720,0,0,8720,Null,Null,124273626,111461,2
124274823,0.0,0.0,12000,12000,0,0,12000,Null,Null,124274823,111461,2
124274854,2.0,2.0,10000,10000,0,0,10000,Null,Null,124274854,111461,2
124274960,71.0,71.0,12000,11000,1000,8,12000,Null,Null,124274960,111461,11935
124275066,339.0,339.0,6000,5000,1000,17,6000,Null,Null,124275066,111461,1815
124275284,0.0,0.0,19000,15000,4000,21,19000,Null,Null,124275284,111461,15318
124275348,13.0,13.0,119000,119000,0,0,119000,Null,Null,124275348,111461,2
124275528,4.0,4.0,7000,7000,0,0,7000,Null,Null,124275528,111461,2
124275587,6.0,6.0,9000,7000,2000,22,9000,Null,Null,124275587,111461,2
124275712,4.0,4.0,6383,6383,0,0,6383,Null,Null,124275712,111461,2
124275797,7.0,7.0,3000,2000,1000,33,3000,Null,Null,124275797,111461,2
124276074,0.0,0.0,4000,2000,2000,50,4000,Null,Null,124276074,111461,2
124276094,1.0,1.0,3000,2970,30,1,3000,Null,Null,124276094,111461,2
124276151,5.0,5.0,7600,7600,0,0,7600,Null,Null,124276151,111461,2
124276358,0.0,0.0,9000,8000,1000,11,9000,Null,Null,124276358,111461,2
124276362,2.0,2.0,35000,35000,0,0,35000,Null,Null,124276362,111461,2
124276426,17.0,17.0,7000,6930,70,1,7000,Null,Null,124276426,111461,2
124276714,0.0,0.0,9000,8000,1000,11,9000,Null,Null,124276714,111461,7064
124276764,112.0,112.0,5000,4950,50,1,5000,Null,Null,124276764,111461,2
124298342,0.0,0.0,1800,1800,0,0,1800,Null,Null,124298342,111461,2363
124392263,394.0,394.0,350000,189000,161000,46,350000,Null,Null,124392263,247367,3216
124413110,1.0,1.0,4343000,3257250,1085750,25,4343000,Null,Null,124413110,26150,8516
124413507,0.0,0.0,17200000,17200000,0,0,17200000,Null,Null,124413507,167287,1803
124431553,432.0,432.0,149000,89000,60000,40,149000,Null,Null,124431553,314675,1838
124479205,2.0,2.0,378000,189000,189000,50,378000,Null,Null,124479205,111461,49724
124479281,1.0,1.0,125000,125000,0,0,125000,Null,Null,124479281,111461,49724
124480931,540.0,540.0,160000,122000,38000,24,160000,Null,Null,124480931,111736,3426
124491136,0.0,0.0,2000,1000,1000,50,2000,Null,Null,124491136,111461,2
124522507,0.0,0.0,60888,60888,0,0,60888,Null,Null,124522507,111461,2514
124554405,768.0,768.0,499000,319000,180000,36,499000,Null,Null,124554405,363961,3177
124554474,0.0,0.0,3500000,3500000,0,0,3500000,Null,Null,124554474,5175843,17170
124575189,0.0,0.0,3500000,3500000,0,0,3500000,Null,Null,124575189,5175843,53350
124575723,0.0,0.0,58888,58888,0,0,58888,Null,Null,124575723,111461,2514
124588781,0.0,0.0,3500000,3500000,0,0,3500000,Null,Null,124588781,5175843,53350
124635776,0.0,0.0,38000000,38000000,0,0,38000000,Null,Null,124635776,231867,27240
124635924,0.0,0.0,3500000,3500000,0,0,3500000,Null,Null,124635924,5175843,17174
124638240,0.0,0.0,3500000,3500000,0,0,3500000,Null,Null,124638240,5175843,53350
124690968,20.0,20.0,165000,165000,0,0,165000,Null,Null,124690968,53819,23288
124702849,5.0,5.0,9000,8910,90,1,9000,Null,Null,124702849,111461,13878
124703099,20.0,20.0,1999,1999,0,0,1999,Null,Null,124703099,111461,2514
124706345,157.0,157.0,1090000,599000,491000,45,1090000,Null,Null,124706345,153086,12928
124710270,13.0,13.0,4590000,3490000,1100000,24,4590000,Null,Null,124710270,4885445,8172
124710495,770.0,770.0,65000,39000,26000,40,65000,Null,Null,124710495,314675,5006
124716435,15.0,15.0,47000,47000,0,0,47000,Null,Null,124716435,111461,23010
124716484,137.0,137.0,960000,900000,60000,6,960000,Null,Null,124716484,64932,1520
124783388,4.0,4.0,10000,10000,0,0,10000,Null,Null,124783388,111461,2
124878786,0.0,0.0,8000,4400,3600,45,8000,Null,Null,124878786,111461,15318
124887396,0.0,0.0,6000,6000,0,0,6000,Null,Null,124887396,111461,20236
124896069,18.0,18.0,36000,36000,0,0,36000,Null,Null,124896069,111461,28738
124904953,2.0,2.0,7500,7500,0,0,7500,Null,Null,124904953,111461,15236
124966957,146.0,146.0,98000,68000,30000,31,98000,Null,Null,124966957,4246951,8602
124975226,35.0,35.0,189900,189900,0,0,189900,Null,Null,124975226,111461,4880
124976828,198.0,198.0,55000,52283,2717,5,55000,Null,Null,124976828,314675,2173
125046586,2051.0,2051.0,32000,27000,5000,16,32000,Null,Null,125046586,32909,11821
125084260,872.0,872.0,39000,38000,1000,3,39000,Null,Null,125084260,697923,23370
125084328,7.0,7.0,7500,7500,0,0,7500,Null,Null,125084328,111461,26658
125084534,0.0,0.0,8800,8800,0,0,8800,Null,Null,125084534,111461,26658
125089517,16.0,16.0,89000,84000,5000,6,89000,Null,Null,125089517,21653,28460
125171081,190.0,190.0,550000,495000,55000,10,550000,Null,Null,125171081,4282483,11897
125171841,24.0,24.0,620000,620000,0,0,620000,Null,Null,125171841,18804,8061
125182567,1044.0,1044.0,3950000,3950000,0,0,3950000,Null,Null,125182567,147856,28856
125287085,70.0,70.0,1400000,923000,477000,34,1400000,Null,Null,125287085,5085219,27128
125290929,0.0,0.0,41000000,29900000,11100000,27,41000000,Null,Null,125290929,184543,2340
125370325,0.0,0.0,9800000,9800000,0,0,9800000,Null,Null,125370325,545405,15250
125419985,202.0,202.0,149000,89000,60000,40,149000,Null,Null,125419985,20271,1837
125485714,2.0,2.0,879000,879000,0,0,879000,Null,Null,125485714,18804,2334
125487609,12.0,12.0,360000,360000,0,0,360000,Null,Null,125487609,530073,1752
125528283,31.0,31.0,29000,29000,0,0,29000,Null,Null,125528283,111461,8513
125533318,271.0,271.0,420000,399000,21000,5,420000,Null,Null,125533318,202607,1601
125534023,4.0,4.0,2500,2500,0,0,2500,Null,Null,125534023,111461,53058
125535245,1.0,1.0,89000,79000,10000,11,89000,Null,Null,125535245,5160827,15318
125543666,0.0,0.0,4080000,4080000,0,0,4080000,Null,Null,125543666,27398,8165
125555122,575.0,575.0,171000,158000,13000,8,171000,Null,Null,125555122,523789,4380
125558936,0.0,0.0,4150000,4150000,0,0,4150000,Null,Null,125558936,27398,8165
125589241,29.0,29.0,9006,9006,0,0,9006,Null,Null,125589241,111461,2
125589564,0.0,0.0,5800,5800,0,0,5800,Null,Null,125589564,111461,2
125590981,64.0,64.0,2090000,2090000,0,0,2090000,Null,Null,125590981,19673,1795
125596400,959.0,959.0,221500,203000,18500,8,221500,Null,Null,125596400,21274,1520
125596412,732.0,732.0,221500,211000,10500,5,221500,Null,Null,125596412,21274,1520
125600698,27.0,27.0,1879000,1399000,480000,26,1879000,Null,Null,125600698,19673,1795
125604009,4.0,4.0,8000,8000,0,0,8000,Null,Null,125604009,111461,15318
125604087,10.0,10.0,2300,2300,0,0,2300,Null,Null,125604087,111461,2
125608918,728.0,728.0,158000,118000,40000,25,158000,Null,Null,125608918,111736,3426
125614269,0.0,0.0,5000,5000,0,0,5000,Null,Null,125614269,111461,2
125614499,8.0,8.0,8000,8000,0,0,8000,Null,Null,125614499,111461,2
125614500,0.0,0.0,3000,3000,0,0,3000,Null,Null,125614500,111461,2
125614539,2.0,2.0,5000,5000,0,0,5000,Null,Null,125614539,111461,2
125614563,0.0,0.0,9000,9000,0,0,9000,Null,Null,125614563,111461,2
125614684,0.0,0.0,9000,9000,0,0,9000,Null,Null,125614684,111461,2
125614688,1.0,1.0,10000,10000,0,0,10000,Null,Null,125614688,111461,2
125614782,0.0,0.0,5000,5000,0,0,5000,Null,Null,125614782,111461,2
125615012,0.0,0.0,4000,4000,0,0,4000,Null,Null,125615012,111461,8205
125615083,1.0,1.0,9000,9000,0,0,9000,Null,Null,125615083,111461,2
125615092,0.0,0.0,9000,9000,0,0,9000,Null,Null,125615092,111461,2
125615143,0.0,0.0,10000,10000,0,0,10000,Null,Null,125615143,111461,2
125615173,0.0,0.0,9000,9000,0,0,9000,Null,Null,125615173,111461,2
125615246,0.0,0.0,9000,9000,0,0,9000,Null,Null,125615246,111461,2
125615469,0.0,0.0,9000,9000,0,0,9000,Null,Null,125615469,111461,2
125616075,1.0,1.0,3490000,3490000,0,0,3490000,Null,Null,125616075,4885445,2340
125616077,4.0,4.0,3490000,3490000,0,0,3490000,Null,Null,125616077,4885445,2340
125616106,2.0,2.0,3490000,3490000,0,0,3490000,Null,Null,125616106,4885445,8172
125616122,1.0,1.0,3490000,3490000,0,0,3490000,Null,Null,125616122,4885445,8172
125616183,1.0,1.0,3490000,3490000,0,0,3490000,Null,Null,125616183,4885445,2340
125616224,10.0,10.0,3490000,3490000,0,0,3490000,Null,Null,125616224,4885445,2340
125658476,585.0,585.0,186000,186000,0,0,186000,Null,Null,125658476,5083311,1936
125667836,2.0,2.0,247000,247000,0,0,247000,Null,Null,125667836,111461,2948
125673210,545.0,545.0,305000,305000,0,0,305000,Null,Null,125673210,5063093,2512
125685284,1573.0,1573.0,3500,2000,1500,43,3500,Null,Null,125685284,111461,2337
125687465,72.0,72.0,480000,480000,0,0,480000,Null,Null,125687465,111454,6742
125687554,1.0,1.0,8500000,8500000,0,0,8500000,Null,Null,125687554,111461,15318
125724844,1.0,1.0,89000,77000,12000,13,89000,Null,Null,125724844,5160827,15318
125740531,0.0,0.0,4600000,4600000,0,0,4600000,Null,Null,125740531,27398,2340
125743082,349.0,349.0,250000,179000,71000,28,250000,Null,Null,125743082,33036,1836
125747743,201.0,201.0,790000,790000,0,0,790000,Null,Null,125747743,45603,11861
125747762,1.0,1.0,29500000,29500000,0,0,29500000,Null,Null,125747762,111461,20254
125748480,125.0,125.0,620000,525000,95000,15,620000,Null,Null,125748480,45603,11859
125751249,4.0,4.0,69000,55200,13800,20,69000,Null,Null,125751249,111461,15318
125753291,10.0,10.0,790000,790000,0,0,790000,Null,Null,125753291,19673,1796
125753416,15.0,15.0,870000,870000,0,0,870000,Null,Null,125753416,19673,1796
125753599,6.0,6.0,990000,990000,0,0,990000,Null,Null,125753599,19673,1796
125753647,27.0,27.0,579000,559000,20000,3,579000,Null,Null,125753647,886169,23034
125761669,0.0,0.0,38000000,38000000,0,0,38000000,Null,Null,125761669,231867,27240
125766729,162.0,162.0,250000,250000,0,0,250000,Null,Null,125766729,156929,28484
125772862,29.0,29.0,46000,46000,0,0,46000,Null,Null,125772862,111461,23134
125773832,0.0,0.0,212900,212900,0,0,212900,Null,Null,125773832,156929,28484
125802463,86.0,86.0,277001,277001,0,0,277001,Null,Null,125802463,2630119,5531
125803654,12.0,12.0,399000,399000,0,0,399000,Null,Null,125803654,193677,2020
125818440,6.0,6.0,8900,8900,0,0,8900,Null,Null,125818440,111461,7064
125819131,110.0,110.0,129000,129000,0,0,129000,Null,Null,125819131,21733,4413
125827968,180.0,180.0,176000,151000,25000,14,176000,Null,Null,125827968,21867,8300
125838051,193.0,193.0,160000,140000,20000,13,160000,Null,Null,125838051,21867,8300
125838055,195.0,195.0,172000,166000,6000,3,172000,Null,Null,125838055,21867,11568
125838064,363.0,363.0,560000,474000,86000,15,560000,Null,Null,125838064,21867,8300
125838068,355.0,355.0,120000,120000,0,0,120000,Null,Null,125838068,21867,8300
125849747,556.0,556.0,32000,32000,0,0,32000,Null,Null,125849747,111461,23236
125864762,1684.0,1684.0,209100,197000,12100,6,209100,Null,Null,125864762,21273,8227
125864764,1100.0,1100.0,464100,360000,104100,22,464100,Null,Null,125864764,21273,1520
125891434,49.0,49.0,220000,220000,0,0,220000,Null,Null,125891434,4971657,4428
125913788,0.0,0.0,28350000,21262500,7087500,25,28350000,Null,Null,125913788,167287,12882
125913928,341.0,341.0,1000,1000,0,0,1000,Null,Null,125913928,111461,2363
125913939,69.0,69.0,159000,129000,30000,19,159000,Null,Null,125913939,111461,23352
125913969,0.0,0.0,12800,12800,0,0,12800,Null,Null,125913969,111461,23276
125914006,0.0,0.0,120000,86000,34000,28,120000,Null,Null,125914006,111461,2020
125937765,0.0,0.0,43000000,43000000,0,0,43000000,Null,Null,125937765,231867,7713
125945950,6.0,6.0,149000,149000,0,0,149000,Null,Null,125945950,111461,15250
125948899,23.0,23.0,10000,10000,0,0,10000,Null,Null,125948899,111461,15936
125964814,0.0,0.0,12000,12000,0,0,12000,Null,Null,125964814,111461,2
125968226,192.0,192.0,345000,225000,120000,35,345000,Null,Null,125968226,111461,2
125968227,8.0,8.0,73599,73599,0,0,73599,Null,Null,125968227,111461,1883
125975097,0.0,0.0,91800000,91800000,0,0,91800000,Null,Null,125975097,111461,23112
125977524,0.0,0.0,111420000,111420000,0,0,111420000,Null,Null,125977524,111461,23112
126010109,7.0,7.0,2000000,1000000,1000000,50,2000000,Null,Null,126010109,111461,15936
126022421,1.0,1.0,3685000,3685000,0,0,3685000,Null,Null,126022421,259989,5893
126022430,2.0,2.0,3496000,3496000,0,0,3496000,Null,Null,126022430,259989,17170
126022549,0.0,0.0,3723500,3723500,0,0,3723500,Null,Null,126022549,259989,17170
126023110,593.0,593.0,660000,599000,61000,9,660000,Null,Null,126023110,111454,12908
126075524,513.0,513.0,390000,290000,100000,26,390000,Null,Null,126075524,111454,12908
126075551,64.0,64.0,13990000,8390000,5600000,40,13990000,Null,Null,126075551,18802,1794
126082769,1.0,1.0,9690000,9690000,0,0,9690000,Null,Null,126082769,111461,2340
126120768,611.0,611.0,1399000,990000,409000,29,1399000,Null,Null,126120768,4250493,4381
126131828,396.0,396.0,654000,327000,327000,50,654000,Null,Null,126131828,63894,1634
126144514,1.0,1.0,2500,2500,0,0,2500,Null,Null,126144514,111461,18876
126147209,0.0,0.0,22190000,22190000,0,0,22190000,Null,Null,126147209,471845,1803
126151275,64.0,64.0,29000,29000,0,0,29000,Null,Null,126151275,111461,23362
126219232,0.0,0.0,21500000,21500000,0,0,21500000,Null,Null,126219232,167287,1813
126235940,432.0,432.0,165000,95000,70000,42,165000,Null,Null,126235940,608153,8217
126236113,111.0,111.0,114900,114900,0,0,114900,Null,Null,126236113,111461,23642
126258005,7.0,7.0,4590000,3490000,1100000,24,4590000,Null,Null,126258005,4885445,8172
126258813,2.0,2.0,4590000,3490000,1100000,24,4590000,Null,Null,126258813,4885445,2340
126260026,71.0,71.0,83999,83999,0,0,83999,Null,Null,126260026,111461,1634
126296874,0.0,0.0,75000000,75000000,0,0,75000000,Null,Null,126296874,231867,27240
126415021,154.0,154.0,99000,99000,0,0,99000,Null,Null,126415021,661985,5566
126473795,0.0,0.0,8999000,8999000,0,0,8999000,Null,Null,126473795,111461,15318
126473799,0.0,0.0,14000000,14000000,0,0,14000000,Null,Null,126473799,111461,15318
126473804,0.0,0.0,12000000,12000000,0,0,12000000,Null,Null,126473804,111461,15318
126473807,0.0,0.0,13000000,13000000,0,0,13000000,Null,Null,126473807,111461,15318
126473810,0.0,0.0,8000000,8000000,0,0,8000000,Null,Null,126473810,111461,15318
126473936,0.0,0.0,8000000,8000000,0,0,8000000,Null,Null,126473936,111461,15318
126474000,0.0,0.0,6000000,6000000,0,0,6000000,Null,Null,126474000,111461,15318
126474007,0.0,0.0,10800000,10800000,0,0,10800000,Null,Null,126474007,111461,15318
126474141,0.0,0.0,6500000,6500000,0,0,6500000,Null,Null,126474141,111461,15318
126682340,105.0,105.0,4290000,3609000,681000,16,4290000,Null,Null,126682340,25422,1795
126689796,2.0,2.0,3400000,3400000,0,0,3400000,Null,Null,126689796,27449,8172
126690362,130.0,130.0,130000,114000,16000,12,130000,Null,Null,126690362,25422,4428
126703130,0.0,0.0,3552000,3552000,0,0,3552000,Null,Null,126703130,25422,1795
126724795,60.0,60.0,890000,793000,97000,11,890000,Null,Null,126724795,111461,2340
126734154,0.0,0.0,5200000,5200000,0,0,5200000,Null,Null,126734154,5175843,8227
126764970,0.0,0.0,15000,15000,0,0,15000,Null,Null,126764970,111461,2
126765029,3.0,3.0,18000,18000,0,0,18000,Null,Null,126765029,111461,2
126765224,0.0,0.0,14102000,12409760,1692240,12,14102000,Null,Null,126765224,167287,2324
126765640,43.0,43.0,229000,229000,0,0,229000,Null,Null,126765640,363011,27196
126808465,272.0,272.0,549000,428000,121000,22,549000,Null,Null,126808465,242273,17170
126810028,1.0,1.0,111200,111200,0,0,111200,Null,Null,126810028,111461,2
126810369,0.0,0.0,119200,119200,0,0,119200,Null,Null,126810369,111461,2
126822580,562.0,562.0,215000,194000,21000,10,215000,Null,Null,126822580,46335,1634
126864846,194.0,194.0,357000,319000,38000,11,357000,Null,Null,126864846,21268,1520
126925274,223.0,223.0,590000,407000,183000,31,590000,Null,Null,126925274,28008,2977
126945321,2040.0,2040.0,60000,42000,18000,30,60000,Null,Null,126945321,182863,1630
126945334,847.0,847.0,335000,219000,116000,35,335000,Null,Null,126945334,182863,1630
126945340,306.0,306.0,135000,99000,36000,27,135000,Null,Null,126945340,182863,1630
126945345,472.0,472.0,49000,36000,13000,27,49000,Null,Null,126945345,182863,1630
126945359,387.0,387.0,135000,99000,36000,27,135000,Null,Null,126945359,182863,1630
126945370,910.0,910.0,215000,179000,36000,17,215000,Null,Null,126945370,182863,1630
126945372,597.0,597.0,35000,29000,6000,17,35000,Null,Null,126945372,182863,1630
126959538,181.0,181.0,161400,161400,0,0,161400,Null,Null,126959538,373379,53350
126962714,110.0,110.0,1781,1781,0,0,1781,Null,Null,126962714,111461,28630
126973509,79.0,79.0,1899,1899,0,0,1899,Null,Null,126973509,111461,6742
126979953,33.0,33.0,1190000,1079000,111000,9,1190000,Null,Null,126979953,19018,2334
126998612,386.0,386.0,3990000,3490000,500000,13,3990000,Null,Null,126998612,20215,2324
127003432,1.0,1.0,30000,30000,0,0,30000,Null,Null,127003432,111461,2
127003495,0.0,0.0,8000,8000,0,0,8000,Null,Null,127003495,111461,2
127007937,524.0,524.0,45000,45000,0,0,45000,Null,Null,127007937,111461,2
127008110,10.0,10.0,19000,19000,0,0,19000,Null,Null,127008110,111461,2
127026903,23295.0,23295.0,139400,129000,10400,7,139400,Null,Null,127026903,21266,1520
127031393,165.0,165.0,506000,263000,243000,48,506000,Null,Null,127031393,48077,1936
127059533,0.0,0.0,10000,10000,0,0,10000,Null,Null,127059533,111461,15318
127120433,14.0,14.0,45000,45000,0,0,45000,Null,Null,127120433,111461,2
127123061,0.0,0.0,9799999,9799999,0,0,9799999,Null,Null,127123061,111461,2340
127123218,0.0,0.0,998000,998000,0,0,998000,Null,Null,127123218,111461,2340
127123470,0.0,0.0,9799999,9799999,0,0,9799999,Null,Null,127123470,111461,2340
127124912,0.0,0.0,9690000,9690000,0,0,9690000,Null,Null,127124912,111461,2340
127127099,0.0,0.0,10299000,10299000,0,0,10299000,Null,Null,127127099,111461,2340
127152344,452.0,452.0,195000,179000,16000,8,195000,Null,Null,127152344,3973395,2
127152391,7.0,7.0,19000,19000,0,0,19000,Null,Null,127152391,111461,15236
127171674,10.0,10.0,7000,7000,0,0,7000,Null,Null,127171674,111461,8073
127202818,0.0,0.0,34885,26987,7898,23,34885,Null,Null,127202818,111461,28484
127203997,30.0,30.0,62000,62000,0,0,62000,Null,Null,127203997,48495,5872
127213379,3.0,3.0,1500,1500,0,0,1500,Null,Null,127213379,111461,2
127219573,17.0,17.0,150000,150000,0,0,150000,Null,Null,127219573,46363,49722
127236876,98.0,98.0,83900,76000,7900,9,83900,Null,Null,127236876,111461,28682
127303135,1.0,1.0,1300,1300,0,0,1300,Null,Null,127303135,111461,2
127303136,1.0,1.0,1400,1400,0,0,1400,Null,Null,127303136,111461,2
127323163,17.0,17.0,449900,449900,0,0,449900,Null,Null,127323163,111461,2
127336788,18.0,18.0,228000,221000,7000,3,228000,Null,Null,127336788,111461,51698
127360217,22.0,22.0,148000,89997,58003,39,148000,Null,Null,127360217,163707,28574
127371586,128.0,128.0,20000,20000,0,0,20000,Null,Null,127371586,444709,15936
127377722,1560.0,1560.0,115000,104000,11000,10,115000,Null,Null,127377722,86206,1583
127377751,24.0,24.0,105000,94500,10500,10,105000,Null,Null,127377751,111461,15236
127382343,0.0,0.0,2000,2000,0,0,2000,Null,Null,127382343,111461,23712
127426927,4.0,4.0,3855000,3855000,0,0,3855000,Null,Null,127426927,840703,11847
127427374,0.0,0.0,7260,7260,0,0,7260,Null,Null,127427374,111461,2
127428236,3.0,3.0,129000,129000,0,0,129000,Null,Null,127428236,111461,2
127428568,30.0,30.0,359000,359000,0,0,359000,Null,Null,127428568,111461,2
127461281,57.0,57.0,48000,24000,24000,50,48000,Null,Null,127461281,4647777,15318
127493230,430.0,430.0,89000,89000,0,0,89000,Null,Null,127493230,111461,28480
127507468,35.0,35.0,30000,15000,15000,50,30000,Null,Null,127507468,4647777,15318
127515106,534.0,534.0,660000,660000,0,0,660000,Null,Null,127515106,239897,11851
127568502,1.0,1.0,50000,50000,0,0,50000,Null,Null,127568502,111461,2
127575646,16.0,16.0,6000,5000,1000,17,6000,Null,Null,127575646,111461,1819
127600456,15.0,15.0,34800,19000,15800,45,34800,Null,Null,127600456,111461,23416
127615619,18.0,18.0,89000,89000,0,0,89000,Null,Null,127615619,111461,2
127623547,283.0,283.0,2000000,1650000,350000,18,2000000,Null,Null,127623547,5204509,23668
127624468,0.0,0.0,14968800,14968800,0,0,14968800,Null,Null,127624468,505049,6653
127626099,5.0,5.0,88900,88900,0,0,88900,Null,Null,127626099,111461,28434
127634713,0.0,0.0,18295200,18295200,0,0,18295200,Null,Null,127634713,505049,6653
127634942,0.0,0.0,2000,2000,0,0,2000,Null,Null,127634942,111461,23042
127635275,213.0,213.0,43000,43000,0,0,43000,Null,Null,127635275,561415,2514
127640474,0.0,0.0,13120800,13120800,0,0,13120800,Null,Null,127640474,505049,6653
127643158,0.0,0.0,58766400,58766400,0,0,58766400,Null,Null,127643158,505049,6653
127649036,302.0,302.0,75000,75000,0,0,75000,Null,Null,127649036,561415,53074
127649109,0.0,0.0,36590400,36590400,0,0,36590400,Null,Null,127649109,505049,6653
127654217,0.0,0.0,95467900,95467900,0,0,95467900,Null,Null,127654217,505049,6653
127671582,1.0,1.0,150000,150000,0,0,150000,Null,Null,127671582,46363,49722
127680203,0.0,0.0,79279200,79279200,0,0,79279200,Null,Null,127680203,505049,6653
127680701,0.0,0.0,3912000,3912000,0,0,3912000,Null,Null,127680701,25643,1795
127680713,231.0,231.0,56000,33000,23000,41,56000,Null,Null,127680713,741117,2514
127680906,0.0,0.0,75842800,75842800,0,0,75842800,Null,Null,127680906,505049,6653
127687083,0.0,0.0,58951200,58951200,0,0,58951200,Null,Null,127687083,505049,28860
127693039,482.0,482.0,320000,249000,71000,22,320000,Null,Null,127693039,5382095,23702
127695415,698.0,698.0,689000,344000,345000,50,689000,Null,Null,127695415,302375,2324
127713429,64.0,64.0,27000,27000,0,0,27000,Null,Null,127713429,5182091,23416
127744188,44.0,44.0,320000,320000,0,0,320000,Null,Null,127744188,411559,28598
127783099,964.0,964.0,1900,1881,19,1,1900,Null,Null,127783099,111461,6742
127784175,0.0,0.0,12810000,9150000,3660000,29,12810000,Null,Null,127784175,405211,8512
127784943,241.0,241.0,33000,27000,6000,18,33000,Null,Null,127784943,200595,17162
127785038,0.0,0.0,17780000,9150000,8630000,49,17780000,Null,Null,127785038,405211,8512
127794615,263.0,263.0,95000,75000,20000,21,95000,Null,Null,127794615,21651,5006
127834614,33.0,33.0,210000,175000,35000,17,210000,Null,Null,127834614,41403,1637
127838243,10.0,10.0,81000,81000,0,0,81000,Null,Null,127838243,111461,2016
127891085,551.0,551.0,130000,78000,52000,40,130000,Null,Null,127891085,198555,1613
127941953,23.0,23.0,828000,459999,368001,44,828000,Null,Null,127941953,111461,26652
127964805,149.0,149.0,349000,344800,4200,1,349000,Null,Null,127964805,111461,23010
127965067,0.0,0.0,19800000,19800000,0,0,19800000,Null,Null,127965067,111461,1803
127966143,0.0,0.0,16300000,16300000,0,0,16300000,Null,Null,127966143,111461,1803
127966263,0.0,0.0,13200000,13200000,0,0,13200000,Null,Null,127966263,111461,1803
127966530,27.0,27.0,250000,250000,0,0,250000,Null,Null,127966530,111461,5531
127966561,57.0,57.0,660000,448000,212000,32,660000,Null,Null,127966561,314675,2324
127979471,85.0,85.0,140089,89001,51088,36,140089,Null,Null,127979471,848485,5995
127986319,195.0,195.0,149000,149000,0,0,149000,Null,Null,127986319,208091,28674
128108398,0.0,0.0,28089600,28089600,0,0,28089600,Null,Null,128108398,505049,6653
128113321,0.0,0.0,36960000,36960000,0,0,36960000,Null,Null,128113321,505049,6653
128116648,0.0,0.0,33079200,33079200,0,0,33079200,Null,Null,128116648,505049,6653
128122653,0.0,0.0,37329600,37329600,0,0,37329600,Null,Null,128122653,505049,6653
128124216,0.0,0.0,8666000,6190000,2476000,29,8666000,Null,Null,128124216,405211,8512
128125427,11.0,11.0,2290000,2038000,252000,11,2290000,Null,Null,128125427,207367,15318
128130603,0.0,0.0,28967400,28967400,0,0,28967400,Null,Null,128130603,505049,6653
128133331,0.0,0.0,25502400,25502400,0,0,25502400,Null,Null,128133331,505049,6653
128133958,11.0,11.0,354900,354900,0,0,354900,Null,Null,128133958,193677,2
128134327,0.0,0.0,19311600,19311600,0,0,19311600,Null,Null,128134327,505049,6653
128213350,214.0,214.0,15000,15000,0,0,15000,Null,Null,128213350,63747,1626
128214007,66.0,66.0,5000,5000,0,0,5000,Null,Null,128214007,63747,11939
128251870,0.0,0.0,10000,10000,0,0,10000,Null,Null,128251870,111461,15320
128251928,17.0,17.0,70000,70000,0,0,70000,Null,Null,128251928,111461,2
128257852,292.0,292.0,500000,450000,50000,10,500000,Null,Null,128257852,111454,4428
128266912,483.0,483.0,285000,185000,100000,35,285000,Null,Null,128266912,245063,17162
128268123,1.0,1.0,47200,47200,0,0,47200,Null,Null,128268123,111461,2
128275569,76.0,76.0,145089,89001,56088,39,145089,Null,Null,128275569,848485,5995
128288106,3.0,3.0,86000,86000,0,0,86000,Null,Null,128288106,111461,15318
128288183,65.0,65.0,299000,199000,100000,33,299000,Null,Null,128288183,625853,2324
128296587,59.0,59.0,57000,56430,570,1,57000,Null,Null,128296587,111461,2
128314730,18.0,18.0,1395000,1395000,0,0,1395000,Null,Null,128314730,749425,11516
128318374,0.0,0.0,10000,10000,0,0,10000,Null,Null,128318374,111461,2
128325116,5.0,5.0,10000,10000,0,0,10000,Null,Null,128325116,111461,17186
128326449,6.0,6.0,2000,2000,0,0,2000,Null,Null,128326449,111461,2
128327710,11.0,11.0,3000,3000,0,0,3000,Null,Null,128327710,111461,17186
128330187,3.0,3.0,2390000,2290000,100000,4,2390000,Null,Null,128330187,207367,15318
128438784,29.0,29.0,840000,459000,381000,45,840000,Null,Null,128438784,19312,28454
128469011,0.0,0.0,1993,1993,0,0,1993,Null,Null,128469011,111461,2
128519708,112.0,112.0,59000,59000,0,0,59000,Null,Null,128519708,111461,20492
128589776,28.0,28.0,950000,950000,0,0,950000,Null,Null,128589776,661985,28644
128593580,0.0,0.0,6305000,5674500,630500,10,6305000,Null,Null,128593580,205847,11873
128606592,0.0,0.0,2290,2290,0,0,2290,Null,Null,128606592,111461,53074
128623442,40.0,40.0,2300,2300,0,0,2300,Null,Null,128623442,111461,2
128624772,0.0,0.0,2200,2200,0,0,2200,Null,Null,128624772,111461,2
128658431,0.0,0.0,11000,11000,0,0,11000,Null,Null,128658431,111461,2
128658745,0.0,0.0,18000,18000,0,0,18000,Null,Null,128658745,111461,2
128658863,0.0,0.0,35000,35000,0,0,35000,Null,Null,128658863,111461,2
128659501,0.0,0.0,15000,15000,0,0,15000,Null,Null,128659501,111461,2
128659651,0.0,0.0,11000,11000,0,0,11000,Null,Null,128659651,111461,2
128660038,5.0,5.0,6000,6000,0,0,6000,Null,Null,128660038,111461,2
128660252,0.0,0.0,17000,17000,0,0,17000,Null,Null,128660252,111461,2
128660259,0.0,0.0,14000,14000,0,0,14000,Null,Null,128660259,111461,2
128660314,1.0,1.0,17000,17000,0,0,17000,Null,Null,128660314,111461,2
128660701,0.0,0.0,10000,10000,0,0,10000,Null,Null,128660701,111461,2
128660802,0.0,0.0,18000,18000,0,0,18000,Null,Null,128660802,111461,2
128661266,0.0,0.0,16000,16000,0,0,16000,Null,Null,128661266,111461,2
128661482,31.0,31.0,14000,14000,0,0,14000,Null,Null,128661482,111461,2
128661725,3.0,3.0,16000,16000,0,0,16000,Null,Null,128661725,111461,2
128661739,2.0,2.0,16000,16000,0,0,16000,Null,Null,128661739,111461,2
128661786,0.0,0.0,18000,18000,0,0,18000,Null,Null,128661786,111461,2
128662042,0.0,0.0,14000,14000,0,0,14000,Null,Null,128662042,111461,2
128662104,80.0,80.0,11000,11000,0,0,11000,Null,Null,128662104,111461,2
128662198,0.0,0.0,14000,14000,0,0,14000,Null,Null,128662198,111461,2
128662261,0.0,0.0,14000,14000,0,0,14000,Null,Null,128662261,111461,2
128662386,60.0,60.0,11000,11000,0,0,11000,Null,Null,128662386,111461,2
128662387,0.0,0.0,15000,15000,0,0,15000,Null,Null,128662387,111461,2
128663719,0.0,0.0,18000,18000,0,0,18000,Null,Null,128663719,111461,2
128663748,10.0,10.0,16000,16000,0,0,16000,Null,Null,128663748,111461,2
128663821,4.0,4.0,8000,8000,0,0,8000,Null,Null,128663821,111461,2
128664029,0.0,0.0,11000,11000,0,0,11000,Null,Null,128664029,111461,2
128702584,1.0,1.0,5065000,4558500,506500,10,5065000,Null,Null,128702584,205847,11869
128710027,1.0,1.0,160000,160000,0,0,160000,Null,Null,128710027,111461,28480
128732833,1.0,1.0,300000,300000,0,0,300000,Null,Null,128732833,171457,2
128793448,0.0,0.0,9700000,6193000,3507000,36,9700000,Null,Null,128793448,416127,3424
128800171,0.0,0.0,12900000,9675000,3225000,25,12900000,Null,Null,128800171,416127,8227
128800629,41.0,41.0,8500,8500,0,0,8500,Null,Null,128800629,561415,5566
128800894,169.0,169.0,8000,8000,0,0,8000,Null,Null,128800894,561415,5566
128800946,0.0,0.0,7000,7000,0,0,7000,Null,Null,128800946,561415,8073
128803988,206.0,206.0,9900,9000,900,9,9900,Null,Null,128803988,111461,10386
128812059,0.0,0.0,14000000,14000000,0,0,14000000,Null,Null,128812059,5203333,20252
128813003,0.0,0.0,2343,2343,0,0,2343,Null,Null,128813003,111461,1819
128823103,0.0,0.0,360000,360000,0,0,360000,Null,Null,128823103,886169,2334
128824297,18.0,18.0,299000,299000,0,0,299000,Null,Null,128824297,886169,2334
128873501,0.0,0.0,20000000,20000000,0,0,20000000,Null,Null,128873501,5207831,2340
128895957,8.0,8.0,3999000,3999000,0,0,3999000,Null,Null,128895957,111461,28856
128912879,853.0,853.0,169000,169000,0,0,169000,Null,Null,128912879,5207801,11923
128934831,0.0,0.0,29863000,26279440,3583560,12,29863000,Null,Null,128934831,111461,11518
128969410,1254.0,1254.0,212000,196000,16000,8,212000,Null,Null,128969410,523789,23658
129009982,0.0,0.0,17000000,11105000,5895000,35,17000000,Null,Null,129009982,416127,8227
129010861,793.0,793.0,59000,59000,0,0,59000,Null,Null,129010861,111461,2
129019379,0.0,0.0,6500,6500,0,0,6500,Null,Null,129019379,111461,28726
129020930,4.0,4.0,1500,1500,0,0,1500,Null,Null,129020930,111461,2
129059170,38.0,38.0,300000,150000,150000,50,300000,Null,Null,129059170,194739,28480
129070719,20.0,20.0,139900,130000,9900,7,139900,Null,Null,129070719,111461,5264
129135037,168.0,168.0,139000,139000,0,0,139000,Null,Null,129135037,149236,4380
129143705,0.0,0.0,135000,135000,0,0,135000,Null,Null,129143705,111461,2
129167166,68.0,68.0,1990000,1299000,691000,35,1990000,Null,Null,129167166,111461,1795
129167418,51.0,51.0,1990000,1315000,675000,34,1990000,Null,Null,129167418,111461,1795
129198756,0.0,0.0,56271000,49518480,6752520,12,56271000,Null,Null,129198756,111461,11518
129206182,0.0,0.0,34697000,30533360,4163640,12,34697000,Null,Null,129206182,111461,11518
129211630,44.0,44.0,39000,39000,0,0,39000,Null,Null,129211630,111461,53054
129211649,54.0,54.0,69000,69000,0,0,69000,Null,Null,129211649,111461,2
129214118,8.0,8.0,7900,7742,158,2,7900,Null,Null,129214118,111461,2
129346976,0.0,0.0,17273000,17273000,0,0,17273000,Null,Null,129346976,26150,2
129347446,0.0,0.0,18137000,18137000,0,0,18137000,Null,Null,129347446,26150,2
129347577,0.0,0.0,12103000,10892700,1210300,10,12103000,Null,Null,129347577,26150,2
129355990,0.0,0.0,43500000,43500000,0,0,43500000,Null,Null,129355990,5201353,23050
129356132,0.0,0.0,1045000,1045000,0,0,1045000,Null,Null,129356132,472079,8061
129356137,135.0,135.0,139000,139000,0,0,139000,Null,Null,129356137,149308,28578
129356493,8.0,8.0,135000,135000,0,0,135000,Null,Null,129356493,111461,23254
129368006,9.0,9.0,30000,30000,0,0,30000,Null,Null,129368006,111461,15320
129380123,4.0,4.0,301000,150500,150500,50,301000,Null,Null,129380123,111461,2
129407931,0.0,0.0,20298000,20298000,0,0,20298000,Null,Null,129407931,111461,2324
129436386,18.0,18.0,56000,56000,0,0,56000,Null,Null,129436386,111461,15250
129521118,579.0,579.0,275000,189000,86000,31,275000,Null,Null,129521118,223749,17170
129521182,422.0,422.0,550000,389000,161000,29,550000,Null,Null,129521182,40626,17170
129523456,1.0,1.0,5900000,5310000,590000,10,5900000,Null,Null,129523456,205847,11873
129536599,120.0,120.0,439000,315000,124000,28,439000,Null,Null,129536599,4250493,4381
129563907,0.0,0.0,56200000,56200000,0,0,56200000,Null,Null,129563907,5201353,23050
129566552,0.0,0.0,62500000,62500000,0,0,62500000,Null,Null,129566552,5201353,23050
129569085,0.0,0.0,38500000,38500000,0,0,38500000,Null,Null,129569085,5201353,23050
129572382,239.0,239.0,1400,1400,0,0,1400,Null,Null,129572382,111461,1819
129573485,0.0,0.0,11416000,11416000,0,0,11416000,Null,Null,129573485,111461,2324
129574590,0.0,0.0,36500000,36500000,0,0,36500000,Null,Null,129574590,5201353,23050
129575548,0.0,0.0,48500000,48500000,0,0,48500000,Null,Null,129575548,5201353,23050
129577489,0.0,0.0,58500000,58500000,0,0,58500000,Null,Null,129577489,5201353,23050
129586552,1.0,1.0,1500,1500,0,0,1500,Null,Null,129586552,111461,2392
129586554,3.0,3.0,1399,1399,0,0,1399,Null,Null,129586554,111461,53074
129586597,0.0,0.0,1400,1400,0,0,1400,Null,Null,129586597,111461,2392
129619655,13.0,13.0,49000,49000,0,0,49000,Null,Null,129619655,111461,2
129619718,38.0,38.0,18700,18700,0,0,18700,Null,Null,129619718,111461,2
129619894,11.0,11.0,79000,79000,0,0,79000,Null,Null,129619894,111461,2
129619907,27.0,27.0,49000,49000,0,0,49000,Null,Null,129619907,111461,2
129666372,0.0,0.0,441000,441000,0,0,441000,Null,Null,129666372,111461,15320
129667111,39.0,39.0,735000,735000,0,0,735000,Null,Null,129667111,111461,28444
129669398,0.0,0.0,4750,4750,0,0,4750,Null,Null,129669398,111461,2
129670052,0.0,0.0,6000,6000,0,0,6000,Null,Null,129670052,111461,20254
129720384,34.0,34.0,99000,99000,0,0,99000,Null,Null,129720384,111461,11907
129727672,113.0,113.0,1318000,532000,786000,60,1318000,Null,Null,129727672,145337,11845
129734368,22.0,22.0,18000,18000,0,0,18000,Null,Null,129734368,111461,15250
129737243,481.0,481.0,125000,125000,0,0,125000,Null,Null,129737243,5159231,2514
129741417,2949.0,2949.0,99000,94000,5000,5,99000,Null,Null,129741417,202607,5900
129747054,566.0,566.0,250000,125000,125000,50,250000,Null,Null,129747054,892751,1936
129765975,1.0,1.0,6022000,6022000,0,0,6022000,Null,Null,129765975,26150,8513
129766324,4.0,4.0,7721000,5498000,2223000,29,7721000,Null,Null,129766324,26150,8513
129766661,117.0,117.0,640000,526000,114000,18,640000,Null,Null,129766661,4935523,12984
129778844,3.0,3.0,756000,604800,151200,20,756000,Null,Null,129778844,111461,2
129871533,0.0,0.0,9600,9600,0,0,9600,Null,Null,129871533,111461,8068
129911118,695.0,695.0,620000,620000,0,0,620000,Null,Null,129911118,4008673,12876
129917002,3.0,3.0,9000,9000,0,0,9000,Null,Null,129917002,537217,2
129947293,449.0,449.0,320000,180000,140000,44,320000,Null,Null,129947293,5211513,17170
129948249,0.0,0.0,1500,1500,0,0,1500,Null,Null,129948249,5211303,2
129948637,12.0,12.0,1500,1500,0,0,1500,Null,Null,129948637,5211303,2
129948697,20.0,20.0,1500,1500,0,0,1500,Null,Null,129948697,5211303,2
129949198,14.0,14.0,2200,2200,0,0,2200,Null,Null,129949198,5211303,2
129949563,0.0,0.0,1500,1500,0,0,1500,Null,Null,129949563,5211303,2
129949948,6.0,6.0,2200,2200,0,0,2200,Null,Null,129949948,5211303,2
129953317,98.0,98.0,890000,550000,340000,38,890000,Null,Null,129953317,4935523,12984
130014150,89.0,89.0,9900,9000,900,9,9900,Null,Null,130014150,111461,8305
130048498,4.0,4.0,175000,139000,36000,21,175000,Null,Null,130048498,111461,28598
130061686,23.0,23.0,375000,375000,0,0,375000,Null,Null,130061686,26150,8513
130062141,38.0,38.0,375000,375000,0,0,375000,Null,Null,130062141,26150,8513
130065401,192.0,192.0,139000,129000,10000,7,139000,Null,Null,130065401,21651,5006
130073582,0.0,0.0,3590000,3590000,0,0,3590000,Null,Null,130073582,192615,8227
130084138,9.0,9.0,7254000,5181750,2072250,29,7254000,Null,Null,130084138,26150,8513
130084156,184.0,184.0,68500,68500,0,0,68500,Null,Null,130084156,21651,5006
130120432,0.0,0.0,50000000,50000000,0,0,50000000,Null,Null,130120432,223415,23102
130133890,1.0,1.0,5000,5000,0,0,5000,Null,Null,130133890,111461,2
130168796,0.0,0.0,48000000,48000000,0,0,48000000,Null,Null,130168796,223415,27212
130170343,538.0,538.0,133000,133000,0,0,133000,Null,Null,130170343,25643,12294
130172342,735.0,735.0,99000,85000,14000,14,99000,Null,Null,130172342,21651,5006
130199624,62.0,62.0,396000,279000,117000,30,396000,Null,Null,130199624,573215,1583
130210163,0.0,0.0,3591000,3591000,0,0,3591000,Null,Null,130210163,192615,8227
130228303,202.0,202.0,1999000,1403000,596000,30,1999000,Null,Null,130228303,4250493,7273
130266484,73.0,73.0,440000,440000,0,0,440000,Null,Null,130266484,4307205,28682
130315179,332.0,332.0,79000,59000,20000,25,79000,Null,Null,130315179,4884089,8167
130366923,39.0,39.0,29000,29000,0,0,29000,Null,Null,130366923,4202899,4593
130385949,48.0,48.0,19000,18810,190,1,19000,Null,Null,130385949,111461,23282
130385982,328.0,328.0,155000,155000,0,0,155000,Null,Null,130385982,143673,27128
130392702,0.0,0.0,6490000,5841000,649000,10,6490000,Null,Null,130392702,26150,2
130392957,0.0,0.0,6490000,6490000,0,0,6490000,Null,Null,130392957,26150,2
130398586,216.0,216.0,234000,191000,43000,18,234000,Null,Null,130398586,86206,8227
130398884,1.0,1.0,100000,100000,0,0,100000,Null,Null,130398884,111461,15250
130399238,0.0,0.0,3700000,3700000,0,0,3700000,Null,Null,130399238,185211,11689
130412896,130.0,130.0,189999,165800,24199,13,189999,Null,Null,130412896,5132069,23042
130413090,0.0,0.0,14990000,14990000,0,0,14990000,Null,Null,130413090,164793,7273
130416657,0.0,0.0,8900,8900,0,0,8900,Null,Null,130416657,111461,2
130416670,1.0,1.0,15000,15000,0,0,15000,Null,Null,130416670,111461,2
130417256,0.0,0.0,9000,9000,0,0,9000,Null,Null,130417256,111461,2
130417624,1.0,1.0,5000,5000,0,0,5000,Null,Null,130417624,111461,2
130417689,0.0,0.0,13000,13000,0,0,13000,Null,Null,130417689,111461,2
130417796,0.0,0.0,19000,19000,0,0,19000,Null,Null,130417796,111461,2
130418344,0.0,0.0,15000,15000,0,0,15000,Null,Null,130418344,111461,2
130418437,0.0,0.0,15000,15000,0,0,15000,Null,Null,130418437,111461,2
130418520,0.0,0.0,11000,11000,0,0,11000,Null,Null,130418520,111461,2
130418819,0.0,0.0,15000,15000,0,0,15000,Null,Null,130418819,111461,2
130419102,0.0,0.0,11000,11000,0,0,11000,Null,Null,130419102,111461,2
130419175,0.0,0.0,13000,13000,0,0,13000,Null,Null,130419175,111461,2
130419242,0.0,0.0,12000,12000,0,0,12000,Null,Null,130419242,111461,2
130420624,0.0,0.0,19000,19000,0,0,19000,Null,Null,130420624,111461,2
130420785,0.0,0.0,15000,15000,0,0,15000,Null,Null,130420785,111461,2
130420952,0.0,0.0,17000,17000,0,0,17000,Null,Null,130420952,111461,2
130420966,0.0,0.0,13000,13000,0,0,13000,Null,Null,130420966,111461,2
130421150,0.0,0.0,15000,15000,0,0,15000,Null,Null,130421150,111461,2
130421361,0.0,0.0,14500,14500,0,0,14500,Null,Null,130421361,111461,2
130422170,0.0,0.0,19000,19000,0,0,19000,Null,Null,130422170,111461,2
130422315,0.0,0.0,19000,19000,0,0,19000,Null,Null,130422315,111461,2
130422585,1.0,1.0,15000,15000,0,0,15000,Null,Null,130422585,111461,2
130422626,0.0,0.0,119000,119000,0,0,119000,Null,Null,130422626,111461,2
130422847,0.0,0.0,19000,19000,0,0,19000,Null,Null,130422847,111461,2
130423424,0.0,0.0,19000,19000,0,0,19000,Null,Null,130423424,111461,2
130423445,1.0,1.0,13000,13000,0,0,13000,Null,Null,130423445,111461,2
130423474,0.0,0.0,13000,13000,0,0,13000,Null,Null,130423474,111461,2
130423958,0.0,0.0,5000,5000,0,0,5000,Null,Null,130423958,111461,2
130424157,0.0,0.0,19000,19000,0,0,19000,Null,Null,130424157,111461,2
130424174,1.0,1.0,9000,9000,0,0,9000,Null,Null,130424174,111461,2
130424184,3.0,3.0,15000,15000,0,0,15000,Null,Null,130424184,111461,2
130424613,0.0,0.0,19000,19000,0,0,19000,Null,Null,130424613,111461,2
130424899,1.0,1.0,19000,19000,0,0,19000,Null,Null,130424899,111461,2
130425110,5.0,5.0,45000,45000,0,0,45000,Null,Null,130425110,111461,2
130425456,19.0,19.0,19000,19000,0,0,19000,Null,Null,130425456,111461,2
130425477,0.0,0.0,19000,19000,0,0,19000,Null,Null,130425477,111461,2
130425482,0.0,0.0,12000,12000,0,0,12000,Null,Null,130425482,111461,2
130425562,0.0,0.0,9000,9000,0,0,9000,Null,Null,130425562,111461,2
130426263,0.0,0.0,19000,19000,0,0,19000,Null,Null,130426263,111461,2
130426461,0.0,0.0,15000,15000,0,0,15000,Null,Null,130426461,111461,2
130426709,0.0,0.0,19000,19000,0,0,19000,Null,Null,130426709,111461,2
130427055,0.0,0.0,13000,13000,0,0,13000,Null,Null,130427055,111461,2
130427449,1.0,1.0,13000,13000,0,0,13000,Null,Null,130427449,111461,2
130448805,105.0,105.0,75000,55000,20000,27,75000,Null,Null,130448805,21653,4428
130468274,64.0,64.0,35000,25000,10000,29,35000,Null,Null,130468274,864561,11803
130472808,46.0,46.0,200000,200000,0,0,200000,Null,Null,130472808,111461,2512
130546622,1.0,1.0,4140000,4140000,0,0,4140000,Null,Null,130546622,5207489,11859
130552060,0.0,0.0,6900000,6900000,0,0,6900000,Null,Null,130552060,5207489,11859
130652529,245.0,245.0,320000,230400,89600,28,320000,Null,Null,130652529,431471,1613
130774948,351.0,351.0,300000,180000,120000,40,300000,Null,Null,130774948,5211513,8217
130781721,35.0,35.0,3000,3000,0,0,3000,Null,Null,130781721,111461,2
130781776,2.0,2.0,2000,2000,0,0,2000,Null,Null,130781776,111461,2
130781854,47.0,47.0,8000,8000,0,0,8000,Null,Null,130781854,111461,1819
130784951,8.0,8.0,24998,12499,12499,50,24998,Null,Null,130784951,111461,28574
130788110,42.0,42.0,1400,1400,0,0,1400,Null,Null,130788110,111461,53074
130834713,33.0,33.0,79000,43999,35001,44,79000,Null,Null,130834713,155563,28484
130864813,0.0,0.0,1980000,1980000,0,0,1980000,Null,Null,130864813,111461,15318
130969202,159.0,159.0,139000,139000,0,0,139000,Null,Null,130969202,274577,28484
130969514,2.0,2.0,598000,299000,299000,50,598000,Null,Null,130969514,111461,15318
130978275,83.0,83.0,192300,163000,29300,15,192300,Null,Null,130978275,41391,2
130996078,0.0,0.0,50000000,50000000,0,0,50000000,Null,Null,130996078,606305,23082
131028406,39.0,39.0,4050000,4050000,0,0,4050000,Null,Null,131028406,111461,1794
131029484,156.0,156.0,75000,75000,0,0,75000,Null,Null,131029484,111461,23800
131094811,0.0,0.0,38000000,38000000,0,0,38000000,Null,Null,131094811,111461,2
131094876,0.0,0.0,42000000,42000000,0,0,42000000,Null,Null,131094876,111461,2
131094918,0.0,0.0,40000000,40000000,0,0,40000000,Null,Null,131094918,111461,2
131094977,0.0,0.0,60000000,60000000,0,0,60000000,Null,Null,131094977,111461,2
131118260,0.0,0.0,2500,2500,0,0,2500,Null,Null,131118260,111461,2
131170526,19.0,19.0,6000000,4000000,2000000,33,6000000,Null,Null,131170526,5215439,8172
131175390,0.0,0.0,7000,7000,0,0,7000,Null,Null,131175390,111461,15318
131175964,2.0,2.0,7000,7000,0,0,7000,Null,Null,131175964,111461,15318
131184578,137.0,137.0,556200,309000,247200,44,556200,Null,Null,131184578,46703,2784
131246722,0.0,0.0,6500000,6500000,0,0,6500000,Null,Null,131246722,618611,11885
131262308,54.0,54.0,69000,69000,0,0,69000,Null,Null,131262308,41506,3177
131335906,1.0,1.0,108888,108888,0,0,108888,Null,Null,131335906,111461,23282
131336118,0.0,0.0,9799999,9799999,0,0,9799999,Null,Null,131336118,111461,2340
131340102,246.0,246.0,335000,335000,0,0,335000,Null,Null,131340102,560863,11859
131385610,3.0,3.0,6000,6000,0,0,6000,Null,Null,131385610,111461,20254
131385617,0.0,0.0,5000,5000,0,0,5000,Null,Null,131385617,111461,20254
131385619,0.0,0.0,5000,5000,0,0,5000,Null,Null,131385619,111461,20254
131385624,0.0,0.0,5000,5000,0,0,5000,Null,Null,131385624,111461,20254
131385625,0.0,0.0,6000,6000,0,0,6000,Null,Null,131385625,111461,20254
131385640,0.0,0.0,5000,5000,0,0,5000,Null,Null,131385640,111461,20254
131385710,0.0,0.0,8000,8000,0,0,8000,Null,Null,131385710,561415,20254
131385718,0.0,0.0,5000,5000,0,0,5000,Null,Null,131385718,111461,8064
131385721,0.0,0.0,8000,8000,0,0,8000,Null,Null,131385721,111461,20254
131385727,0.0,0.0,15000,15000,0,0,15000,Null,Null,131385727,111461,20254
131385778,0.0,0.0,5000,5000,0,0,5000,Null,Null,131385778,111461,20254
131385868,1.0,1.0,9000,9000,0,0,9000,Null,Null,131385868,111461,5566
131385922,0.0,0.0,4000,4000,0,0,4000,Null,Null,131385922,111461,8073
131385935,0.0,0.0,9000,9000,0,0,9000,Null,Null,131385935,561415,20254
131385978,0.0,0.0,8000,8000,0,0,8000,Null,Null,131385978,111461,20254
131385989,0.0,0.0,8000,8000,0,0,8000,Null,Null,131385989,111461,5566
131385997,0.0,0.0,5000,5000,0,0,5000,Null,Null,131385997,111461,5566
131386070,0.0,0.0,5000,5000,0,0,5000,Null,Null,131386070,111461,20254
131386088,0.0,0.0,4000,4000,0,0,4000,Null,Null,131386088,561415,5566
131386178,0.0,0.0,4000,4000,0,0,4000,Null,Null,131386178,111461,5566
131386202,0.0,0.0,8000,8000,0,0,8000,Null,Null,131386202,111461,20254
131386293,0.0,0.0,8000,8000,0,0,8000,Null,Null,131386293,111461,20254
131386318,0.0,0.0,8000,8000,0,0,8000,Null,Null,131386318,111461,20254
131386350,0.0,0.0,5000,5000,0,0,5000,Null,Null,131386350,111461,20254
131386441,0.0,0.0,8000,8000,0,0,8000,Null,Null,131386441,561415,20254
131386490,2.0,2.0,6999,6999,0,0,6999,Null,Null,131386490,111461,5566
131386506,0.0,0.0,8000,8000,0,0,8000,Null,Null,131386506,111461,20254
131386527,0.0,0.0,3000,3000,0,0,3000,Null,Null,131386527,111461,20254
131386549,0.0,0.0,6000,6000,0,0,6000,Null,Null,131386549,111461,20254
131397027,345.0,345.0,33000,33000,0,0,33000,Null,Null,131397027,111461,23078
131405298,10.0,10.0,219000,165000,54000,25,219000,Null,Null,131405298,111461,15318
131407862,0.0,0.0,420000,420000,0,0,420000,Null,Null,131407862,111461,2
131407951,0.0,0.0,390000,390000,0,0,390000,Null,Null,131407951,111461,2
131421529,13.0,13.0,1500,1500,0,0,1500,Null,Null,131421529,111461,2
131504612,90.0,90.0,35000,35000,0,0,35000,Null,Null,131504612,185875,1583
131504615,170.0,170.0,100000,100000,0,0,100000,Null,Null,131504615,185875,1613
131504747,648.0,648.0,300000,300000,0,0,300000,Null,Null,131504747,185875,1613
131531503,1.0,1.0,19000,19000,0,0,19000,Null,Null,131531503,5196303,15318
131866600,24.0,24.0,37199,37199,0,0,37199,Null,Null,131866600,4202899,5006
131932066,317.0,317.0,189000,92000,97000,51,189000,Null,Null,131932066,5048343,23242
131951374,12.0,12.0,50000,37000,13000,26,50000,Null,Null,131951374,111461,2
132051929,2.0,2.0,18000000,9000000,9000000,50,18000000,Null,Null,132051929,40734,1520
132063015,1.0,1.0,3600000,3600000,0,0,3600000,Null,Null,132063015,711855,2342
132068858,20085.0,20085.0,4990000,3550000,1440000,29,4990000,Null,Null,132068858,25643,1795
132078096,1.0,1.0,5500,5500,0,0,5500,Null,Null,132078096,111461,28480
132081621,986.0,986.0,320000,300000,20000,6,320000,Null,Null,132081621,64932,2
132081941,1891.0,1891.0,280000,280000,0,0,280000,Null,Null,132081941,64932,2
132144149,844.0,844.0,151000,151000,0,0,151000,Null,Null,132144149,274577,28484
132182674,24.0,24.0,37000,30000,7000,19,37000,Null,Null,132182674,111461,23416
132189779,1.0,1.0,3000,3000,0,0,3000,Null,Null,132189779,111461,2
132234204,0.0,0.0,20000000,11880000,8120000,41,20000000,Null,Null,132234204,18802,1795
132245379,0.0,0.0,1200,1200,0,0,1200,Null,Null,132245379,111461,2
132245578,1.0,1.0,2000,2000,0,0,2000,Null,Null,132245578,111461,2
132247327,1.0,1.0,159000,159000,0,0,159000,Null,Null,132247327,111461,2
132247480,1.0,1.0,2500,2500,0,0,2500,Null,Null,132247480,111461,2
132286262,226.0,226.0,245000,208250,36750,15,245000,Null,Null,132286262,542605,1613
132353050,2402.0,2402.0,17000,10100,6900,41,17000,Null,Null,132353050,886923,8305
132362880,109.0,109.0,185000,157250,27750,15,185000,Null,Null,132362880,542605,1616
132366103,0.0,0.0,1500,1000,500,33,1500,Null,Null,132366103,111461,6305
132366446,269.0,269.0,430000,430000,0,0,430000,Null,Null,132366446,542605,8223
132699764,251.0,251.0,1435001,1435001,0,0,1435001,Null,Null,132699764,2630119,2657
132701877,37.0,37.0,65000,65000,0,0,65000,Null,Null,132701877,111461,49722
132709062,18.0,18.0,69000,69000,0,0,69000,Null,Null,132709062,111461,49722
132776173,183.0,183.0,120000,69000,51000,43,120000,Null,Null,132776173,4401579,2225
132776348,76.0,76.0,145900,145900,0,0,145900,Null,Null,132776348,111461,28694
132782154,87.0,87.0,75000,75000,0,0,75000,Null,Null,132782154,111461,2
132809146,225.0,225.0,115000,115000,0,0,115000,Null,Null,132809146,111461,2
132812897,14.0,14.0,120000,120000,0,0,120000,Null,Null,132812897,111461,26652
132827914,130.0,130.0,108900,108900,0,0,108900,Null,Null,132827914,111461,51698
132829504,7.0,7.0,48000,48000,0,0,48000,Null,Null,132829504,111461,3877
132847845,0.0,0.0,4500000,4500000,0,0,4500000,Null,Null,132847845,185127,11889
132851843,2.0,2.0,2240,2240,0,0,2240,Null,Null,132851843,111461,2
132855042,0.0,0.0,2299,2299,0,0,2299,Null,Null,132855042,111461,2
132881144,0.0,0.0,9000,9000,0,0,9000,Null,Null,132881144,111461,2
132881520,17.0,17.0,1672,1672,0,0,1672,Null,Null,132881520,111461,2
132895619,0.0,0.0,6750000,6750000,0,0,6750000,Null,Null,132895619,185127,11868
132986593,12.0,12.0,2000,2000,0,0,2000,Null,Null,132986593,111461,2
133002064,0.0,0.0,15000,15000,0,0,15000,Null,Null,133002064,111461,15320
133077905,15.0,15.0,128000,124994,3006,2,128000,Null,Null,133077905,578915,5006
133135975,326.0,326.0,2000,2000,0,0,2000,Null,Null,133135975,111461,23134
133136224,7.0,7.0,29000,29000,0,0,29000,Null,Null,133136224,111461,23134
133136616,636.0,636.0,55000,33000,22000,40,55000,Null,Null,133136616,111461,23134
133137748,151.0,151.0,2000,2000,0,0,2000,Null,Null,133137748,111461,23134
133139418,111.0,111.0,590000,575000,15000,3,590000,Null,Null,133139418,150002,5267
133165247,6.0,6.0,92000,58918,33082,36,92000,Null,Null,133165247,4522605,28486
133165279,0.0,0.0,68000,68000,0,0,68000,Null,Null,133165279,4522605,28596
133192651,75.0,75.0,100000,83000,17000,17,100000,Null,Null,133192651,111461,23416
133245970,1891.0,1891.0,250000,194000,56000,22,250000,Null,Null,133245970,21271,11833
133245977,737.0,737.0,215509,200000,15509,7,215509,Null,Null,133245977,21271,11833
133247757,185.0,185.0,69000,69000,0,0,69000,Null,Null,133247757,4883627,2488
133252909,3.0,3.0,59950,59950,0,0,59950,Null,Null,133252909,111461,1838
133431763,22.0,22.0,39000,39000,0,0,39000,Null,Null,133431763,111461,2
133438909,45.0,45.0,265000,265000,0,0,265000,Null,Null,133438909,111461,2
133545037,18.0,18.0,490000,490000,0,0,490000,Null,Null,133545037,111461,28856
133573968,1792.0,1792.0,124950,85000,39950,32,124950,Null,Null,133573968,111461,2238
133579166,42.0,42.0,1459000,960000,499000,34,1459000,Null,Null,133579166,114328,53350
133587681,340.0,340.0,99000,86000,13000,13,99000,Null,Null,133587681,4766405,1631
133594959,1.0,1.0,1500,1500,0,0,1500,Null,Null,133594959,111461,2
133601401,168.0,168.0,4000,3000,1000,25,4000,Null,Null,133601401,154443,11921
133630024,12.0,12.0,13500,9000,4500,33,13500,Null,Null,133630024,154443,11921
133630160,8.0,8.0,4390000,4275000,115000,3,4390000,Null,Null,133630160,892671,8167
133630179,0.0,0.0,18700000,12300000,6400000,34,18700000,Null,Null,133630179,892671,5905
133630183,75.0,75.0,5345000,4275000,1070000,20,5345000,Null,Null,133630183,892671,8165
133630199,2.0,2.0,11000000,6800000,4200000,38,11000000,Null,Null,133630199,892671,11935
133630713,13.0,13.0,165000,165000,0,0,165000,Null,Null,133630713,111461,2
133637826,1062.0,1062.0,3000,1000,2000,67,3000,Null,Null,133637826,111461,2
133647235,476.0,476.0,2290000,1840000,450000,20,2290000,Null,Null,133647235,18641,8400
133667702,0.0,0.0,9000,9000,0,0,9000,Null,Null,133667702,111461,15250
133668007,15.0,15.0,1999,1999,0,0,1999,Null,Null,133668007,111461,27212
133668506,0.0,0.0,10000,10000,0,0,10000,Null,Null,133668506,111461,15250
133669284,0.0,0.0,7000,7000,0,0,7000,Null,Null,133669284,111461,15250
133683724,86.0,86.0,290000,290000,0,0,290000,Null,Null,133683724,143353,28574
133712719,23.0,23.0,55000,55000,0,0,55000,Null,Null,133712719,111461,2
133769004,1.0,1.0,350000,350000,0,0,350000,Null,Null,133769004,111461,15318
133776364,1.0,1.0,980,980,0,0,980,Null,Null,133776364,111461,2
133776413,0.0,0.0,2249,2249,0,0,2249,Null,Null,133776413,111461,2
133776444,0.0,0.0,4900,4900,0,0,4900,Null,Null,133776444,111461,15250
133776498,6.0,6.0,976,976,0,0,976,Null,Null,133776498,111461,2
133776634,1.0,1.0,1061,1061,0,0,1061,Null,Null,133776634,111461,2
133776788,0.0,0.0,1000,1000,0,0,1000,Null,Null,133776788,111461,2
133777068,0.0,0.0,1067,1067,0,0,1067,Null,Null,133777068,111461,2
133777101,2.0,2.0,1799,1799,0,0,1799,Null,Null,133777101,111461,2
133777351,9.0,9.0,985,985,0,0,985,Null,Null,133777351,111461,2
133781298,2.0,2.0,5000,5000,0,0,5000,Null,Null,133781298,111461,2
133781516,33.0,33.0,317000,317000,0,0,317000,Null,Null,133781516,111461,2
133786464,6.0,6.0,13000,13000,0,0,13000,Null,Null,133786464,111461,15250
133792748,3.0,3.0,16500,16500,0,0,16500,Null,Null,133792748,111461,15250
133810473,375.0,375.0,9800,9702,98,1,9800,Null,Null,133810473,111461,6742
133811308,322.0,322.0,9800,9702,98,1,9800,Null,Null,133811308,111461,6742
133812703,237.0,237.0,9800,9702,98,1,9800,Null,Null,133812703,111461,6742
133813148,87.0,87.0,99000,97020,1980,2,99000,Null,Null,133813148,361293,12908
133828351,0.0,0.0,11000,11000,0,0,11000,Null,Null,133828351,111461,2
133828729,0.0,0.0,9000,9000,0,0,9000,Null,Null,133828729,111461,2
133829477,0.0,0.0,17000,17000,0,0,17000,Null,Null,133829477,111461,2
133829902,0.0,0.0,7000,7000,0,0,7000,Null,Null,133829902,111461,2
133830063,2.0,2.0,11000,11000,0,0,11000,Null,Null,133830063,111461,2
133830211,2.0,2.0,12000,12000,0,0,12000,Null,Null,133830211,111461,2
133831012,4.0,4.0,7500,7500,0,0,7500,Null,Null,133831012,111461,2
133831836,9.0,9.0,7000,7000,0,0,7000,Null,Null,133831836,111461,2
133832046,0.0,0.0,5000,5000,0,0,5000,Null,Null,133832046,111461,2
133832129,0.0,0.0,11000,11000,0,0,11000,Null,Null,133832129,111461,2
133832207,4.0,4.0,5000,5000,0,0,5000,Null,Null,133832207,111461,2
133832256,23.0,23.0,6000,6000,0,0,6000,Null,Null,133832256,111461,2
133832533,1.0,1.0,12000,12000,0,0,12000,Null,Null,133832533,111461,2
133832830,1.0,1.0,16000,16000,0,0,16000,Null,Null,133832830,111461,2
133866129,767.0,767.0,43000,43000,0,0,43000,Null,Null,133866129,4401579,2363
133870923,75.0,75.0,249000,211650,37350,15,249000,Null,Null,133870923,5132069,23622
133878527,3.0,3.0,139000,138899,101,0,139000,Null,Null,133878527,149308,28484
133878592,308.0,308.0,145000,145000,0,0,145000,Null,Null,133878592,403371,11883
133885059,99.0,99.0,195000,195000,0,0,195000,Null,Null,133885059,4548297,23006
133887925,38.0,38.0,790000,383000,407000,52,790000,Null,Null,133887925,204385,2971
133888085,3.0,3.0,114000,114000,0,0,114000,Null,Null,133888085,111461,2
133914884,3.0,3.0,350000,350000,0,0,350000,Null,Null,133914884,111461,15318
133916249,0.0,0.0,14512000,14512000,0,0,14512000,Null,Null,133916249,19032,1803
133919683,1.0,1.0,12000,12000,0,0,12000,Null,Null,133919683,111461,49728
133922359,3.0,3.0,990,990,0,0,990,Null,Null,133922359,111461,1883
133922754,13.0,13.0,1000,1000,0,0,1000,Null,Null,133922754,111461,27214
133928750,0.0,0.0,25729000,25729000,0,0,25729000,Null,Null,133928750,18802,8067
133939248,39.0,39.0,165000,165000,0,0,165000,Null,Null,133939248,111461,4342
133943177,159.0,159.0,5000,5000,0,0,5000,Null,Null,133943177,111461,20258
134016395,0.0,0.0,25000,25000,0,0,25000,Null,Null,134016395,111461,1883
134016740,3.0,3.0,3360000,3360000,0,0,3360000,Null,Null,134016740,5215707,1520
134025408,0.0,0.0,17800000,15600000,2200000,12,17800000,Null,Null,134025408,4093985,2340
134025454,0.0,0.0,17800000,15600000,2200000,12,17800000,Null,Null,134025454,4093985,2340
134232221,378.0,378.0,133000,133000,0,0,133000,Null,Null,134232221,4202899,2140
134236234,4.0,4.0,60000,60000,0,0,60000,Null,Null,134236234,111461,15318
134276111,187.0,187.0,229000,229000,0,0,229000,Null,Null,134276111,111461,53186
134281584,140.0,140.0,40000,20000,20000,50,40000,Null,Null,134281584,111461,2
134282008,105.0,105.0,430000,353000,77000,18,430000,Null,Null,134282008,111461,2
134282513,0.0,0.0,82900,82900,0,0,82900,Null,Null,134282513,111461,1883
134283118,17.0,17.0,99000,99000,0,0,99000,Null,Null,134283118,111461,2
134296372,107.0,107.0,79000,79000,0,0,79000,Null,Null,134296372,111461,2
134313121,2.0,2.0,60000,60000,0,0,60000,Null,Null,134313121,111461,15320
134318997,4020.0,4020.0,40000,36000,4000,10,40000,Null,Null,134318997,111461,49676
134333367,0.0,0.0,5581000,5022900,558100,10,5581000,Null,Null,134333367,5191813,17170
134360700,105.0,105.0,75000,65000,10000,13,75000,Null,Null,134360700,19312,2153
134360858,4.0,4.0,55000,55000,0,0,55000,Null,Null,134360858,18804,2153
134360863,235.0,235.0,98000,89000,9000,9,98000,Null,Null,134360863,19312,2153
134364062,45.0,45.0,1036000,739000,297000,29,1036000,Null,Null,134364062,26150,8516
134364069,15.0,15.0,1036000,739000,297000,29,1036000,Null,Null,134364069,26150,8516
134364129,1709.0,1709.0,129000,125000,4000,3,129000,Null,Null,134364129,27464,20182
134390487,95.0,95.0,2590000,1999000,591000,23,2590000,Null,Null,134390487,5246949,2340
134408281,127.0,127.0,139900,123000,16900,12,139900,Null,Null,134408281,111461,2
134409000,159.0,159.0,6000,4500,1500,25,6000,Null,Null,134409000,111461,49676
134412128,28.0,28.0,140000,140000,0,0,140000,Null,Null,134412128,111461,49722
134417090,29.0,29.0,95000,95000,0,0,95000,Null,Null,134417090,111461,49722
134419412,12.0,12.0,15900,15900,0,0,15900,Null,Null,134419412,111461,23134
134438470,0.0,0.0,65000,65000,0,0,65000,Null,Null,134438470,111461,3710
134439385,0.0,0.0,7000,7000,0,0,7000,Null,Null,134439385,111461,8205
134441706,24.0,24.0,99000,99000,0,0,99000,Null,Null,134441706,111461,49722
134443789,0.0,0.0,9798000,9798000,0,0,9798000,Null,Null,134443789,111461,2340
134465100,0.0,0.0,9798000,9798000,0,0,9798000,Null,Null,134465100,111461,2340
134476352,0.0,0.0,16200,9000,7200,44,16200,Null,Null,134476352,111461,1819
134507202,0.0,0.0,29500,29500,0,0,29500,Null,Null,134507202,111461,2685
134507669,2.0,2.0,6000,6000,0,0,6000,Null,Null,134507669,111461,8197
134507862,3.0,3.0,192000,192000,0,0,192000,Null,Null,134507862,111461,2340
134508392,0.0,0.0,2500,2500,0,0,2500,Null,Null,134508392,111461,2685
134515126,477.0,477.0,592000,344000,248000,42,592000,Null,Null,134515126,48077,1936
134516887,8.0,8.0,10000,10000,0,0,10000,Null,Null,134516887,111461,2
134522531,238.0,238.0,270000,231000,39000,14,270000,Null,Null,134522531,143353,28594
134523097,0.0,0.0,70700000,70700000,0,0,70700000,Null,Null,134523097,4558659,2340
134541240,0.0,0.0,9000,9000,0,0,9000,Null,Null,134541240,111461,28576
134549162,347.0,347.0,195000,195000,0,0,195000,Null,Null,134549162,289291,11897
134566059,29.0,29.0,2000,2000,0,0,2000,Null,Null,134566059,111461,2
134582052,0.0,0.0,380000,380000,0,0,380000,Null,Null,134582052,111461,2
134582783,16.0,16.0,110000,110000,0,0,110000,Null,Null,134582783,111461,49722
134591513,596.0,596.0,290000,290000,0,0,290000,Null,Null,134591513,85867,17162
134598890,4.0,4.0,23330000,13990000,9340000,40,23330000,Null,Null,134598890,5222401,2340
134607281,33.0,33.0,23330000,13990000,9340000,40,23330000,Null,Null,134607281,5222401,2340
134622182,20.0,20.0,52999,52999,0,0,52999,Null,Null,134622182,111461,6948
134641493,109.0,109.0,360000,232000,128000,36,360000,Null,Null,134641493,5221825,23832
134670126,12.0,12.0,149000,149000,0,0,149000,Null,Null,134670126,111461,49722
134736738,22.0,22.0,85000,82000,3000,4,85000,Null,Null,134736738,111461,1813
134749817,340.0,340.0,55000,55000,0,0,55000,Null,Null,134749817,111461,2
134754154,15.0,15.0,790000,790000,0,0,790000,Null,Null,134754154,111461,2
134819853,9.0,9.0,5000,5000,0,0,5000,Null,Null,134819853,111461,2
134820299,18.0,18.0,16000,9800,6200,39,16000,Null,Null,134820299,111461,2
134844715,0.0,0.0,12941000,7647000,5294000,41,12941000,Null,Null,134844715,18802,1794
134851588,0.0,0.0,2000,2000,0,0,2000,Null,Null,134851588,111461,2
134853381,30.0,30.0,601000,329000,272000,45,601000,Null,Null,134853381,48077,1936
134894285,0.0,0.0,3366000,3366000,0,0,3366000,Null,Null,134894285,5224067,53350
134957211,629.0,629.0,84000,41000,43000,51,84000,Null,Null,134957211,234753,23416
134974081,630.0,630.0,165000,160000,5000,3,165000,Null,Null,134974081,18802,1820
135029881,120.0,120.0,480000,354000,126000,26,480000,Null,Null,135029881,307609,53350
135043870,0.0,0.0,2500,2500,0,0,2500,Null,Null,135043870,111461,2
135044385,1.0,1.0,2000,2000,0,0,2000,Null,Null,135044385,111461,2
135056197,20.0,20.0,190000,190000,0,0,190000,Null,Null,135056197,111461,49722
135057122,5.0,5.0,9500,9500,0,0,9500,Null,Null,135057122,111461,11943
135071936,20.0,20.0,2500,2500,0,0,2500,Null,Null,135071936,111461,2
135076431,5.0,5.0,2500,2500,0,0,2500,Null,Null,135076431,111461,2
135077306,875.0,875.0,58000,29000,29000,50,58000,Null,Null,135077306,111461,49676
135077364,36.0,36.0,80000,80000,0,0,80000,Null,Null,135077364,111461,49722
135078386,127.0,127.0,249000,131000,118000,47,249000,Null,Null,135078386,302375,1838
135092259,0.0,0.0,129689000,129689000,0,0,129689000,Null,Null,135092259,185631,53074
135111159,0.0,0.0,2500,2500,0,0,2500,Null,Null,135111159,111461,2
135111243,1.0,1.0,20000,11000,9000,45,20000,Null,Null,135111243,111461,2
135111515,0.0,0.0,12999,12999,0,0,12999,Null,Null,135111515,111461,2
135151945,707.0,707.0,3490000,1990000,1500000,43,3490000,Null,Null,135151945,17827,1815
135156202,0.0,0.0,4352000,3916800,435200,10,4352000,Null,Null,135156202,5191813,53350
135216908,29.0,29.0,25000,25000,0,0,25000,Null,Null,135216908,111461,15236
135223614,3.0,3.0,2000,2000,0,0,2000,Null,Null,135223614,154455,18876
135223616,2.0,2.0,887000,887000,0,0,887000,Null,Null,135223616,111461,2340
135228421,0.0,0.0,13500000,9487000,4013000,30,13500000,Null,Null,135228421,18802,1794
135266139,2.0,2.0,10000000,6946000,3054000,31,10000000,Null,Null,135266139,18802,1794
135266664,0.0,0.0,4352000,3916800,435200,10,4352000,Null,Null,135266664,5191813,53350
135266767,193.0,193.0,263000,173000,90000,34,263000,Null,Null,135266767,79682,11835
135281362,0.0,0.0,3850000,3850000,0,0,3850000,Null,Null,135281362,33365,11845
135281910,0.0,0.0,4352000,3916800,435200,10,4352000,Null,Null,135281910,5191813,53350
135282810,1.0,1.0,3756500,3756500,0,0,3756500,Null,Null,135282810,5233667,1601
135284107,538.0,538.0,495000,495000,0,0,495000,Null,Null,135284107,146202,4429
135284114,0.0,0.0,5000,5000,0,0,5000,Null,Null,135284114,146202,28484
135286784,0.0,0.0,15000,15000,0,0,15000,Null,Null,135286784,111461,2
135321378,305.0,305.0,14000,14000,0,0,14000,Null,Null,135321378,111461,1883
135321411,206.0,206.0,50000,50000,0,0,50000,Null,Null,135321411,111461,2
135321859,0.0,0.0,4352000,3916800,435200,10,4352000,Null,Null,135321859,5191813,53350
135322157,18.0,18.0,2290000,1599000,691000,30,2290000,Null,Null,135322157,19673,1795
135326465,0.0,0.0,10724000,7660000,3064000,29,10724000,Null,Null,135326465,405211,8512
135328812,0.0,0.0,7660000,7660000,0,0,7660000,Null,Null,135328812,405211,8512
135332196,5.0,5.0,1590000,1590000,0,0,1590000,Null,Null,135332196,19673,1795
135348102,8.0,8.0,149000,149000,0,0,149000,Null,Null,135348102,111461,49722
135349213,489.0,489.0,149000,149000,0,0,149000,Null,Null,135349213,5207801,11923
135350740,0.0,0.0,23500000,22795000,705000,3,23500000,Null,Null,135350740,111461,28860
135350935,97.0,97.0,85000,85000,0,0,85000,Null,Null,135350935,149236,11856
135352499,229.0,229.0,169000,169000,0,0,169000,Null,Null,135352499,5207801,11923
135353722,103.0,103.0,189000,187110,1890,1,189000,Null,Null,135353722,111461,28596
135370198,4.0,4.0,99000,69000,30000,30,99000,Null,Null,135370198,111461,2
135370224,0.0,0.0,1500,1500,0,0,1500,Null,Null,135370224,111461,2
135370246,1.0,1.0,9000,9000,0,0,9000,Null,Null,135370246,111461,2
135370292,0.0,0.0,1700,1700,0,0,1700,Null,Null,135370292,111461,2
135396068,12.0,12.0,15500,15500,0,0,15500,Null,Null,135396068,505165,15318
135397403,44.0,44.0,15500,15500,0,0,15500,Null,Null,135397403,505165,15318
135398200,0.0,0.0,15000,15000,0,0,15000,Null,Null,135398200,505165,15318
135407709,9.0,9.0,2000,2000,0,0,2000,Null,Null,135407709,111461,2685
135410778,321.0,321.0,86000,86000,0,0,86000,Null,Null,135410778,21653,28574
135412837,209.0,209.0,550000,550000,0,0,550000,Null,Null,135412837,111454,12928
135420534,61.0,61.0,29000,29000,0,0,29000,Null,Null,135420534,4254887,28480
135442231,0.0,0.0,600000,545000,55000,9,600000,Null,Null,135442231,46703,1978
135442243,14.0,14.0,24000,24000,0,0,24000,Null,Null,135442243,46703,4451
135442398,3.0,3.0,85000,85000,0,0,85000,Null,Null,135442398,46703,4451
135442410,3.0,3.0,498000,498000,0,0,498000,Null,Null,135442410,46703,27190
135450776,33.0,33.0,1200,1200,0,0,1200,Null,Null,135450776,111461,2
135458582,0.0,0.0,3300,3300,0,0,3300,Null,Null,135458582,111461,28480
135465286,13.0,13.0,410000,400000,10000,2,410000,Null,Null,135465286,111461,5264
135507759,378.0,378.0,120000,87000,33000,28,120000,Null,Null,135507759,5085219,27128
135507898,0.0,0.0,43000,33920,9080,21,43000,Null,Null,135507898,111461,28484
135511749,0.0,0.0,36014000,36014000,0,0,36014000,Null,Null,135511749,5225181,1979
135516822,0.0,0.0,40425000,40425000,0,0,40425000,Null,Null,135516822,5225181,1979
135538303,17.0,17.0,2000,2000,0,0,2000,Null,Null,135538303,111461,2
135538474,3.0,3.0,10000,3000,7000,70,10000,Null,Null,135538474,111461,2
135543096,0.0,0.0,1870,1870,0,0,1870,Null,Null,135543096,111461,2
135548560,214.0,214.0,15000,9000,6000,40,15000,Null,Null,135548560,5199273,28674
135572957,0.0,0.0,70000000,70000000,0,0,70000000,Null,Null,135572957,111461,23112
135601611,0.0,0.0,18600,18600,0,0,18600,Null,Null,135601611,111461,2
135601871,0.0,0.0,15000,15000,0,0,15000,Null,Null,135601871,111461,2
135628261,0.0,0.0,1000,1000,0,0,1000,Null,Null,135628261,111461,2
135628345,0.0,0.0,2500,2500,0,0,2500,Null,Null,135628345,111461,2
135716110,102.0,102.0,63000,63000,0,0,63000,Null,Null,135716110,111461,28486
135720334,85.0,85.0,288000,147900,140100,49,288000,Null,Null,135720334,48077,3990
135810827,368.0,368.0,50000,50000,0,0,50000,Null,Null,135810827,111461,2514
135837186,28.0,28.0,64000,64000,0,0,64000,Null,Null,135837186,111461,12590
135897574,15.0,15.0,150000,150000,0,0,150000,Null,Null,135897574,111461,49722
135939644,227.0,227.0,9000,9000,0,0,9000,Null,Null,135939644,48398,11817
135968324,443.0,443.0,9000,9000,0,0,9000,Null,Null,135968324,48398,11817
136007899,20.0,20.0,78990,78990,0,0,78990,Null,Null,136007899,111461,49722
136014171,126.0,126.0,358000,179000,179000,50,358000,Null,Null,136014171,111461,23282
136015647,45.0,45.0,189000,112000,77000,41,189000,Null,Null,136015647,53040,13878
136020332,14.0,14.0,77890,77890,0,0,77890,Null,Null,136020332,111454,5006
136020601,10.0,10.0,90000,90000,0,0,90000,Null,Null,136020601,111461,49722
136021325,73.0,73.0,600000,600000,0,0,600000,Null,Null,136021325,186091,12876
136023838,10.0,10.0,90000,90000,0,0,90000,Null,Null,136023838,111461,49722
136025520,5.0,5.0,90000,90000,0,0,90000,Null,Null,136025520,111461,49722
136029472,139.0,139.0,149000,149000,0,0,149000,Null,Null,136029472,5228261,11833
136038683,0.0,0.0,12900000,12900000,0,0,12900000,Null,Null,136038683,111461,2
136038728,0.0,0.0,3500000,3500000,0,0,3500000,Null,Null,136038728,111461,2
136042337,312.0,312.0,389000,242000,147000,38,389000,Null,Null,136042337,5048343,4593
136048477,11.0,11.0,1800,1800,0,0,1800,Null,Null,136048477,31512,23800
136049636,337.0,337.0,169000,88000,81000,48,169000,Null,Null,136049636,4246951,8602
136061406,166.0,166.0,141000,141000,0,0,141000,Null,Null,136061406,4401579,3178
136093155,3.0,3.0,359000,359000,0,0,359000,Null,Null,136093155,111461,15318
136093400,0.0,0.0,1299,1299,0,0,1299,Null,Null,136093400,111461,2
136105348,0.0,0.0,18680000,18680000,0,0,18680000,Null,Null,136105348,111461,2340
136116492,0.0,0.0,4470000,4470000,0,0,4470000,Null,Null,136116492,214935,8309
136117900,40.0,40.0,156000,156000,0,0,156000,Null,Null,136117900,111461,2
136118134,0.0,0.0,1500,1500,0,0,1500,Null,Null,136118134,111461,2
136118412,0.0,0.0,240000,205000,35000,15,240000,Null,Null,136118412,111461,2
136126144,213.0,213.0,160000,160000,0,0,160000,Null,Null,136126144,372895,8192
136131459,0.0,0.0,11400000,11400000,0,0,11400000,Null,Null,136131459,5227079,28646
136134202,9.0,9.0,164000,164000,0,0,164000,Null,Null,136134202,50025,2
136155693,197.0,197.0,6800,6800,0,0,6800,Null,Null,136155693,111461,2
136202975,3.0,3.0,2000,2000,0,0,2000,Null,Null,136202975,111461,2
136203393,0.0,0.0,13600000,13600000,0,0,13600000,Null,Null,136203393,167287,6653
136215560,164.0,164.0,180000,159000,21000,12,180000,Null,Null,136215560,5147565,28682
136218622,3.0,3.0,35000,35000,0,0,35000,Null,Null,136218622,111461,2
136219012,2.0,2.0,19000,19000,0,0,19000,Null,Null,136219012,111461,2
136219070,37.0,37.0,10000,10000,0,0,10000,Null,Null,136219070,111461,2
136219112,0.0,0.0,10000,10000,0,0,10000,Null,Null,136219112,111461,2
136219171,16.0,16.0,19000,19000,0,0,19000,Null,Null,136219171,111461,2
136219290,29.0,29.0,35000,35000,0,0,35000,Null,Null,136219290,111461,2
136219335,2.0,2.0,8000,8000,0,0,8000,Null,Null,136219335,111461,2
136219344,3.0,3.0,5000,5000,0,0,5000,Null,Null,136219344,111461,2
136219817,1.0,1.0,9888,9888,0,0,9888,Null,Null,136219817,111461,2
136293805,0.0,0.0,10000,10000,0,0,10000,Null,Null,136293805,111461,17186
136293894,31.0,31.0,4300,4300,0,0,4300,Null,Null,136293894,111461,17186
136312573,92.0,92.0,80000,57230,22770,28,80000,Null,Null,136312573,143353,20222
136314186,5.0,5.0,2500,2500,0,0,2500,Null,Null,136314186,111461,2
136351710,5.0,5.0,5250000,5250000,0,0,5250000,Null,Null,136351710,48945,11833
136364272,0.0,0.0,4800000,4800000,0,0,4800000,Null,Null,136364272,112638,1794
136368496,11.0,11.0,30000,30000,0,0,30000,Null,Null,136368496,111461,2
136368998,8.0,8.0,5000,5000,0,0,5000,Null,Null,136368998,111461,2
136383784,0.0,0.0,20000000,11880000,8120000,41,20000000,Null,Null,136383784,18802,1795
136403721,0.0,0.0,11300000,11300000,0,0,11300000,Null,Null,136403721,167287,6653
136424990,0.0,0.0,19850000,19850000,0,0,19850000,Null,Null,136424990,217953,8073
136430680,0.0,0.0,2500,2000,500,20,2500,Null,Null,136430680,111461,2
136431987,6.0,6.0,9000,9000,0,0,9000,Null,Null,136431987,111461,2
136461596,0.0,0.0,9798000,9798000,0,0,9798000,Null,Null,136461596,111461,2340
136484644,2.0,2.0,489000,489000,0,0,489000,Null,Null,136484644,111461,2
136499842,18.0,18.0,8000,8000,0,0,8000,Null,Null,136499842,111461,8205
136523556,247.0,247.0,85000,55000,30000,35,85000,Null,Null,136523556,155487,23056
136540312,1.0,1.0,59000,53000,6000,10,59000,Null,Null,136540312,5160827,15318
136603264,0.0,0.0,19350000,19350000,0,0,19350000,Null,Null,136603264,111461,2340
136618532,144.0,144.0,319000,282000,37000,12,319000,Null,Null,136618532,46335,1634
136653916,199.0,199.0,250000,169000,81000,32,250000,Null,Null,136653916,625265,28574
136664045,902.0,902.0,174000,160000,14000,8,174000,Null,Null,136664045,21276,1616
136666870,5976.0,5976.0,174000,160000,14000,8,174000,Null,Null,136666870,21276,1613
136678663,0.0,0.0,1200,1200,0,0,1200,Null,Null,136678663,660685,15320
136679359,0.0,0.0,7000,7000,0,0,7000,Null,Null,136679359,660685,15250
136690839,15100.0,15100.0,188000,176000,12000,6,188000,Null,Null,136690839,21278,1613
136693708,2.0,2.0,9000,9000,0,0,9000,Null,Null,136693708,111461,8198
136716771,1.0,1.0,12700000,7800000,4900000,39,12700000,Null,Null,136716771,892671,8167
136717706,2.0,2.0,14500000,9400000,5100000,35,14500000,Null,Null,136717706,892671,8167
136785689,18.0,18.0,170000,170000,0,0,170000,Null,Null,136785689,737489,28464
136815683,4.0,4.0,2000,2000,0,0,2000,Null,Null,136815683,111461,20258
136815702,36.0,36.0,28999,28999,0,0,28999,Null,Null,136815702,111461,2266
136816036,0.0,0.0,27300000,27300000,0,0,27300000,Null,Null,136816036,180963,6653
136816203,408.0,408.0,599000,305000,294000,49,599000,Null,Null,136816203,7378235,11883
136816295,468.0,468.0,97900,95000,2900,3,97900,Null,Null,136816295,111461,20182
136818264,541.0,541.0,150000,129000,21000,14,150000,Null,Null,136818264,625265,28574
136818299,40.0,40.0,90000,90000,0,0,90000,Null,Null,136818299,111461,49722
136819055,1.0,1.0,9000,9000,0,0,9000,Null,Null,136819055,111461,28480
136820031,28.0,28.0,1165000,1136000,29000,2,1165000,Null,Null,136820031,150433,28454
136820608,41.0,41.0,195000,165750,29250,15,195000,Null,Null,136820608,111461,23416
136825732,0.0,0.0,11530000,11530000,0,0,11530000,Null,Null,136825732,4508621,7079
136840120,14.0,14.0,1000000,1000000,0,0,1000000,Null,Null,136840120,472079,8061
136855309,125.0,125.0,239000,157000,82000,34,239000,Null,Null,136855309,4732457,1613
136855341,121.0,121.0,379000,245000,134000,35,379000,Null,Null,136855341,4732457,1637
136855407,352.0,352.0,239000,156000,83000,35,239000,Null,Null,136855407,4732457,13878
136868821,21.0,21.0,29000,29000,0,0,29000,Null,Null,136868821,111461,1831
136872903,1.0,1.0,2425,2425,0,0,2425,Null,Null,136872903,111461,2
136874055,0.0,0.0,9000,9000,0,0,9000,Null,Null,136874055,111461,2
136874704,0.0,0.0,169900,169900,0,0,169900,Null,Null,136874704,111461,2
136876846,2.0,2.0,7990000,6705000,1285000,16,7990000,Null,Null,136876846,18802,1794
136879621,0.0,0.0,5000,5000,0,0,5000,Null,Null,136879621,111461,2
136941091,89.0,89.0,2000,1000,1000,50,2000,Null,Null,136941091,111461,2363
136971092,307.0,307.0,69000,49000,20000,29,69000,Null,Null,136971092,625265,28574
136981450,24.0,24.0,1190000,1190000,0,0,1190000,Null,Null,136981450,146479,28640
136985736,243.0,243.0,800000,490000,310000,39,800000,Null,Null,136985736,500047,7081
136988304,3882.0,3882.0,158000,134000,24000,15,158000,Null,Null,136988304,22653,17162
137006736,55.0,55.0,145000,145000,0,0,145000,Null,Null,137006736,47427,11905
137009222,0.0,0.0,4199000,4199000,0,0,4199000,Null,Null,137009222,281039,5893
137010477,18.0,18.0,1000,1000,0,0,1000,Null,Null,137010477,111461,2
137010903,0.0,0.0,2500,2500,0,0,2500,Null,Null,137010903,111461,2
137011428,0.0,0.0,4000,4000,0,0,4000,Null,Null,137011428,111461,2
137011564,0.0,0.0,5000,5000,0,0,5000,Null,Null,137011564,111461,2
137011710,0.0,0.0,5000,5000,0,0,5000,Null,Null,137011710,111461,2
137011858,0.0,0.0,3000,3000,0,0,3000,Null,Null,137011858,111461,2
137011862,0.0,0.0,5000,5000,0,0,5000,Null,Null,137011862,111461,2
137011964,0.0,0.0,4000,4000,0,0,4000,Null,Null,137011964,111461,2
137011991,0.0,0.0,9000,9000,0,0,9000,Null,Null,137011991,111461,2
137012064,9.0,9.0,59000,59000,0,0,59000,Null,Null,137012064,111461,2
137012116,0.0,0.0,9000,9000,0,0,9000,Null,Null,137012116,111461,2
137012211,0.0,0.0,7000,7000,0,0,7000,Null,Null,137012211,111461,2
137012242,7.0,7.0,3000,3000,0,0,3000,Null,Null,137012242,111461,2
137012260,0.0,0.0,4000,4000,0,0,4000,Null,Null,137012260,111461,2
137012338,20.0,20.0,4000,4000,0,0,4000,Null,Null,137012338,111461,2
137012481,0.0,0.0,5000,5000,0,0,5000,Null,Null,137012481,111461,2
137012547,0.0,0.0,4000,4000,0,0,4000,Null,Null,137012547,111461,2
137012593,0.0,0.0,4000,4000,0,0,4000,Null,Null,137012593,111461,2
137012801,0.0,0.0,5000,5000,0,0,5000,Null,Null,137012801,111461,2
137012904,0.0,0.0,5000,5000,0,0,5000,Null,Null,137012904,111461,2
137012912,0.0,0.0,5000,5000,0,0,5000,Null,Null,137012912,111461,2
137012964,10.0,10.0,2200,2200,0,0,2200,Null,Null,137012964,111461,2
137013316,0.0,0.0,1500,1500,0,0,1500,Null,Null,137013316,111461,2
137013338,0.0,0.0,4000,4000,0,0,4000,Null,Null,137013338,111461,2
137013426,0.0,0.0,5000,5000,0,0,5000,Null,Null,137013426,111461,2
137013432,0.0,0.0,4000,4000,0,0,4000,Null,Null,137013432,111461,2
137013522,0.0,0.0,4000,4000,0,0,4000,Null,Null,137013522,111461,2
137013530,0.0,0.0,9000,9000,0,0,9000,Null,Null,137013530,111461,2
137013874,0.0,0.0,4000,4000,0,0,4000,Null,Null,137013874,111461,2
137020448,185.0,185.0,290000,287000,3000,1,290000,Null,Null,137020448,47427,11905
137067621,43.0,43.0,138000,138000,0,0,138000,Null,Null,137067621,4187373,28738
137118336,11.0,11.0,1999,1999,0,0,1999,Null,Null,137118336,111461,2337
137118482,105.0,105.0,1250000,1250000,0,0,1250000,Null,Null,137118482,25277,28452
137118491,7.0,7.0,3000,1500,1500,50,3000,Null,Null,137118491,111461,23134
137131111,0.0,0.0,21720000,21720000,0,0,21720000,Null,Null,137131111,180151,11518
137136120,0.0,0.0,18885000,17185000,1700000,9,18885000,Null,Null,137136120,622961,8227
137203873,6.0,6.0,2990000,2929000,61000,2,2990000,Null,Null,137203873,52232,1795
137209450,12.0,12.0,90000,90000,0,0,90000,Null,Null,137209450,111461,49722
137211953,1.0,1.0,299000,299000,0,0,299000,Null,Null,137211953,111461,2
137212050,0.0,0.0,13000,13000,0,0,13000,Null,Null,137212050,111461,15936
137212125,47.0,47.0,39000,39000,0,0,39000,Null,Null,137212125,111461,15320
137212305,8.0,8.0,35000,35000,0,0,35000,Null,Null,137212305,111461,2
137226640,506.0,506.0,165000,165000,0,0,165000,Null,Null,137226640,173743,23078
137243024,0.0,0.0,2000,2000,0,0,2000,Null,Null,137243024,111461,2
137249481,95.0,95.0,329000,206000,123000,37,329000,Null,Null,137249481,111461,2659
137251666,115.0,115.0,2700000,2090000,610000,23,2700000,Null,Null,137251666,160667,28618
137253580,37.0,37.0,35000,35000,0,0,35000,Null,Null,137253580,111461,2
137301897,36.0,36.0,55000,55000,0,0,55000,Null,Null,137301897,111461,2
137330613,34.0,34.0,28000,28000,0,0,28000,Null,Null,137330613,111461,15250
137442930,3168.0,3168.0,42000,42000,0,0,42000,Null,Null,137442930,3748887,3877
137467632,4.0,4.0,170000,170000,0,0,170000,Null,Null,137467632,111461,49722
137478459,77.0,77.0,8000,8000,0,0,8000,Null,Null,137478459,21271,11833
137481194,66.0,66.0,115000,115000,0,0,115000,Null,Null,137481194,21265,1616
137498406,1.0,1.0,230000,230000,0,0,230000,Null,Null,137498406,111461,15250
137523735,45.0,45.0,360000,320000,40000,11,360000,Null,Null,137523735,565173,17170
137540606,0.0,0.0,17890000,17890000,0,0,17890000,Null,Null,137540606,111461,2340
137543223,71.0,71.0,139000,139000,0,0,139000,Null,Null,137543223,4638969,10073
137548073,0.0,0.0,95000,95000,0,0,95000,Null,Null,137548073,111461,5566
137551637,4.0,4.0,18000,18000,0,0,18000,Null,Null,137551637,111461,15250
137552544,12.0,12.0,18000,18000,0,0,18000,Null,Null,137552544,111461,15250
137553267,6.0,6.0,35000,35000,0,0,35000,Null,Null,137553267,111461,15250
137554469,0.0,0.0,10000,10000,0,0,10000,Null,Null,137554469,111461,2
137559548,10.0,10.0,35000,35000,0,0,35000,Null,Null,137559548,111461,15250
137562237,0.0,0.0,3912000,3912000,0,0,3912000,Null,Null,137562237,25643,1795
137564048,26.0,26.0,18000,18000,0,0,18000,Null,Null,137564048,111461,15250
137567893,145.0,145.0,330000,228000,102000,31,330000,Null,Null,137567893,930377,2346
137568009,3.0,3.0,3810000,3810000,0,0,3810000,Null,Null,137568009,532965,8227
137572183,7.0,7.0,18000,18000,0,0,18000,Null,Null,137572183,111461,15250
137572223,0.0,0.0,3912000,3912000,0,0,3912000,Null,Null,137572223,25643,1795
137572447,2680.0,2680.0,66000,42000,24000,36,66000,Null,Null,137572447,19018,2488
137580835,15.0,15.0,140000,140000,0,0,140000,Null,Null,137580835,111461,49722
137582801,8.0,8.0,2990000,2002000,988000,33,2990000,Null,Null,137582801,247549,1795
137592725,13.0,13.0,140000,140000,0,0,140000,Null,Null,137592725,111461,49722
137671794,1100.0,1100.0,295000,195000,100000,34,295000,Null,Null,137671794,5063093,3515
137672120,134.0,134.0,161000,134000,27000,17,161000,Null,Null,137672120,63747,2363
137672538,238.0,238.0,114000,95000,19000,17,114000,Null,Null,137672538,63747,2234
137672904,0.0,0.0,1200,1200,0,0,1200,Null,Null,137672904,111461,2
137672943,1398.0,1398.0,1000,1000,0,0,1000,Null,Null,137672943,111461,1883
137672963,0.0,0.0,1000,1000,0,0,1000,Null,Null,137672963,111461,2
137672967,2766.0,2766.0,2700,2700,0,0,2700,Null,Null,137672967,111461,1883
137672977,667.0,667.0,1800,1800,0,0,1800,Null,Null,137672977,111461,1883
137673084,514.0,514.0,1000,1000,0,0,1000,Null,Null,137673084,111461,2
137673117,0.0,0.0,1500,1500,0,0,1500,Null,Null,137673117,111461,2
137673136,25.0,25.0,12999,12999,0,0,12999,Null,Null,137673136,111461,2
137673258,3.0,3.0,1800,1800,0,0,1800,Null,Null,137673258,111461,1883
137673401,134.0,134.0,1200,1200,0,0,1200,Null,Null,137673401,111461,1883
137673638,0.0,0.0,1400,1400,0,0,1400,Null,Null,137673638,111461,2
137673660,105.0,105.0,1700,1700,0,0,1700,Null,Null,137673660,111461,2
137673668,40.0,40.0,2000,2000,0,0,2000,Null,Null,137673668,111461,1883
137673671,15.0,15.0,1800,1800,0,0,1800,Null,Null,137673671,111461,2
137733225,216.0,216.0,145000,135000,10000,7,145000,Null,Null,137733225,445011,1752
137741828,42.0,42.0,125312,87718,37594,30,125312,Null,Null,137741828,111461,28430
137751880,11.0,11.0,82000,61000,21000,26,82000,Null,Null,137751880,111461,15236
137780195,177.0,177.0,182700,159000,23700,13,182700,Null,Null,137780195,47803,11897
137786486,0.0,0.0,87000,63000,24000,28,87000,Null,Null,137786486,111461,15250
137796584,1326.0,1326.0,99000,99000,0,0,99000,Null,Null,137796584,5132069,3877
137797842,0.0,0.0,2500,2500,0,0,2500,Null,Null,137797842,111461,2
137827533,121.0,121.0,99999,99999,0,0,99999,Null,Null,137827533,111461,49676
137827663,99.0,99.0,199000,199000,0,0,199000,Null,Null,137827663,111461,23376
137829896,0.0,0.0,155000,155000,0,0,155000,Null,Null,137829896,111461,1622
137834931,0.0,0.0,9798000,9798000,0,0,9798000,Null,Null,137834931,111461,2340
137836531,14.0,14.0,99000,99000,0,0,99000,Null,Null,137836531,111461,49722
137847856,1134.0,1134.0,120000,58000,62000,52,120000,Null,Null,137847856,5228529,1637
137850749,3.0,3.0,17000,8500,8500,50,17000,Null,Null,137850749,111461,11831
137851100,40.0,40.0,40000,40000,0,0,40000,Null,Null,137851100,111461,28576
137861808,7.0,7.0,4295000,4037300,257700,6,4295000,Null,Null,137861808,205847,11873
137863529,45.0,45.0,115900,115900,0,0,115900,Null,Null,137863529,111461,28596
137863603,0.0,0.0,15000,15000,0,0,15000,Null,Null,137863603,111461,49728
137864049,30.0,30.0,3990000,3990000,0,0,3990000,Null,Null,137864049,112735,1795
137864299,6.0,6.0,35000,35000,0,0,35000,Null,Null,137864299,111461,5384
137864606,1333.0,1333.0,199000,118000,81000,41,199000,Null,Null,137864606,4224691,1831
137864664,100.0,100.0,25000,25000,0,0,25000,Null,Null,137864664,111461,5905
137906913,49.0,49.0,32000,32000,0,0,32000,Null,Null,137906913,111461,5384
137914045,91.0,91.0,499000,499000,0,0,499000,Null,Null,137914045,25535,8170
137934711,0.0,0.0,16000,16000,0,0,16000,Null,Null,137934711,111461,49728
137938136,24.0,24.0,120000,120000,0,0,120000,Null,Null,137938136,111461,49722
137940304,40.0,40.0,65000,65000,0,0,65000,Null,Null,137940304,111461,49722
137941726,0.0,0.0,8000,8000,0,0,8000,Null,Null,137941726,111461,20174
137941919,123.0,123.0,40000,40000,0,0,40000,Null,Null,137941919,111461,49722
137942120,0.0,0.0,15900,15900,0,0,15900,Null,Null,137942120,111461,49728
137942665,86.0,86.0,2000,1000,1000,50,2000,Null,Null,137942665,111461,2363
137944079,0.0,0.0,3861200,3861200,0,0,3861200,Null,Null,137944079,111461,2
137944516,0.0,0.0,2000,2000,0,0,2000,Null,Null,137944516,111461,2363
137946676,44.0,44.0,56000,56000,0,0,56000,Null,Null,137946676,111461,49722
137956128,75.0,75.0,39000,39000,0,0,39000,Null,Null,137956128,162313,28578
137956251,412.0,412.0,2000,2000,0,0,2000,Null,Null,137956251,111461,2337
137966461,22.0,22.0,120000,120000,0,0,120000,Null,Null,137966461,4973949,20244
137980484,0.0,0.0,56000000,56000000,0,0,56000000,Null,Null,137980484,111461,2
137995723,30.0,30.0,1000,1000,0,0,1000,Null,Null,137995723,111461,2
137996423,8.0,8.0,1500,1500,0,0,1500,Null,Null,137996423,111461,2
138030410,367.0,367.0,9800,9800,0,0,9800,Null,Null,138030410,111461,1627
138077200,4.0,4.0,69900,69900,0,0,69900,Null,Null,138077200,111461,2334
138226961,62.0,62.0,7999,7999,0,0,7999,Null,Null,138226961,5147565,28480
138239475,0.0,0.0,47800000,47800000,0,0,47800000,Null,Null,138239475,5095895,11516
138280194,0.0,0.0,46800000,46800000,0,0,46800000,Null,Null,138280194,5095895,11516
138306725,0.0,0.0,8628000,7765200,862800,10,8628000,Null,Null,138306725,26150,8513
138307858,0.0,0.0,14000,14000,0,0,14000,Null,Null,138307858,111461,2
138323542,0.0,0.0,26500000,25705000,795000,3,26500000,Null,Null,138323542,111461,2340
138336249,338.0,338.0,129500,129500,0,0,129500,Null,Null,138336249,851519,23658
138336401,5.0,5.0,2000,2000,0,0,2000,Null,Null,138336401,111461,2
138357394,14.0,14.0,120000,120000,0,0,120000,Null,Null,138357394,111461,49722
138358906,11.0,11.0,90000,90000,0,0,90000,Null,Null,138358906,111461,49722
138359306,69.0,69.0,90000,90000,0,0,90000,Null,Null,138359306,111461,49722
138359526,138.0,138.0,599000,490000,109000,18,599000,Null,Null,138359526,148961,2513
138359591,121.0,121.0,350000,268000,82000,23,350000,Null,Null,138359591,362757,4428
138370615,0.0,0.0,57000000,57000000,0,0,57000000,Null,Null,138370615,111461,2
138374307,75.0,75.0,140000,134260,5740,4,140000,Null,Null,138374307,111461,2
138375047,8.0,8.0,190000,190000,0,0,190000,Null,Null,138375047,111461,49722
138379037,78.0,78.0,320000,320000,0,0,320000,Null,Null,138379037,111461,2
138379953,25.0,25.0,79000,79000,0,0,79000,Null,Null,138379953,21651,12294
138380932,30.0,30.0,40000,15000,25000,63,40000,Null,Null,138380932,111461,2
138381161,30.0,30.0,120000,58000,62000,52,120000,Null,Null,138381161,111461,2
138382915,0.0,0.0,7000,7000,0,0,7000,Null,Null,138382915,111461,2
138382948,2.0,2.0,9000,9000,0,0,9000,Null,Null,138382948,111461,2
138383114,0.0,0.0,7000,7000,0,0,7000,Null,Null,138383114,111461,2
138383459,0.0,0.0,15000,5000,10000,67,15000,Null,Null,138383459,111461,2
138383501,0.0,0.0,7000,7000,0,0,7000,Null,Null,138383501,111461,2
138383706,0.0,0.0,3000,3000,0,0,3000,Null,Null,138383706,111461,2
138383731,0.0,0.0,5000,5000,0,0,5000,Null,Null,138383731,111461,2
138383878,1.0,1.0,7200,7200,0,0,7200,Null,Null,138383878,111461,2
138384000,12.0,12.0,7000,7000,0,0,7000,Null,Null,138384000,111461,2
138384727,1.0,1.0,14000,14000,0,0,14000,Null,Null,138384727,111461,2
138385193,0.0,0.0,16000,16000,0,0,16000,Null,Null,138385193,111461,2
138385402,4.0,4.0,9999,9999,0,0,9999,Null,Null,138385402,111461,2
138385430,0.0,0.0,5500,5500,0,0,5500,Null,Null,138385430,111461,2
138386063,0.0,0.0,3000,3000,0,0,3000,Null,Null,138386063,111461,2
138386143,85.0,85.0,145000,145000,0,0,145000,Null,Null,138386143,21651,28458
138386182,0.0,0.0,7000,7000,0,0,7000,Null,Null,138386182,111461,2
138386195,14.0,14.0,7000,7000,0,0,7000,Null,Null,138386195,111461,2
138386335,197.0,197.0,6000,6000,0,0,6000,Null,Null,138386335,111461,2
138386784,1.0,1.0,3500,3500,0,0,3500,Null,Null,138386784,111461,2
138386797,6.0,6.0,4999,4999,0,0,4999,Null,Null,138386797,111461,2
138386876,0.0,0.0,9000,9000,0,0,9000,Null,Null,138386876,111461,2
138438077,0.0,0.0,9030000,6450000,2580000,29,9030000,Null,Null,138438077,405211,8512
138442002,0.0,0.0,9030000,6450000,2580000,29,9030000,Null,Null,138442002,405211,8512
138457860,756.0,756.0,15000,15000,0,0,15000,Null,Null,138457860,111461,2
138460516,209.0,209.0,307000,201000,106000,35,307000,Null,Null,138460516,21125,1934
138465683,0.0,0.0,16400000,16400000,0,0,16400000,Null,Null,138465683,167287,28860
138479433,4.0,4.0,1500,1500,0,0,1500,Null,Null,138479433,111461,2
138480328,4.0,4.0,6900000,3450000,3450000,50,6900000,Null,Null,138480328,5207489,11859
138487583,0.0,0.0,12300000,12300000,0,0,12300000,Null,Null,138487583,167287,20170
138489704,92.0,92.0,29000,23000,6000,21,29000,Null,Null,138489704,463577,6742
138492558,9.0,9.0,249900,249900,0,0,249900,Null,Null,138492558,463577,6742
138505253,0.0,0.0,2400,2400,0,0,2400,Null,Null,138505253,111461,2
138510329,67.0,67.0,7000,7000,0,0,7000,Null,Null,138510329,111461,2
138545277,8.0,8.0,220000,220000,0,0,220000,Null,Null,138545277,111461,15320
138552235,136.0,136.0,39000,39000,0,0,39000,Null,Null,138552235,111461,20244
138559231,1.0,1.0,1450,1450,0,0,1450,Null,Null,138559231,111461,2
138559476,9.0,9.0,1600,1600,0,0,1600,Null,Null,138559476,111461,2
138559953,60.0,60.0,1400,1400,0,0,1400,Null,Null,138559953,111461,2
138560274,192.0,192.0,25000,25000,0,0,25000,Null,Null,138560274,111461,2
138561367,0.0,0.0,17600,17600,0,0,17600,Null,Null,138561367,111461,2
138561390,2.0,2.0,10000,10000,0,0,10000,Null,Null,138561390,111461,2
138563549,0.0,0.0,591000,591000,0,0,591000,Null,Null,138563549,111461,11941
138602601,0.0,0.0,41000,41000,0,0,41000,Null,Null,138602601,111461,2
138603299,5.0,5.0,6000,6000,0,0,6000,Null,Null,138603299,111461,2
138603396,18.0,18.0,1000,1000,0,0,1000,Null,Null,138603396,111461,2
138603606,2.0,2.0,9000,9000,0,0,9000,Null,Null,138603606,111461,2
138603771,3.0,3.0,1000,1000,0,0,1000,Null,Null,138603771,111461,2
138603772,0.0,0.0,5200,5200,0,0,5200,Null,Null,138603772,111461,2
138603840,345.0,345.0,120000,60000,60000,50,120000,Null,Null,138603840,5209695,11867
138615431,5.0,5.0,2500,2500,0,0,2500,Null,Null,138615431,111461,53074
138615457,0.0,0.0,1200,1200,0,0,1200,Null,Null,138615457,111461,53074
138615723,48.0,48.0,1500,1500,0,0,1500,Null,Null,138615723,111461,53074
138615833,0.0,0.0,1000,1000,0,0,1000,Null,Null,138615833,111461,53074
138615852,0.0,0.0,2500,2500,0,0,2500,Null,Null,138615852,111461,2363
138616008,0.0,0.0,1500,1500,0,0,1500,Null,Null,138616008,111461,23244
138616099,21.0,21.0,2500,2500,0,0,2500,Null,Null,138616099,111461,53074
138616566,52.0,52.0,1000,1000,0,0,1000,Null,Null,138616566,111461,53074
138616922,0.0,0.0,2300,2300,0,0,2300,Null,Null,138616922,111461,27180
138616978,35.0,35.0,1200,1200,0,0,1200,Null,Null,138616978,111461,53070
138617058,28.0,28.0,2000,2000,0,0,2000,Null,Null,138617058,111461,2392
138617434,1.0,1.0,2500,2500,0,0,2500,Null,Null,138617434,111461,53074
138617528,50.0,50.0,2470,2470,0,0,2470,Null,Null,138617528,111461,53074
138662376,397.0,397.0,330000,240000,90000,27,330000,Null,Null,138662376,221187,1752
138669495,239.0,239.0,43700,33000,10700,24,43700,Null,Null,138669495,561415,49676
138686151,13.0,13.0,1600,1600,0,0,1600,Null,Null,138686151,111461,2
138705363,0.0,0.0,1000,1000,0,0,1000,Null,Null,138705363,111461,2
138711737,0.0,0.0,1000,1000,0,0,1000,Null,Null,138711737,111461,2
138738860,15.0,15.0,790000,790000,0,0,790000,Null,Null,138738860,149789,12676
138777213,10.0,10.0,75000,67500,7500,10,75000,Null,Null,138777213,111461,15236
138811439,1.0,1.0,229000,183200,45800,20,229000,Null,Null,138811439,111461,15318
138814386,331.0,331.0,30000,30000,0,0,30000,Null,Null,138814386,111461,2
138826652,0.0,0.0,9600,9600,0,0,9600,Null,Null,138826652,111461,2
138830694,61.0,61.0,10000,9000,1000,10,10000,Null,Null,138830694,111461,2
138830848,11.0,11.0,19000,19000,0,0,19000,Null,Null,138830848,111461,2
138831982,0.0,0.0,2400,2400,0,0,2400,Null,Null,138831982,111461,2
138832597,0.0,0.0,2400,2400,0,0,2400,Null,Null,138832597,111461,2
138834407,0.0,0.0,2400,2400,0,0,2400,Null,Null,138834407,111461,2
138840117,14.0,14.0,2000,2000,0,0,2000,Null,Null,138840117,111461,2
138841237,4.0,4.0,15000,15000,0,0,15000,Null,Null,138841237,111461,2
138841777,0.0,0.0,2500,2500,0,0,2500,Null,Null,138841777,111461,2
138842458,0.0,0.0,2400,2400,0,0,2400,Null,Null,138842458,111461,2
138842859,1.0,1.0,1500,1500,0,0,1500,Null,Null,138842859,111461,2
138843610,2.0,2.0,2000,2000,0,0,2000,Null,Null,138843610,111461,2
138844966,0.0,0.0,2400,2400,0,0,2400,Null,Null,138844966,111461,2
138845131,0.0,0.0,2400,2400,0,0,2400,Null,Null,138845131,111461,2
138846531,0.0,0.0,2400,2400,0,0,2400,Null,Null,138846531,111461,2
138847306,0.0,0.0,2400,2400,0,0,2400,Null,Null,138847306,111461,2
138848036,3.0,3.0,6000,6000,0,0,6000,Null,Null,138848036,111461,2
138848946,0.0,0.0,2400,2400,0,0,2400,Null,Null,138848946,111461,2
138849268,0.0,0.0,2400,2400,0,0,2400,Null,Null,138849268,111461,2
138850256,0.0,0.0,2400,2400,0,0,2400,Null,Null,138850256,111461,2
138850283,0.0,0.0,2400,2400,0,0,2400,Null,Null,138850283,111461,2
138850899,0.0,0.0,2400,2400,0,0,2400,Null,Null,138850899,111461,2
138851835,0.0,0.0,2400,2400,0,0,2400,Null,Null,138851835,111461,2
138852582,0.0,0.0,2400,2400,0,0,2400,Null,Null,138852582,111461,2
138852583,0.0,0.0,2400,2400,0,0,2400,Null,Null,138852583,111461,2
138854350,0.0,0.0,2400,2400,0,0,2400,Null,Null,138854350,111461,2
138867253,4.0,4.0,2990000,2519000,471000,16,2990000,Null,Null,138867253,162007,1795
138897545,0.0,0.0,3500,3500,0,0,3500,Null,Null,138897545,111461,2
138899891,7.0,7.0,9000,9000,0,0,9000,Null,Null,138899891,111461,2
138900011,2.0,2.0,9900,9900,0,0,9900,Null,Null,138900011,111461,2
138900378,0.0,0.0,9000,9000,0,0,9000,Null,Null,138900378,111461,2
138906949,17.0,17.0,2200,2200,0,0,2200,Null,Null,138906949,111461,3179
138907184,1.0,1.0,2200,2200,0,0,2200,Null,Null,138907184,111461,2363
138910755,9.0,9.0,572000,319000,253000,44,572000,Null,Null,138910755,48077,6305
138914479,0.0,0.0,2200,2200,0,0,2200,Null,Null,138914479,111461,2
138952791,2563.0,2563.0,42000,42000,0,0,42000,Null,Null,138952791,746615,2363
139010252,7.0,7.0,110000,110000,0,0,110000,Null,Null,139010252,111461,49722
139050886,0.0,0.0,6815000,6815000,0,0,6815000,Null,Null,139050886,26150,8513
139051158,0.0,0.0,16290000,16290000,0,0,16290000,Null,Null,139051158,477955,28860
139067285,0.0,0.0,7254000,7254000,0,0,7254000,Null,Null,139067285,26150,8513
139071708,22.0,22.0,250000,250000,0,0,250000,Null,Null,139071708,111461,28462
139072350,15.0,15.0,99000,99000,0,0,99000,Null,Null,139072350,111461,28468
139072528,2.0,2.0,325000,325000,0,0,325000,Null,Null,139072528,111461,28462
139076733,199.0,199.0,49000,38000,11000,22,49000,Null,Null,139076733,111461,1883
139078034,17.0,17.0,79000,79000,0,0,79000,Null,Null,139078034,111461,2
139092367,0.0,0.0,10000,10000,0,0,10000,Null,Null,139092367,111461,15320
139092382,0.0,0.0,10000,10000,0,0,10000,Null,Null,139092382,111461,15320
139125881,44.0,44.0,149000,149000,0,0,149000,Null,Null,139125881,197443,13878
139140805,30.0,30.0,73147,66498,6649,9,73147,Null,Null,139140805,111461,2
139161475,763.0,763.0,45000,45000,0,0,45000,Null,Null,139161475,5063093,3179
139192638,1.0,1.0,69000,69000,0,0,69000,Null,Null,139192638,111461,2
139197462,55.0,55.0,990000,399000,591000,60,990000,Null,Null,139197462,204385,8400
139197707,36.0,36.0,990000,399000,591000,60,990000,Null,Null,139197707,204385,8400
139199225,12.0,12.0,144000,144000,0,0,144000,Null,Null,139199225,111461,15250
139203175,54.0,54.0,500000,264000,236000,47,500000,Null,Null,139203175,500047,8400
139214348,0.0,0.0,16000,16000,0,0,16000,Null,Null,139214348,111461,2
139217861,0.0,0.0,4000,4000,0,0,4000,Null,Null,139217861,111461,2
139218246,66.0,66.0,18000,18000,0,0,18000,Null,Null,139218246,111461,2
139220202,1.0,1.0,10000,10000,0,0,10000,Null,Null,139220202,111461,2
139239637,0.0,0.0,11540000,11540000,0,0,11540000,Null,Null,139239637,477955,11516
139240468,0.0,0.0,14550000,14550000,0,0,14550000,Null,Null,139240468,477955,11516
139243257,0.0,0.0,25480000,25480000,0,0,25480000,Null,Null,139243257,477955,28860
139251125,0.0,0.0,19580000,19580000,0,0,19580000,Null,Null,139251125,477955,8067
139263923,19.0,19.0,2000,2000,0,0,2000,Null,Null,139263923,111461,8167
139270410,0.0,0.0,38000000,38000000,0,0,38000000,Null,Null,139270410,111461,2
139277453,26.0,26.0,119000,119000,0,0,119000,Null,Null,139277453,111461,15250
139283531,0.0,0.0,15000,15000,0,0,15000,Null,Null,139283531,111461,2
139283562,2.0,2.0,45000,45000,0,0,45000,Null,Null,139283562,111461,2
139283571,307.0,307.0,15200,15200,0,0,15200,Null,Null,139283571,111461,2
139283601,3866.0,3866.0,2500,2500,0,0,2500,Null,Null,139283601,111461,2
139283603,1133.0,1133.0,2500,2000,500,20,2500,Null,Null,139283603,111461,2
139283667,435.0,435.0,2700,1900,800,30,2700,Null,Null,139283667,111461,2
139285172,20.0,20.0,1150,1150,0,0,1150,Null,Null,139285172,111461,6948
139285283,8.0,8.0,1250,1250,0,0,1250,Null,Null,139285283,111461,6948
139287191,17.0,17.0,144444,103989,40455,28,144444,Null,Null,139287191,111461,3177
139289249,0.0,0.0,340000,315000,25000,7,340000,Null,Null,139289249,111461,2
139299917,0.0,0.0,11350000,11350000,0,0,11350000,Null,Null,139299917,477955,28860
139374491,1.0,1.0,8000,8000,0,0,8000,Null,Null,139374491,111461,2
139430608,152.0,152.0,590000,378000,212000,36,590000,Null,Null,139430608,280191,27128
139462714,309.0,309.0,300000,180000,120000,40,300000,Null,Null,139462714,4224691,4429
139478724,11.0,11.0,14950,12000,2950,20,14950,Null,Null,139478724,111461,49728
139481061,120.0,120.0,74500,74500,0,0,74500,Null,Null,139481061,111461,1883
139481423,395.0,395.0,24000,24000,0,0,24000,Null,Null,139481423,111461,2
139482943,20.0,20.0,1495000,637000,858000,57,1495000,Null,Null,139482943,505907,12928
139487083,0.0,0.0,2000,2000,0,0,2000,Null,Null,139487083,111461,2
139524744,0.0,0.0,19900000,19900000,0,0,19900000,Null,Null,139524744,939519,28870
139559701,0.0,0.0,26900000,26900000,0,0,26900000,Null,Null,139559701,939519,28870
139562345,802.0,802.0,16499,16499,0,0,16499,Null,Null,139562345,111461,1883
139594224,47.0,47.0,43776,43776,0,0,43776,Null,Null,139594224,111461,2
139599823,14.0,14.0,129000,129000,0,0,129000,Null,Null,139599823,21651,5006
139600248,4687.0,4687.0,12000,12000,0,0,12000,Null,Null,139600248,185677,53074
139624735,13.0,13.0,1500,1500,0,0,1500,Null,Null,139624735,111461,2
139632023,11.0,11.0,5098000,5098000,0,0,5098000,Null,Null,139632023,183625,28856
139656019,0.0,0.0,2000,2000,0,0,2000,Null,Null,139656019,111461,2
139656290,5.0,5.0,2000,2000,0,0,2000,Null,Null,139656290,111461,2
139656975,145.0,145.0,1500,1500,0,0,1500,Null,Null,139656975,111461,2
139713984,123.0,123.0,199000,177000,22000,11,199000,Null,Null,139713984,111461,5531
139723967,619.0,619.0,19500,19500,0,0,19500,Null,Null,139723967,245945,2685
139731003,0.0,0.0,9798000,9798000,0,0,9798000,Null,Null,139731003,111461,2340
139731982,0.0,0.0,2500,2500,0,0,2500,Null,Null,139731982,111461,2
139741033,0.0,0.0,8900,8900,0,0,8900,Null,Null,139741033,111461,2
139741993,795.0,795.0,800000,690000,110000,14,800000,Null,Null,139741993,111454,28454
139743668,0.0,0.0,9798000,9798000,0,0,9798000,Null,Null,139743668,111461,2340
139815683,59.0,59.0,79000,79000,0,0,79000,Null,Null,139815683,111461,2
139922716,0.0,0.0,1000,1000,0,0,1000,Null,Null,139922716,111461,2
139930616,0.0,0.0,1000,1000,0,0,1000,Null,Null,139930616,111461,2
139947502,555.0,555.0,45000,33000,12000,27,45000,Null,Null,139947502,886923,8305
139948330,5.0,5.0,10000,10000,0,0,10000,Null,Null,139948330,111461,1622
139948372,0.0,0.0,10000,10000,0,0,10000,Null,Null,139948372,5196303,1622
140013826,205.0,205.0,170000,170000,0,0,170000,Null,Null,140013826,111461,2
140046636,185.0,185.0,48000,48000,0,0,48000,Null,Null,140046636,111461,53190
140101083,0.0,0.0,13100000,13100000,0,0,13100000,Null,Null,140101083,4508621,7079
140101772,0.0,0.0,11970000,11970000,0,0,11970000,Null,Null,140101772,4508621,7079
140129681,3.0,3.0,18000,18000,0,0,18000,Null,Null,140129681,111461,49728
140131541,37.0,37.0,16500,16500,0,0,16500,Null,Null,140131541,111461,1883
140132041,23.0,23.0,7500,7500,0,0,7500,Null,Null,140132041,111461,8167
140135702,68.0,68.0,67990,67990,0,0,67990,Null,Null,140135702,162313,28484
140144656,0.0,0.0,4990000,3529000,1461000,29,4990000,Null,Null,140144656,247549,1795
140145901,0.0,0.0,2000,2000,0,0,2000,Null,Null,140145901,111461,2
140163114,0.0,0.0,3912000,3912000,0,0,3912000,Null,Null,140163114,25643,1795
140168431,3.0,3.0,29000,29000,0,0,29000,Null,Null,140168431,254343,8511
140174734,2.0,2.0,18000,18000,0,0,18000,Null,Null,140174734,111461,49728
140184098,65.0,65.0,1990000,1065000,925000,46,1990000,Null,Null,140184098,257333,1795
140187660,3.0,3.0,18000,18000,0,0,18000,Null,Null,140187660,111461,49728
140206582,67.0,67.0,1600000,1520000,80000,5,1600000,Null,Null,140206582,5069783,11885
140217566,359.0,359.0,129000,94000,35000,27,129000,Null,Null,140217566,709163,23276
140248669,35.0,35.0,410000,365000,45000,11,410000,Null,Null,140248669,18792,1813
140299305,3.0,3.0,90000,90000,0,0,90000,Null,Null,140299305,111461,49722
140308974,2.0,2.0,90000,90000,0,0,90000,Null,Null,140308974,111461,49722
140321114,2.0,2.0,10000,10000,0,0,10000,Null,Null,140321114,111461,2
140323712,2340.0,2340.0,1290000,899000,391000,30,1290000,Null,Null,140323712,160211,3422
140332075,11.0,11.0,1200,1200,0,0,1200,Null,Null,140332075,111461,2
140332113,4.0,4.0,9900,9900,0,0,9900,Null,Null,140332113,111461,2
140332199,361.0,361.0,1200,1200,0,0,1200,Null,Null,140332199,111461,2
140332241,0.0,0.0,13200,13200,0,0,13200,Null,Null,140332241,111461,2
140332529,0.0,0.0,1650,1650,0,0,1650,Null,Null,140332529,111461,2
140332542,1.0,1.0,16500,16500,0,0,16500,Null,Null,140332542,111461,2
140332808,0.0,0.0,16500,16500,0,0,16500,Null,Null,140332808,111461,2
140333055,4.0,4.0,3850,3850,0,0,3850,Null,Null,140333055,111461,2
140333242,6.0,6.0,8800,8800,0,0,8800,Null,Null,140333242,111461,2
140333339,172.0,172.0,399000,323000,76000,19,399000,Null,Null,140333339,5249373,17184
140361063,26.0,26.0,89000,87000,2000,2,89000,Null,Null,140361063,111461,28482
140371946,151.0,151.0,790000,450000,340000,43,790000,Null,Null,140371946,17827,3805
140374830,694.0,694.0,117500,95000,22500,19,117500,Null,Null,140374830,216511,1630
140376071,339.0,339.0,990000,649000,341000,34,990000,Null,Null,140376071,111454,8400
140390000,0.0,0.0,1000,1000,0,0,1000,Null,Null,140390000,111461,2
140411676,0.0,0.0,1000,1000,0,0,1000,Null,Null,140411676,111461,2
140429265,0.0,0.0,1250,1250,0,0,1250,Null,Null,140429265,111461,2
140436661,2816.0,2816.0,7790000,4970000,2820000,36,7790000,Null,Null,140436661,17827,1811
140440052,267.0,267.0,2980000,1699000,1281000,43,2980000,Null,Null,140440052,5246949,2340
140448667,6.0,6.0,999,999,0,0,999,Null,Null,140448667,111461,2
140450172,1.0,1.0,8000,8000,0,0,8000,Null,Null,140450172,111461,2
140451347,1.0,1.0,279300,279300,0,0,279300,Null,Null,140451347,5249843,15318
140479613,185.0,185.0,236000,119000,117000,50,236000,Null,Null,140479613,561415,11856
140514257,1.0,1.0,6000,6000,0,0,6000,Null,Null,140514257,111461,2
140515287,34.0,34.0,8000,8000,0,0,8000,Null,Null,140515287,111461,2
140515371,1.0,1.0,3900,3900,0,0,3900,Null,Null,140515371,111461,2
140515395,0.0,0.0,2500,2500,0,0,2500,Null,Null,140515395,111461,2
140516610,0.0,0.0,1500,1500,0,0,1500,Null,Null,140516610,111461,2
140517461,0.0,0.0,1900,1900,0,0,1900,Null,Null,140517461,111461,2
140520488,17.0,17.0,6100,6100,0,0,6100,Null,Null,140520488,111461,8167
140520506,2.0,2.0,7000,7000,0,0,7000,Null,Null,140520506,111461,8167
140520543,12.0,12.0,4500,4500,0,0,4500,Null,Null,140520543,111461,2
140520693,20.0,20.0,6700,6700,0,0,6700,Null,Null,140520693,111461,8167
140520742,0.0,0.0,7600,7600,0,0,7600,Null,Null,140520742,111461,8167
140520872,3.0,3.0,2400,2400,0,0,2400,Null,Null,140520872,111461,8167
140520919,0.0,0.0,5445,5445,0,0,5445,Null,Null,140520919,111461,8167
140522638,74.0,74.0,14000,11000,3000,21,14000,Null,Null,140522638,111461,2
140523443,157.0,157.0,268000,208000,60000,22,268000,Null,Null,140523443,150002,1838
140537792,2364.0,2364.0,54180,53100,1080,2,54180,Null,Null,140537792,217777,1583
140537916,75.0,75.0,450000,329000,121000,27,450000,Null,Null,140537916,5331955,3426
140543197,277.0,277.0,350000,228000,122000,35,350000,Null,Null,140543197,5211513,53350
140543455,0.0,0.0,1000,1000,0,0,1000,Null,Null,140543455,111461,2
140543473,2.0,2.0,39000,39000,0,0,39000,Null,Null,140543473,111461,2
140615001,15.0,15.0,1900,1900,0,0,1900,Null,Null,140615001,111461,2
140615263,0.0,0.0,2500,2500,0,0,2500,Null,Null,140615263,111461,2
140615353,0.0,0.0,1900,1900,0,0,1900,Null,Null,140615353,111461,2
140615595,30.0,30.0,1100,1100,0,0,1100,Null,Null,140615595,111461,2
140627797,0.0,0.0,13850000,13850000,0,0,13850000,Null,Null,140627797,5255587,7079
140627811,0.0,0.0,14990000,14990000,0,0,14990000,Null,Null,140627811,5258105,2
140627852,7.0,7.0,350000,350000,0,0,350000,Null,Null,140627852,111461,15318
140630116,11.0,11.0,160000,160000,0,0,160000,Null,Null,140630116,111461,49722
140634860,146.0,146.0,129000,99000,30000,23,129000,Null,Null,140634860,111461,5531
140656713,425.0,425.0,420000,249000,171000,41,420000,Null,Null,140656713,938179,3877
140741819,20.0,20.0,2390000,2390000,0,0,2390000,Null,Null,140741819,111461,1794
140743036,0.0,0.0,9900000,9900000,0,0,9900000,Null,Null,140743036,228187,2334
140747649,1.0,1.0,3790000,3479000,311000,8,3790000,Null,Null,140747649,247549,1795
140747978,0.0,0.0,0,5000,0,0,5000,Null,Null,140747978,111461,0
140748056,10.0,10.0,3000,3000,0,0,3000,Null,Null,140748056,111461,2
140769745,161.0,161.0,1000,1000,0,0,1000,Null,Null,140769745,111461,2
140770130,12.0,12.0,1200,1200,0,0,1200,Null,Null,140770130,111461,2
140770262,5.0,5.0,1000,1000,0,0,1000,Null,Null,140770262,111461,2
140770538,0.0,0.0,2760,2760,0,0,2760,Null,Null,140770538,111461,2
140770722,33.0,33.0,2500,2500,0,0,2500,Null,Null,140770722,111461,2
140791193,1021.0,1021.0,90000,56000,34000,38,90000,Null,Null,140791193,19018,2488
140821601,83.0,83.0,1800,1800,0,0,1800,Null,Null,140821601,111461,2
140830690,1.0,1.0,1100,1100,0,0,1100,Null,Null,140830690,111461,2
140832504,0.0,0.0,2000,2000,0,0,2000,Null,Null,140832504,111461,2
140832579,4.0,4.0,125000,125000,0,0,125000,Null,Null,140832579,111461,2
140923048,1.0,1.0,33500000,33500000,0,0,33500000,Null,Null,140923048,167287,2324
140934602,433.0,433.0,250000,148000,102000,41,250000,Null,Null,140934602,4224691,2234
140934746,215.0,215.0,99999,99999,0,0,99999,Null,Null,140934746,111461,49676
140940220,21.0,21.0,8679000,7811100,867900,10,8679000,Null,Null,140940220,183625,28856
140953992,966.0,966.0,89000,89000,0,0,89000,Null,Null,140953992,4281839,8224
140962214,21.0,21.0,790000,499000,291000,37,790000,Null,Null,140962214,25643,8400
140965646,0.0,0.0,2000,2000,0,0,2000,Null,Null,140965646,111461,2
140966670,0.0,0.0,2000,2000,0,0,2000,Null,Null,140966670,111461,2
140967331,0.0,0.0,2000,2000,0,0,2000,Null,Null,140967331,111461,2
140973611,2.0,2.0,780000,780000,0,0,780000,Null,Null,140973611,469547,15250
141001037,56.0,56.0,165000,165000,0,0,165000,Null,Null,141001037,198877,2488
141001207,338.0,338.0,800000,499000,301000,38,800000,Null,Null,141001207,4250493,4381
141002105,0.0,0.0,9699000,9699000,0,0,9699000,Null,Null,141002105,111461,2340
141006744,0.0,0.0,13290000,13290000,0,0,13290000,Null,Null,141006744,313739,20170
141009002,164.0,164.0,160000,160000,0,0,160000,Null,Null,141009002,111461,2
141009792,50.0,50.0,2000,2000,0,0,2000,Null,Null,141009792,561415,49728
141009799,13.0,13.0,599000,599000,0,0,599000,Null,Null,141009799,111461,8513
141009836,0.0,0.0,28999,28999,0,0,28999,Null,Null,141009836,111461,49726
141038274,0.0,0.0,1000,1000,0,0,1000,Null,Null,141038274,111461,2
141039902,0.0,0.0,1300,1300,0,0,1300,Null,Null,141039902,111461,2
141051115,0.0,0.0,3350000,3350000,0,0,3350000,Null,Null,141051115,111461,2
141075179,947.0,947.0,20000,20000,0,0,20000,Null,Null,141075179,5063093,3179
141087694,82.0,82.0,750000,709000,41000,5,750000,Null,Null,141087694,19673,1796
141096255,908.0,908.0,125000,65000,60000,48,125000,Null,Null,141096255,4766405,1631
141127824,17.0,17.0,285000,285000,0,0,285000,Null,Null,141127824,111461,2
141127877,0.0,0.0,1000,1000,0,0,1000,Null,Null,141127877,111461,2
141129744,0.0,0.0,9000,9000,0,0,9000,Null,Null,141129744,111461,2
141129775,3.0,3.0,9000,9000,0,0,9000,Null,Null,141129775,111461,2
141129839,3.0,3.0,3000,3000,0,0,3000,Null,Null,141129839,111461,2
141131381,95.0,95.0,88000,88000,0,0,88000,Null,Null,141131381,111461,2
141143706,446.0,446.0,349000,249000,100000,29,349000,Null,Null,141143706,363961,3177
141154022,13.0,13.0,160000,160000,0,0,160000,Null,Null,141154022,111461,2
141154060,1.0,1.0,395000,395000,0,0,395000,Null,Null,141154060,111461,2
141201958,361.0,361.0,449000,299000,150000,33,449000,Null,Null,141201958,363961,3177
141219477,0.0,0.0,15000,15000,0,0,15000,Null,Null,141219477,111461,2
141230683,286.0,286.0,112000,112000,0,0,112000,Null,Null,141230683,111461,12590
141232964,8.0,8.0,739000,709000,30000,4,739000,Null,Null,141232964,5252841,15318
141233095,19.0,19.0,45000,15000,30000,67,45000,Null,Null,141233095,5252841,49724
141233154,1.0,1.0,329000,299000,30000,9,329000,Null,Null,141233154,5252841,15318
141233382,32.0,32.0,220000,190000,30000,14,220000,Null,Null,141233382,5252841,15318
141233656,19.0,19.0,199000,199000,0,0,199000,Null,Null,141233656,5252841,15318
141233727,26.0,26.0,269000,239000,30000,11,269000,Null,Null,141233727,5252841,15318
141233730,2.0,2.0,220000,190000,30000,14,220000,Null,Null,141233730,5252841,15318
141233817,67.0,67.0,50000,20000,30000,60,50000,Null,Null,141233817,5252841,15318
141233971,41.0,41.0,185000,155000,30000,16,185000,Null,Null,141233971,5252841,15318
141234212,32.0,32.0,40000,10000,30000,75,40000,Null,Null,141234212,5252841,15318
141234280,5.0,5.0,269000,239000,30000,11,269000,Null,Null,141234280,5252841,15318
141234281,38.0,38.0,220000,190000,30000,14,220000,Null,Null,141234281,5252841,15318
141246639,14.0,14.0,800000,449000,351000,44,800000,Null,Null,141246639,48077,2225
141258470,182.0,182.0,239000,239000,0,0,239000,Null,Null,141258470,5132069,3178
141260753,5.0,5.0,2500,2500,0,0,2500,Null,Null,141260753,111461,2
141337014,0.0,0.0,3912000,3912000,0,0,3912000,Null,Null,141337014,25643,1795
141347393,4.0,4.0,2000,2000,0,0,2000,Null,Null,141347393,111461,2
141347427,0.0,0.0,2000,2000,0,0,2000,Null,Null,141347427,111461,2
141347482,7.0,7.0,2000,2000,0,0,2000,Null,Null,141347482,111461,2
141376178,2786.0,2786.0,180000,139000,41000,23,180000,Null,Null,141376178,25643,4428
141470309,71.0,71.0,7000,3500,3500,50,7000,Null,Null,141470309,111461,2
141470339,74.0,74.0,1500,1000,500,33,1500,Null,Null,141470339,111461,2
141470343,1043.0,1043.0,109000,55000,54000,50,109000,Null,Null,141470343,111461,8165
141472707,307.0,307.0,84000,75000,9000,11,84000,Null,Null,141472707,111461,23010
141473496,22.0,22.0,50000,45000,5000,10,50000,Null,Null,141473496,111461,2
141480009,7.0,7.0,1590000,1590000,0,0,1590000,Null,Null,141480009,111461,28856
141496858,0.0,0.0,3912000,3912000,0,0,3912000,Null,Null,141496858,25643,1795
141497150,69.0,69.0,249000,249000,0,0,249000,Null,Null,141497150,155263,28694
141497779,5.0,5.0,6000,6000,0,0,6000,Null,Null,141497779,111461,2
141513855,0.0,0.0,15000,15000,0,0,15000,Null,Null,141513855,111461,15250
141529940,0.0,0.0,4290000,2909000,1381000,32,4290000,Null,Null,141529940,247549,1795
141546635,13.0,13.0,1790000,1790000,0,0,1790000,Null,Null,141546635,111461,28856
141556736,323.0,323.0,2900000,1760000,1140000,39,2900000,Null,Null,141556736,79682,1626
141584457,73.0,73.0,2000,2000,0,0,2000,Null,Null,141584457,111461,2
141584477,16.0,16.0,2500,2500,0,0,2500,Null,Null,141584477,111461,2
141584478,96.0,96.0,2000,2000,0,0,2000,Null,Null,141584478,111461,2
141584495,3.0,3.0,118000,118000,0,0,118000,Null,Null,141584495,111461,2514
141590582,83.0,83.0,135000,135000,0,0,135000,Null,Null,141590582,111461,2
141597632,2.0,2.0,5000,5000,0,0,5000,Null,Null,141597632,111461,8198
141644891,3.0,3.0,20000,20000,0,0,20000,Null,Null,141644891,111461,2
141645156,0.0,0.0,11000,11000,0,0,11000,Null,Null,141645156,111461,15250
141645241,1.0,1.0,11000,11000,0,0,11000,Null,Null,141645241,111461,2
141645697,0.0,0.0,15000,15000,0,0,15000,Null,Null,141645697,111461,2
141654346,31.0,31.0,937,937,0,0,937,Null,Null,141654346,111461,2
141656257,34.0,34.0,1999,1999,0,0,1999,Null,Null,141656257,111461,2
141656315,53.0,53.0,991,991,0,0,991,Null,Null,141656315,111461,2
141656405,33.0,33.0,931,931,0,0,931,Null,Null,141656405,111461,2
141656562,0.0,0.0,497,497,0,0,497,Null,Null,141656562,111461,23112
141658188,95.0,95.0,25000,25000,0,0,25000,Null,Null,141658188,111461,15318
141659396,0.0,0.0,6000,6000,0,0,6000,Null,Null,141659396,111461,8205
141660939,2.0,2.0,2500,2500,0,0,2500,Null,Null,141660939,111461,2
141661120,41.0,41.0,45000,45000,0,0,45000,Null,Null,141661120,111461,2
141661890,14.0,14.0,16000,16000,0,0,16000,Null,Null,141661890,111461,2
141662616,52.0,52.0,99000,93000,6000,6,99000,Null,Null,141662616,111461,20244
141662732,0.0,0.0,19000,19000,0,0,19000,Null,Null,141662732,111461,15318
141662849,63.0,63.0,175000,175000,0,0,175000,Null,Null,141662849,111461,1831
141663080,27.0,27.0,3099000,3099000,0,0,3099000,Null,Null,141663080,183625,28856
141665187,2.0,2.0,25000,25000,0,0,25000,Null,Null,141665187,111461,15320
141665290,5.0,5.0,11000,11000,0,0,11000,Null,Null,141665290,561415,15250
141673214,662.0,662.0,280000,189000,91000,33,280000,Null,Null,141673214,18984,1831
141678363,80.0,80.0,350000,239000,111000,32,350000,Null,Null,141678363,449693,11881
141678437,81.0,81.0,484000,192000,292000,60,484000,Null,Null,141678437,449693,11861
141678620,53.0,53.0,340000,275000,65000,19,340000,Null,Null,141678620,248191,1616
141678994,1.0,1.0,3600000,3600000,0,0,3600000,Null,Null,141678994,410199,8223
141680413,28.0,28.0,690000,399000,291000,42,690000,Null,Null,141680413,150433,12908
141740797,297.0,297.0,58000,42000,16000,28,58000,Null,Null,141740797,79682,11835
141757541,0.0,0.0,40000000,24300000,15700000,39,40000000,Null,Null,141757541,51302,2340
141758582,34.0,34.0,4500000,3990000,510000,11,4500000,Null,Null,141758582,892671,8165
141771587,20.0,20.0,2000,2000,0,0,2000,Null,Null,141771587,111461,2
141774833,6.0,6.0,7990000,7990000,0,0,7990000,Null,Null,141774833,18802,1794
141792990,97.0,97.0,100000,63000,37000,37,100000,Null,Null,141792990,5085219,27128
141808788,3.0,3.0,35000,35000,0,0,35000,Null,Null,141808788,111461,15250
141819424,0.0,0.0,12800000,12800000,0,0,12800000,Null,Null,141819424,50331,6653
141859564,80.0,80.0,144000,144000,0,0,144000,Null,Null,141859564,111461,23658
141899574,0.0,0.0,2000,2000,0,0,2000,Null,Null,141899574,111461,2
141923658,47.0,47.0,135000,135000,0,0,135000,Null,Null,141923658,111461,28596
141924087,144.0,144.0,60000,60000,0,0,60000,Null,Null,141924087,111461,28616
141961668,7.0,7.0,8000,8000,0,0,8000,Null,Null,141961668,111461,2
141971217,0.0,0.0,16800000,16800000,0,0,16800000,Null,Null,141971217,50331,28860
141971329,260.0,260.0,69000,69000,0,0,69000,Null,Null,141971329,5076287,2514
141972238,32.0,32.0,1980,1980,0,0,1980,Null,Null,141972238,111461,2
141972329,0.0,0.0,5600,5600,0,0,5600,Null,Null,141972329,111461,2
141982055,25.0,25.0,16000,16000,0,0,16000,Null,Null,141982055,111461,1520
141984382,7.0,7.0,129600,129600,0,0,129600,Null,Null,141984382,111461,2
141985890,0.0,0.0,5880000,5880000,0,0,5880000,Null,Null,141985890,111461,2
141985895,1.0,1.0,900000,900000,0,0,900000,Null,Null,141985895,111461,2
141986160,101.0,101.0,410000,205000,205000,50,410000,Null,Null,141986160,883175,23362
142010480,0.0,0.0,10299000,10299000,0,0,10299000,Null,Null,142010480,51302,2340
142089981,63.0,63.0,28000,28000,0,0,28000,Null,Null,142089981,111461,28482
142096809,1.0,1.0,478000,478000,0,0,478000,Null,Null,142096809,111461,4381
142117009,885.0,885.0,28000,28000,0,0,28000,Null,Null,142117009,5063093,23220
142133183,0.0,0.0,9000,9000,0,0,9000,Null,Null,142133183,111461,15320
142135437,269.0,269.0,65000,65000,0,0,65000,Null,Null,142135437,111461,28616
142144708,25.0,25.0,228000,228000,0,0,228000,Null,Null,142144708,111461,8513
142163872,152.0,152.0,85000,71880,13120,15,85000,Null,Null,142163872,110682,28480
142172775,0.0,0.0,176000,176000,0,0,176000,Null,Null,142172775,111461,2324
142206998,34.0,34.0,1500,1500,0,0,1500,Null,Null,142206998,111461,2
142213338,10.0,10.0,169000,89000,80000,47,169000,Null,Null,142213338,48077,2513
142236617,0.0,0.0,38000000,38000000,0,0,38000000,Null,Null,142236617,111461,2
142238727,191.0,191.0,2090000,2090000,0,0,2090000,Null,Null,142238727,18984,5264
142239175,88.0,88.0,45000,42750,2250,5,45000,Null,Null,142239175,4269901,2337
142261128,674.0,674.0,580000,339000,241000,42,580000,Null,Null,142261128,3797113,23362
142310121,45.0,45.0,7000,7000,0,0,7000,Null,Null,142310121,111461,15236
142312219,26.0,26.0,300000,207000,93000,31,300000,Null,Null,142312219,111461,23376
142316350,454.0,454.0,30000,26000,4000,13,30000,Null,Null,142316350,5232359,4428
142321604,84.0,84.0,280000,199000,81000,29,280000,Null,Null,142321604,508185,28458
142323009,156.0,156.0,390000,239000,151000,39,390000,Null,Null,142323009,246045,3804
142362871,7.0,7.0,109000,109000,0,0,109000,Null,Null,142362871,111461,2
142377629,1.0,1.0,5000,5000,0,0,5000,Null,Null,142377629,111461,2
142377651,9.0,9.0,8000,8000,0,0,8000,Null,Null,142377651,111461,2
142377665,0.0,0.0,7000,7000,0,0,7000,Null,Null,142377665,111461,2
142377670,0.0,0.0,5000,5000,0,0,5000,Null,Null,142377670,111461,2
142377694,0.0,0.0,7000,7000,0,0,7000,Null,Null,142377694,111461,2
142377839,1.0,1.0,8000,8000,0,0,8000,Null,Null,142377839,111461,2
142377880,8.0,8.0,6000,6000,0,0,6000,Null,Null,142377880,111461,2
142377881,3.0,3.0,6000,6000,0,0,6000,Null,Null,142377881,111461,2
142377952,0.0,0.0,5500,5500,0,0,5500,Null,Null,142377952,111461,2
142377968,40.0,40.0,17000,17000,0,0,17000,Null,Null,142377968,111461,2
142377969,4.0,4.0,9000,9000,0,0,9000,Null,Null,142377969,111461,2
142378006,0.0,0.0,5000,5000,0,0,5000,Null,Null,142378006,111461,2
142378018,0.0,0.0,5000,5000,0,0,5000,Null,Null,142378018,111461,2
142378043,2.0,2.0,5000,5000,0,0,5000,Null,Null,142378043,111461,2
142378079,0.0,0.0,7000,7000,0,0,7000,Null,Null,142378079,111461,2
142378080,0.0,0.0,8000,8000,0,0,8000,Null,Null,142378080,111461,2
142378112,11.0,11.0,5000,5000,0,0,5000,Null,Null,142378112,111461,2
142382946,1.0,1.0,500000,500000,0,0,500000,Null,Null,142382946,111461,2
142383139,21.0,21.0,1000,1000,0,0,1000,Null,Null,142383139,111461,2363
142383547,15.0,15.0,1000,1000,0,0,1000,Null,Null,142383547,111461,2363
142387407,322.0,322.0,290000,290000,0,0,290000,Null,Null,142387407,4202899,2016
142403573,377.0,377.0,5300,5300,0,0,5300,Null,Null,142403573,111461,2514
142405137,3.0,3.0,17850000,16090000,1760000,10,17850000,Null,Null,142405137,5740935,28638
142425442,70.0,70.0,460000,364650,95350,21,460000,Null,Null,142425442,19034,5006
142428725,0.0,0.0,224000,224000,0,0,224000,Null,Null,142428725,4647777,15250
142439870,277.0,277.0,95000,95000,0,0,95000,Null,Null,142439870,21651,5006
142441641,0.0,0.0,9900,9702,198,2,9900,Null,Null,142441641,111461,2
142441994,0.0,0.0,6000,5000,1000,17,6000,Null,Null,142441994,111461,2
142448847,2.0,2.0,3000000,3000000,0,0,3000000,Null,Null,142448847,154754,2
142448882,7.0,7.0,3000000,3000000,0,0,3000000,Null,Null,142448882,154754,2
142467213,102.0,102.0,425000,361250,63750,15,425000,Null,Null,142467213,19034,5006
142476713,126.0,126.0,119900,119900,0,0,119900,Null,Null,142476713,111461,1831
142477644,242.0,242.0,550000,329000,221000,40,550000,Null,Null,142477644,246045,12908
142545270,23270.0,23270.0,3190000,2390000,800000,25,3190000,Null,Null,142545270,25643,1795
142667114,0.0,0.0,9900,9900,0,0,9900,Null,Null,142667114,241479,1601
142671578,203.0,203.0,38000,38000,0,0,38000,Null,Null,142671578,111461,18876
142699319,2.0,2.0,6900,6900,0,0,6900,Null,Null,142699319,111461,28480
142699678,5.0,5.0,6000,6000,0,0,6000,Null,Null,142699678,111461,20222
142712009,47.0,47.0,2000,2000,0,0,2000,Null,Null,142712009,111461,2
142712139,28.0,28.0,2000,2000,0,0,2000,Null,Null,142712139,111461,2
142712415,4.0,4.0,73000,65700,7300,10,73000,Null,Null,142712415,111461,15320
142720688,0.0,0.0,10000,10000,0,0,10000,Null,Null,142720688,111461,2
142762742,14.0,14.0,1500,1500,0,0,1500,Null,Null,142762742,111461,2
142768181,0.0,0.0,15000,12000,3000,20,15000,Null,Null,142768181,111461,2
142783489,113.0,113.0,99999,99999,0,0,99999,Null,Null,142783489,111461,49676
142795351,3.0,3.0,989000,689000,300000,30,989000,Null,Null,142795351,111461,2
142801225,5.0,5.0,180000,180000,0,0,180000,Null,Null,142801225,111461,6305
142857609,10.0,10.0,2500,2500,0,0,2500,Null,Null,142857609,111461,2
142858439,1.0,1.0,2250,1690,560,25,2250,Null,Null,142858439,111461,2
142858586,58.0,58.0,1500,1000,500,33,1500,Null,Null,142858586,111461,2
142872838,0.0,0.0,4000000,4000000,0,0,4000000,Null,Null,142872838,576869,8167
142874656,270.0,270.0,790000,790000,0,0,790000,Null,Null,142874656,45603,11871
142989680,1.0,1.0,499000,499000,0,0,499000,Null,Null,142989680,111461,53186
142989705,0.0,0.0,210000,210000,0,0,210000,Null,Null,142989705,111461,53186
142996288,0.0,0.0,99999,99999,0,0,99999,Null,Null,142996288,111461,8305
142997283,32.0,32.0,2880,2880,0,0,2880,Null,Null,142997283,111461,2
143001862,553.0,553.0,149000,139000,10000,7,149000,Null,Null,143001862,5055663,53190
143002904,741.0,741.0,499000,475000,24000,5,499000,Null,Null,143002904,5055663,53190
143063049,136.0,136.0,169000,149000,20000,12,169000,Null,Null,143063049,41661,1627
143115803,267.0,267.0,65000,34000,31000,48,65000,Null,Null,143115803,280167,11605
143115900,8.0,8.0,599000,599000,0,0,599000,Null,Null,143115900,48865,2
143116243,0.0,0.0,2100,2100,0,0,2100,Null,Null,143116243,5209537,23112
143116281,235.0,235.0,1100,1100,0,0,1100,Null,Null,143116281,5209537,23112
143116313,1.0,1.0,1080,1080,0,0,1080,Null,Null,143116313,5209537,23112
143117183,8.0,8.0,17000,17000,0,0,17000,Null,Null,143117183,111461,15320
143117319,5.0,5.0,19000,19000,0,0,19000,Null,Null,143117319,111461,15320
143117470,2.0,2.0,46000,46000,0,0,46000,Null,Null,143117470,111461,7449
143147347,246.0,246.0,260000,156000,104000,40,260000,Null,Null,143147347,25643,4428
143217219,464.0,464.0,308000,284000,24000,8,308000,Null,Null,143217219,523789,23588
143226505,27.0,27.0,6000,6000,0,0,6000,Null,Null,143226505,5259865,1622
143226517,65.0,65.0,5000,5000,0,0,5000,Null,Null,143226517,5259865,1622
143226567,20.0,20.0,6000,6000,0,0,6000,Null,Null,143226567,5259865,1622
143226686,5.0,5.0,5000,5000,0,0,5000,Null,Null,143226686,5259865,1622
143226706,1.0,1.0,1900,1900,0,0,1900,Null,Null,143226706,5259865,8205
143226745,0.0,0.0,3977,3977,0,0,3977,Null,Null,143226745,5259865,8205
143226756,25.0,25.0,6000,6000,0,0,6000,Null,Null,143226756,5259865,1622
143226759,23.0,23.0,6000,6000,0,0,6000,Null,Null,143226759,5259865,1622
143226781,20.0,20.0,6000,6000,0,0,6000,Null,Null,143226781,5259865,11803
143240989,0.0,0.0,153999,153999,0,0,153999,Null,Null,143240989,111461,2266
143275339,734.0,734.0,30000,30000,0,0,30000,Null,Null,143275339,111461,4428
143292300,0.0,0.0,12170000,12170000,0,0,12170000,Null,Null,143292300,113119,28870
143292817,979.0,979.0,50000,45000,5000,10,50000,Null,Null,143292817,5147565,28480
143292947,96.0,96.0,41000,41000,0,0,41000,Null,Null,143292947,111461,3177
143320981,4.0,4.0,145000,145000,0,0,145000,Null,Null,143320981,111461,2
143322314,662.0,662.0,35000,35000,0,0,35000,Null,Null,143322314,111461,53074
143337082,1.0,1.0,10000,10000,0,0,10000,Null,Null,143337082,111461,2
143337091,3.0,3.0,10000,10000,0,0,10000,Null,Null,143337091,111461,2
143337174,3.0,3.0,10000,10000,0,0,10000,Null,Null,143337174,111461,2
143353548,6.0,6.0,181000,181000,0,0,181000,Null,Null,143353548,111461,2324
143359355,23.0,23.0,2990000,2062000,928000,31,2990000,Null,Null,143359355,162007,1795
143363686,195.0,195.0,55000,55000,0,0,55000,Null,Null,143363686,111461,2
143376290,159.0,159.0,2500,2500,0,0,2500,Null,Null,143376290,111461,2
143376304,65.0,65.0,9500,9500,0,0,9500,Null,Null,143376304,111461,2
143377788,0.0,0.0,10000,10000,0,0,10000,Null,Null,143377788,111461,15320
143378398,0.0,0.0,3425000,3425000,0,0,3425000,Null,Null,143378398,111461,1520
143378445,0.0,0.0,8500,8500,0,0,8500,Null,Null,143378445,111461,2
143378518,0.0,0.0,5000,5000,0,0,5000,Null,Null,143378518,111461,8167
143378604,1.0,1.0,6000,6000,0,0,6000,Null,Null,143378604,111461,2
143378673,10.0,10.0,6300,6300,0,0,6300,Null,Null,143378673,111461,2
143378694,0.0,0.0,4000,4000,0,0,4000,Null,Null,143378694,111461,2
143378704,0.0,0.0,6150,6150,0,0,6150,Null,Null,143378704,111461,2
143378716,2.0,2.0,8900,8900,0,0,8900,Null,Null,143378716,111461,2
143378717,6.0,6.0,9030,9030,0,0,9030,Null,Null,143378717,111461,2
143378724,0.0,0.0,5600,5600,0,0,5600,Null,Null,143378724,111461,8167
143385359,0.0,0.0,2000,2000,0,0,2000,Null,Null,143385359,111461,2
143397923,1078.0,1078.0,29000,28000,1000,3,29000,Null,Null,143397923,111461,1831
143469973,13.0,13.0,2000,2000,0,0,2000,Null,Null,143469973,111461,53070
143469996,20.0,20.0,1500,1500,0,0,1500,Null,Null,143469996,111461,53070
143470267,9.0,9.0,10000,10000,0,0,10000,Null,Null,143470267,111461,15320
143486513,18.0,18.0,7000,7000,0,0,7000,Null,Null,143486513,111461,8073
143499388,0.0,0.0,2000,2000,0,0,2000,Null,Null,143499388,111461,2
143499402,0.0,0.0,2000,2000,0,0,2000,Null,Null,143499402,111461,2
143524140,0.0,0.0,40000000,40000000,0,0,40000000,Null,Null,143524140,315481,2340
143526841,227.0,227.0,88000,78000,10000,11,88000,Null,Null,143526841,21733,1583
143608684,113.0,113.0,9800,9800,0,0,9800,Null,Null,143608684,111461,2
143612039,5.0,5.0,5000,5000,0,0,5000,Null,Null,143612039,111461,2
143612745,0.0,0.0,2000,2000,0,0,2000,Null,Null,143612745,111461,2
143638283,88.0,88.0,279000,279000,0,0,279000,Null,Null,143638283,111461,1978
143643037,0.0,0.0,9600,9600,0,0,9600,Null,Null,143643037,111461,2
143643317,0.0,0.0,13200,13200,0,0,13200,Null,Null,143643317,111461,2
143668306,0.0,0.0,57000000,57000000,0,0,57000000,Null,Null,143668306,315481,2340
143765558,236.0,236.0,9000,9000,0,0,9000,Null,Null,143765558,63747,8305
143779168,821.0,821.0,25000,25000,0,0,25000,Null,Null,143779168,293033,23392
143786928,155.0,155.0,344000,218000,126000,37,344000,Null,Null,143786928,4246951,8602
143787255,34.0,34.0,239000,239000,0,0,239000,Null,Null,143787255,111461,2
143807509,0.0,0.0,8990,8990,0,0,8990,Null,Null,143807509,4254887,28484
143809629,32.0,32.0,207207,207207,0,0,207207,Null,Null,143809629,111461,2
143829162,89.0,89.0,284000,185000,99000,35,284000,Null,Null,143829162,4738431,49722
143838450,215.0,215.0,320000,225000,95000,30,320000,Null,Null,143838450,4738431,49722
143839272,73.0,73.0,350000,210000,140000,40,350000,Null,Null,143839272,4738431,49722
143858081,700.0,700.0,9800,9000,800,8,9800,Null,Null,143858081,111461,6742
143860118,274.0,274.0,900000,549000,351000,39,900000,Null,Null,143860118,111454,28454
143909492,68.0,68.0,6500,6500,0,0,6500,Null,Null,143909492,111461,2
143909508,125.0,125.0,26000,26000,0,0,26000,Null,Null,143909508,111461,2
143909535,54.0,54.0,5000,5000,0,0,5000,Null,Null,143909535,111461,2
143909573,103.0,103.0,8500,8500,0,0,8500,Null,Null,143909573,111461,2
143909617,14.0,14.0,6500,6500,0,0,6500,Null,Null,143909617,111461,2
143909718,198.0,198.0,10000,10000,0,0,10000,Null,Null,143909718,111461,2
143909741,74.0,74.0,4000,4000,0,0,4000,Null,Null,143909741,111461,2
143909760,43.0,43.0,5000,5000,0,0,5000,Null,Null,143909760,111461,2
143909761,1821.0,1821.0,12500,12500,0,0,12500,Null,Null,143909761,111461,2
143909813,300.0,300.0,9000,9000,0,0,9000,Null,Null,143909813,111461,8167
143909826,19.0,19.0,5000,5000,0,0,5000,Null,Null,143909826,111461,2
143909866,8.0,8.0,6000,6000,0,0,6000,Null,Null,143909866,111461,2
143909877,190.0,190.0,10000,10000,0,0,10000,Null,Null,143909877,111461,2
143910043,18.0,18.0,9000,9000,0,0,9000,Null,Null,143910043,111461,2
143910073,10.0,10.0,7500,7500,0,0,7500,Null,Null,143910073,111461,2
143953787,0.0,0.0,2800,2800,0,0,2800,Null,Null,143953787,111461,2
143957287,2346.0,2346.0,133000,133000,0,0,133000,Null,Null,143957287,4888937,8519
143959941,0.0,0.0,1150,1150,0,0,1150,Null,Null,143959941,111461,2
143960604,374.0,374.0,327000,190000,137000,42,327000,Null,Null,143960604,4738431,49722
143960839,91.0,91.0,240000,240000,0,0,240000,Null,Null,143960839,111461,4381
143963189,10.0,10.0,330000,288000,42000,13,330000,Null,Null,143963189,19071,1838
143983026,4754.0,4754.0,50000,25000,25000,50,50000,Null,Null,143983026,5265159,8305
144084918,103.0,103.0,321000,195000,126000,39,321000,Null,Null,144084918,4738431,49722
144092824,0.0,0.0,3980000,3980000,0,0,3980000,Null,Null,144092824,4244773,11873
144097374,2.0,2.0,5000,4950,50,1,5000,Null,Null,144097374,111461,7064
144112670,11.0,11.0,36000,18000,18000,50,36000,Null,Null,144112670,111461,15318
144112673,1.0,1.0,33000,15000,18000,55,33000,Null,Null,144112673,111461,15318
144112674,9.0,9.0,33000,15000,18000,55,33000,Null,Null,144112674,111461,15318
144112680,19.0,19.0,44000,20000,24000,55,44000,Null,Null,144112680,111461,15318
144112695,5.0,5.0,65000,29000,36000,55,65000,Null,Null,144112695,111461,15318
144112707,10.0,10.0,58000,26000,32000,55,58000,Null,Null,144112707,111461,15318
144142520,0.0,0.0,4990000,3149000,1841000,37,4990000,Null,Null,144142520,247549,1795
144179529,23.0,23.0,23500,23500,0,0,23500,Null,Null,144179529,111461,2
144180404,1.0,1.0,7500,7500,0,0,7500,Null,Null,144180404,111461,2
144180720,4.0,4.0,7500,7500,0,0,7500,Null,Null,144180720,111461,2
144180838,85.0,85.0,5500,5500,0,0,5500,Null,Null,144180838,111461,2
144181055,50.0,50.0,9000,9000,0,0,9000,Null,Null,144181055,111461,2
144181278,53.0,53.0,1500,1500,0,0,1500,Null,Null,144181278,111461,2
144181325,60.0,60.0,99000,99000,0,0,99000,Null,Null,144181325,111461,2
144182000,4.0,4.0,9500,9500,0,0,9500,Null,Null,144182000,111461,2
144182007,89.0,89.0,2000,2000,0,0,2000,Null,Null,144182007,111461,2
144183557,110.0,110.0,1900,1900,0,0,1900,Null,Null,144183557,111461,53070
144191635,178.0,178.0,53000,53000,0,0,53000,Null,Null,144191635,111461,8165
144193363,0.0,0.0,19200000,19200000,0,0,19200000,Null,Null,144193363,191611,12876
144198792,0.0,0.0,3000,2500,500,17,3000,Null,Null,144198792,111461,2
144199536,0.0,0.0,7000,6000,1000,14,7000,Null,Null,144199536,111461,2
144200254,0.0,0.0,37000,37000,0,0,37000,Null,Null,144200254,111461,2
144200408,15.0,15.0,799000,783020,15980,2,799000,Null,Null,144200408,111461,8061
144201385,13.0,13.0,550000,539000,11000,2,550000,Null,Null,144201385,111461,8061
144201636,1.0,1.0,100000,81000,19000,19,100000,Null,Null,144201636,19071,2977
144203022,2.0,2.0,68000,68000,0,0,68000,Null,Null,144203022,111461,15320
144203362,4.0,4.0,682000,682000,0,0,682000,Null,Null,144203362,48077,2225
144203367,343.0,343.0,726000,359000,367000,51,726000,Null,Null,144203367,48077,2225
144208542,19.0,19.0,400000,275000,125000,31,400000,Null,Null,144208542,155842,53350
144211234,1.0,1.0,689000,689000,0,0,689000,Null,Null,144211234,111461,8167
144218656,2.0,2.0,7500,7500,0,0,7500,Null,Null,144218656,111461,2
144228451,1637.0,1637.0,7400,7400,0,0,7400,Null,Null,144228451,112493,8305
144231179,17.0,17.0,880000,862400,17600,2,880000,Null,Null,144231179,111461,8061
144243147,14.0,14.0,80000,80000,0,0,80000,Null,Null,144243147,111461,15250
144259220,118.0,118.0,109000,109000,0,0,109000,Null,Null,144259220,4888937,3428
144263565,66.0,66.0,155000,155000,0,0,155000,Null,Null,144263565,4888937,3428
144269032,56.0,56.0,2000,2000,0,0,2000,Null,Null,144269032,111461,23544
144269492,63.0,63.0,39000,39000,0,0,39000,Null,Null,144269492,111461,15320
144274045,28.0,28.0,829000,412000,417000,50,829000,Null,Null,144274045,111461,2
144321607,31.0,31.0,38000,38000,0,0,38000,Null,Null,144321607,111461,28892
144326903,0.0,0.0,2476,2476,0,0,2476,Null,Null,144326903,111461,2
144328039,4.0,4.0,2000,2000,0,0,2000,Null,Null,144328039,111461,2
144328778,0.0,0.0,2000,2000,0,0,2000,Null,Null,144328778,111461,2
144337870,13.0,13.0,5785000,4190000,1595000,28,5785000,Null,Null,144337870,5211335,1520
144342850,0.0,0.0,2500,2500,0,0,2500,Null,Null,144342850,111461,2
144345242,0.0,0.0,79000,79000,0,0,79000,Null,Null,144345242,111461,15320
144345275,1.0,1.0,315000,310000,5000,2,315000,Null,Null,144345275,111461,15250
144368271,5.0,5.0,69000,69000,0,0,69000,Null,Null,144368271,111461,2
144368278,0.0,0.0,12000,12000,0,0,12000,Null,Null,144368278,111461,2
144368285,33.0,33.0,20000,20000,0,0,20000,Null,Null,144368285,111461,15236
144368334,1.0,1.0,58000,58000,0,0,58000,Null,Null,144368334,111461,2
144368396,6.0,6.0,72800,72800,0,0,72800,Null,Null,144368396,111461,2
144368397,99.0,99.0,23000,23000,0,0,23000,Null,Null,144368397,111461,15236
144368438,38.0,38.0,21850,21850,0,0,21850,Null,Null,144368438,111461,15236
144368452,1.0,1.0,19000,19000,0,0,19000,Null,Null,144368452,111461,2
144368479,7.0,7.0,19000,19000,0,0,19000,Null,Null,144368479,111461,15320
144368523,2.0,2.0,19000,19000,0,0,19000,Null,Null,144368523,111461,2
144368543,1.0,1.0,15000,15000,0,0,15000,Null,Null,144368543,111461,2
144368545,2.0,2.0,63000,63000,0,0,63000,Null,Null,144368545,111461,15236
144368554,6.0,6.0,56050,56050,0,0,56050,Null,Null,144368554,111461,15236
144368589,6.0,6.0,21850,21850,0,0,21850,Null,Null,144368589,111461,15236
144368604,53.0,53.0,21850,21850,0,0,21850,Null,Null,144368604,111461,15236
144450194,19.0,19.0,38999,38999,0,0,38999,Null,Null,144450194,111461,2266
144461925,18.0,18.0,21900,21900,0,0,21900,Null,Null,144461925,111461,2
144461995,0.0,0.0,9500,9500,0,0,9500,Null,Null,144461995,111461,2
144462628,0.0,0.0,1999,1999,0,0,1999,Null,Null,144462628,111461,2
144462769,32.0,32.0,55000,55000,0,0,55000,Null,Null,144462769,111461,2
144464432,2.0,2.0,10000,10000,0,0,10000,Null,Null,144464432,111461,2
144465073,1.0,1.0,20000,20000,0,0,20000,Null,Null,144465073,111461,2
144487724,27.0,27.0,5190000,5190000,0,0,5190000,Null,Null,144487724,144779,8400
144503748,93.0,93.0,755000,377000,378000,50,755000,Null,Null,144503748,5310901,2340
144509353,130.0,130.0,2500,2500,0,0,2500,Null,Null,144509353,111461,23622
144510100,1.0,1.0,5900,5900,0,0,5900,Null,Null,144510100,111461,2
144511392,0.0,0.0,2000,2000,0,0,2000,Null,Null,144511392,111461,53074
144514902,42.0,42.0,156000,156000,0,0,156000,Null,Null,144514902,4888937,6742
144515356,9.0,9.0,79000,79000,0,0,79000,Null,Null,144515356,111461,2234
144527016,166.0,166.0,95959,95959,0,0,95959,Null,Null,144527016,111461,1978
144531526,4.0,4.0,432000,216000,216000,50,432000,Null,Null,144531526,111461,15318
144531539,2.0,2.0,120000,60000,60000,50,120000,Null,Null,144531539,111461,15250
144534656,1.0,1.0,880000,880000,0,0,880000,Null,Null,144534656,18851,8067
144540700,1.0,1.0,3608000,3490000,118000,3,3608000,Null,Null,144540700,450333,8066
144540787,0.0,0.0,4290000,4290000,0,0,4290000,Null,Null,144540787,18851,8067
144566720,0.0,0.0,298000,298000,0,0,298000,Null,Null,144566720,111461,15318
144573566,1.0,1.0,129000,129000,0,0,129000,Null,Null,144573566,111461,15236
144584821,2.0,2.0,2618000,1768000,850000,32,2618000,Null,Null,144584821,26150,8513
144590196,415.0,415.0,105000,105000,0,0,105000,Null,Null,144590196,5063093,27256
144616106,419.0,419.0,30000,30000,0,0,30000,Null,Null,144616106,939243,8305
144629641,0.0,0.0,19692000,19692000,0,0,19692000,Null,Null,144629641,181409,20170
144631656,0.0,0.0,31480000,29906000,1574000,5,31480000,Null,Null,144631656,181409,20170
144640385,0.0,0.0,1600,1600,0,0,1600,Null,Null,144640385,111461,2514
144640824,190.0,190.0,1000,1000,0,0,1000,Null,Null,144640824,111461,23134
144640940,0.0,0.0,630000,630000,0,0,630000,Null,Null,144640940,112638,1796
144641277,27.0,27.0,134000,129000,5000,4,134000,Null,Null,144641277,111461,28598
144641482,0.0,0.0,242000,242000,0,0,242000,Null,Null,144641482,111461,2
144660979,0.0,0.0,1000,1000,0,0,1000,Null,Null,144660979,111461,2
144677459,0.0,0.0,1000,1000,0,0,1000,Null,Null,144677459,111461,2
144735880,2.0,2.0,5000,5000,0,0,5000,Null,Null,144735880,143006,1634
144737655,607.0,607.0,16000,16000,0,0,16000,Null,Null,144737655,111461,8305
144752155,0.0,0.0,14000,14000,0,0,14000,Null,Null,144752155,111461,2685
144754339,38.0,38.0,129000,129000,0,0,129000,Null,Null,144754339,111461,2
144803060,282.0,282.0,40000,40000,0,0,40000,Null,Null,144803060,111461,3177
144803506,84.0,84.0,180000,150000,30000,17,180000,Null,Null,144803506,7486975,23078
144803533,228.0,228.0,530000,530000,0,0,530000,Null,Null,144803533,18984,1838
144830730,16.0,16.0,3000,3000,0,0,3000,Null,Null,144830730,111461,2363
144870494,0.0,0.0,3012000,2794000,218000,7,3012000,Null,Null,144870494,25643,1795
144874085,148.0,148.0,150000,120000,30000,20,150000,Null,Null,144874085,7486975,23078
144882485,50.0,50.0,390000,170000,220000,56,390000,Null,Null,144882485,111461,27196
144916637,2.0,2.0,25000,25000,0,0,25000,Null,Null,144916637,111461,2685
144917264,10.0,10.0,2200,2200,0,0,2200,Null,Null,144917264,111461,1883
144917514,13.0,13.0,1900,1900,0,0,1900,Null,Null,144917514,111461,2
144917539,311.0,311.0,2000,2000,0,0,2000,Null,Null,144917539,111461,2
144917761,64.0,64.0,120000,120000,0,0,120000,Null,Null,144917761,111461,23446
144918673,4.0,4.0,10550,10550,0,0,10550,Null,Null,144918673,111461,2266
144939522,340.0,340.0,199000,95000,104000,52,199000,Null,Null,144939522,314675,5263
144973012,42.0,42.0,225000,225000,0,0,225000,Null,Null,144973012,150002,1838
145083076,67.0,67.0,149000,119000,30000,20,149000,Null,Null,145083076,5073869,1831
145092650,161.0,161.0,55000,35000,20000,36,55000,Null,Null,145092650,4738431,49722
145094008,1.0,1.0,251668,251668,0,0,251668,Null,Null,145094008,111461,2
145114920,1.0,1.0,120000,120000,0,0,120000,Null,Null,145114920,111461,15318
145124952,254.0,254.0,60000,60000,0,0,60000,Null,Null,145124952,21653,28484
145177161,167.0,167.0,190000,190000,0,0,190000,Null,Null,145177161,858145,11735
145177483,43.0,43.0,299000,299000,0,0,299000,Null,Null,145177483,111461,5531
145216189,1.0,1.0,150000,125000,25000,17,150000,Null,Null,145216189,5264641,15250
145219207,43.0,43.0,15000,9000,6000,40,15000,Null,Null,145219207,111461,6742
145221424,328.0,328.0,149000,149000,0,0,149000,Null,Null,145221424,332203,8305
145224589,0.0,0.0,2500,2500,0,0,2500,Null,Null,145224589,111461,23168
145225010,12.0,12.0,399000,355000,44000,11,399000,Null,Null,145225010,47882,8513
145243984,29.0,29.0,98500,98500,0,0,98500,Null,Null,145243984,162313,28484
145290317,5.0,5.0,2500,2500,0,0,2500,Null,Null,145290317,111461,2
145291162,1.0,1.0,59000,59000,0,0,59000,Null,Null,145291162,111461,15318
145291215,155.0,155.0,49000,49000,0,0,49000,Null,Null,145291215,4820975,18876
145296443,81.0,81.0,115000,115000,0,0,115000,Null,Null,145296443,111461,28596
145297418,73.0,73.0,115000,115000,0,0,115000,Null,Null,145297418,111461,28596
145297587,0.0,0.0,10979000,10869210,109790,1,10979000,Null,Null,145297587,5200629,2340
145297805,222.0,222.0,125000,99000,26000,21,125000,Null,Null,145297805,4534193,23622
145304290,210.0,210.0,89000,88000,1000,1,89000,Null,Null,145304290,111461,20244
145372505,0.0,0.0,3650000,3650000,0,0,3650000,Null,Null,145372505,111461,2
145386942,84.0,84.0,460000,330000,130000,28,460000,Null,Null,145386942,741117,23258
145393160,16.0,16.0,2500,2500,0,0,2500,Null,Null,145393160,111461,2
145393357,1.0,1.0,2500,2500,0,0,2500,Null,Null,145393357,111461,2
145393816,0.0,0.0,50000,50000,0,0,50000,Null,Null,145393816,111461,2
145400574,67.0,67.0,499000,429000,70000,14,499000,Null,Null,145400574,111461,23022
145410027,138.0,138.0,420000,208000,212000,50,420000,Null,Null,145410027,111461,27196
145472433,0.0,0.0,36000,18000,18000,50,36000,Null,Null,145472433,111461,15318
145488761,152.0,152.0,65000,65000,0,0,65000,Null,Null,145488761,111461,28484
145495105,129.0,129.0,38000,38000,0,0,38000,Null,Null,145495105,4534193,11923
145495427,449.0,449.0,88000,78000,10000,11,88000,Null,Null,145495427,220233,1820
145495739,219.0,219.0,150000,95000,55000,37,150000,Null,Null,145495739,7486975,23078
145520625,6.0,6.0,9200,9200,0,0,9200,Null,Null,145520625,111461,11935
145534016,1.0,1.0,2500,2500,0,0,2500,Null,Null,145534016,111461,2
145534172,0.0,0.0,2500,2500,0,0,2500,Null,Null,145534172,111461,2
145534221,0.0,0.0,2500,2500,0,0,2500,Null,Null,145534221,111461,2
145540028,29.0,29.0,1000,1000,0,0,1000,Null,Null,145540028,111461,2
145540483,370.0,370.0,590000,389000,201000,34,590000,Null,Null,145540483,246045,4593
145540811,6.0,6.0,1820,1820,0,0,1820,Null,Null,145540811,111461,23432
145541076,28.0,28.0,2250,2250,0,0,2250,Null,Null,145541076,111461,2
145541347,0.0,0.0,1820,1820,0,0,1820,Null,Null,145541347,111461,2
145549400,1.0,1.0,2200,2200,0,0,2200,Null,Null,145549400,111461,2
145551547,34.0,34.0,789000,689000,100000,13,789000,Null,Null,145551547,46363,5385
145562363,11.0,11.0,195000,195000,0,0,195000,Null,Null,145562363,111461,5531
145613865,24.0,24.0,615000,615000,0,0,615000,Null,Null,145613865,28008,8044
145614019,3.0,3.0,3500,3500,0,0,3500,Null,Null,145614019,111461,2
145620839,37.0,37.0,1100000,799000,301000,27,1100000,Null,Null,145620839,150433,28454
145656739,237.0,237.0,2400,2400,0,0,2400,Null,Null,145656739,111461,23678
145680613,0.0,0.0,25729000,25729000,0,0,25729000,Null,Null,145680613,18802,8067
145685024,0.0,0.0,4000,4000,0,0,4000,Null,Null,145685024,111461,8197
145716685,302.0,302.0,2000000,1190000,810000,41,2000000,Null,Null,145716685,632677,7273
145762126,1.0,1.0,699000,699000,0,0,699000,Null,Null,145762126,111461,1796
145763559,10.0,10.0,18000,18000,0,0,18000,Null,Null,145763559,111461,49728
145763561,8.0,8.0,18000,18000,0,0,18000,Null,Null,145763561,111461,49728
145763565,101.0,101.0,45000,45000,0,0,45000,Null,Null,145763565,111461,49728
145763569,195.0,195.0,58000,58000,0,0,58000,Null,Null,145763569,111461,49728
145763594,140.0,140.0,53000,53000,0,0,53000,Null,Null,145763594,111461,49728
145763626,27.0,27.0,20000,20000,0,0,20000,Null,Null,145763626,111461,49728
145777028,20.0,20.0,70000,38000,32000,46,70000,Null,Null,145777028,111461,2
145845342,0.0,0.0,2000,2000,0,0,2000,Null,Null,145845342,111461,2
145846701,0.0,0.0,1200,1200,0,0,1200,Null,Null,145846701,111461,2
145847082,1.0,1.0,2000,2000,0,0,2000,Null,Null,145847082,111461,2
145847756,0.0,0.0,1700,1700,0,0,1700,Null,Null,145847756,111461,2
145851165,6.0,6.0,11000,8000,3000,27,11000,Null,Null,145851165,111461,8198
145971993,1.0,1.0,110000,98000,12000,11,110000,Null,Null,145971993,5264641,15320
145972424,0.0,0.0,3012000,2794000,218000,7,3012000,Null,Null,145972424,25643,1795
145977610,29.0,29.0,73000,73000,0,0,73000,Null,Null,145977610,80019,1838
146077597,0.0,0.0,2300,2300,0,0,2300,Null,Null,146077597,111461,2
146079330,0.0,0.0,2200,2200,0,0,2200,Null,Null,146079330,111461,2
146134706,197.0,197.0,2000,2000,0,0,2000,Null,Null,146134706,111461,2225
146139553,0.0,0.0,1000,1000,0,0,1000,Null,Null,146139553,111461,2
146217718,19.0,19.0,149000,149000,0,0,149000,Null,Null,146217718,111461,11858
146231866,101.0,101.0,183000,123000,60000,33,183000,Null,Null,146231866,111461,2238
146233628,8.0,8.0,94999,94999,0,0,94999,Null,Null,146233628,111461,2805
146262084,2677.0,2677.0,560000,339000,221000,39,560000,Null,Null,146262084,3797113,23362
146266186,1885.0,1885.0,30000,30000,0,0,30000,Null,Null,146266186,111461,1831
146266882,18.0,18.0,480000,240000,240000,50,480000,Null,Null,146266882,111461,8512
146266933,15.0,15.0,298000,149000,149000,50,298000,Null,Null,146266933,111461,5385
146285757,0.0,0.0,198000,198000,0,0,198000,Null,Null,146285757,5147565,23246
146288543,33.0,33.0,850000,699000,151000,18,850000,Null,Null,146288543,632677,2340
146289206,0.0,0.0,13770000,13770000,0,0,13770000,Null,Null,146289206,180151,28860
146289211,111.0,111.0,285000,270000,15000,5,285000,Null,Null,146289211,111461,1978
146291844,0.0,0.0,280000,280000,0,0,280000,Null,Null,146291844,111461,15320
146291859,0.0,0.0,23900000,23900000,0,0,23900000,Null,Null,146291859,180151,8064
146364791,61.0,61.0,830000,709000,121000,15,830000,Null,Null,146364791,19673,1796
146365404,58.0,58.0,870000,809000,61000,7,870000,Null,Null,146365404,19673,1796
146366425,303.0,303.0,1350,1350,0,0,1350,Null,Null,146366425,111461,23156
146366501,142.0,142.0,129000,129000,0,0,129000,Null,Null,146366501,561415,23082
146370563,4.0,4.0,249000,185000,64000,26,249000,Null,Null,146370563,111461,8512
146381678,4.0,4.0,3300,3300,0,0,3300,Null,Null,146381678,111461,2
146384829,9.0,9.0,1509000,1459000,50000,3,1509000,Null,Null,146384829,111461,4381
146432055,996.0,996.0,42000,42000,0,0,42000,Null,Null,146432055,111461,53186
146448766,5.0,5.0,219000,219000,0,0,219000,Null,Null,146448766,111461,2
146493292,0.0,0.0,14000,12000,2000,14,14000,Null,Null,146493292,111461,2
146493419,0.0,0.0,7000,6000,1000,14,7000,Null,Null,146493419,111461,2
146495143,520.0,520.0,129000,129000,0,0,129000,Null,Null,146495143,5272071,23622
146498880,6.0,6.0,6000,6000,0,0,6000,Null,Null,146498880,111461,2
146509745,1120.0,1120.0,329000,329000,0,0,329000,Null,Null,146509745,5272071,2225
146518024,0.0,0.0,13500000,13500000,0,0,13500000,Null,Null,146518024,254733,11516
146562737,119.0,119.0,800000,800000,0,0,800000,Null,Null,146562737,204301,23352
146564243,179.0,179.0,800000,800000,0,0,800000,Null,Null,146564243,204301,23346
146585907,0.0,0.0,2000,2000,0,0,2000,Null,Null,146585907,111461,2
146614227,0.0,0.0,5000,5000,0,0,5000,Null,Null,146614227,111461,2
146620669,80.0,80.0,5500,4000,1500,27,5500,Null,Null,146620669,111461,2
146620759,81.0,81.0,958000,958000,0,0,958000,Null,Null,146620759,111461,2
146620932,27.0,27.0,3000,2970,30,1,3000,Null,Null,146620932,111461,2
146621636,3.0,3.0,5500,3000,2500,45,5500,Null,Null,146621636,111461,2
146628789,181.0,181.0,129000,129000,0,0,129000,Null,Null,146628789,111461,1936
146638176,0.0,0.0,61379000,61379000,0,0,61379000,Null,Null,146638176,273205,23588
146639981,0.0,0.0,39074000,39074000,0,0,39074000,Null,Null,146639981,273205,1883
146649359,167.0,167.0,159000,159000,0,0,159000,Null,Null,146649359,5076287,2514
146728842,4.0,4.0,3628000,2753000,875000,24,3628000,Null,Null,146728842,26150,8513
146735043,3.0,3.0,1234000,740400,493600,40,1234000,Null,Null,146735043,26150,8513
146825117,8.0,8.0,175000,175000,0,0,175000,Null,Null,146825117,111461,2
146845655,0.0,0.0,2320000,2320000,0,0,2320000,Null,Null,146845655,111461,2
146845686,45.0,45.0,350000,350000,0,0,350000,Null,Null,146845686,111461,28428
146845870,213.0,213.0,198000,198000,0,0,198000,Null,Null,146845870,5272071,2016
146847195,16.0,16.0,149000,99000,50000,34,149000,Null,Null,146847195,20271,1831
146887596,47.0,47.0,99000,99000,0,0,99000,Null,Null,146887596,111461,28428
146887829,1255.0,1255.0,148000,148000,0,0,148000,Null,Null,146887829,5272071,2016
146922777,0.0,0.0,1500,1500,0,0,1500,Null,Null,146922777,111461,2
146924621,65.0,65.0,1500,1500,0,0,1500,Null,Null,146924621,111461,23544
146926660,6.0,6.0,108000,89000,19000,18,108000,Null,Null,146926660,111461,15318
146932006,0.0,0.0,36500000,36500000,0,0,36500000,Null,Null,146932006,50331,8067
146935645,293.0,293.0,219600,145000,74600,34,219600,Null,Null,146935645,111461,8305
146935801,0.0,0.0,119000,119000,0,0,119000,Null,Null,146935801,21274,1612
146943489,69.0,69.0,153900,151000,2900,2,153900,Null,Null,146943489,111461,2
146956887,1.0,1.0,9000,8910,90,1,9000,Null,Null,146956887,111461,28484
146959126,0.0,0.0,9000,8910,90,1,9000,Null,Null,146959126,111461,28484
146959189,3.0,3.0,7200,7128,72,1,7200,Null,Null,146959189,111461,28484
146964923,20.0,20.0,1800,1800,0,0,1800,Null,Null,146964923,111461,2
146979906,0.0,0.0,38690000,36750000,1940000,5,38690000,Null,Null,146979906,328295,23376
146989529,0.0,0.0,45199000,42930000,2269000,5,45199000,Null,Null,146989529,328295,23376
146994949,0.0,0.0,38778000,36830000,1948000,5,38778000,Null,Null,146994949,328295,23376
147003460,0.0,0.0,14900000,14900000,0,0,14900000,Null,Null,147003460,20215,11516
147003888,0.0,0.0,42516000,40390000,2126000,5,42516000,Null,Null,147003888,328295,23376
147006085,0.0,0.0,11800000,11800000,0,0,11800000,Null,Null,147006085,20215,11516
147011023,0.0,0.0,6000,6000,0,0,6000,Null,Null,147011023,111461,2
147011489,2.0,2.0,6000,6000,0,0,6000,Null,Null,147011489,111461,2
147011935,4.0,4.0,5000,5000,0,0,5000,Null,Null,147011935,111461,2
147023979,0.0,0.0,48366000,45940000,2426000,5,48366000,Null,Null,147023979,328295,23376
147029352,0.0,0.0,64034000,60830000,3204000,5,64034000,Null,Null,147029352,328295,23376
147043572,1761.0,1761.0,76000,57000,19000,25,76000,Null,Null,147043572,5305191,17186
147043633,0.0,0.0,51220000,48650000,2570000,5,51220000,Null,Null,147043633,328295,23376
147043724,0.0,0.0,58626000,55690000,2936000,5,58626000,Null,Null,147043724,328295,23376
147050117,1.0,1.0,1169000,1169000,0,0,1169000,Null,Null,147050117,46363,5385
147058165,18.0,18.0,2890000,2190000,700000,24,2890000,Null,Null,147058165,19673,1795
147099372,18.0,18.0,140900,140900,0,0,140900,Null,Null,147099372,111461,2
147108917,0.0,0.0,17900000,17900000,0,0,17900000,Null,Null,147108917,20215,8064
147109066,0.0,0.0,5985000,5985000,0,0,5985000,Null,Null,147109066,25502,8511
147111815,1.0,1.0,7773000,3943000,3830000,49,7773000,Null,Null,147111815,26150,8512
147113237,0.0,0.0,5985000,5985000,0,0,5985000,Null,Null,147113237,25502,8511
147122757,0.0,0.0,16900000,16900000,0,0,16900000,Null,Null,147122757,20215,11518
147125671,0.0,0.0,6685000,6685000,0,0,6685000,Null,Null,147125671,25502,8511
147125769,224.0,224.0,55000,47530,7470,14,55000,Null,Null,147125769,111461,1831
147128458,253.0,253.0,700000,700000,0,0,700000,Null,Null,147128458,33203,8170
147128819,0.0,0.0,13900000,13900000,0,0,13900000,Null,Null,147128819,20215,8064
147207652,0.0,0.0,47900000,47900000,0,0,47900000,Null,Null,147207652,20215,28870
147216184,408.0,408.0,126000,85000,41000,33,126000,Null,Null,147216184,111461,2238
147218862,0.0,0.0,12500000,12500000,0,0,12500000,Null,Null,147218862,4508621,7079
147219086,65.0,65.0,629000,419000,210000,33,629000,Null,Null,147219086,46363,5384
147265074,30.0,30.0,24000,24000,0,0,24000,Null,Null,147265074,177955,2153
147352932,17.0,17.0,799000,689000,110000,14,799000,Null,Null,147352932,46363,5385
147380498,7.0,7.0,325000,219000,106000,33,325000,Null,Null,147380498,111461,15318
147389222,3.0,3.0,5750000,5750000,0,0,5750000,Null,Null,147389222,464767,17174
147400127,443.0,443.0,99999,84999,15000,15,99999,Null,Null,147400127,4855937,20182
147413892,5.0,5.0,2299,2299,0,0,2299,Null,Null,147413892,111461,2
147423267,0.0,0.0,6000,6000,0,0,6000,Null,Null,147423267,111461,2
147423286,132.0,132.0,1500,1500,0,0,1500,Null,Null,147423286,111461,2
147423308,16.0,16.0,2000,2000,0,0,2000,Null,Null,147423308,111461,1883
147423332,10.0,10.0,1000,1000,0,0,1000,Null,Null,147423332,111461,1883
147423349,2.0,2.0,2000,2000,0,0,2000,Null,Null,147423349,111461,2
147423370,16.0,16.0,2000,2000,0,0,2000,Null,Null,147423370,111461,2
147423472,85.0,85.0,1500,1500,0,0,1500,Null,Null,147423472,111461,2
147423544,0.0,0.0,1500,1500,0,0,1500,Null,Null,147423544,111461,2
147423569,7.0,7.0,2000,2000,0,0,2000,Null,Null,147423569,111461,2
147423601,0.0,0.0,5500,5500,0,0,5500,Null,Null,147423601,111461,2
147423680,47.0,47.0,1200,1200,0,0,1200,Null,Null,147423680,111461,2
147423684,2.0,2.0,3000,3000,0,0,3000,Null,Null,147423684,111461,2
147423695,39.0,39.0,2000,2000,0,0,2000,Null,Null,147423695,111461,2
147423729,10.0,10.0,2000,2000,0,0,2000,Null,Null,147423729,111461,2
147423739,0.0,0.0,2000,2000,0,0,2000,Null,Null,147423739,111461,2
147423757,1.0,1.0,2500,2500,0,0,2500,Null,Null,147423757,111461,2
147423774,1.0,1.0,1500,1500,0,0,1500,Null,Null,147423774,111461,2
147423798,135.0,135.0,1500,1500,0,0,1500,Null,Null,147423798,111461,2
147423834,45.0,45.0,1000,1000,0,0,1000,Null,Null,147423834,111461,2
147423907,9.0,9.0,5500,5500,0,0,5500,Null,Null,147423907,111461,2
147423931,178.0,178.0,2500,2500,0,0,2500,Null,Null,147423931,111461,2
147423939,21.0,21.0,3000,3000,0,0,3000,Null,Null,147423939,111461,2
147429611,3.0,3.0,1000,1000,0,0,1000,Null,Null,147429611,4408565,53048
147437599,22.0,22.0,1100,1100,0,0,1100,Null,Null,147437599,111461,2
147437640,70.0,70.0,1400,1400,0,0,1400,Null,Null,147437640,111461,2
147497050,0.0,0.0,41100000,41100000,0,0,41100000,Null,Null,147497050,4508621,7079
147500843,112.0,112.0,26000,26000,0,0,26000,Null,Null,147500843,111461,2
147564358,3.0,3.0,2425,2425,0,0,2425,Null,Null,147564358,111461,2685
147570785,0.0,0.0,5785000,5785000,0,0,5785000,Null,Null,147570785,25502,8511
147629468,0.0,0.0,8900,8900,0,0,8900,Null,Null,147629468,111461,1520
147634114,0.0,0.0,7000,7000,0,0,7000,Null,Null,147634114,111461,1520
147634213,1.0,1.0,9900,9900,0,0,9900,Null,Null,147634213,111461,1520
147634442,0.0,0.0,9000,9000,0,0,9000,Null,Null,147634442,111461,1520
147636521,0.0,0.0,5900,5900,0,0,5900,Null,Null,147636521,111461,1520
147638178,0.0,0.0,8000,8000,0,0,8000,Null,Null,147638178,111461,1520
147640264,0.0,0.0,5000,5000,0,0,5000,Null,Null,147640264,111461,2
147641640,0.0,0.0,8900,8900,0,0,8900,Null,Null,147641640,111461,1520
147642195,0.0,0.0,4900,4900,0,0,4900,Null,Null,147642195,111461,1520
147643558,4.0,4.0,2900,2900,0,0,2900,Null,Null,147643558,111461,1520
147652779,0.0,0.0,3000,3000,0,0,3000,Null,Null,147652779,111461,2
147694768,42.0,42.0,19999,19999,0,0,19999,Null,Null,147694768,111461,2
147696112,0.0,0.0,90000,55000,35000,39,90000,Null,Null,147696112,111461,2
147710040,0.0,0.0,6085000,6085000,0,0,6085000,Null,Null,147710040,25502,8511
147715107,0.0,0.0,7985000,7985000,0,0,7985000,Null,Null,147715107,25502,8511
147720255,41.0,41.0,5000,5000,0,0,5000,Null,Null,147720255,111461,7064
147725250,0.0,0.0,5000,5000,0,0,5000,Null,Null,147725250,111461,2
147725545,11.0,11.0,5000,5000,0,0,5000,Null,Null,147725545,111461,2
147729250,44.0,44.0,140000,140000,0,0,140000,Null,Null,147729250,111461,49722
147731249,90.0,90.0,1554000,1554000,0,0,1554000,Null,Null,147731249,682635,11859
147762006,0.0,0.0,6300000,6300000,0,0,6300000,Null,Null,147762006,111461,15318
147782055,23.0,23.0,1000,1000,0,0,1000,Null,Null,147782055,111461,2
147782311,11.0,11.0,2300,2300,0,0,2300,Null,Null,147782311,111461,2
147782508,0.0,0.0,9320000,8575000,745000,8,9320000,Null,Null,147782508,174699,7449
147782511,0.0,0.0,9050000,9050000,0,0,9050000,Null,Null,147782511,174699,7449
147782513,0.0,0.0,8690000,7995000,695000,8,8690000,Null,Null,147782513,174699,7449
147782515,1.0,1.0,8690000,7821000,869000,10,8690000,Null,Null,147782515,174699,7449
147782519,0.0,0.0,11760000,10584000,1176000,10,11760000,Null,Null,147782519,174699,7449
147782522,0.0,0.0,23160000,21308000,1852000,8,23160000,Null,Null,147782522,174699,8511
147782526,0.0,0.0,10400000,9568000,832000,8,10400000,Null,Null,147782526,174699,7449
147782527,1.0,1.0,9160000,8428000,732000,8,9160000,Null,Null,147782527,174699,7449
147782533,6.0,6.0,7800000,7176000,624000,8,7800000,Null,Null,147782533,174699,8511
147782538,0.0,0.0,9160000,8428000,732000,8,9160000,Null,Null,147782538,174699,7449
147782542,0.0,0.0,10800000,9720000,1080000,10,10800000,Null,Null,147782542,174699,5384
147782549,0.0,0.0,8050000,7406000,644000,8,8050000,Null,Null,147782549,174699,7449
147782552,8.0,8.0,3350000,3082000,268000,8,3350000,Null,Null,147782552,174699,5384
147782558,0.0,0.0,11800000,10856000,944000,8,11800000,Null,Null,147782558,174699,7449
147782560,0.0,0.0,10680000,9826000,854000,8,10680000,Null,Null,147782560,174699,8511
147782566,0.0,0.0,8050000,7406000,644000,8,8050000,Null,Null,147782566,174699,8511
147784215,1.0,1.0,21999000,12999000,9000000,41,21999000,Null,Null,147784215,204665,2340
147787524,75.0,75.0,599000,350000,249000,42,599000,Null,Null,147787524,5147565,28480
147796425,0.0,0.0,4250000,4199000,51000,1,4250000,Null,Null,147796425,875757,11885
147798912,0.0,0.0,16000,16000,0,0,16000,Null,Null,147798912,111461,53074
147800518,895.0,895.0,199000,199000,0,0,199000,Null,Null,147800518,5147565,2659
147806456,6.0,6.0,2190000,1861500,328500,15,2190000,Null,Null,147806456,19072,1838
147822879,0.0,0.0,2000,2000,0,0,2000,Null,Null,147822879,111461,2
147824060,0.0,0.0,1200,1200,0,0,1200,Null,Null,147824060,111461,2
147837138,0.0,0.0,4050000,3402000,648000,16,4050000,Null,Null,147837138,412709,11847
147854056,0.0,0.0,5500,5500,0,0,5500,Null,Null,147854056,111461,8189
147854061,0.0,0.0,5000,5000,0,0,5000,Null,Null,147854061,111461,8167
147854359,2.0,2.0,6000,6000,0,0,6000,Null,Null,147854359,111461,8167
147854428,0.0,0.0,8989,8989,0,0,8989,Null,Null,147854428,111461,8193
147855034,7.0,7.0,199000,199000,0,0,199000,Null,Null,147855034,111461,15250
147867839,90.0,90.0,60000,45000,15000,25,60000,Null,Null,147867839,5219281,2514
147880111,72.0,72.0,34500,34500,0,0,34500,Null,Null,147880111,111461,2
147888476,0.0,0.0,7985000,7985000,0,0,7985000,Null,Null,147888476,25502,8511
147891198,134.0,134.0,3000,3000,0,0,3000,Null,Null,147891198,111461,2
147891242,0.0,0.0,4300,4300,0,0,4300,Null,Null,147891242,111461,2
147891244,55.0,55.0,1500,1500,0,0,1500,Null,Null,147891244,111461,2
147891245,262.0,262.0,1500,1500,0,0,1500,Null,Null,147891245,111461,2
147891264,62.0,62.0,6000,6000,0,0,6000,Null,Null,147891264,111461,2
147891313,275.0,275.0,1500,1500,0,0,1500,Null,Null,147891313,111461,2
147891316,264.0,264.0,1500,1500,0,0,1500,Null,Null,147891316,111461,2
147891328,225.0,225.0,1000,1000,0,0,1000,Null,Null,147891328,111461,2
147891334,167.0,167.0,1500,1500,0,0,1500,Null,Null,147891334,111461,2
147891399,40.0,40.0,1500,1500,0,0,1500,Null,Null,147891399,111461,2
147891406,336.0,336.0,2200,2200,0,0,2200,Null,Null,147891406,111461,2
147891457,450.0,450.0,3555,3555,0,0,3555,Null,Null,147891457,111461,2
147891469,271.0,271.0,5950,5950,0,0,5950,Null,Null,147891469,111461,2
147891471,187.0,187.0,2000,2000,0,0,2000,Null,Null,147891471,111461,2
147891483,25.0,25.0,5900,5900,0,0,5900,Null,Null,147891483,111461,2
147891541,860.0,860.0,7500,7500,0,0,7500,Null,Null,147891541,111461,2
147891553,280.0,280.0,1100,1100,0,0,1100,Null,Null,147891553,111461,2
147891557,196.0,196.0,2500,2500,0,0,2500,Null,Null,147891557,111461,2
147891591,128.0,128.0,1500,1500,0,0,1500,Null,Null,147891591,111461,2
147891636,163.0,163.0,1000,1000,0,0,1000,Null,Null,147891636,111461,2
147891643,24.0,24.0,1500,1500,0,0,1500,Null,Null,147891643,111461,2
147891644,82.0,82.0,2500,2500,0,0,2500,Null,Null,147891644,111461,2
147891651,101.0,101.0,1500,1500,0,0,1500,Null,Null,147891651,111461,2
147891652,124.0,124.0,1500,1500,0,0,1500,Null,Null,147891652,111461,2
147891653,0.0,0.0,7500,7500,0,0,7500,Null,Null,147891653,111461,2
147891669,67.0,67.0,4300,4300,0,0,4300,Null,Null,147891669,111461,2
147891730,44.0,44.0,6900,6900,0,0,6900,Null,Null,147891730,111461,2
147891749,50.0,50.0,2000,2000,0,0,2000,Null,Null,147891749,111461,2
147891751,21.0,21.0,5900,5900,0,0,5900,Null,Null,147891751,111461,2
147891752,33.0,33.0,3000,3000,0,0,3000,Null,Null,147891752,111461,2
147891758,21.0,21.0,2000,2000,0,0,2000,Null,Null,147891758,111461,1520
147891761,47.0,47.0,1500,1500,0,0,1500,Null,Null,147891761,111461,2
147891797,32.0,32.0,1500,1500,0,0,1500,Null,Null,147891797,111461,1883
147891801,18.0,18.0,1500,1500,0,0,1500,Null,Null,147891801,111461,2
147891829,16.0,16.0,3000,3000,0,0,3000,Null,Null,147891829,111461,1883
147891869,601.0,601.0,2300,2300,0,0,2300,Null,Null,147891869,111461,2
147891964,111.0,111.0,1500,1500,0,0,1500,Null,Null,147891964,111461,1883
147891965,101.0,101.0,1500,1500,0,0,1500,Null,Null,147891965,111461,1520
147891983,486.0,486.0,1500,1500,0,0,1500,Null,Null,147891983,111461,1520
147892009,222.0,222.0,1500,1500,0,0,1500,Null,Null,147892009,111461,2
147892021,0.0,0.0,35000,34000,1000,3,35000,Null,Null,147892021,111461,2
147892130,36.0,36.0,1000,1000,0,0,1000,Null,Null,147892130,111461,1520
147892372,94.0,94.0,1700,1700,0,0,1700,Null,Null,147892372,111461,2
147912774,82.0,82.0,19950,19950,0,0,19950,Null,Null,147912774,111461,2
147946423,4.0,4.0,8900,8900,0,0,8900,Null,Null,147946423,111461,2
147946842,3.0,3.0,2500,2500,0,0,2500,Null,Null,147946842,111461,2
147947006,3.0,3.0,8500,8500,0,0,8500,Null,Null,147947006,111461,2
147947236,0.0,0.0,6000,6000,0,0,6000,Null,Null,147947236,111461,2
147947259,0.0,0.0,5700,5700,0,0,5700,Null,Null,147947259,111461,2
147947266,0.0,0.0,9900,9900,0,0,9900,Null,Null,147947266,111461,2
147947418,0.0,0.0,8500,8500,0,0,8500,Null,Null,147947418,111461,2
147947640,4.0,4.0,1800,1800,0,0,1800,Null,Null,147947640,111461,2
147947692,28.0,28.0,1000,1000,0,0,1000,Null,Null,147947692,111461,2
147947937,5.0,5.0,1500,1500,0,0,1500,Null,Null,147947937,111461,2
147948068,2.0,2.0,4000,4000,0,0,4000,Null,Null,147948068,111461,2
147948081,17.0,17.0,9900,9900,0,0,9900,Null,Null,147948081,111461,2
147948558,0.0,0.0,9000,9000,0,0,9000,Null,Null,147948558,111461,2
147948947,5.0,5.0,5000,5000,0,0,5000,Null,Null,147948947,111461,2
147949227,0.0,0.0,6300,6300,0,0,6300,Null,Null,147949227,111461,2
147963352,0.0,0.0,5785000,5785000,0,0,5785000,Null,Null,147963352,25502,8511
147965023,0.0,0.0,1500,1500,0,0,1500,Null,Null,147965023,5227303,2363
147966115,18.0,18.0,1500,1500,0,0,1500,Null,Null,147966115,5225483,2363
147966172,8.0,8.0,1500,1500,0,0,1500,Null,Null,147966172,5225483,2363
147967821,0.0,0.0,1299,1299,0,0,1299,Null,Null,147967821,111461,2
147969070,7.0,7.0,2390000,2390000,0,0,2390000,Null,Null,147969070,111684,1795
147976287,1091.0,1091.0,55000,55000,0,0,55000,Null,Null,147976287,3748887,3877
147980452,80.0,80.0,275000,269000,6000,2,275000,Null,Null,147980452,111461,8165
147980704,0.0,0.0,25000,25000,0,0,25000,Null,Null,147980704,111461,23022
147981048,0.0,0.0,6185000,6185000,0,0,6185000,Null,Null,147981048,25502,8511
147981051,122.0,122.0,195000,195000,0,0,195000,Null,Null,147981051,111461,11941
147993536,1.0,1.0,20000,20000,0,0,20000,Null,Null,147993536,111461,15318
147995401,0.0,0.0,6785000,6785000,0,0,6785000,Null,Null,147995401,25502,5385
147996137,0.0,0.0,1800,1800,0,0,1800,Null,Null,147996137,111461,2
147999955,9.0,9.0,2200,2200,0,0,2200,Null,Null,147999955,111461,2225
148006703,4.0,4.0,5000,5000,0,0,5000,Null,Null,148006703,111461,2
148006890,6.0,6.0,3900,3900,0,0,3900,Null,Null,148006890,111461,2
148007139,10.0,10.0,6000,6000,0,0,6000,Null,Null,148007139,111461,2
148007454,0.0,0.0,8500,8500,0,0,8500,Null,Null,148007454,111461,2
148008292,2.0,2.0,593900,593900,0,0,593900,Null,Null,148008292,111461,2324
148010842,27.0,27.0,1650000,1650000,0,0,1650000,Null,Null,148010842,185209,26652
148016407,4.0,4.0,22750,22750,0,0,22750,Null,Null,148016407,111461,2
148016592,0.0,0.0,18000,18000,0,0,18000,Null,Null,148016592,111461,2
148017369,0.0,0.0,8250,8250,0,0,8250,Null,Null,148017369,111461,2
148017414,0.0,0.0,2500,2500,0,0,2500,Null,Null,148017414,111461,2
148019016,0.0,0.0,12000,12000,0,0,12000,Null,Null,148019016,111461,2
148019512,1.0,1.0,22750,22750,0,0,22750,Null,Null,148019512,111461,2
148021061,4.0,4.0,19000,19000,0,0,19000,Null,Null,148021061,111461,2
148040948,246.0,246.0,68000,63240,4760,7,68000,Null,Null,148040948,111461,9052
148076760,26.0,26.0,3300,3300,0,0,3300,Null,Null,148076760,111461,2
148267032,0.0,0.0,41900000,36900000,5000000,12,41900000,Null,Null,148267032,152553,23576
148541605,1.0,1.0,28000,28000,0,0,28000,Null,Null,148541605,111461,15250
148546819,248.0,248.0,86000,85000,1000,1,86000,Null,Null,148546819,216511,1631
148550775,0.0,0.0,17070000,17070000,0,0,17070000,Null,Null,148550775,217953,8073
148552450,41.0,41.0,76000,76000,0,0,76000,Null,Null,148552450,111461,1831
148587103,0.0,0.0,1000,1000,0,0,1000,Null,Null,148587103,111461,2
148637384,8.0,8.0,1400,1400,0,0,1400,Null,Null,148637384,111461,2
148638642,83.0,83.0,1600,1600,0,0,1600,Null,Null,148638642,111461,2
148672458,42.0,42.0,2000,2000,0,0,2000,Null,Null,148672458,111461,2
148699082,107.0,107.0,6000,6000,0,0,6000,Null,Null,148699082,111461,2
148701811,0.0,0.0,2599000,2599000,0,0,2599000,Null,Null,148701811,183625,28856
148711655,131.0,131.0,140000,140000,0,0,140000,Null,Null,148711655,111461,28574
148714452,348.0,348.0,40000,40000,0,0,40000,Null,Null,148714452,111461,8073
148714567,1390.0,1390.0,199000,199000,0,0,199000,Null,Null,148714567,49331,8170
148716679,0.0,0.0,3576000,3576000,0,0,3576000,Null,Null,148716679,111461,2
148749586,4.0,4.0,76000,76000,0,0,76000,Null,Null,148749586,111461,15236
148756133,5.0,5.0,20000,20000,0,0,20000,Null,Null,148756133,111461,15250
148804492,3.0,3.0,28000,28000,0,0,28000,Null,Null,148804492,111461,15236
148806003,0.0,0.0,9999,9999,0,0,9999,Null,Null,148806003,111461,49726
148806742,10.0,10.0,379000,379000,0,0,379000,Null,Null,148806742,111461,7449
148812247,359.0,359.0,191000,191000,0,0,191000,Null,Null,148812247,872003,17162
148813478,8.0,8.0,124900,124900,0,0,124900,Null,Null,148813478,20271,5263
148813604,9.0,9.0,305000,305000,0,0,305000,Null,Null,148813604,18984,1838
148814464,89.0,89.0,43000,36550,6450,15,43000,Null,Null,148814464,5132069,2225
148824107,70.0,70.0,182000,182000,0,0,182000,Null,Null,148824107,872003,10228
148824326,9.0,9.0,1243000,932250,310750,25,1243000,Null,Null,148824326,26150,8513
148824604,129.0,129.0,39000,31000,8000,21,39000,Null,Null,148824604,111461,20182
148824669,234.0,234.0,85000,85000,0,0,85000,Null,Null,148824669,111461,3710
148845180,96.0,96.0,346900,338000,8900,3,346900,Null,Null,148845180,111461,51698
148856120,18.0,18.0,8000,7920,80,1,8000,Null,Null,148856120,111461,8197
148856435,1.0,1.0,19000,19000,0,0,19000,Null,Null,148856435,111461,23258
148870333,0.0,0.0,8985000,8985000,0,0,8985000,Null,Null,148870333,25502,8511
148871966,83.0,83.0,1000,1000,0,0,1000,Null,Null,148871966,505165,23244
148873333,177.0,177.0,99000,99000,0,0,99000,Null,Null,148873333,111461,23016
148883107,166.0,166.0,190000,190000,0,0,190000,Null,Null,148883107,111461,23634
148889143,0.0,0.0,9399,9399,0,0,9399,Null,Null,148889143,111461,1815
148891256,8.0,8.0,8300000,4150000,4150000,50,8300000,Null,Null,148891256,25533,11935
148895986,0.0,0.0,1900,1900,0,0,1900,Null,Null,148895986,111461,2
148908372,0.0,0.0,8885000,8885000,0,0,8885000,Null,Null,148908372,25502,8511
148908708,0.0,0.0,9071429,6350000,2721429,30,9071429,Null,Null,148908708,405211,5384
148908716,0.0,0.0,8885000,8885000,0,0,8885000,Null,Null,148908716,25502,8511
148909765,0.0,0.0,9685000,9685000,0,0,9685000,Null,Null,148909765,25502,8511
148924714,0.0,0.0,2000,2000,0,0,2000,Null,Null,148924714,111461,18876
148924740,0.0,0.0,2000,2000,0,0,2000,Null,Null,148924740,111461,18876
148939715,3.0,3.0,378000,189000,189000,50,378000,Null,Null,148939715,111461,49724
148940462,1.0,1.0,358000,179000,179000,50,358000,Null,Null,148940462,111461,49724
148940466,434.0,434.0,1250000,1129000,121000,10,1250000,Null,Null,148940466,26689,53350
148952120,0.0,0.0,115000,115000,0,0,115000,Null,Null,148952120,111461,49724
148955371,2.0,2.0,450000,235000,215000,48,450000,Null,Null,148955371,111461,49724
148960140,70.0,70.0,16800,8400,8400,50,16800,Null,Null,148960140,111461,15318
148987692,0.0,0.0,1500,1500,0,0,1500,Null,Null,148987692,111461,27214
149044997,0.0,0.0,98999,98999,0,0,98999,Null,Null,149044997,111461,2
149045005,36.0,36.0,2250,2250,0,0,2250,Null,Null,149045005,111461,2
149095984,95.0,95.0,49000,49000,0,0,49000,Null,Null,149095984,111461,53054
149146137,27.0,27.0,420000,420000,0,0,420000,Null,Null,149146137,41048,2136
149146481,193.0,193.0,170000,115000,55000,32,170000,Null,Null,149146481,4509271,23336
149146526,0.0,0.0,1900,1900,0,0,1900,Null,Null,149146526,111461,2
149153349,0.0,0.0,1499,1499,0,0,1499,Null,Null,149153349,111461,2363
149175428,0.0,0.0,7150000,4671000,2479000,35,7150000,Null,Null,149175428,416127,8227
149175510,7.0,7.0,8000,8000,0,0,8000,Null,Null,149175510,21867,8300
149175631,3.0,3.0,9900,9900,0,0,9900,Null,Null,149175631,21867,8300
149194155,2.0,2.0,3300,3300,0,0,3300,Null,Null,149194155,111461,2
149195720,0.0,0.0,2200,2200,0,0,2200,Null,Null,149195720,111461,2
149198400,108.0,108.0,6000,5940,60,1,6000,Null,Null,149198400,111461,1520
149211981,0.0,0.0,1500,1500,0,0,1500,Null,Null,149211981,111461,2
149212026,0.0,0.0,2500,2500,0,0,2500,Null,Null,149212026,111461,2
149212087,0.0,0.0,1500,1500,0,0,1500,Null,Null,149212087,111461,2
149212169,0.0,0.0,2500,2500,0,0,2500,Null,Null,149212169,111461,2
149242751,14.0,14.0,1000,1000,0,0,1000,Null,Null,149242751,111461,2
149246200,37.0,37.0,398999,398999,0,0,398999,Null,Null,149246200,4522605,28618
149248566,69.0,69.0,339999,225654,114345,34,339999,Null,Null,149248566,228967,28596
149261327,6.0,6.0,990000,990000,0,0,990000,Null,Null,149261327,18641,2324
149268222,305.0,305.0,8700,8700,0,0,8700,Null,Null,149268222,111461,8198
149274329,40.0,40.0,169000,169000,0,0,169000,Null,Null,149274329,111461,2
149346549,116.0,116.0,150000,132000,18000,12,150000,Null,Null,149346549,200189,11851
149349961,376.0,376.0,165000,165000,0,0,165000,Null,Null,149349961,173743,23078
149362200,906.0,906.0,251900,242000,9900,4,251900,Null,Null,149362200,18984,1838
149399136,0.0,0.0,50000000,50000000,0,0,50000000,Null,Null,149399136,111461,2
149400389,0.0,0.0,11745666,11745666,0,0,11745666,Null,Null,149400389,111461,2
149400539,0.0,0.0,70324000,70324000,0,0,70324000,Null,Null,149400539,111461,2
149425187,247.0,247.0,488000,350000,138000,28,488000,Null,Null,149425187,248191,13878
149427696,0.0,0.0,2490,2490,0,0,2490,Null,Null,149427696,111461,2
149428246,0.0,0.0,1900,1900,0,0,1900,Null,Null,149428246,111461,2
149428320,0.0,0.0,1500,1500,0,0,1500,Null,Null,149428320,111461,2
149428533,0.0,0.0,1900,1900,0,0,1900,Null,Null,149428533,111461,2
149429067,0.0,0.0,1000,1000,0,0,1000,Null,Null,149429067,111461,2
149429141,0.0,0.0,1950,1950,0,0,1950,Null,Null,149429141,111461,2
149429362,0.0,0.0,1800,1800,0,0,1800,Null,Null,149429362,111461,2
149436727,15.0,15.0,5000,5000,0,0,5000,Null,Null,149436727,111461,2
149446602,0.0,0.0,8400,8400,0,0,8400,Null,Null,149446602,111461,2
149446698,0.0,0.0,15000,15000,0,0,15000,Null,Null,149446698,111461,2
149446700,0.0,0.0,15000,15000,0,0,15000,Null,Null,149446700,111461,2
149447633,0.0,0.0,15000,15000,0,0,15000,Null,Null,149447633,111461,2
149448177,0.0,0.0,15000,15000,0,0,15000,Null,Null,149448177,111461,2
149448249,17.0,17.0,9900,9900,0,0,9900,Null,Null,149448249,111461,2
149459707,11.0,11.0,4379000,3897310,481690,11,4379000,Null,Null,149459707,205847,11873
149470732,0.0,0.0,9214286,6450000,2764286,30,9214286,Null,Null,149470732,405211,8511
149478721,0.0,0.0,47600000,47600000,0,0,47600000,Null,Null,149478721,736135,1883
149485921,0.0,0.0,7800000,7800000,0,0,7800000,Null,Null,149485921,405211,8511
149492287,0.0,0.0,9214286,6450000,2764286,30,9214286,Null,Null,149492287,405211,8511
149500286,0.0,0.0,5800000,5800000,0,0,5800000,Null,Null,149500286,860053,15250
149500287,0.0,0.0,10500000,10500000,0,0,10500000,Null,Null,149500287,860053,12218
149500843,0.0,0.0,7200000,7200000,0,0,7200000,Null,Null,149500843,860053,15318
149527169,1.0,1.0,159000,159000,0,0,159000,Null,Null,149527169,4217099,15318
149534477,4.0,4.0,148198,148198,0,0,148198,Null,Null,149534477,111461,2
149567061,17.0,17.0,2000,2000,0,0,2000,Null,Null,149567061,111461,53074
149591446,124.0,124.0,41580,41580,0,0,41580,Null,Null,149591446,111461,2
149617968,587.0,587.0,516000,359000,157000,30,516000,Null,Null,149617968,262521,23136
149623608,0.0,0.0,1000,1000,0,0,1000,Null,Null,149623608,111461,2
149631618,0.0,0.0,1000,1000,0,0,1000,Null,Null,149631618,111461,2
149650674,56.0,56.0,30800,30800,0,0,30800,Null,Null,149650674,111461,2
149650755,3.0,3.0,2200,2200,0,0,2200,Null,Null,149650755,111461,2
149651211,203.0,203.0,20000,20000,0,0,20000,Null,Null,149651211,111461,2
149653443,240.0,240.0,170000,170000,0,0,170000,Null,Null,149653443,5147565,1832
149653525,40.0,40.0,290000,290000,0,0,290000,Null,Null,149653525,21717,20244
149706998,1.0,1.0,5934000,5281260,652740,11,5934000,Null,Null,149706998,205847,11873
149708953,1.0,1.0,1500,1500,0,0,1500,Null,Null,149708953,111461,2
149711944,0.0,0.0,7000,7000,0,0,7000,Null,Null,149711944,111461,2
149712451,0.0,0.0,11450000,11450000,0,0,11450000,Null,Null,149712451,217953,28860
149746950,18.0,18.0,56200,56200,0,0,56200,Null,Null,149746950,111461,2
149753076,0.0,0.0,37320000,37320000,0,0,37320000,Null,Null,149753076,4683857,2340
149753086,0.0,0.0,5980000,5980000,0,0,5980000,Null,Null,149753086,111461,15318
149758085,0.0,0.0,53000,53000,0,0,53000,Null,Null,149758085,111461,2
149765286,0.0,0.0,5980000,5980000,0,0,5980000,Null,Null,149765286,111461,15318
149765410,1.0,1.0,1000,1000,0,0,1000,Null,Null,149765410,111461,2
149765436,0.0,0.0,1500,1500,0,0,1500,Null,Null,149765436,111461,2
149772789,0.0,0.0,6142857,6142857,0,0,6142857,Null,Null,149772789,405211,8511
149773737,28.0,28.0,34500,34000,500,1,34500,Null,Null,149773737,111461,2
149776401,36.0,36.0,1690000,802000,888000,53,1690000,Null,Null,149776401,4960305,1795
149776661,9.0,9.0,50000,50000,0,0,50000,Null,Null,149776661,111461,2
149780885,0.0,0.0,8980000,8980000,0,0,8980000,Null,Null,149780885,111461,15318
149785130,87.0,87.0,720000,720000,0,0,720000,Null,Null,149785130,111461,23282
149785286,0.0,0.0,5980000,5980000,0,0,5980000,Null,Null,149785286,111461,15318
149797747,573.0,573.0,591001,591001,0,0,591001,Null,Null,149797747,2630119,2657
149799097,1.0,1.0,349000,349000,0,0,349000,Null,Null,149799097,111461,15318
149799276,0.0,0.0,6980000,6980000,0,0,6980000,Null,Null,149799276,111461,15318
149847254,7.0,7.0,3257000,2442000,815000,25,3257000,Null,Null,149847254,26150,8516
149847256,2.0,2.0,9043000,6782250,2260750,25,9043000,Null,Null,149847256,26150,8513
149932453,25.0,25.0,200000,105000,95000,48,200000,Null,Null,149932453,111461,2971
149932538,75.0,75.0,220000,137000,83000,38,220000,Null,Null,149932538,47803,11897
149948328,16.0,16.0,7900,7900,0,0,7900,Null,Null,149948328,111461,2
149969300,123.0,123.0,278600,198000,80600,29,278600,Null,Null,149969300,5337837,11863
149970619,73.0,73.0,70000,50000,20000,29,70000,Null,Null,149970619,111461,11873
149971471,0.0,0.0,1000,1000,0,0,1000,Null,Null,149971471,111461,2
149972877,0.0,0.0,50000,50000,0,0,50000,Null,Null,149972877,111461,2
149975033,3.0,3.0,164000,159000,5000,3,164000,Null,Null,149975033,5132069,23362
149977112,0.0,0.0,6500,6500,0,0,6500,Null,Null,149977112,111461,2
150006846,3.0,3.0,1790000,1790000,0,0,1790000,Null,Null,150006846,111461,28868
150016863,928.0,928.0,80000,48000,32000,40,80000,Null,Null,150016863,861765,8305
150021935,27.0,27.0,256000,199000,57000,22,256000,Null,Null,150021935,5132069,23392
150022122,5.0,5.0,2000,2000,0,0,2000,Null,Null,150022122,111461,53054
150145251,2.0,2.0,4276000,3038000,1238000,29,4276000,Null,Null,150145251,26150,8513
150149953,48.0,48.0,499000,269000,230000,46,499000,Null,Null,150149953,625853,28454
150150734,73.0,73.0,180000,180000,0,0,180000,Null,Null,150150734,111461,49722
150171465,74.0,74.0,275000,275000,0,0,275000,Null,Null,150171465,111461,23236
150173820,5.0,5.0,149000,149000,0,0,149000,Null,Null,150173820,111461,28596
150183106,53.0,53.0,159000,159000,0,0,159000,Null,Null,150183106,5325303,28486
150205187,1.0,1.0,1490,1490,0,0,1490,Null,Null,150205187,111461,2
150205193,19.0,19.0,180000,180000,0,0,180000,Null,Null,150205193,111461,49722
150213047,54.0,54.0,180000,180000,0,0,180000,Null,Null,150213047,111461,49722
150247888,0.0,0.0,7000,7000,0,0,7000,Null,Null,150247888,111461,1520
150248043,0.0,0.0,5000,5000,0,0,5000,Null,Null,150248043,111461,2
150248257,1.0,1.0,10000,10000,0,0,10000,Null,Null,150248257,111461,2
150248552,0.0,0.0,10000,10000,0,0,10000,Null,Null,150248552,111461,2
150248611,0.0,0.0,4000,4000,0,0,4000,Null,Null,150248611,111461,2
150249175,0.0,0.0,9000,9000,0,0,9000,Null,Null,150249175,111461,2
150249180,2.0,2.0,2000,2000,0,0,2000,Null,Null,150249180,111461,2
150249196,1.0,1.0,7000,7000,0,0,7000,Null,Null,150249196,111461,2
150249674,0.0,0.0,10000,10000,0,0,10000,Null,Null,150249674,111461,2
150249721,0.0,0.0,2000,2000,0,0,2000,Null,Null,150249721,111461,2
150249930,0.0,0.0,5000,5000,0,0,5000,Null,Null,150249930,111461,2
150250343,0.0,0.0,5000,5000,0,0,5000,Null,Null,150250343,111461,2
150250623,0.0,0.0,10000,10000,0,0,10000,Null,Null,150250623,111461,1520
150250727,1.0,1.0,1200,1200,0,0,1200,Null,Null,150250727,111461,2
150250985,0.0,0.0,3000,3000,0,0,3000,Null,Null,150250985,111461,2
150251034,0.0,0.0,5000,5000,0,0,5000,Null,Null,150251034,111461,1520
150251049,0.0,0.0,6000,6000,0,0,6000,Null,Null,150251049,111461,2
150251405,1.0,1.0,6000,6000,0,0,6000,Null,Null,150251405,111461,2
150251749,0.0,0.0,3000,3000,0,0,3000,Null,Null,150251749,111461,2
150251787,0.0,0.0,5000,5000,0,0,5000,Null,Null,150251787,111461,2
150251841,1.0,1.0,9000,9000,0,0,9000,Null,Null,150251841,111461,2
150251874,5.0,5.0,9000,9000,0,0,9000,Null,Null,150251874,111461,2
150251971,0.0,0.0,4000,4000,0,0,4000,Null,Null,150251971,111461,2
150252007,4.0,4.0,4500,4500,0,0,4500,Null,Null,150252007,111461,2
150252367,1.0,1.0,10000,10000,0,0,10000,Null,Null,150252367,111461,2
150252399,0.0,0.0,2700,2700,0,0,2700,Null,Null,150252399,111461,2
150252490,1.0,1.0,4500,4500,0,0,4500,Null,Null,150252490,111461,2
150252584,0.0,0.0,2500,2500,0,0,2500,Null,Null,150252584,111461,2
150253013,0.0,0.0,20000,20000,0,0,20000,Null,Null,150253013,111461,2
150253029,0.0,0.0,3000,3000,0,0,3000,Null,Null,150253029,111461,2
150253471,0.0,0.0,7000,7000,0,0,7000,Null,Null,150253471,111461,1520
150253687,1.0,1.0,2000,2000,0,0,2000,Null,Null,150253687,111461,2
150253882,3.0,3.0,4999,4999,0,0,4999,Null,Null,150253882,111461,2
150296053,97.0,97.0,155000,109000,46000,30,155000,Null,Null,150296053,156043,11857
150385834,1.0,1.0,84000,84000,0,0,84000,Null,Null,150385834,111461,15250
150385856,15.0,15.0,21850,21850,0,0,21850,Null,Null,150385856,111461,15236
150385859,2.0,2.0,18600,18600,0,0,18600,Null,Null,150385859,111461,2
150385879,17.0,17.0,21850,21850,0,0,21850,Null,Null,150385879,111461,15236
150385884,0.0,0.0,18600,18600,0,0,18600,Null,Null,150385884,111461,2
150385887,19.0,19.0,21850,21850,0,0,21850,Null,Null,150385887,111461,15236
150385899,23.0,23.0,21850,21850,0,0,21850,Null,Null,150385899,111461,15236
150385918,7.0,7.0,13200,13200,0,0,13200,Null,Null,150385918,111461,2
150385920,3.0,3.0,21850,21850,0,0,21850,Null,Null,150385920,111461,15236
150385922,0.0,0.0,18600,18600,0,0,18600,Null,Null,150385922,111461,2
150493229,50.0,50.0,58000,58000,0,0,58000,Null,Null,150493229,111461,2
150602678,52.0,52.0,120000,120000,0,0,120000,Null,Null,150602678,111461,49722
150602897,4.0,4.0,4900000,4410000,490000,10,4900000,Null,Null,150602897,205847,11873
150605291,76.0,76.0,99000,89000,10000,10,99000,Null,Null,150605291,364503,23040
150607329,1290.0,1290.0,1285000,839000,446000,35,1285000,Null,Null,150607329,160211,3422
150612611,78.0,78.0,154000,154000,0,0,154000,Null,Null,150612611,111461,2
150647085,14.0,14.0,2200,2200,0,0,2200,Null,Null,150647085,111461,2
150647855,5.0,5.0,1999,1999,0,0,1999,Null,Null,150647855,111461,2
150648556,0.0,0.0,2500,2500,0,0,2500,Null,Null,150648556,111461,2
150663096,307.0,307.0,400000,320000,80000,20,400000,Null,Null,150663096,5130989,2
150704800,161.0,161.0,42000,21000,21000,50,42000,Null,Null,150704800,111461,15318
150724369,3.0,3.0,3700000,3700000,0,0,3700000,Null,Null,150724369,111461,1794
150731791,24.0,24.0,17000,8000,9000,53,17000,Null,Null,150731791,111461,15318
150761329,189.0,189.0,235000,235000,0,0,235000,Null,Null,150761329,111461,5995
150763505,203.0,203.0,150000,150000,0,0,150000,Null,Null,150763505,111461,20244
150805933,44.0,44.0,50000,50000,0,0,50000,Null,Null,150805933,505165,23260
150805940,0.0,0.0,14420000,14420000,0,0,14420000,Null,Null,150805940,5306553,28472
150819660,28.0,28.0,29900,29900,0,0,29900,Null,Null,150819660,632589,8212
150828311,244.0,244.0,800000,800000,0,0,800000,Null,Null,150828311,286925,23634
150840961,0.0,0.0,5000,4500,500,10,5000,Null,Null,150840961,111461,2
150851260,47.0,47.0,16000,13000,3000,19,16000,Null,Null,150851260,5132069,3710
150863698,0.0,0.0,6500000,6500000,0,0,6500000,Null,Null,150863698,111461,15250
150872863,39.0,39.0,9000,9000,0,0,9000,Null,Null,150872863,111461,28574
150879971,53.0,53.0,349000,349000,0,0,349000,Null,Null,150879971,20271,1836
150887439,37.0,37.0,40000,11000,29000,73,40000,Null,Null,150887439,111461,15250
150898622,295.0,295.0,39000,39000,0,0,39000,Null,Null,150898622,3748887,3877
150921536,128.0,128.0,79000,79000,0,0,79000,Null,Null,150921536,111461,28428
150936608,22.0,22.0,560000,560000,0,0,560000,Null,Null,150936608,150002,5267
150936651,517.0,517.0,18000,9000,9000,50,18000,Null,Null,150936651,111461,2363
150937588,20.0,20.0,259000,139000,120000,46,259000,Null,Null,150937588,111454,5006
151221824,0.0,0.0,2000,2000,0,0,2000,Null,Null,151221824,111461,1883
151420174,112.0,112.0,1090000,990000,100000,9,1090000,Null,Null,151420174,20215,2324
151427153,18.0,18.0,1000,1000,0,0,1000,Null,Null,151427153,111461,2
151428378,2.0,2.0,2500,2500,0,0,2500,Null,Null,151428378,111461,2
151458076,3.0,3.0,1796,1796,0,0,1796,Null,Null,151458076,111461,2
151463645,1.0,1.0,6490000,6490000,0,0,6490000,Null,Null,151463645,229213,1795
151497112,54.0,54.0,115000,115000,0,0,115000,Null,Null,151497112,111461,28596
151499560,0.0,0.0,2500,2500,0,0,2500,Null,Null,151499560,111461,2
151502441,116.0,116.0,60000,60000,0,0,60000,Null,Null,151502441,111461,2
151519624,0.0,0.0,4800000,4800000,0,0,4800000,Null,Null,151519624,861339,5893
151519665,1448.0,1448.0,105000,82000,23000,22,105000,Null,Null,151519665,4766405,1630
151534244,103.0,103.0,239000,239000,0,0,239000,Null,Null,151534244,20271,1838
151536102,0.0,0.0,15000,15000,0,0,15000,Null,Null,151536102,111461,2
151536104,0.0,0.0,19000,19000,0,0,19000,Null,Null,151536104,111461,2
151536145,0.0,0.0,17020,17020,0,0,17020,Null,Null,151536145,111461,2
151536547,10.0,10.0,9000,9000,0,0,9000,Null,Null,151536547,111461,2
151536657,1.0,1.0,129000,129000,0,0,129000,Null,Null,151536657,111461,2
151536785,0.0,0.0,15000,15000,0,0,15000,Null,Null,151536785,111461,2
151536998,0.0,0.0,14608,14608,0,0,14608,Null,Null,151536998,111461,2
151537096,0.0,0.0,17722,17722,0,0,17722,Null,Null,151537096,111461,2
151537142,0.0,0.0,17000,17000,0,0,17000,Null,Null,151537142,111461,2
151537349,1.0,1.0,13900,13900,0,0,13900,Null,Null,151537349,111461,2
151537428,0.0,0.0,9000,9000,0,0,9000,Null,Null,151537428,111461,2
151537571,0.0,0.0,15000,15000,0,0,15000,Null,Null,151537571,111461,2
151548636,4.0,4.0,219000,175200,43800,20,219000,Null,Null,151548636,111461,15318
151553282,28.0,28.0,87900,87900,0,0,87900,Null,Null,151553282,111461,2
151555923,0.0,0.0,2000,2000,0,0,2000,Null,Null,151555923,111461,2
151556008,0.0,0.0,8000,8000,0,0,8000,Null,Null,151556008,111461,8167
151564798,197.0,197.0,499000,329000,170000,34,499000,Null,Null,151564798,20271,1838
151575793,30.0,30.0,1390000,869000,521000,37,1390000,Null,Null,151575793,20271,1838
151576667,12.0,12.0,108000,108000,0,0,108000,Null,Null,151576667,203101,1752
151586605,40.0,40.0,5000,5000,0,0,5000,Null,Null,151586605,111461,8165
151586622,17.0,17.0,5000,5000,0,0,5000,Null,Null,151586622,111461,8165
151589858,34.0,34.0,49000,49000,0,0,49000,Null,Null,151589858,111461,2514
151615675,0.0,0.0,32998000,17999000,14999000,45,32998000,Null,Null,151615675,204665,2340
151641374,0.0,0.0,290000,145000,145000,50,290000,Null,Null,151641374,111461,2
151676600,25.0,25.0,245000,189000,56000,23,245000,Null,Null,151676600,25401,1641
151676645,85.0,85.0,115000,81000,34000,30,115000,Null,Null,151676645,25401,5900
151687747,42.0,42.0,2500,2500,0,0,2500,Null,Null,151687747,111461,2
151688252,1.0,1.0,1000,1000,0,0,1000,Null,Null,151688252,111461,2
151712789,5.0,5.0,2500,2500,0,0,2500,Null,Null,151712789,111461,27128
151713477,15.0,15.0,479000,439000,40000,8,479000,Null,Null,151713477,4884089,28682
151757682,0.0,0.0,13370000,13370000,0,0,13370000,Null,Null,151757682,217953,7079
151765384,0.0,0.0,2000,2000,0,0,2000,Null,Null,151765384,111461,2
151768842,1.0,1.0,1850000,1850000,0,0,1850000,Null,Null,151768842,111461,4380
151783424,3.0,3.0,9000,9000,0,0,9000,Null,Null,151783424,111461,8197
151819145,769.0,769.0,21000,21000,0,0,21000,Null,Null,151819145,111461,53054
151861264,143.0,143.0,95000,95000,0,0,95000,Null,Null,151861264,111461,23622
151922783,83.0,83.0,150000,150000,0,0,150000,Null,Null,151922783,111461,20244
151933238,93.0,93.0,2500,2500,0,0,2500,Null,Null,151933238,111461,2
151933450,217.0,217.0,1000,1000,0,0,1000,Null,Null,151933450,111461,2
151945395,3.0,3.0,1200,1200,0,0,1200,Null,Null,151945395,111461,23678
151951218,13.0,13.0,45000,12000,33000,73,45000,Null,Null,151951218,111461,15250
151967387,125.0,125.0,275000,275000,0,0,275000,Null,Null,151967387,25422,1634
151969209,91.0,91.0,70000,39000,31000,44,70000,Null,Null,151969209,314675,12908
151975627,91.0,91.0,349000,229000,120000,34,349000,Null,Null,151975627,314675,1836
151997207,0.0,0.0,5250000,4725000,525000,10,5250000,Null,Null,151997207,153743,11847
152010422,0.0,0.0,3800000,3800000,0,0,3800000,Null,Null,152010422,153743,11879
152010547,43.0,43.0,280000,239000,41000,15,280000,Null,Null,152010547,18802,4428
152010910,7.0,7.0,1950,1950,0,0,1950,Null,Null,152010910,111461,2
152010995,106.0,106.0,1000,1000,0,0,1000,Null,Null,152010995,111461,2
152011359,64.0,64.0,141898,128999,12899,9,141898,Null,Null,152011359,111461,28596
152015621,206.0,206.0,175000,175000,0,0,175000,Null,Null,152015621,4964815,11833
152024108,0.0,0.0,139999,139999,0,0,139999,Null,Null,152024108,111461,2
152046723,1.0,1.0,12950000,12950000,0,0,12950000,Null,Null,152046723,50368,20170
152052056,40.0,40.0,2000,2000,0,0,2000,Null,Null,152052056,111461,27232
152052465,16.0,16.0,1000,1000,0,0,1000,Null,Null,152052465,111461,27232
152097278,324.0,324.0,174000,102000,72000,41,174000,Null,Null,152097278,251871,11605
152097288,1549.0,1549.0,217500,127000,90500,42,217500,Null,Null,152097288,251871,11605
152097289,132.0,132.0,199000,119000,80000,40,199000,Null,Null,152097289,251871,11605
152097299,204.0,204.0,174000,102000,72000,41,174000,Null,Null,152097299,251871,11605
152104724,10.0,10.0,390000,350000,40000,10,390000,Null,Null,152104724,5326719,11865
152108694,0.0,0.0,10000,10000,0,0,10000,Null,Null,152108694,111461,11923
152179026,39.0,39.0,69000,69000,0,0,69000,Null,Null,152179026,111461,23042
152182395,221.0,221.0,431000,380000,51000,12,431000,Null,Null,152182395,196199,8226
152182415,288.0,288.0,234000,190000,44000,19,234000,Null,Null,152182415,196199,11747
152182419,312.0,312.0,65000,56000,9000,14,65000,Null,Null,152182419,196199,11827
152182429,290.0,290.0,65000,56000,9000,14,65000,Null,Null,152182429,196199,11827
152182435,611.0,611.0,234000,195000,39000,17,234000,Null,Null,152182435,196199,11747
152182469,422.0,422.0,315000,268000,47000,15,315000,Null,Null,152182469,196199,1637
152182481,229.0,229.0,315000,262000,53000,17,315000,Null,Null,152182481,196199,1637
152182524,473.0,473.0,158000,140000,18000,11,158000,Null,Null,152182524,196199,17162
152193332,9.0,9.0,600000,570000,30000,5,600000,Null,Null,152193332,5326719,11859
152209577,221.0,221.0,10000,10000,0,0,10000,Null,Null,152209577,111461,2514
152282444,1.0,1.0,9945000,6961000,2984000,30,9945000,Null,Null,152282444,26150,8513
152289918,14.0,14.0,100000,100000,0,0,100000,Null,Null,152289918,111461,2
152291573,31.0,31.0,12000,6000,6000,50,12000,Null,Null,152291573,111461,15318
152294366,0.0,0.0,10257143,7180000,3077143,30,10257143,Null,Null,152294366,405211,8511
152296708,0.0,0.0,9571429,6700000,2871429,30,9571429,Null,Null,152296708,405211,8511
152367267,0.0,0.0,6000000,6000000,0,0,6000000,Null,Null,152367267,497893,15318
152376569,0.0,0.0,1150,1150,0,0,1150,Null,Null,152376569,111461,2
152376883,0.0,0.0,2100,2100,0,0,2100,Null,Null,152376883,111461,2
152376892,0.0,0.0,1001,1001,0,0,1001,Null,Null,152376892,111461,2
152383399,145.0,145.0,599000,479000,120000,20,599000,Null,Null,152383399,20271,9013
152387531,7.0,7.0,47500,47500,0,0,47500,Null,Null,152387531,111461,53054
152446288,43.0,43.0,78000,39000,39000,50,78000,Null,Null,152446288,111461,18888
152446348,38.0,38.0,320000,160000,160000,50,320000,Null,Null,152446348,111461,18888
152446397,18.0,18.0,130000,65000,65000,50,130000,Null,Null,152446397,111461,18888
152446426,271.0,271.0,72000,36000,36000,50,72000,Null,Null,152446426,111461,18888
152446478,65.0,65.0,78000,39000,39000,50,78000,Null,Null,152446478,111461,18888
152446590,261.0,261.0,56000,28000,28000,50,56000,Null,Null,152446590,111461,18888
152446672,96.0,96.0,100000,50000,50000,50,100000,Null,Null,152446672,111461,18888
152446814,29.0,29.0,270000,135000,135000,50,270000,Null,Null,152446814,111461,18888
152463356,57.0,57.0,159000,159000,0,0,159000,Null,Null,152463356,4603211,17186
152463683,67.0,67.0,2000,2000,0,0,2000,Null,Null,152463683,111461,6948
152463792,5.0,5.0,1500,1500,0,0,1500,Null,Null,152463792,111461,5450
152464834,7.0,7.0,158499,158499,0,0,158499,Null,Null,152464834,21651,28458
152468616,0.0,0.0,685000,685000,0,0,685000,Null,Null,152468616,111461,8513
152475567,382.0,382.0,10000,9000,1000,10,10000,Null,Null,152475567,111461,49676
152493788,83.0,83.0,205000,190000,15000,7,205000,Null,Null,152493788,111461,28480
152493901,11.0,11.0,5000,3950,1050,21,5000,Null,Null,152493901,111461,2
152521474,264.0,264.0,59000,50150,8850,15,59000,Null,Null,152521474,5132069,23026
152521672,0.0,0.0,16000000,16000000,0,0,16000000,Null,Null,152521672,5324369,1520
152534326,234.0,234.0,84000,63000,21000,25,84000,Null,Null,152534326,155505,1520
152534368,139.0,139.0,490000,282000,208000,42,490000,Null,Null,152534368,4935523,12984
152536148,0.0,0.0,15000,15000,0,0,15000,Null,Null,152536148,111461,49722
152547158,0.0,0.0,14170000,14170000,0,0,14170000,Null,Null,152547158,217953,8073
152548213,212.0,212.0,269000,134500,134500,50,269000,Null,Null,152548213,197767,23030
152561356,491.0,491.0,17900,17900,0,0,17900,Null,Null,152561356,111461,1883
152564355,31.0,31.0,375000,375000,0,0,375000,Null,Null,152564355,26150,8513
152567389,45.0,45.0,155000,155000,0,0,155000,Null,Null,152567389,21653,28454
152637153,0.0,0.0,10500000,10500000,0,0,10500000,Null,Null,152637153,185211,1601
152705765,469.0,469.0,99000,98000,1000,1,99000,Null,Null,152705765,4958627,2019
152709523,94.0,94.0,299000,181000,118000,39,299000,Null,Null,152709523,5048343,2340
152709645,127.0,127.0,163500,157000,6500,4,163500,Null,Null,152709645,111461,28598
152709665,306.0,306.0,186000,186000,0,0,186000,Null,Null,152709665,4958627,1626
152709674,36.0,36.0,140000,140000,0,0,140000,Null,Null,152709674,111461,28598
152709786,73.0,73.0,120000,120000,0,0,120000,Null,Null,152709786,111461,28428
152748311,38.0,38.0,269000,269000,0,0,269000,Null,Null,152748311,111461,3990
152760816,22.0,22.0,29900,29900,0,0,29900,Null,Null,152760816,111461,28484
152785434,0.0,0.0,0,7150,0,0,7150,Null,Null,152785434,111461,0
152810169,618.0,618.0,65000,65000,0,0,65000,Null,Null,152810169,21651,12294
152816167,544.0,544.0,149000,149000,0,0,149000,Null,Null,152816167,4884089,23282
152816262,0.0,0.0,79000,79000,0,0,79000,Null,Null,152816262,21651,5006
152837254,31.0,31.0,92000,92000,0,0,92000,Null,Null,152837254,111461,1622
152850871,0.0,0.0,1900,1900,0,0,1900,Null,Null,152850871,111461,2
152915395,0.0,0.0,99000,99000,0,0,99000,Null,Null,152915395,5132069,53074
152919527,3.0,3.0,35000,27000,8000,23,35000,Null,Null,152919527,111461,53074
152920382,66.0,66.0,35000,23000,12000,34,35000,Null,Null,152920382,111461,23416
152920415,1780.0,1780.0,3000,1990,1010,34,3000,Null,Null,152920415,111461,23416
152923535,117.0,117.0,138600,99000,39600,29,138600,Null,Null,152923535,4408565,28674
152923655,0.0,0.0,11770000,11770000,0,0,11770000,Null,Null,152923655,248533,12876
152924362,2.0,2.0,31600,15800,15800,50,31600,Null,Null,152924362,111461,15318
152928962,0.0,0.0,13200000,13200000,0,0,13200000,Null,Null,152928962,248533,12876
152938870,0.0,0.0,23100000,23100000,0,0,23100000,Null,Null,152938870,248533,12876
152988623,0.0,0.0,26400000,26400000,0,0,26400000,Null,Null,152988623,248533,12876
152989514,0.0,0.0,2399,2399,0,0,2399,Null,Null,152989514,111461,2
152989604,6.0,6.0,2400,2400,0,0,2400,Null,Null,152989604,111461,2
152992477,0.0,0.0,2000,2000,0,0,2000,Null,Null,152992477,111461,2
153027290,169.0,169.0,179000,179000,0,0,179000,Null,Null,153027290,111461,23042
153027295,17.0,17.0,158000,158000,0,0,158000,Null,Null,153027295,111461,23042
153064772,8.0,8.0,159000,136220,22780,14,159000,Null,Null,153064772,111454,12918
153066085,57.0,57.0,20000,20000,0,0,20000,Null,Null,153066085,21437,2153
153066111,26.0,26.0,65000,65000,0,0,65000,Null,Null,153066111,21437,49728
153073728,0.0,0.0,125000000,115000000,10000000,8,125000000,Null,Null,153073728,152553,23576
153261187,0.0,0.0,22850000,22850000,0,0,22850000,Null,Null,153261187,167287,11518
153263106,79.0,79.0,65000,44100,20900,32,65000,Null,Null,153263106,5132069,27256
153287661,0.0,0.0,1800,1800,0,0,1800,Null,Null,153287661,111461,2
153288240,0.0,0.0,2000,2000,0,0,2000,Null,Null,153288240,111461,2
153288571,7.0,7.0,2000,2000,0,0,2000,Null,Null,153288571,111461,2
153290253,1.0,1.0,1800,1800,0,0,1800,Null,Null,153290253,111461,2
153290373,0.0,0.0,1800,1800,0,0,1800,Null,Null,153290373,111461,2
153290522,0.0,0.0,1800,1800,0,0,1800,Null,Null,153290522,111461,2
153291977,689.0,689.0,25000,25000,0,0,25000,Null,Null,153291977,111461,53074
153319578,3.0,3.0,3000,3000,0,0,3000,Null,Null,153319578,111461,8198
153402874,21.0,21.0,118999,118999,0,0,118999,Null,Null,153402874,111461,2225
153409645,0.0,0.0,18999,18999,0,0,18999,Null,Null,153409645,111461,15318
153466072,0.0,0.0,18698900,18698900,0,0,18698900,Null,Null,153466072,248533,12876
153467342,259.0,259.0,15000,15000,0,0,15000,Null,Null,153467342,111461,1883
153471379,6.0,6.0,39000,39000,0,0,39000,Null,Null,153471379,4217099,15936
153472791,0.0,0.0,6000000,6000000,0,0,6000000,Null,Null,153472791,111461,15936
153494768,0.0,0.0,6500000,6500000,0,0,6500000,Null,Null,153494768,111461,15236
153498992,68.0,68.0,60500,60500,0,0,60500,Null,Null,153498992,111461,2
153500159,0.0,0.0,11500000,11500000,0,0,11500000,Null,Null,153500159,111461,15250
153500169,0.0,0.0,12500000,12500000,0,0,12500000,Null,Null,153500169,111461,15250
153500182,0.0,0.0,8600000,8600000,0,0,8600000,Null,Null,153500182,111461,15250
153500191,0.0,0.0,11500000,11500000,0,0,11500000,Null,Null,153500191,111461,15250
153511391,36.0,36.0,21850,21850,0,0,21850,Null,Null,153511391,111461,15236
153516568,0.0,0.0,11745666,11745666,0,0,11745666,Null,Null,153516568,111461,2
153516872,0.0,0.0,50000000,50000000,0,0,50000000,Null,Null,153516872,111461,2
153517159,0.0,0.0,38700000,38700000,0,0,38700000,Null,Null,153517159,111461,2
153517347,0.0,0.0,59130430,59130430,0,0,59130430,Null,Null,153517347,111461,2
153517597,0.0,0.0,9548696,9548696,0,0,9548696,Null,Null,153517597,111461,2
153528093,50.0,50.0,4000,4000,0,0,4000,Null,Null,153528093,111461,8205
153528243,0.0,0.0,9600,9600,0,0,9600,Null,Null,153528243,111461,2
153528391,0.0,0.0,12000,12000,0,0,12000,Null,Null,153528391,111461,2
153528392,0.0,0.0,2400,2400,0,0,2400,Null,Null,153528392,111461,2
153528550,0.0,0.0,9750,9750,0,0,9750,Null,Null,153528550,561415,1520
153528745,0.0,0.0,8000,8000,0,0,8000,Null,Null,153528745,111461,8205
153528884,1.0,1.0,8000,8000,0,0,8000,Null,Null,153528884,111461,2
153528931,0.0,0.0,8000,8000,0,0,8000,Null,Null,153528931,111461,2
153528999,0.0,0.0,12000,12000,0,0,12000,Null,Null,153528999,111461,2
153529055,0.0,0.0,12000,12000,0,0,12000,Null,Null,153529055,111461,2
153529181,0.0,0.0,6400,6400,0,0,6400,Null,Null,153529181,111461,8167
153529218,0.0,0.0,9750,9750,0,0,9750,Null,Null,153529218,111461,8202
153529530,0.0,0.0,6000,6000,0,0,6000,Null,Null,153529530,111461,2
153529656,0.0,0.0,8000,8000,0,0,8000,Null,Null,153529656,111461,2
153530052,0.0,0.0,8000,8000,0,0,8000,Null,Null,153530052,111461,2
153530060,0.0,0.0,3250,3250,0,0,3250,Null,Null,153530060,111461,2
153530121,0.0,0.0,8000,8000,0,0,8000,Null,Null,153530121,111461,2
153530122,0.0,0.0,8000,8000,0,0,8000,Null,Null,153530122,111461,2
153530248,0.0,0.0,5100,5100,0,0,5100,Null,Null,153530248,111461,8205
153530544,0.0,0.0,5000,5000,0,0,5000,Null,Null,153530544,111461,2
153530710,0.0,0.0,9600,9600,0,0,9600,Null,Null,153530710,111461,8205
153530715,0.0,0.0,8000,8000,0,0,8000,Null,Null,153530715,111461,8202
153530812,20.0,20.0,1500,1500,0,0,1500,Null,Null,153530812,111461,1622
153530815,0.0,0.0,7500,7500,0,0,7500,Null,Null,153530815,111461,8202
153530820,3.0,3.0,9750,9750,0,0,9750,Null,Null,153530820,111461,8202
153530842,0.0,0.0,3500,3500,0,0,3500,Null,Null,153530842,111461,1622
153530859,0.0,0.0,4500,4500,0,0,4500,Null,Null,153530859,111461,8202
153531004,7.0,7.0,9000,9000,0,0,9000,Null,Null,153531004,111461,11803
153531051,0.0,0.0,4500,4500,0,0,4500,Null,Null,153531051,111461,8202
153531090,3.0,3.0,4500,4500,0,0,4500,Null,Null,153531090,111461,8202
153531115,0.0,0.0,4000,4000,0,0,4000,Null,Null,153531115,111461,11803
153546336,0.0,0.0,24850000,24850000,0,0,24850000,Null,Null,153546336,167287,2324
153547416,130.0,130.0,4500000,4235000,265000,6,4500000,Null,Null,153547416,112614,2657
153564498,50.0,50.0,169000,169000,0,0,169000,Null,Null,153564498,111461,2
153580016,2.0,2.0,1500,1500,0,0,1500,Null,Null,153580016,111461,2
153580318,0.0,0.0,1500,1500,0,0,1500,Null,Null,153580318,111461,2
153581522,0.0,0.0,3300000,2850000,450000,14,3300000,Null,Null,153581522,111461,28856
153581568,0.0,0.0,659000,519000,140000,21,659000,Null,Null,153581568,112638,1796
153597872,182.0,182.0,165000,126000,39000,24,165000,Null,Null,153597872,154733,1609
153599393,1155.0,1155.0,180000,146000,34000,19,180000,Null,Null,153599393,5334715,1609
153766365,57.0,57.0,16000,10000,6000,38,16000,Null,Null,153766365,111461,28674
153768273,58.0,58.0,135000,135000,0,0,135000,Null,Null,153768273,111461,23658
153771036,0.0,0.0,2000,2000,0,0,2000,Null,Null,153771036,111461,2
153806496,166.0,166.0,49000,35900,13100,27,49000,Null,Null,153806496,5195449,8305
153814643,44.0,44.0,64000,44800,19200,30,64000,Null,Null,153814643,111461,20244
153843550,36.0,36.0,45000,45000,0,0,45000,Null,Null,153843550,111461,2
153869040,611.0,611.0,39000,29000,10000,26,39000,Null,Null,153869040,182863,1630
153873800,0.0,0.0,33900000,33900000,0,0,33900000,Null,Null,153873800,167287,20170
153905789,27.0,27.0,9000,9000,0,0,9000,Null,Null,153905789,111461,18876
153912861,58.0,58.0,425000,399000,26000,6,425000,Null,Null,153912861,312329,5267
153920447,1.0,1.0,8000,8000,0,0,8000,Null,Null,153920447,111461,2
153945765,2558.0,2558.0,99000,94000,5000,5,99000,Null,Null,153945765,202607,1608
153945936,212.0,212.0,630000,599000,31000,5,630000,Null,Null,153945936,202607,2347
153960356,0.0,0.0,59000,59000,0,0,59000,Null,Null,153960356,111461,15318
153972866,161.0,161.0,80000,80000,0,0,80000,Null,Null,153972866,111461,28596
153985659,0.0,0.0,16500,16500,0,0,16500,Null,Null,153985659,111461,2
153989129,0.0,0.0,18000,18000,0,0,18000,Null,Null,153989129,111461,2
154062138,0.0,0.0,2500,2500,0,0,2500,Null,Null,154062138,111461,2
154073615,0.0,0.0,8750000,7875000,875000,10,8750000,Null,Null,154073615,704815,15250
154121670,0.0,0.0,499000,499000,0,0,499000,Null,Null,154121670,111461,15318
154152749,5.0,5.0,139000,139000,0,0,139000,Null,Null,154152749,4217099,15318
154155684,2.0,2.0,8560000,8560000,0,0,8560000,Null,Null,154155684,111461,2340
154155758,4.0,4.0,3500000,3500000,0,0,3500000,Null,Null,154155758,111461,2340
154155774,2.0,2.0,7200000,7200000,0,0,7200000,Null,Null,154155774,111461,2340
154155777,1.0,1.0,4800000,4800000,0,0,4800000,Null,Null,154155777,111461,2340
154155784,0.0,0.0,19000000,19000000,0,0,19000000,Null,Null,154155784,111461,2340
154157961,794.0,794.0,140000,133000,7000,5,140000,Null,Null,154157961,839837,53186
154165330,49.0,49.0,2200,1300,900,41,2200,Null,Null,154165330,111461,23134
154165852,31.0,31.0,4600,2500,2100,46,4600,Null,Null,154165852,111461,23134
154166419,534.0,534.0,4400,2400,2000,45,4400,Null,Null,154166419,111461,23134
154166820,2.0,2.0,11500,11500,0,0,11500,Null,Null,154166820,111461,6742
154171529,0.0,0.0,1500,1500,0,0,1500,Null,Null,154171529,111461,2
154171576,51.0,51.0,2500,2500,0,0,2500,Null,Null,154171576,111461,2
154179829,8.0,8.0,37000,37000,0,0,37000,Null,Null,154179829,111461,2
154179833,2.0,2.0,69000,69000,0,0,69000,Null,Null,154179833,111461,2
154180059,8.0,8.0,52000,52000,0,0,52000,Null,Null,154180059,111461,2
154180352,3.0,3.0,16490,16490,0,0,16490,Null,Null,154180352,111461,15318
154180624,1.0,1.0,72750,72750,0,0,72750,Null,Null,154180624,111461,2
154180648,3.0,3.0,57000,57000,0,0,57000,Null,Null,154180648,111461,2
154180794,12.0,12.0,41710,41710,0,0,41710,Null,Null,154180794,111461,2
154181157,4.0,4.0,63000,63000,0,0,63000,Null,Null,154181157,111461,2
154181295,6.0,6.0,49470,49470,0,0,49470,Null,Null,154181295,111461,2
154234832,1.0,1.0,260000,260000,0,0,260000,Null,Null,154234832,111461,2
154234867,3.0,3.0,133000,133000,0,0,133000,Null,Null,154234867,111461,2
154235055,10.0,10.0,297500,297500,0,0,297500,Null,Null,154235055,111461,2
154244414,0.0,0.0,2000,2000,0,0,2000,Null,Null,154244414,4282553,5995
154279853,176.0,176.0,1572001,1572001,0,0,1572001,Null,Null,154279853,2630119,2657
154283394,93.0,93.0,43000,43000,0,0,43000,Null,Null,154283394,111461,2
154284977,2.0,2.0,6000,6000,0,0,6000,Null,Null,154284977,111461,2
154286298,0.0,0.0,13000,13000,0,0,13000,Null,Null,154286298,111461,2
154314122,13.0,13.0,3257000,2442000,815000,25,3257000,Null,Null,154314122,26150,8516
154403867,0.0,0.0,1500,1500,0,0,1500,Null,Null,154403867,111461,2
154406424,54.0,54.0,51418,51418,0,0,51418,Null,Null,154406424,111461,2
154412458,4.0,4.0,2500,2500,0,0,2500,Null,Null,154412458,111461,2
154444972,0.0,0.0,12500000,12500000,0,0,12500000,Null,Null,154444972,111461,15250
154444977,0.0,0.0,12500000,12500000,0,0,12500000,Null,Null,154444977,111461,15250
154447237,37.0,37.0,7600,7600,0,0,7600,Null,Null,154447237,217627,8308
154454007,18.0,18.0,586000,586000,0,0,586000,Null,Null,154454007,26150,5384
154461120,34.0,34.0,79000,79000,0,0,79000,Null,Null,154461120,111461,23592
154461516,13.0,13.0,115000,115000,0,0,115000,Null,Null,154461516,111461,23592
154494890,37.0,37.0,2499,2499,0,0,2499,Null,Null,154494890,561415,1883
154567019,53.0,53.0,20000,5000,15000,75,20000,Null,Null,154567019,561415,23134
154727379,543.0,543.0,250000,125000,125000,50,250000,Null,Null,154727379,892751,1634
154835064,338.0,338.0,400001,400001,0,0,400001,Null,Null,154835064,2630119,2657
154835088,2977.0,2977.0,380000,205000,175000,46,380000,Null,Null,154835088,5265159,8305
154853843,0.0,0.0,20300000,20300000,0,0,20300000,Null,Null,154853843,222805,20170
154858409,1.0,1.0,110000,110000,0,0,110000,Null,Null,154858409,111461,2
154861307,405.0,405.0,50000,25000,25000,50,50000,Null,Null,154861307,5265159,8305
154879609,1103.0,1103.0,235000,235000,0,0,235000,Null,Null,154879609,5063093,2513
154879638,3.0,3.0,119000,119000,0,0,119000,Null,Null,154879638,4217099,15318
154920805,2.0,2.0,271000,209000,62000,23,271000,Null,Null,154920805,173547,15250
154969298,0.0,0.0,1000,1000,0,0,1000,Null,Null,154969298,111461,2
154972592,0.0,0.0,1000,1000,0,0,1000,Null,Null,154972592,111461,2
154987571,5.0,5.0,80000,80000,0,0,80000,Null,Null,154987571,111461,2
154988123,1.0,1.0,3499000,3499000,0,0,3499000,Null,Null,154988123,281039,53350
155000050,16.0,16.0,9000,9000,0,0,9000,Null,Null,155000050,5259865,1622
155000071,106.0,106.0,5000,5000,0,0,5000,Null,Null,155000071,5259865,8202
155000074,5.0,5.0,9000,9000,0,0,9000,Null,Null,155000074,5259865,8202
155000202,0.0,0.0,9000,9000,0,0,9000,Null,Null,155000202,5259865,8202
155000210,1.0,1.0,9000,9000,0,0,9000,Null,Null,155000210,5259865,8202
155005868,0.0,0.0,2000,2000,0,0,2000,Null,Null,155005868,111461,2
155007953,257.0,257.0,169000,123000,46000,27,169000,Null,Null,155007953,111461,28598
155014397,4.0,4.0,68000,61200,6800,10,68000,Null,Null,155014397,111461,15236
155046132,14.0,14.0,65000,65000,0,0,65000,Null,Null,155046132,111461,2
155049181,64.0,64.0,15000,15000,0,0,15000,Null,Null,155049181,5063093,2363
155055287,0.0,0.0,11250000,11250000,0,0,11250000,Null,Null,155055287,691055,8511
155055289,0.0,0.0,12850000,12850000,0,0,12850000,Null,Null,155055289,691055,8511
155055290,0.0,0.0,12850000,12850000,0,0,12850000,Null,Null,155055290,691055,8511
155055293,0.0,0.0,11250000,11250000,0,0,11250000,Null,Null,155055293,691055,8511
155055295,0.0,0.0,12850000,12850000,0,0,12850000,Null,Null,155055295,691055,8511
155055297,0.0,0.0,10895000,10895000,0,0,10895000,Null,Null,155055297,691055,8511
155055301,0.0,0.0,11250000,11250000,0,0,11250000,Null,Null,155055301,691055,8511
155055303,0.0,0.0,12595000,12595000,0,0,12595000,Null,Null,155055303,691055,8511
155061543,59.0,59.0,250000,125000,125000,50,250000,Null,Null,155061543,562001,53350
155098044,0.0,0.0,6580000,6580000,0,0,6580000,Null,Null,155098044,691055,5385
155098051,0.0,0.0,4780000,4780000,0,0,4780000,Null,Null,155098051,691055,5385
155098061,0.0,0.0,6150000,6150000,0,0,6150000,Null,Null,155098061,691055,5385
155098063,0.0,0.0,6580000,6580000,0,0,6580000,Null,Null,155098063,691055,5385
155098065,0.0,0.0,6580000,6580000,0,0,6580000,Null,Null,155098065,691055,5385
155098071,0.0,0.0,6580000,6580000,0,0,6580000,Null,Null,155098071,691055,5385
155098083,0.0,0.0,6150000,6150000,0,0,6150000,Null,Null,155098083,691055,5385
155098105,0.0,0.0,6150000,6150000,0,0,6150000,Null,Null,155098105,691055,5385
155101406,89.0,89.0,199000,129000,70000,35,199000,Null,Null,155101406,111461,53074
155106936,3.0,3.0,200000,154000,46000,23,200000,Null,Null,155106936,173547,15320
155109099,0.0,0.0,2500,2500,0,0,2500,Null,Null,155109099,111461,2
155109216,0.0,0.0,1000,1000,0,0,1000,Null,Null,155109216,111461,2
155109698,0.0,0.0,2000,2000,0,0,2000,Null,Null,155109698,111461,2
155112079,0.0,0.0,46000000,46000000,0,0,46000000,Null,Null,155112079,939519,8064
155114109,14.0,14.0,119000,119000,0,0,119000,Null,Null,155114109,111461,23660
155115197,1.0,1.0,280000,280000,0,0,280000,Null,Null,155115197,111461,15250
155143328,219.0,219.0,45000,38250,6750,15,45000,Null,Null,155143328,837721,53190
155147353,0.0,0.0,125000,125000,0,0,125000,Null,Null,155147353,164597,1634
155147380,0.0,0.0,325000,325000,0,0,325000,Null,Null,155147380,476503,1634
155163531,12.0,12.0,2300,2300,0,0,2300,Null,Null,155163531,111461,2363
155163712,157.0,157.0,9800,9000,800,8,9800,Null,Null,155163712,111461,49676
155184630,1086.0,1086.0,26950,26950,0,0,26950,Null,Null,155184630,197767,2337
155215510,0.0,0.0,9200,9200,0,0,9200,Null,Null,155215510,111461,2
155215897,0.0,0.0,9350,9350,0,0,9350,Null,Null,155215897,111461,2
155225312,0.0,0.0,3949000,3949000,0,0,3949000,Null,Null,155225312,632589,13878
155225486,0.0,0.0,6500000,6500000,0,0,6500000,Null,Null,155225486,111461,15250
155225498,0.0,0.0,6500000,6500000,0,0,6500000,Null,Null,155225498,111461,15250
155240979,0.0,0.0,7800,7800,0,0,7800,Null,Null,155240979,111461,8193
155242320,0.0,0.0,8000,8000,0,0,8000,Null,Null,155242320,111461,8167
155243273,0.0,0.0,2999,2999,0,0,2999,Null,Null,155243273,111461,8189
155243522,0.0,0.0,1999,1999,0,0,1999,Null,Null,155243522,111461,8193
155251789,0.0,0.0,1000,1000,0,0,1000,Null,Null,155251789,111461,2363
155251799,0.0,0.0,1499,1499,0,0,1499,Null,Null,155251799,111461,2363
155252951,28.0,28.0,320000,320000,0,0,320000,Null,Null,155252951,111461,2
155253236,34.0,34.0,52900,52900,0,0,52900,Null,Null,155253236,21437,2153
155266787,96.0,96.0,110000,55000,55000,50,110000,Null,Null,155266787,4647777,15250
155266899,45.0,45.0,380000,119000,261000,69,380000,Null,Null,155266899,160715,23282
155269374,128.0,128.0,200000,135000,65000,33,200000,Null,Null,155269374,868633,23258
155272007,149.0,149.0,99000,99000,0,0,99000,Null,Null,155272007,5272071,23588
155286090,141.0,141.0,199000,149000,50000,25,199000,Null,Null,155286090,5147565,2659
155287338,41.0,41.0,99000,99000,0,0,99000,Null,Null,155287338,149256,28578
155289695,287.0,287.0,7000,7000,0,0,7000,Null,Null,155289695,274275,8305
155289779,215.0,215.0,690000,379000,311000,45,690000,Null,Null,155289779,246045,4593
155325545,78.0,78.0,81290,78000,3290,4,81290,Null,Null,155325545,111461,2
155326704,297.0,297.0,65000,61750,3250,5,65000,Null,Null,155326704,4740303,27118
155338744,25.0,25.0,44700,44700,0,0,44700,Null,Null,155338744,111461,2
155339564,70.0,70.0,1989999,1093000,896999,45,1989999,Null,Null,155339564,111461,1795
155340900,2.0,2.0,5150000,5150000,0,0,5150000,Null,Null,155340900,5354115,2340
155346732,3.0,3.0,5999,5999,0,0,5999,Null,Null,155346732,111461,2
155346803,0.0,0.0,6000,6000,0,0,6000,Null,Null,155346803,111461,2
155346806,0.0,0.0,6000,6000,0,0,6000,Null,Null,155346806,111461,2
155346892,0.0,0.0,2900,2900,0,0,2900,Null,Null,155346892,111461,2
155346966,8.0,8.0,5000,5000,0,0,5000,Null,Null,155346966,111461,2
155347028,0.0,0.0,3400,3400,0,0,3400,Null,Null,155347028,111461,2
155347076,1.0,1.0,10000,10000,0,0,10000,Null,Null,155347076,111461,2
155347325,1.0,1.0,5000,5000,0,0,5000,Null,Null,155347325,111461,2
155347743,0.0,0.0,6000,6000,0,0,6000,Null,Null,155347743,111461,2
155347876,1.0,1.0,3500,3500,0,0,3500,Null,Null,155347876,111461,2
155348716,0.0,0.0,16000000,15000000,1000000,6,16000000,Null,Null,155348716,5215439,2340
155350454,4.0,4.0,15500000,15500000,0,0,15500000,Null,Null,155350454,5354115,2340
155358003,0.0,0.0,4590000,3790000,800000,17,4590000,Null,Null,155358003,27398,2340
155367016,46.0,46.0,100000,59000,41000,41,100000,Null,Null,155367016,562001,1583
155398419,18.0,18.0,9000,9000,0,0,9000,Null,Null,155398419,111461,11939
155398602,123.0,123.0,600000,481000,119000,20,600000,Null,Null,155398602,248191,8223
155411289,12.0,12.0,2500,2500,0,0,2500,Null,Null,155411289,111461,2
155412216,0.0,0.0,2500,2500,0,0,2500,Null,Null,155412216,111461,2
155427916,2.0,2.0,9000,9000,0,0,9000,Null,Null,155427916,111461,2
155427923,0.0,0.0,1900,1900,0,0,1900,Null,Null,155427923,111461,2
155427938,15.0,15.0,4000,4000,0,0,4000,Null,Null,155427938,111461,2
155427942,0.0,0.0,4500,4500,0,0,4500,Null,Null,155427942,111461,2
155427952,28.0,28.0,1000,1000,0,0,1000,Null,Null,155427952,111461,2
155427968,0.0,0.0,2000,2000,0,0,2000,Null,Null,155427968,111461,2
155427978,0.0,0.0,5000,5000,0,0,5000,Null,Null,155427978,111461,2
155428058,0.0,0.0,4000,4000,0,0,4000,Null,Null,155428058,111461,2
155428067,1.0,1.0,4000,4000,0,0,4000,Null,Null,155428067,111461,2
155428113,0.0,0.0,5000,5000,0,0,5000,Null,Null,155428113,111461,2
155428142,0.0,0.0,4000,4000,0,0,4000,Null,Null,155428142,111461,2
155428144,16.0,16.0,4000,4000,0,0,4000,Null,Null,155428144,111461,2
155428166,0.0,0.0,3400,3400,0,0,3400,Null,Null,155428166,111461,2
155428216,0.0,0.0,4000,4000,0,0,4000,Null,Null,155428216,111461,2
155428255,0.0,0.0,4000,4000,0,0,4000,Null,Null,155428255,111461,2
155428281,0.0,0.0,6500,6500,0,0,6500,Null,Null,155428281,111461,2
155428318,2.0,2.0,6000,6000,0,0,6000,Null,Null,155428318,111461,2
155428320,0.0,0.0,1800,1800,0,0,1800,Null,Null,155428320,111461,2
155428328,24.0,24.0,1000,1000,0,0,1000,Null,Null,155428328,111461,2
155428357,4.0,4.0,2000,2000,0,0,2000,Null,Null,155428357,111461,2
155428377,0.0,0.0,6000,6000,0,0,6000,Null,Null,155428377,111461,2
155428382,0.0,0.0,1500,1500,0,0,1500,Null,Null,155428382,111461,2
155428393,0.0,0.0,9000,9000,0,0,9000,Null,Null,155428393,111461,2
155428436,2.0,2.0,4000,4000,0,0,4000,Null,Null,155428436,111461,2
155428460,0.0,0.0,6000,6000,0,0,6000,Null,Null,155428460,111461,2
155428535,0.0,0.0,1900,1900,0,0,1900,Null,Null,155428535,111461,2
155428544,0.0,0.0,7000,7000,0,0,7000,Null,Null,155428544,111461,2
155428545,0.0,0.0,4000,4000,0,0,4000,Null,Null,155428545,111461,2
155428553,1.0,1.0,8000,8000,0,0,8000,Null,Null,155428553,111461,2
155428575,0.0,0.0,6500,6500,0,0,6500,Null,Null,155428575,111461,2
155428632,0.0,0.0,7000,7000,0,0,7000,Null,Null,155428632,111461,2
155428653,0.0,0.0,1799,1799,0,0,1799,Null,Null,155428653,111461,2
155428685,5.0,5.0,10000,10000,0,0,10000,Null,Null,155428685,111461,2
155428687,0.0,0.0,7500,7500,0,0,7500,Null,Null,155428687,111461,2
155428690,1.0,1.0,8000,8000,0,0,8000,Null,Null,155428690,111461,2
155428765,0.0,0.0,3000,3000,0,0,3000,Null,Null,155428765,111461,2
155428771,2.0,2.0,1200,1200,0,0,1200,Null,Null,155428771,111461,2
155428780,0.0,0.0,4000,4000,0,0,4000,Null,Null,155428780,111461,2
155428819,0.0,0.0,7200,7200,0,0,7200,Null,Null,155428819,111461,2
155428830,0.0,0.0,7000,7000,0,0,7000,Null,Null,155428830,111461,2
155443718,13.0,13.0,30000,22000,8000,27,30000,Null,Null,155443718,111461,49728
155448502,23.0,23.0,35000,28000,7000,20,35000,Null,Null,155448502,111461,49728
155462607,19.0,19.0,35000,26250,8750,25,35000,Null,Null,155462607,111461,49728
155464523,4.0,4.0,50000,45000,5000,10,50000,Null,Null,155464523,111461,49728
155528718,317.0,317.0,84000,84000,0,0,84000,Null,Null,155528718,111461,2
155532442,39.0,39.0,9900,9000,900,9,9900,Null,Null,155532442,111461,8305
155532685,3.0,3.0,2000,2000,0,0,2000,Null,Null,155532685,489065,1883
155536275,170.0,170.0,16990000,10490000,6500000,38,16990000,Null,Null,155536275,18802,1795
155536493,0.0,0.0,18900000,12000000,6900000,37,18900000,Null,Null,155536493,18802,1795
155566272,0.0,0.0,15000,15000,0,0,15000,Null,Null,155566272,21437,2
155602526,18.0,18.0,289000,268000,21000,7,289000,Null,Null,155602526,18792,1813
155610168,0.0,0.0,1500,1500,0,0,1500,Null,Null,155610168,111461,2
155639498,1.0,1.0,617500,617500,0,0,617500,Null,Null,155639498,111461,15318
155640169,1.0,1.0,427500,427500,0,0,427500,Null,Null,155640169,111461,15318
155651720,21.0,21.0,30000,22500,7500,25,30000,Null,Null,155651720,111461,49728
155653070,12.0,12.0,30000,22500,7500,25,30000,Null,Null,155653070,111461,49728
155654429,0.0,0.0,24000,24000,0,0,24000,Null,Null,155654429,111461,49728
155657991,2.0,2.0,108800,97000,11800,11,108800,Null,Null,155657991,111461,28482
155675049,6.0,6.0,28000,28000,0,0,28000,Null,Null,155675049,111461,49728
155678869,7.0,7.0,35000,27000,8000,23,35000,Null,Null,155678869,111461,49728
155679843,41.0,41.0,25000,17500,7500,30,25000,Null,Null,155679843,561415,49728
155689697,13.0,13.0,30000,24500,5500,18,30000,Null,Null,155689697,111461,49728
155691282,191.0,191.0,156000,119000,37000,24,156000,Null,Null,155691282,204895,23258
155698364,0.0,0.0,8842857,6190000,2652857,30,8842857,Null,Null,155698364,405211,8511
155701239,0.0,0.0,4500000,3375000,1125000,25,4500000,Null,Null,155701239,46007,8227
155707427,0.0,0.0,14000000,13580000,420000,3,14000000,Null,Null,155707427,50365,28860
155718305,0.0,0.0,5999,5999,0,0,5999,Null,Null,155718305,111461,49676
155762690,1.0,1.0,3519000,3519000,0,0,3519000,Null,Null,155762690,19018,1634
155764001,36.0,36.0,390000,329000,61000,16,390000,Null,Null,155764001,18792,2324
155769287,3.0,3.0,9598800,7999000,1599800,17,9598800,Null,Null,155769287,111461,8513
155772986,0.0,0.0,5900,5900,0,0,5900,Null,Null,155772986,111461,2
155772990,2.0,2.0,1650,1650,0,0,1650,Null,Null,155772990,111461,2
155773051,0.0,0.0,7500,7500,0,0,7500,Null,Null,155773051,111461,2
155780905,532.0,532.0,300000,239000,61000,20,300000,Null,Null,155780905,626205,4428
155786446,5.0,5.0,50000,47500,2500,5,50000,Null,Null,155786446,561415,49728
155800802,8.0,8.0,30000,28500,1500,5,30000,Null,Null,155800802,111461,49728
155803861,137.0,137.0,7000,7000,0,0,7000,Null,Null,155803861,111461,2
155803971,69.0,69.0,159000,159000,0,0,159000,Null,Null,155803971,111461,2
155808248,3.0,3.0,4580000,4580000,0,0,4580000,Null,Null,155808248,111461,2340
155808563,13.0,13.0,22000,22000,0,0,22000,Null,Null,155808563,111461,2
155809409,0.0,0.0,16500,16500,0,0,16500,Null,Null,155809409,111461,2
155811204,1.0,1.0,8800,8800,0,0,8800,Null,Null,155811204,111461,2
155827291,0.0,0.0,42900000,42900000,0,0,42900000,Null,Null,155827291,111461,23576
155833852,6.0,6.0,2390000,1859000,531000,22,2390000,Null,Null,155833852,112638,1795
155890913,2.0,2.0,781000,781000,0,0,781000,Null,Null,155890913,111461,2
155925399,61.0,61.0,1243000,929000,314000,25,1243000,Null,Null,155925399,26150,8513
155925409,24.0,24.0,1243000,929000,314000,25,1243000,Null,Null,155925409,26150,8513
155987378,129.0,129.0,9000,8000,1000,11,9000,Null,Null,155987378,111461,11921
155996709,0.0,0.0,49599555,49599555,0,0,49599555,Null,Null,155996709,111461,2
155996778,0.0,0.0,37500555,37500555,0,0,37500555,Null,Null,155996778,111461,2
155997492,0.0,0.0,43699555,43699555,0,0,43699555,Null,Null,155997492,111461,2
156169194,0.0,0.0,11942857,8360000,3582857,30,11942857,Null,Null,156169194,405211,8511
156188492,217.0,217.0,142571,99800,42771,30,142571,Null,Null,156188492,111461,20244
156199750,96.0,96.0,38000,38000,0,0,38000,Null,Null,156199750,111461,53054
156205331,53.0,53.0,26000,26000,0,0,26000,Null,Null,156205331,111461,5566
156222386,0.0,0.0,459000,449000,10000,2,459000,Null,Null,156222386,18804,8061
156234295,0.0,0.0,4220000,4220000,0,0,4220000,Null,Null,156234295,160189,11883
156239981,94.0,94.0,2200,2200,0,0,2200,Null,Null,156239981,111461,2
156239989,0.0,0.0,2200,2200,0,0,2200,Null,Null,156239989,111461,2
156240009,0.0,0.0,2490,2490,0,0,2490,Null,Null,156240009,111461,2
156240010,0.0,0.0,1900,1900,0,0,1900,Null,Null,156240010,111461,2
156240021,84.0,84.0,1000,1000,0,0,1000,Null,Null,156240021,111461,2
156240051,0.0,0.0,2500,2500,0,0,2500,Null,Null,156240051,111461,2
156240144,1.0,1.0,1900,1900,0,0,1900,Null,Null,156240144,111461,2
156240222,2.0,2.0,1400,1400,0,0,1400,Null,Null,156240222,111461,2
156240226,2.0,2.0,1300,1300,0,0,1300,Null,Null,156240226,111461,2
156240261,1.0,1.0,1300,1300,0,0,1300,Null,Null,156240261,111461,2
156240337,0.0,0.0,1990,1990,0,0,1990,Null,Null,156240337,111461,2
156262628,105.0,105.0,70000,70000,0,0,70000,Null,Null,156262628,444709,15936
156634748,402.0,402.0,48000,39000,9000,19,48000,Null,Null,156634748,21653,5006
156659134,188.0,188.0,9900,9900,0,0,9900,Null,Null,156659134,111461,7064
156681774,5.0,5.0,250999,250999,0,0,250999,Null,Null,156681774,111461,23236
156682180,8.0,8.0,450000,399000,51000,11,450000,Null,Null,156682180,111461,2
156732372,0.0,0.0,7773000,5829750,1943250,25,7773000,Null,Null,156732372,26150,8513
156732378,0.0,0.0,7773000,5829750,1943250,25,7773000,Null,Null,156732378,26150,8513
156853145,66.0,66.0,999000,599000,400000,40,999000,Null,Null,156853145,198523,2225
157019763,4.0,4.0,73000,65700,7300,10,73000,Null,Null,157019763,111461,15320
157027735,188.0,188.0,49000,35000,14000,29,49000,Null,Null,157027735,4820811,2340
157046098,0.0,0.0,2000,2000,0,0,2000,Null,Null,157046098,111461,2
157055091,334.0,334.0,32000,32000,0,0,32000,Null,Null,157055091,5132069,23276
157055093,93.0,93.0,1044000,505000,539000,52,1044000,Null,Null,157055093,464405,23362
157055245,77.0,77.0,39000,39000,0,0,39000,Null,Null,157055245,111461,2685
157060310,64.0,64.0,38000,29000,9000,24,38000,Null,Null,157060310,5132069,23706
157069960,0.0,0.0,2400,2400,0,0,2400,Null,Null,157069960,111461,2363
157070296,0.0,0.0,2100,2100,0,0,2100,Null,Null,157070296,111461,2238
157070311,0.0,0.0,2500,2500,0,0,2500,Null,Null,157070311,111461,23258
157070402,0.0,0.0,7900,7900,0,0,7900,Null,Null,157070402,111461,49722
157070845,0.0,0.0,2000,1000,1000,50,2000,Null,Null,157070845,5132069,23042
157076797,0.0,0.0,9500000,7125000,2375000,25,9500000,Null,Null,157076797,26150,8513
157083107,36.0,36.0,148999,128999,20000,13,148999,Null,Null,157083107,111461,28596
157087620,0.0,0.0,17000,4000,13000,76,17000,Null,Null,157087620,111461,1815
157125129,0.0,0.0,52000000,52000000,0,0,52000000,Null,Null,157125129,5375205,23446
157143818,635.0,635.0,7000,7000,0,0,7000,Null,Null,157143818,111461,2363
157152581,48.0,48.0,5999,5999,0,0,5999,Null,Null,157152581,111461,2363
157154448,86.0,86.0,68000,68000,0,0,68000,Null,Null,157154448,111461,20492
157175018,596.0,596.0,105000,69000,36000,34,105000,Null,Null,157175018,201089,23588
157208662,212.0,212.0,325000,276250,48750,15,325000,Null,Null,157208662,542605,8220
157209494,0.0,0.0,11490000,11490000,0,0,11490000,Null,Null,157209494,114527,2657
157215759,135.0,135.0,310000,310000,0,0,310000,Null,Null,157215759,5376747,1838
157236870,0.0,0.0,25100000,25100000,0,0,25100000,Null,Null,157236870,167287,2324
157240561,236.0,236.0,490000,445900,44100,9,490000,Null,Null,157240561,5220265,53350
157241929,0.0,0.0,15190000,15190000,0,0,15190000,Null,Null,157241929,477955,28860
157242067,8.0,8.0,699000,699000,0,0,699000,Null,Null,157242067,46363,5385
157244914,610.0,610.0,589000,311000,278000,47,589000,Null,Null,157244914,302375,28454
157244942,0.0,0.0,5500000,5500000,0,0,5500000,Null,Null,157244942,5069783,11885
157258775,0.0,0.0,12000000,12000000,0,0,12000000,Null,Null,157258775,5375981,53352
157258951,349.0,349.0,1800,1800,0,0,1800,Null,Null,157258951,111461,18876
157271444,187.0,187.0,170000,120000,50000,29,170000,Null,Null,157271444,562001,17170
157314121,598.0,598.0,26000,26000,0,0,26000,Null,Null,157314121,111461,2
157316575,0.0,0.0,4172000,2972000,1200000,29,4172000,Null,Null,157316575,26150,8513
157399433,0.0,0.0,6000000,6000000,0,0,6000000,Null,Null,157399433,111461,2
157405381,2.0,2.0,12000,9800,2200,18,12000,Null,Null,157405381,111461,2
157405648,17.0,17.0,10000,7000,3000,30,10000,Null,Null,157405648,111461,2
157405919,1.0,1.0,15000,9800,5200,35,15000,Null,Null,157405919,111461,2
157417398,0.0,0.0,879000,878000,1000,0,879000,Null,Null,157417398,841705,49722
157421414,34.0,34.0,699000,699000,0,0,699000,Null,Null,157421414,21651,4593
157423880,26.0,26.0,14000,14000,0,0,14000,Null,Null,157423880,111461,8197
157424112,1.0,1.0,11490000,11490000,0,0,11490000,Null,Null,157424112,114527,8043
157424429,14.0,14.0,8700,8700,0,0,8700,Null,Null,157424429,5302243,1622
157424963,3.0,3.0,94900,94900,0,0,94900,Null,Null,157424963,111461,2
157433863,12.0,12.0,1500,1500,0,0,1500,Null,Null,157433863,111461,2
157446248,89.0,89.0,74000,74000,0,0,74000,Null,Null,157446248,21651,12294
157446280,0.0,0.0,26990000,23300000,3690000,14,26990000,Null,Null,157446280,21673,2324
157480658,0.0,0.0,1501,1501,0,0,1501,Null,Null,157480658,111461,2
157480664,4.0,4.0,19497,19497,0,0,19497,Null,Null,157480664,111461,2
157480923,0.0,0.0,1245,1245,0,0,1245,Null,Null,157480923,111461,2
157490476,148.0,148.0,100000,79000,21000,21,100000,Null,Null,157490476,836453,28674
157504731,65.0,65.0,149000,149000,0,0,149000,Null,Null,157504731,21651,12294
157511267,24.0,24.0,195000,195000,0,0,195000,Null,Null,157511267,193677,53190
157511278,26.0,26.0,255000,255000,0,0,255000,Null,Null,157511278,193677,53190
157525033,186.0,186.0,225000,204750,20250,9,225000,Null,Null,157525033,5220265,53350
157525704,19.0,19.0,289000,289000,0,0,289000,Null,Null,157525704,5220265,53350
157537059,144.0,144.0,12000,7000,5000,42,12000,Null,Null,157537059,111461,2
157548456,189.0,189.0,138600,103950,34650,25,138600,Null,Null,157548456,5339599,11873
157550639,0.0,0.0,6900000,6900000,0,0,6900000,Null,Null,157550639,5207489,11859
157553868,0.0,0.0,6000,4200,1800,30,6000,Null,Null,157553868,111461,8165
157553875,20.0,20.0,150000,119000,31000,21,150000,Null,Null,157553875,111461,8165
157553877,0.0,0.0,7000,4900,2100,30,7000,Null,Null,157553877,111461,8165
157591051,0.0,0.0,44900000,44900000,0,0,44900000,Null,Null,157591051,111461,23576
157601565,9.0,9.0,87000,87000,0,0,87000,Null,Null,157601565,111461,2
157710380,134.0,134.0,167000,160000,7000,4,167000,Null,Null,157710380,111461,28598
157713880,4.0,4.0,5441000,4078000,1363000,25,5441000,Null,Null,157713880,26150,8513
157713884,5.0,5.0,5441000,4079000,1362000,25,5441000,Null,Null,157713884,26150,8513
157803141,1.0,1.0,153000,153000,0,0,153000,Null,Null,157803141,111461,15250
157835051,7.0,7.0,380000,380000,0,0,380000,Null,Null,157835051,18804,8061
157961567,42.0,42.0,59000,39000,20000,34,59000,Null,Null,157961567,5132069,23282
158003888,13.0,13.0,1109000,889000,220000,20,1109000,Null,Null,158003888,46363,5384
158006134,124.0,124.0,120000,74000,46000,38,120000,Null,Null,158006134,726703,11873
158007371,5.0,5.0,1989000,1989000,0,0,1989000,Null,Null,158007371,46363,5385
158010110,0.0,0.0,1700,1700,0,0,1700,Null,Null,158010110,111461,2
158010195,0.0,0.0,4000,4000,0,0,4000,Null,Null,158010195,111461,8205
158018228,69.0,69.0,158000,149000,9000,6,158000,Null,Null,158018228,4246951,8602
158076846,0.0,0.0,2500,2500,0,0,2500,Null,Null,158076846,111461,2
158076893,2.0,2.0,5500,5500,0,0,5500,Null,Null,158076893,111461,2
158077286,0.0,0.0,5000,5000,0,0,5000,Null,Null,158077286,111461,2
158077455,0.0,0.0,6000,6000,0,0,6000,Null,Null,158077455,111461,2
158077512,0.0,0.0,7000,7000,0,0,7000,Null,Null,158077512,111461,2
158077656,0.0,0.0,2500,2500,0,0,2500,Null,Null,158077656,111461,2
158078793,0.0,0.0,1900,1900,0,0,1900,Null,Null,158078793,111461,2
158078848,0.0,0.0,3000,3000,0,0,3000,Null,Null,158078848,111461,2
158078902,43.0,43.0,3000,3000,0,0,3000,Null,Null,158078902,111461,2
158079023,0.0,0.0,4500,4500,0,0,4500,Null,Null,158079023,111461,2
158079037,0.0,0.0,1800,1800,0,0,1800,Null,Null,158079037,111461,2
158079192,0.0,0.0,5000,5000,0,0,5000,Null,Null,158079192,111461,2
158079232,0.0,0.0,1700,1700,0,0,1700,Null,Null,158079232,111461,2
158079309,39.0,39.0,1700,1700,0,0,1700,Null,Null,158079309,111461,2
158079311,0.0,0.0,9000,9000,0,0,9000,Null,Null,158079311,111461,2
158091991,0.0,0.0,12990000,10990000,2000000,15,12990000,Null,Null,158091991,52232,1795
158093971,0.0,0.0,37500000,37500000,0,0,37500000,Null,Null,158093971,111461,23576
158100325,1.0,1.0,2200,2200,0,0,2200,Null,Null,158100325,111461,2
158111307,0.0,0.0,37000000,37000000,0,0,37000000,Null,Null,158111307,111461,23576
158122562,4.0,4.0,280000,280000,0,0,280000,Null,Null,158122562,111461,15250
158125854,0.0,0.0,36000000,36000000,0,0,36000000,Null,Null,158125854,111461,23576
158130431,0.0,0.0,42000000,42000000,0,0,42000000,Null,Null,158130431,111461,23576
158138623,2630.0,2630.0,17800,8900,8900,50,17800,Null,Null,158138623,111461,8305
158165120,117.0,117.0,29000,29000,0,0,29000,Null,Null,158165120,5326489,5007
158185087,4.0,4.0,10000,10000,0,0,10000,Null,Null,158185087,111461,2
158207945,35.0,35.0,175000,154000,21000,12,175000,Null,Null,158207945,47663,13878
158213624,2.0,2.0,8000,8000,0,0,8000,Null,Null,158213624,111461,7064
158220423,4.0,4.0,1000,1000,0,0,1000,Null,Null,158220423,111461,2363
158220827,0.0,0.0,40500000,40500000,0,0,40500000,Null,Null,158220827,111461,23576
158222298,0.0,0.0,84000000,84000000,0,0,84000000,Null,Null,158222298,111461,23576
158222388,106.0,106.0,730000,625000,105000,14,730000,Null,Null,158222388,150215,11845
158222396,0.0,0.0,80000000,80000000,0,0,80000000,Null,Null,158222396,111461,23576
158225176,0.0,0.0,43500000,43500000,0,0,43500000,Null,Null,158225176,111461,23576
158225735,0.0,0.0,42000000,42000000,0,0,42000000,Null,Null,158225735,111461,23576
158226774,0.0,0.0,92000000,92000000,0,0,92000000,Null,Null,158226774,111461,23576
158227685,0.0,0.0,66000000,66000000,0,0,66000000,Null,Null,158227685,111461,23576
158348732,0.0,0.0,85000000,85000000,0,0,85000000,Null,Null,158348732,111461,23576
158349112,0.0,0.0,6950000,6950000,0,0,6950000,Null,Null,158349112,111461,7449
158349223,0.0,0.0,6950000,6950000,0,0,6950000,Null,Null,158349223,111461,5384
158349273,0.0,0.0,12500000,12500000,0,0,12500000,Null,Null,158349273,111461,8513
158349291,1.0,1.0,7500000,7500000,0,0,7500000,Null,Null,158349291,111461,5384
158349323,0.0,0.0,7850000,7850000,0,0,7850000,Null,Null,158349323,111461,5385
158349472,3.0,3.0,169000,169000,0,0,169000,Null,Null,158349472,111461,49722
158382979,0.0,0.0,40000000,40000000,0,0,40000000,Null,Null,158382979,111461,23576
158386738,0.0,0.0,38000000,38000000,0,0,38000000,Null,Null,158386738,111461,23576
158387431,0.0,0.0,85000000,85000000,0,0,85000000,Null,Null,158387431,111461,23576
158388861,0.0,0.0,43000000,43000000,0,0,43000000,Null,Null,158388861,111461,23576
158399593,7287.0,7287.0,320000,210000,110000,34,320000,Null,Null,158399593,861765,8305
158430053,0.0,0.0,37000000,37000000,0,0,37000000,Null,Null,158430053,111461,23576
158430273,0.0,0.0,90000000,90000000,0,0,90000000,Null,Null,158430273,111461,23576
158433821,0.0,0.0,45000000,45000000,0,0,45000000,Null,Null,158433821,111461,23576
158461088,0.0,0.0,3912000,3912000,0,0,3912000,Null,Null,158461088,25643,1795
158461763,0.0,0.0,40000000,40000000,0,0,40000000,Null,Null,158461763,111461,23576
158477452,0.0,0.0,37000000,37000000,0,0,37000000,Null,Null,158477452,111461,23576
158492257,440.0,440.0,12000,9000,3000,25,12000,Null,Null,158492257,427547,8305
158498840,0.0,0.0,37500000,37500000,0,0,37500000,Null,Null,158498840,111461,23576
158501338,0.0,0.0,62000000,62000000,0,0,62000000,Null,Null,158501338,111461,23576
158562871,0.0,0.0,42000000,42000000,0,0,42000000,Null,Null,158562871,111461,23576
158564268,0.0,0.0,42000000,42000000,0,0,42000000,Null,Null,158564268,111461,23576
158564745,43.0,43.0,18887,18887,0,0,18887,Null,Null,158564745,111461,2
158582730,3.0,3.0,168000,168000,0,0,168000,Null,Null,158582730,111461,49722
158582762,0.0,0.0,66000000,66000000,0,0,66000000,Null,Null,158582762,111461,23576
158585441,7.0,7.0,204000,204000,0,0,204000,Null,Null,158585441,111461,49722
158595550,0.0,0.0,20000000,11880000,8120000,41,20000000,Null,Null,158595550,18802,1795
158600157,19.0,19.0,1900,1881,19,1,1900,Null,Null,158600157,111461,8305
158602522,20.0,20.0,20000,20000,0,0,20000,Null,Null,158602522,111461,49728
158602551,3.0,3.0,130000,130000,0,0,130000,Null,Null,158602551,111461,49722
158602614,7.0,7.0,190000,190000,0,0,190000,Null,Null,158602614,111461,49722
158633905,0.0,0.0,41900000,36900000,5000000,12,41900000,Null,Null,158633905,152553,23576
158634445,0.0,0.0,48000000,48000000,0,0,48000000,Null,Null,158634445,111461,23576
158639945,219.0,219.0,150000,145000,5000,3,150000,Null,Null,158639945,21437,2153
158641114,2.0,2.0,165000,165000,0,0,165000,Null,Null,158641114,111461,53074
158641485,0.0,0.0,40000000,40000000,0,0,40000000,Null,Null,158641485,111461,23576
158646190,0.0,0.0,92000000,92000000,0,0,92000000,Null,Null,158646190,111461,23576
158693009,40.0,40.0,150000,139000,11000,7,150000,Null,Null,158693009,162313,28484
158714974,0.0,0.0,3500000,3500000,0,0,3500000,Null,Null,158714974,18802,1795
158741127,0.0,0.0,3500000,3500000,0,0,3500000,Null,Null,158741127,18802,1795
158742790,0.0,0.0,8000000,5324000,2676000,33,8000000,Null,Null,158742790,18802,1794
158743936,24.0,24.0,71990,71990,0,0,71990,Null,Null,158743936,111461,5450
158744739,188.0,188.0,5000,5000,0,0,5000,Null,Null,158744739,5104653,17186
158762755,805.0,805.0,120000,120000,0,0,120000,Null,Null,158762755,5026491,1752
158772428,137.0,137.0,159000,159000,0,0,159000,Null,Null,158772428,3985581,2340
158788377,92.0,92.0,175000,135000,40000,23,175000,Null,Null,158788377,5334659,1628
158797348,15.0,15.0,295996,295996,0,0,295996,Null,Null,158797348,111461,6305
158808107,0.0,0.0,3990000,2650000,1340000,34,3990000,Null,Null,158808107,25643,1795
158816167,1.0,1.0,2000,2000,0,0,2000,Null,Null,158816167,111461,18876
158817980,338.0,338.0,62000,62000,0,0,62000,Null,Null,158817980,777069,1837
158847023,0.0,0.0,3420000,3420000,0,0,3420000,Null,Null,158847023,111461,11933
158848954,443.0,443.0,112000,112000,0,0,112000,Null,Null,158848954,4888937,1838
158849015,518.0,518.0,210000,164000,46000,22,210000,Null,Null,158849015,930377,10228
158868703,1691.0,1691.0,550000,339000,211000,38,550000,Null,Null,158868703,52724,28452
158868825,391.0,391.0,350000,219000,131000,37,350000,Null,Null,158868825,52724,28452
158880691,0.0,0.0,3500000,3500000,0,0,3500000,Null,Null,158880691,18802,1795
158883198,0.0,0.0,80000000,80000000,0,0,80000000,Null,Null,158883198,223415,23102
158886741,0.0,0.0,2000,2000,0,0,2000,Null,Null,158886741,111461,27214
158886806,0.0,0.0,950000,950000,0,0,950000,Null,Null,158886806,111461,5385
158895857,1.0,1.0,5990000,5939000,51000,1,5990000,Null,Null,158895857,52232,1795
158905104,99.0,99.0,175000,175000,0,0,175000,Null,Null,158905104,111461,1831
158959656,0.0,0.0,3912000,3912000,0,0,3912000,Null,Null,158959656,25643,1795
159000756,589.0,589.0,1600000,960000,640000,40,1600000,Null,Null,159000756,632677,4381
159011902,12.0,12.0,1000,1000,0,0,1000,Null,Null,159011902,111461,1883
159027192,1.0,1.0,55000,55000,0,0,55000,Null,Null,159027192,111461,15320
159058219,33.0,33.0,8500,8500,0,0,8500,Null,Null,159058219,5104653,11929
159058707,0.0,0.0,3550,3550,0,0,3550,Null,Null,159058707,111461,2
159060557,1079.0,1079.0,12100,12100,0,0,12100,Null,Null,159060557,111461,7064
159144262,12.0,12.0,519000,519000,0,0,519000,Null,Null,159144262,310913,2234
159144266,2.0,2.0,549000,549000,0,0,549000,Null,Null,159144266,310913,2234
159249123,112.0,112.0,8000,8000,0,0,8000,Null,Null,159249123,5104653,11929
159298167,2.0,2.0,989000,978000,11000,1,989000,Null,Null,159298167,841705,49722
159389786,137.0,137.0,38000,38000,0,0,38000,Null,Null,159389786,111461,6742
159433094,6.0,6.0,14900000,13890000,1010000,7,14900000,Null,Null,159433094,20215,2324
159440670,105.0,105.0,1587001,1587001,0,0,1587001,Null,Null,159440670,2630119,2657
159501937,197.0,197.0,100000,65000,35000,35,100000,Null,Null,159501937,562001,8206
159514714,256.0,256.0,200000,115000,85000,43,200000,Null,Null,159514714,562001,8220
159601515,13.0,13.0,5000,5000,0,0,5000,Null,Null,159601515,111461,2
159602584,81.0,81.0,15000,15000,0,0,15000,Null,Null,159602584,111461,11831
159602685,0.0,0.0,6000000,6000000,0,0,6000000,Null,Null,159602685,4658569,1601
159676329,189.0,189.0,17000,8500,8500,50,17000,Null,Null,159676329,5104653,8305
159725951,1.0,1.0,3500000,3500000,0,0,3500000,Null,Null,159725951,18802,1795
159730187,3.0,3.0,1243000,932250,310750,25,1243000,Null,Null,159730187,26150,8513
159730193,2.0,2.0,1140000,855000,285000,25,1140000,Null,Null,159730193,26150,8513
159732719,122.0,122.0,15000,7000,8000,53,15000,Null,Null,159732719,111461,2
159765477,189.0,189.0,159000,109000,50000,31,159000,Null,Null,159765477,230607,23228
159773175,1.0,1.0,24000,11000,13000,54,24000,Null,Null,159773175,111461,15318
159787712,0.0,0.0,9000,5000,4000,44,9000,Null,Null,159787712,111461,20222
159849867,1.0,1.0,6009500,5408550,600950,10,6009500,Null,Null,159849867,205847,11873
159853930,0.0,0.0,12900000,12900000,0,0,12900000,Null,Null,159853930,18802,1795
159854912,0.0,0.0,2000,2000,0,0,2000,Null,Null,159854912,111461,2
159855152,0.0,0.0,2100,2100,0,0,2100,Null,Null,159855152,111461,2
159855959,369.0,369.0,11000,11000,0,0,11000,Null,Null,159855959,111461,2
159857405,120.0,120.0,42000,42000,0,0,42000,Null,Null,159857405,111461,23416
159886869,298.0,298.0,445000,445000,0,0,445000,Null,Null,159886869,5380019,17170
159886922,77.0,77.0,290000,145200,144800,50,290000,Null,Null,159886922,111461,27256
159887168,0.0,0.0,13400000,12000000,1400000,10,13400000,Null,Null,159887168,18802,1795
159887172,1.0,1.0,22450000,22450000,0,0,22450000,Null,Null,159887172,18802,1795
159887209,0.0,0.0,15000000,15000000,0,0,15000000,Null,Null,159887209,18802,1795
159887243,0.0,0.0,20000000,11880000,8120000,41,20000000,Null,Null,159887243,18802,1795
159887246,0.0,0.0,34950000,34950000,0,0,34950000,Null,Null,159887246,18802,1795
159887721,136.0,136.0,945000,945000,0,0,945000,Null,Null,159887721,5380019,53350
159893283,81.0,81.0,79000,68000,11000,14,79000,Null,Null,159893283,196199,11827
159918243,4.0,4.0,5268000,5268000,0,0,5268000,Null,Null,159918243,111461,8227
159971094,1205.0,1205.0,250000,139000,111000,44,250000,Null,Null,159971094,245945,23622
159971502,1.0,1.0,3770000,3770000,0,0,3770000,Null,Null,159971502,5177735,8227
160049599,165.0,165.0,320000,320000,0,0,320000,Null,Null,160049599,111461,23834
160051494,0.0,0.0,689000,679000,10000,1,689000,Null,Null,160051494,112638,1796
160051501,3.0,3.0,465000,465000,0,0,465000,Null,Null,160051501,112638,1796
160051933,3473.0,3473.0,32000,32000,0,0,32000,Null,Null,160051933,86206,1601
160054528,20.0,20.0,2500,2500,0,0,2500,Null,Null,160054528,111461,2
160056383,0.0,0.0,1900,1900,0,0,1900,Null,Null,160056383,111461,2
160056557,2.0,2.0,2500,2500,0,0,2500,Null,Null,160056557,111461,3179
160067398,0.0,0.0,2400,2400,0,0,2400,Null,Null,160067398,111461,2
160095063,439.0,439.0,86000,79000,7000,8,86000,Null,Null,160095063,4766405,1752
160095200,1.0,1.0,3668000,3668000,0,0,3668000,Null,Null,160095200,244351,11873
160133689,0.0,0.0,149000,149000,0,0,149000,Null,Null,160133689,111461,2
160148278,0.0,0.0,2000,2000,0,0,2000,Null,Null,160148278,111461,2
160148282,0.0,0.0,2000,2000,0,0,2000,Null,Null,160148282,111461,2
160148327,0.0,0.0,2000,2000,0,0,2000,Null,Null,160148327,111461,2
160148343,0.0,0.0,2500,2500,0,0,2500,Null,Null,160148343,111461,2
160148344,0.0,0.0,2060,2060,0,0,2060,Null,Null,160148344,111461,2
160148353,0.0,0.0,2360,2360,0,0,2360,Null,Null,160148353,111461,2
160148376,0.0,0.0,2000,2000,0,0,2000,Null,Null,160148376,111461,2
160148377,0.0,0.0,2000,2000,0,0,2000,Null,Null,160148377,111461,2
160148386,0.0,0.0,2000,2000,0,0,2000,Null,Null,160148386,111461,2
160148402,0.0,0.0,2000,2000,0,0,2000,Null,Null,160148402,111461,2
160148416,0.0,0.0,2000,2000,0,0,2000,Null,Null,160148416,111461,2
160148444,0.0,0.0,2000,2000,0,0,2000,Null,Null,160148444,111461,2
160152603,259.0,259.0,59000,49000,10000,17,59000,Null,Null,160152603,5173455,8193
160205756,0.0,0.0,179000,179000,0,0,179000,Null,Null,160205756,111461,8224
160212514,0.0,0.0,240000,205000,35000,15,240000,Null,Null,160212514,111461,2
160213419,25.0,25.0,1900,1900,0,0,1900,Null,Null,160213419,111461,2
160213556,0.0,0.0,1900,1100,800,42,1900,Null,Null,160213556,111461,2
160216016,0.0,0.0,1900,1111,789,42,1900,Null,Null,160216016,111461,2
160216172,0.0,0.0,1900,1111,789,42,1900,Null,Null,160216172,111461,2
160220271,6.0,6.0,1100,1000,100,9,1100,Null,Null,160220271,111461,2
160220432,0.0,0.0,1900,1881,19,1,1900,Null,Null,160220432,111461,2
160265257,28.0,28.0,1498,1498,0,0,1498,Null,Null,160265257,111461,2
160265326,111.0,111.0,11999,11999,0,0,11999,Null,Null,160265326,111461,2
160265514,49.0,49.0,1899,1899,0,0,1899,Null,Null,160265514,111461,2
160290371,0.0,0.0,6430000,5979900,450100,7,6430000,Null,Null,160290371,205847,11873
160299335,64.0,64.0,290000,203000,87000,30,290000,Null,Null,160299335,202607,8217
160299337,111.0,111.0,290000,203000,87000,30,290000,Null,Null,160299337,202607,8217
160299522,199.0,199.0,880000,814000,66000,8,880000,Null,Null,160299522,202607,53350
160299528,80.0,80.0,290000,203000,87000,30,290000,Null,Null,160299528,202607,8217
160303941,3.0,3.0,2290000,1659000,631000,28,2290000,Null,Null,160303941,19673,1795
160306737,143.0,143.0,450000,230000,220000,49,450000,Null,Null,160306737,111461,2
160306775,118.0,118.0,91350,85000,6350,7,91350,Null,Null,160306775,111461,2
160310125,0.0,0.0,80000,65000,15000,19,80000,Null,Null,160310125,310913,2685
160310283,1326.0,1326.0,33000,29700,3300,10,33000,Null,Null,160310283,839837,53048
160356614,6.0,6.0,250000,250000,0,0,250000,Null,Null,160356614,111461,15250
160369069,1.0,1.0,7500,7500,0,0,7500,Null,Null,160369069,111461,2
160370376,141.0,141.0,195000,195000,0,0,195000,Null,Null,160370376,5380019,1583
160372486,1.0,1.0,107000,107000,0,0,107000,Null,Null,160372486,111461,15318
160372572,5.0,5.0,105000,105000,0,0,105000,Null,Null,160372572,111461,15318
160418295,97.0,97.0,179000,179000,0,0,179000,Null,Null,160418295,111461,28430
160419235,1.0,1.0,15000,15000,0,0,15000,Null,Null,160419235,111461,49728
160419250,7.0,7.0,25000,25000,0,0,25000,Null,Null,160419250,111461,49728
160419252,11.0,11.0,62000,62000,0,0,62000,Null,Null,160419252,111461,49728
160419268,1.0,1.0,45000,45000,0,0,45000,Null,Null,160419268,111461,49728
160419270,7.0,7.0,15000,15000,0,0,15000,Null,Null,160419270,111461,49728
160419283,13.0,13.0,160000,160000,0,0,160000,Null,Null,160419283,111461,49722
160419316,41.0,41.0,55000,55000,0,0,55000,Null,Null,160419316,111461,49728
160419319,18.0,18.0,55000,55000,0,0,55000,Null,Null,160419319,111461,49728
160419339,5.0,5.0,18000,18000,0,0,18000,Null,Null,160419339,111461,49728
160419349,9.0,9.0,25000,25000,0,0,25000,Null,Null,160419349,111461,49728
160424898,2.0,2.0,899000,878000,21000,2,899000,Null,Null,160424898,841705,49722
160428085,69.0,69.0,338000,185000,153000,45,338000,Null,Null,160428085,4246951,8602
160432235,6.0,6.0,1575,1575,0,0,1575,Null,Null,160432235,111461,2
160432236,408.0,408.0,12075,12075,0,0,12075,Null,Null,160432236,111461,2
160434731,11.0,11.0,8490000,5699000,2791000,33,8490000,Null,Null,160434731,18802,1794
160445980,102.0,102.0,549000,428000,121000,22,549000,Null,Null,160445980,21279,17170
160450655,5.0,5.0,3790000,2711000,1079000,28,3790000,Null,Null,160450655,112638,1794
160551317,0.0,0.0,9000,9000,0,0,9000,Null,Null,160551317,111461,2
160551484,0.0,0.0,9000,9000,0,0,9000,Null,Null,160551484,111461,20222
160556149,13.0,13.0,8490000,5729000,2761000,33,8490000,Null,Null,160556149,18802,1794
160556216,23.0,23.0,39500,39500,0,0,39500,Null,Null,160556216,174391,9052
160559258,0.0,0.0,9800,9800,0,0,9800,Null,Null,160559258,111461,2
160559330,0.0,0.0,6230,6230,0,0,6230,Null,Null,160559330,111461,2
160559417,8.0,8.0,1000,1000,0,0,1000,Null,Null,160559417,111461,2
160559600,0.0,0.0,5000,5000,0,0,5000,Null,Null,160559600,111461,2
160580932,2.0,2.0,10000,9000,1000,10,10000,Null,Null,160580932,111461,15318
160664361,601.0,601.0,725000,469000,256000,35,725000,Null,Null,160664361,505907,4593
160666612,0.0,0.0,24900000,24900000,0,0,24900000,Null,Null,160666612,20215,8067
160670305,0.0,0.0,6750000,6075000,675000,10,6750000,Null,Null,160670305,704815,15318
160694199,3.0,3.0,169000,169000,0,0,169000,Null,Null,160694199,49022,8511
160705131,146.0,146.0,45000,45000,0,0,45000,Null,Null,160705131,111461,20244
160797086,8.0,8.0,5999000,5140000,859000,14,5999000,Null,Null,160797086,52232,1795
160797141,0.0,0.0,3630000,3630000,0,0,3630000,Null,Null,160797141,262661,8227
160797845,10.0,10.0,35000,35000,0,0,35000,Null,Null,160797845,21653,5006
160797854,65.0,65.0,1800,1800,0,0,1800,Null,Null,160797854,111461,28470
160801738,87.0,87.0,4690000,3899000,791000,17,4690000,Null,Null,160801738,25422,1795
160801751,0.0,0.0,4440000,4440000,0,0,4440000,Null,Null,160801751,25422,1795
160814867,45.0,45.0,9000,9000,0,0,9000,Null,Null,160814867,111461,1634
160815354,93.0,93.0,55000,37000,18000,33,55000,Null,Null,160815354,111461,49676
160818667,10.0,10.0,80000,80000,0,0,80000,Null,Null,160818667,111461,20244
160819119,64.0,64.0,4990000,4099000,891000,18,4990000,Null,Null,160819119,25422,1795
160819279,0.0,0.0,4716000,4716000,0,0,4716000,Null,Null,160819279,25422,1795
160823152,16.0,16.0,35000,35000,0,0,35000,Null,Null,160823152,21653,5006
160831486,7.0,7.0,138900,138900,0,0,138900,Null,Null,160831486,111461,2
160834678,79.0,79.0,189000,189000,0,0,189000,Null,Null,160834678,4654165,8309
160835931,0.0,0.0,2000,2000,0,0,2000,Null,Null,160835931,111461,7713
160875002,76.0,76.0,2900,2900,0,0,2900,Null,Null,160875002,111461,8190
160875289,0.0,0.0,10000,10000,0,0,10000,Null,Null,160875289,111461,8196
160875472,1114.0,1114.0,106000,55000,51000,48,106000,Null,Null,160875472,737237,53074
160876389,578.0,578.0,106000,55000,51000,48,106000,Null,Null,160876389,737237,53074
160879414,64.0,64.0,198000,198000,0,0,198000,Null,Null,160879414,4187373,20182
160880365,8.0,8.0,10000,2000,8000,80,10000,Null,Null,160880365,111461,5450
160890501,0.0,0.0,2500,2500,0,0,2500,Null,Null,160890501,111461,23078
160898202,10.0,10.0,110000,55500,54500,50,110000,Null,Null,160898202,111461,8513
160909295,388.0,388.0,65000,65000,0,0,65000,Null,Null,160909295,111461,23134
160944369,97.0,97.0,165000,165000,0,0,165000,Null,Null,160944369,4777435,23800
160946538,100.0,100.0,250000,149000,101000,40,250000,Null,Null,160946538,192489,28574
161002084,148.0,148.0,1999000,1399000,600000,30,1999000,Null,Null,161002084,5246949,2340
161007768,721.0,721.0,69000,49000,20000,29,69000,Null,Null,161007768,625265,28574
161008501,1.0,1.0,3990000,3990000,0,0,3990000,Null,Null,161008501,5333833,8165
161020253,3.0,3.0,1200,1200,0,0,1200,Null,Null,161020253,111461,23112
161024333,0.0,0.0,12000000,12000000,0,0,12000000,Null,Null,161024333,111461,15250
161024341,0.0,0.0,8500000,8500000,0,0,8500000,Null,Null,161024341,111461,15250
161029368,0.0,0.0,14390000,11512000,2878000,20,14390000,Null,Null,161029368,691575,7079
161030427,385.0,385.0,199000,139000,60000,30,199000,Null,Null,161030427,4259821,2234
161031877,4.0,4.0,19000,19000,0,0,19000,Null,Null,161031877,111461,2
161031891,0.0,0.0,19000,19000,0,0,19000,Null,Null,161031891,111461,2
161031924,0.0,0.0,19000,19000,0,0,19000,Null,Null,161031924,111461,2
161031956,6.0,6.0,65000,65000,0,0,65000,Null,Null,161031956,111461,2
161032092,2.0,2.0,79000,79000,0,0,79000,Null,Null,161032092,111461,2
161032174,1.0,1.0,42000,42000,0,0,42000,Null,Null,161032174,111461,15236
161032242,12.0,12.0,95000,95000,0,0,95000,Null,Null,161032242,111461,2
161032262,0.0,0.0,19000,19000,0,0,19000,Null,Null,161032262,111461,2
161032295,1.0,1.0,19000,19000,0,0,19000,Null,Null,161032295,111461,2
161032451,152.0,152.0,63000,63000,0,0,63000,Null,Null,161032451,111461,2
161032781,2.0,2.0,69000,69000,0,0,69000,Null,Null,161032781,111461,2
161032791,26.0,26.0,105000,105000,0,0,105000,Null,Null,161032791,111461,2
161033177,1.0,1.0,29000,29000,0,0,29000,Null,Null,161033177,111461,2
161033375,1.0,1.0,55000,55000,0,0,55000,Null,Null,161033375,111461,2
161033417,0.0,0.0,5000,5000,0,0,5000,Null,Null,161033417,111461,2
161033534,0.0,0.0,19000,19000,0,0,19000,Null,Null,161033534,111461,2
161033694,1.0,1.0,48000,48000,0,0,48000,Null,Null,161033694,111461,2
161033719,41.0,41.0,10000,10000,0,0,10000,Null,Null,161033719,111461,2
161033753,0.0,0.0,19000,19000,0,0,19000,Null,Null,161033753,111461,2
161034213,1.0,1.0,99000,99000,0,0,99000,Null,Null,161034213,111461,2
161034232,0.0,0.0,15000,15000,0,0,15000,Null,Null,161034232,111461,2
161034377,35.0,35.0,84000,84000,0,0,84000,Null,Null,161034377,111461,2
161034497,4.0,4.0,94000,94000,0,0,94000,Null,Null,161034497,111461,15236
161034526,0.0,0.0,12900,12900,0,0,12900,Null,Null,161034526,111461,2
161034899,1.0,1.0,89000,89000,0,0,89000,Null,Null,161034899,111461,2
161034959,0.0,0.0,99000,99000,0,0,99000,Null,Null,161034959,111461,2
161035011,18.0,18.0,100000,100000,0,0,100000,Null,Null,161035011,111461,2
161158099,2.0,2.0,2690000,2690000,0,0,2690000,Null,Null,161158099,49994,1795
161178498,4.0,4.0,1990000,1990000,0,0,1990000,Null,Null,161178498,49994,1795
161211125,956.0,956.0,140000,86000,54000,39,140000,Null,Null,161211125,4766405,1631
161216768,29.0,29.0,799000,589000,210000,26,799000,Null,Null,161216768,46363,5384
161216789,22.0,22.0,1199000,989000,210000,18,1199000,Null,Null,161216789,46363,5385
161225352,48.0,48.0,13900,13900,0,0,13900,Null,Null,161225352,111461,2363
161236218,9.0,9.0,418000,271700,146300,35,418000,Null,Null,161236218,111461,2
161240462,0.0,0.0,1650,1650,0,0,1650,Null,Null,161240462,111461,2
161249996,92.0,92.0,188000,188000,0,0,188000,Null,Null,161249996,149308,28682
161256062,321.0,321.0,139000,113000,26000,19,139000,Null,Null,161256062,112886,1613
161256063,271.0,271.0,69000,66100,2900,4,69000,Null,Null,161256063,112886,8212
161261771,11.0,11.0,1000,1000,0,0,1000,Null,Null,161261771,111461,2
161298033,172.0,172.0,182000,140000,42000,23,182000,Null,Null,161298033,48077,2234
161344255,0.0,0.0,6500000,6500000,0,0,6500000,Null,Null,161344255,111461,15250
161344259,0.0,0.0,12500000,12500000,0,0,12500000,Null,Null,161344259,111461,15250
161368381,2.0,2.0,399000,255000,144000,36,399000,Null,Null,161368381,182293,8206
161385088,3.0,3.0,25000,25000,0,0,25000,Null,Null,161385088,111461,2
161395935,73.0,73.0,119000,119000,0,0,119000,Null,Null,161395935,111461,28598
161397043,55.0,55.0,39000,39000,0,0,39000,Null,Null,161397043,111461,28484
161397226,81.0,81.0,99000,99000,0,0,99000,Null,Null,161397226,162313,28426
161397316,22.0,22.0,190000,190000,0,0,190000,Null,Null,161397316,111461,28428
161455577,34.0,34.0,45400,45400,0,0,45400,Null,Null,161455577,111461,2
161455624,1092.0,1092.0,49000,48000,1000,2,49000,Null,Null,161455624,111461,2
161456144,0.0,0.0,77000000,77000000,0,0,77000000,Null,Null,161456144,4235555,2340
161456430,0.0,0.0,39283000,39283000,0,0,39283000,Null,Null,161456430,111461,20254
161457693,0.0,0.0,0,2000,0,0,2000,Null,Null,161457693,111461,0
161458777,0.0,0.0,16950000,16950000,0,0,16950000,Null,Null,161458777,50307,7079
161458834,0.0,0.0,29000000,29000000,0,0,29000000,Null,Null,161458834,4235555,2340
161458913,0.0,0.0,27000000,27000000,0,0,27000000,Null,Null,161458913,4235555,2340
161459206,0.0,0.0,44000000,44000000,0,0,44000000,Null,Null,161459206,4235555,2340
161459843,0.0,0.0,43000000,43000000,0,0,43000000,Null,Null,161459843,4235555,2340
161464936,81.0,81.0,220000,151000,69000,31,220000,Null,Null,161464936,111461,23184
161465473,0.0,0.0,2000,2000,0,0,2000,Null,Null,161465473,111461,2
161465566,0.0,0.0,4200,4200,0,0,4200,Null,Null,161465566,111461,2
161465586,0.0,0.0,3000,3000,0,0,3000,Null,Null,161465586,111461,2
161465595,25.0,25.0,6500,6500,0,0,6500,Null,Null,161465595,111461,2
161465620,8.0,8.0,7500,7500,0,0,7500,Null,Null,161465620,111461,2
161465787,0.0,0.0,3500,3500,0,0,3500,Null,Null,161465787,111461,2
161465977,5.0,5.0,9000,9000,0,0,9000,Null,Null,161465977,111461,2
161488159,250.0,250.0,89000,67000,22000,25,89000,Null,Null,161488159,111461,23184
161490393,1323.0,1323.0,16000,13000,3000,19,16000,Null,Null,161490393,4766405,1752
161493461,0.0,0.0,15000000,9900000,5100000,34,15000000,Null,Null,161493461,5215439,2340
161493630,409.0,409.0,700000,455000,245000,35,700000,Null,Null,161493630,713343,11845
161501208,195.0,195.0,539000,269000,270000,50,539000,Null,Null,161501208,19813,2136
161509961,0.0,0.0,5000,5000,0,0,5000,Null,Null,161509961,111461,2
161510662,79.0,79.0,579000,289000,290000,50,579000,Null,Null,161510662,19813,2136
161522816,11.0,11.0,200000,200000,0,0,200000,Null,Null,161522816,111461,2
161522862,35.0,35.0,99000,99000,0,0,99000,Null,Null,161522862,111461,2
161522889,1.0,1.0,19000,19000,0,0,19000,Null,Null,161522889,111461,2
161522894,19.0,19.0,149000,149000,0,0,149000,Null,Null,161522894,111461,2
161522981,8.0,8.0,59000,59000,0,0,59000,Null,Null,161522981,111461,2
161523086,8.0,8.0,200000,200000,0,0,200000,Null,Null,161523086,111461,2
161523242,39.0,39.0,25000,25000,0,0,25000,Null,Null,161523242,111461,2
161523391,39.0,39.0,58800,58800,0,0,58800,Null,Null,161523391,111461,2
161523475,16.0,16.0,135000,135000,0,0,135000,Null,Null,161523475,111461,2
161524196,204.0,204.0,1819000,909000,910000,50,1819000,Null,Null,161524196,19813,2136
161524513,121.0,121.0,2099000,1049000,1050000,50,2099000,Null,Null,161524513,19813,2136
161528424,0.0,0.0,12500000,12500000,0,0,12500000,Null,Null,161528424,111461,15250
161528430,0.0,0.0,6800000,6800000,0,0,6800000,Null,Null,161528430,111461,15250
161528452,0.0,0.0,6500000,6500000,0,0,6500000,Null,Null,161528452,111461,15250
161528458,0.0,0.0,4500000,4500000,0,0,4500000,Null,Null,161528458,111461,15250
161538046,257.0,257.0,99000,79000,20000,20,99000,Null,Null,161538046,5203971,2685
161538136,161.0,161.0,210000,145000,65000,31,210000,Null,Null,161538136,5010125,8212
161541208,102.0,102.0,295000,295000,0,0,295000,Null,Null,161541208,111454,12294
161550675,0.0,0.0,8500000,8500000,0,0,8500000,Null,Null,161550675,111461,15250
161550682,0.0,0.0,6500000,6500000,0,0,6500000,Null,Null,161550682,111461,15250
161550696,0.0,0.0,6500000,6500000,0,0,6500000,Null,Null,161550696,111461,15250
161550706,0.0,0.0,8500000,8500000,0,0,8500000,Null,Null,161550706,111461,15250
161550708,0.0,0.0,6500000,6500000,0,0,6500000,Null,Null,161550708,111461,15250
161550712,0.0,0.0,11500000,11500000,0,0,11500000,Null,Null,161550712,111461,15250
161550732,0.0,0.0,6800000,6800000,0,0,6800000,Null,Null,161550732,111461,15250
161553090,134.0,134.0,79000,79000,0,0,79000,Null,Null,161553090,18984,1837
161877006,0.0,0.0,10000,10000,0,0,10000,Null,Null,161877006,111461,2
161878808,91.0,91.0,145000,119000,26000,18,145000,Null,Null,161878808,111461,23184
161889357,0.0,0.0,15299000,15299000,0,0,15299000,Null,Null,161889357,74999,8066
161934195,2.0,2.0,8999,8999,0,0,8999,Null,Null,161934195,111461,2
161935679,0.0,0.0,2400,2400,0,0,2400,Null,Null,161935679,111461,2
161935764,0.0,0.0,10000,10000,0,0,10000,Null,Null,161935764,111461,2
161935897,0.0,0.0,4800,2400,2400,50,4800,Null,Null,161935897,111461,2
161936211,12.0,12.0,2400,2400,0,0,2400,Null,Null,161936211,111461,2
161936311,0.0,0.0,2400,2400,0,0,2400,Null,Null,161936311,111461,2
161936500,0.0,0.0,2400,2400,0,0,2400,Null,Null,161936500,111461,2
161939590,23.0,23.0,1749000,1049000,700000,40,1749000,Null,Null,161939590,19813,2136
161939744,0.0,0.0,9000,9000,0,0,9000,Null,Null,161939744,111461,8194
161939764,47.0,47.0,9000,9000,0,0,9000,Null,Null,161939764,111461,8194
161941894,28.0,28.0,20000,20000,0,0,20000,Null,Null,161941894,111461,2
161942361,46.0,46.0,80000,80000,0,0,80000,Null,Null,161942361,111461,2
161944685,81.0,81.0,29000,29000,0,0,29000,Null,Null,161944685,111461,2514
161955965,345.0,345.0,35000,25000,10000,29,35000,Null,Null,161955965,151647,8305
161956615,15.0,15.0,2000,2000,0,0,2000,Null,Null,161956615,111461,3710
161971828,0.0,0.0,18000,18000,0,0,18000,Null,Null,161971828,111461,15320
161974516,82.0,82.0,70000,49000,21000,30,70000,Null,Null,161974516,251107,11835
161979773,0.0,0.0,47500000,47500000,0,0,47500000,Null,Null,161979773,433227,2340
162024935,3.0,3.0,7000,7000,0,0,7000,Null,Null,162024935,111461,20222
162025092,1.0,1.0,5000,5000,0,0,5000,Null,Null,162025092,111461,20222
162025703,149.0,149.0,535000,183000,352000,66,535000,Null,Null,162025703,166495,28574
162028506,385.0,385.0,99000,59000,40000,40,99000,Null,Null,162028506,625265,28574
162029801,0.0,0.0,1200000,1200000,0,0,1200000,Null,Null,162029801,111461,15250
162030596,6.0,6.0,35000,35000,0,0,35000,Null,Null,162030596,255877,8516
162031744,6.0,6.0,50000,50000,0,0,50000,Null,Null,162031744,111461,8516
162031872,0.0,0.0,40000,40000,0,0,40000,Null,Null,162031872,111461,5385
162032496,8.0,8.0,98999,94554,4445,4,98999,Null,Null,162032496,111461,28484
162033749,64.0,64.0,65000,44899,20101,31,65000,Null,Null,162033749,111461,28484
162042619,0.0,0.0,2200,2200,0,0,2200,Null,Null,162042619,111461,2225
162044724,0.0,0.0,1450,1450,0,0,1450,Null,Null,162044724,111461,2225
162060191,76.0,76.0,650000,618000,32000,5,650000,Null,Null,162060191,189445,28596
162085003,46.0,46.0,1700,1700,0,0,1700,Null,Null,162085003,111461,2
162085086,6.0,6.0,2000,2000,0,0,2000,Null,Null,162085086,111461,2
162089024,0.0,0.0,18500000,18500000,0,0,18500000,Null,Null,162089024,111461,15250
162089026,0.0,0.0,6500000,6500000,0,0,6500000,Null,Null,162089026,111461,15250
162089047,0.0,0.0,15500000,15500000,0,0,15500000,Null,Null,162089047,111461,15250
162092119,0.0,0.0,1500,1500,0,0,1500,Null,Null,162092119,111461,2
162101612,156.0,156.0,165000,165000,0,0,165000,Null,Null,162101612,111461,23592
162112331,32.0,32.0,650000,618000,32000,5,650000,Null,Null,162112331,189445,28596
162116326,68.0,68.0,899000,899000,0,0,899000,Null,Null,162116326,5047129,1626
162134279,2.0,2.0,890000,890000,0,0,890000,Null,Null,162134279,5403099,15250
162134479,1.0,1.0,580000,580000,0,0,580000,Null,Null,162134479,5403099,15250
162137920,36.0,36.0,24000,24000,0,0,24000,Null,Null,162137920,111461,2
162144054,119.0,119.0,150000,150000,0,0,150000,Null,Null,162144054,372895,1583
162144843,20.0,20.0,60000,60000,0,0,60000,Null,Null,162144843,110944,23520
162145601,15.0,15.0,720000,720000,0,0,720000,Null,Null,162145601,46363,5384
162148679,2.0,2.0,28999,28999,0,0,28999,Null,Null,162148679,162313,28574
162154641,18.0,18.0,619000,549000,70000,11,619000,Null,Null,162154641,46363,5384
162157162,0.0,0.0,1999,1999,0,0,1999,Null,Null,162157162,111461,2
162157251,10.0,10.0,1999,1999,0,0,1999,Null,Null,162157251,111461,2
162157340,30.0,30.0,1999,1999,0,0,1999,Null,Null,162157340,111461,2
162157368,111.0,111.0,89999,89999,0,0,89999,Null,Null,162157368,111461,2
162157390,14.0,14.0,1500,1500,0,0,1500,Null,Null,162157390,111461,2
162157573,6.0,6.0,1999,1999,0,0,1999,Null,Null,162157573,111461,2
162157819,3.0,3.0,2000,2000,0,0,2000,Null,Null,162157819,111461,2
162158213,61.0,61.0,1000,1000,0,0,1000,Null,Null,162158213,111461,2
162158299,60.0,60.0,1999,1999,0,0,1999,Null,Null,162158299,111461,2
162158333,0.0,0.0,1999,1999,0,0,1999,Null,Null,162158333,111461,2
162159265,1.0,1.0,1500,1500,0,0,1500,Null,Null,162159265,111461,2
162159658,0.0,0.0,2399,2399,0,0,2399,Null,Null,162159658,111461,2
162159787,0.0,0.0,1899,1899,0,0,1899,Null,Null,162159787,111461,2
162159893,1.0,1.0,1500,1500,0,0,1500,Null,Null,162159893,111461,2
162160370,2.0,2.0,1499,1499,0,0,1499,Null,Null,162160370,111461,2
162168460,0.0,0.0,99990000,56990000,43000000,43,99990000,Null,Null,162168460,4712171,2340
162168462,7.0,7.0,39990000,39990000,0,0,39990000,Null,Null,162168462,4712171,2340
162168764,102.0,102.0,750000,713000,37000,5,750000,Null,Null,162168764,189445,28596
162169413,101.0,101.0,12000,9000,3000,25,12000,Null,Null,162169413,424177,11889
162173375,2.0,2.0,5500,5500,0,0,5500,Null,Null,162173375,111461,8193
162173406,0.0,0.0,1300,1300,0,0,1300,Null,Null,162173406,111461,27214
162173501,0.0,0.0,1500,1500,0,0,1500,Null,Null,162173501,111461,23134
162173588,0.0,0.0,2000,2000,0,0,2000,Null,Null,162173588,111461,6948
162173624,67.0,67.0,2000,2000,0,0,2000,Null,Null,162173624,111461,6948
162173635,1.0,1.0,9000,9000,0,0,9000,Null,Null,162173635,111461,1520
162173661,0.0,0.0,2500,2500,0,0,2500,Null,Null,162173661,111461,23134
162173770,0.0,0.0,1500,1500,0,0,1500,Null,Null,162173770,111461,5450
162173865,0.0,0.0,3500,3500,0,0,3500,Null,Null,162173865,111461,8193
162174069,8.0,8.0,9000,9000,0,0,9000,Null,Null,162174069,111461,1520
162177437,197.0,197.0,2000,2000,0,0,2000,Null,Null,162177437,111461,18876
162189829,156.0,156.0,165000,165000,0,0,165000,Null,Null,162189829,173743,23078
162196352,276.0,276.0,1000000,950000,50000,5,1000000,Null,Null,162196352,64932,17170
162196430,490.0,490.0,600000,580000,20000,3,600000,Null,Null,162196430,64932,1583
162196436,115.0,115.0,1000000,920000,80000,8,1000000,Null,Null,162196436,64932,1583
162199076,0.0,0.0,4000,4000,0,0,4000,Null,Null,162199076,111461,2
162199342,0.0,0.0,7000,7000,0,0,7000,Null,Null,162199342,111461,2
162210732,0.0,0.0,268000,268000,0,0,268000,Null,Null,162210732,46703,2266
162235693,1.0,1.0,15000,15000,0,0,15000,Null,Null,162235693,111461,2
162260458,0.0,0.0,5990000,5990000,0,0,5990000,Null,Null,162260458,31701,2340
162261558,62.0,62.0,55000,55000,0,0,55000,Null,Null,162261558,111461,4593
162342026,0.0,0.0,64000000,64000000,0,0,64000000,Null,Null,162342026,195775,23710
162342961,33.0,33.0,8499000,4499000,4000000,47,8499000,Null,Null,162342961,432537,8165
162355432,3.0,3.0,7900000,5900000,2000000,25,7900000,Null,Null,162355432,5656587,1794
162361388,3.0,3.0,815000,578650,236350,29,815000,Null,Null,162361388,26150,8513
162361392,3.0,3.0,1737000,1239000,498000,29,1737000,Null,Null,162361392,26150,8513
162370998,0.0,0.0,103000000,103000000,0,0,103000000,Null,Null,162370998,195775,23710
162383851,0.0,0.0,2900,2900,0,0,2900,Null,Null,162383851,111461,2
162388038,52.0,52.0,12000,12000,0,0,12000,Null,Null,162388038,561415,49722
162405009,0.0,0.0,12500000,12500000,0,0,12500000,Null,Null,162405009,111461,15250
162405017,0.0,0.0,12500000,12500000,0,0,12500000,Null,Null,162405017,111461,15250
162405036,0.0,0.0,6500000,6500000,0,0,6500000,Null,Null,162405036,111461,15250
162405041,0.0,0.0,6500000,6500000,0,0,6500000,Null,Null,162405041,111461,15250
162405538,0.0,0.0,56000000,56000000,0,0,56000000,Null,Null,162405538,111461,23708
162406110,0.0,0.0,5600,5600,0,0,5600,Null,Null,162406110,111461,2
162406191,3.0,3.0,29549,26426,3123,11,29549,Null,Null,162406191,111461,2
162406985,29.0,29.0,1500,1500,0,0,1500,Null,Null,162406985,111461,4408
162407312,0.0,0.0,1300,1300,0,0,1300,Null,Null,162407312,111461,2
162433228,0.0,0.0,2200,2200,0,0,2200,Null,Null,162433228,111461,2225
162448623,9.0,9.0,1450,1450,0,0,1450,Null,Null,162448623,111461,2225
162454480,7.0,7.0,2000,2000,0,0,2000,Null,Null,162454480,111461,2
162473705,0.0,0.0,4716000,4716000,0,0,4716000,Null,Null,162473705,25422,1795
162475814,218.0,218.0,99875,99875,0,0,99875,Null,Null,162475814,21653,28482
162515998,1.0,1.0,168000,168000,0,0,168000,Null,Null,162515998,111461,8512
162524211,0.0,0.0,9500,9500,0,0,9500,Null,Null,162524211,111461,2
162524320,10.0,10.0,54999,54999,0,0,54999,Null,Null,162524320,111461,2
162525329,6.0,6.0,1500,1500,0,0,1500,Null,Null,162525329,111461,2
162526068,1108.0,1108.0,49000,49000,0,0,49000,Null,Null,162526068,520061,23416
162548473,1819.0,1819.0,95000,95000,0,0,95000,Null,Null,162548473,738187,23622
162548943,0.0,0.0,6350000,6350000,0,0,6350000,Null,Null,162548943,885749,8511
162549117,0.0,0.0,6350000,6350000,0,0,6350000,Null,Null,162549117,885749,8511
162582680,0.0,0.0,39998,19999,19999,50,39998,Null,Null,162582680,162313,28576
162583902,53.0,53.0,25990000,17700000,8290000,32,25990000,Null,Null,162583902,18802,1795
162583980,56.0,56.0,27490000,21970000,5520000,20,27490000,Null,Null,162583980,18802,1795
162587217,28.0,28.0,180000,180000,0,0,180000,Null,Null,162587217,111461,23658
162588731,57.0,57.0,190000,190000,0,0,190000,Null,Null,162588731,865409,7078
162589510,71.0,71.0,181000,162900,18100,10,181000,Null,Null,162589510,111461,28596
162589997,0.0,0.0,7760000,7760000,0,0,7760000,Null,Null,162589997,885749,8511
162590074,0.0,0.0,9310000,7760000,1550000,17,9310000,Null,Null,162590074,885749,8511
162593114,55.0,55.0,30990000,24770000,6220000,20,30990000,Null,Null,162593114,18802,1795
162593136,212.0,212.0,33990000,27160000,6830000,20,33990000,Null,Null,162593136,18802,1795
162593187,38.0,38.0,36990000,36990000,0,0,36990000,Null,Null,162593187,18802,1795
162593229,0.0,0.0,20500000,17700000,2800000,14,20500000,Null,Null,162593229,18802,1794
162593286,0.0,0.0,24000000,22500000,1500000,6,24000000,Null,Null,162593286,18802,1794
162594094,73.0,73.0,79000,79000,0,0,79000,Null,Null,162594094,179387,23702
162597623,5.0,5.0,1399000,1199000,200000,14,1399000,Null,Null,162597623,46363,5385
162597633,175.0,175.0,24000,24000,0,0,24000,Null,Null,162597633,111461,23588
162597803,11.0,11.0,1699000,1199000,500000,29,1699000,Null,Null,162597803,46363,5385
162616715,4.0,4.0,979000,979000,0,0,979000,Null,Null,162616715,46363,5384
162713454,0.0,0.0,760000,380000,380000,50,760000,Null,Null,162713454,111461,23246
162728553,0.0,0.0,4716000,4716000,0,0,4716000,Null,Null,162728553,25422,1795
162750369,3.0,3.0,355000,240000,115000,32,355000,Null,Null,162750369,173547,15320
162752403,0.0,0.0,7000,7000,0,0,7000,Null,Null,162752403,111461,2
162752414,0.0,0.0,6000,6000,0,0,6000,Null,Null,162752414,111461,2
162752454,0.0,0.0,10000,10000,0,0,10000,Null,Null,162752454,111461,2
162767387,1.0,1.0,1009,1009,0,0,1009,Null,Null,162767387,111461,2
162770358,2.0,2.0,2000,2000,0,0,2000,Null,Null,162770358,111461,2
162770407,0.0,0.0,2000,2000,0,0,2000,Null,Null,162770407,111461,2
162772687,143.0,143.0,594000,594000,0,0,594000,Null,Null,162772687,18984,1838
162777054,0.0,0.0,1000,1000,0,0,1000,Null,Null,162777054,111461,2
162777111,6.0,6.0,3500,3500,0,0,3500,Null,Null,162777111,111461,2
162814199,0.0,0.0,7150000,7150000,0,0,7150000,Null,Null,162814199,885749,8511
162826030,33.0,33.0,12900000,11360000,1540000,12,12900000,Null,Null,162826030,20215,2324
162838907,21.0,21.0,1899000,1660000,239000,13,1899000,Null,Null,162838907,19018,2334
162841377,46.0,46.0,499000,499000,0,0,499000,Null,Null,162841377,111461,11935
162841493,18.0,18.0,990000,885000,105000,11,990000,Null,Null,162841493,19018,1634
162841495,18.0,18.0,790000,703000,87000,11,790000,Null,Null,162841495,19018,1634
162866839,11.0,11.0,3146000,2500000,646000,21,3146000,Null,Null,162866839,171169,1794
162874953,0.0,0.0,2000,2000,0,0,2000,Null,Null,162874953,111461,53074
162966753,3.0,3.0,4000,4000,0,0,4000,Null,Null,162966753,111461,2
162969496,431.0,431.0,99000,99000,0,0,99000,Null,Null,162969496,1099817,8305
162969504,1081.0,1081.0,278000,278000,0,0,278000,Null,Null,162969504,1099817,8305
162995487,133.0,133.0,89000,80100,8900,10,89000,Null,Null,162995487,111461,28596
163015014,0.0,0.0,15000,15000,0,0,15000,Null,Null,163015014,111461,15318
163016862,25.0,25.0,25000,25000,0,0,25000,Null,Null,163016862,111461,2
163025008,64.0,64.0,4000,4000,0,0,4000,Null,Null,163025008,4187373,20190
163033894,17.0,17.0,3000,3000,0,0,3000,Null,Null,163033894,111461,53054
163034018,0.0,0.0,12600000,12600000,0,0,12600000,Null,Null,163034018,433157,7079
163034025,143.0,143.0,2000,2000,0,0,2000,Null,Null,163034025,111461,2
163038330,0.0,0.0,68540000,44551000,23989000,35,68540000,Null,Null,163038330,561415,23376
163039754,1.0,1.0,4716000,4716000,0,0,4716000,Null,Null,163039754,25422,1795
163163281,148.0,148.0,1050000,748000,302000,29,1050000,Null,Null,163163281,19018,1634
163170278,120.0,120.0,1900,1900,0,0,1900,Null,Null,163170278,111461,18876
163266114,27.0,27.0,2000,2000,0,0,2000,Null,Null,163266114,111461,53074
163281226,127.0,127.0,120000,84000,36000,30,120000,Null,Null,163281226,25643,5007
163281266,3.0,3.0,8900,8900,0,0,8900,Null,Null,163281266,406683,1633
163282898,0.0,0.0,12900,12000,900,7,12900,Null,Null,163282898,111461,2
163297433,20.0,20.0,159000,159000,0,0,159000,Null,Null,163297433,49128,3804
163297630,0.0,0.0,6010000,6010000,0,0,6010000,Null,Null,163297630,111643,8513
163297657,0.0,0.0,6010000,6010000,0,0,6010000,Null,Null,163297657,111643,8513
163297824,0.0,0.0,1999,1999,0,0,1999,Null,Null,163297824,111461,2
163297864,0.0,0.0,1500,1500,0,0,1500,Null,Null,163297864,111461,2
163298191,0.0,0.0,1999,1999,0,0,1999,Null,Null,163298191,111461,2
163298670,0.0,0.0,2500,2500,0,0,2500,Null,Null,163298670,111461,2
163299049,0.0,0.0,1000,1000,0,0,1000,Null,Null,163299049,111461,2
163299175,0.0,0.0,2199,2199,0,0,2199,Null,Null,163299175,111461,2
163299339,72.0,72.0,186000,167400,18600,10,186000,Null,Null,163299339,111461,28596
163299500,0.0,0.0,1499,1499,0,0,1499,Null,Null,163299500,111461,2
163299510,31.0,31.0,1999,1999,0,0,1999,Null,Null,163299510,111461,2
163299700,0.0,0.0,2000,2000,0,0,2000,Null,Null,163299700,111461,2
163299710,0.0,0.0,1500,1500,0,0,1500,Null,Null,163299710,111461,2
163300179,9.0,9.0,1999,1999,0,0,1999,Null,Null,163300179,111461,2
163300821,0.0,0.0,1300,1300,0,0,1300,Null,Null,163300821,111461,2
163301174,25.0,25.0,1899,1899,0,0,1899,Null,Null,163301174,111461,2
163301295,10.0,10.0,1500,1500,0,0,1500,Null,Null,163301295,111461,2
163318271,0.0,0.0,15000000,15000000,0,0,15000000,Null,Null,163318271,18802,1795
163398765,14.0,14.0,105000,79000,26000,25,105000,Null,Null,163398765,5132069,6305
163550425,57.0,57.0,500000,399000,101000,20,500000,Null,Null,163550425,5405899,23376
163560846,0.0,0.0,269000,269000,0,0,269000,Null,Null,163560846,561415,49722
163569501,0.0,0.0,14000,14000,0,0,14000,Null,Null,163569501,561415,15318
163572573,2.0,2.0,14000,14000,0,0,14000,Null,Null,163572573,561415,15318
163573877,5.0,5.0,200000,169000,31000,16,200000,Null,Null,163573877,255877,8512
163574136,0.0,0.0,199000,199000,0,0,199000,Null,Null,163574136,274953,8513
163687268,33.0,33.0,1600,1600,0,0,1600,Null,Null,163687268,111461,2514
163701407,27.0,27.0,290000,179000,111000,38,290000,Null,Null,163701407,562001,3426
163703503,159.0,159.0,150000,137000,13000,9,150000,Null,Null,163703503,561415,1634
163704059,766.0,766.0,60000,31000,29000,48,60000,Null,Null,163704059,192731,8305
163708918,206.0,206.0,125000,125000,0,0,125000,Null,Null,163708918,18802,1820
163712622,129.0,129.0,28812,28812,0,0,28812,Null,Null,163712622,561415,28484
163714587,0.0,0.0,2000,2000,0,0,2000,Null,Null,163714587,111461,2
163715252,0.0,0.0,2000,2000,0,0,2000,Null,Null,163715252,111461,2
163731514,4.0,4.0,5000,5000,0,0,5000,Null,Null,163731514,111461,8073
163731565,3.0,3.0,8000,8000,0,0,8000,Null,Null,163731565,111461,20254
163731569,0.0,0.0,1000,1000,0,0,1000,Null,Null,163731569,111461,20254
163731605,26.0,26.0,5000,5000,0,0,5000,Null,Null,163731605,111461,20254
163731610,0.0,0.0,3000,3000,0,0,3000,Null,Null,163731610,111461,20254
163731634,30.0,30.0,1000,1000,0,0,1000,Null,Null,163731634,111461,20254
163731649,0.0,0.0,7000,7000,0,0,7000,Null,Null,163731649,111461,20254
163731672,4.0,4.0,4000,4000,0,0,4000,Null,Null,163731672,111461,20254
163731688,0.0,0.0,8000,8000,0,0,8000,Null,Null,163731688,111461,20254
163731692,0.0,0.0,8000,8000,0,0,8000,Null,Null,163731692,111461,20254
163731699,2.0,2.0,1000,1000,0,0,1000,Null,Null,163731699,111461,20254
163731700,0.0,0.0,5000,5000,0,0,5000,Null,Null,163731700,111461,20254
163731704,6.0,6.0,6000,6000,0,0,6000,Null,Null,163731704,111461,20254
163731707,38.0,38.0,2000,2000,0,0,2000,Null,Null,163731707,111461,20254
163731709,6.0,6.0,8000,8000,0,0,8000,Null,Null,163731709,111461,20254
163731750,0.0,0.0,2000,2000,0,0,2000,Null,Null,163731750,111461,20254
163731754,3.0,3.0,8000,8000,0,0,8000,Null,Null,163731754,111461,20254
163731762,0.0,0.0,6000,6000,0,0,6000,Null,Null,163731762,111461,20254
163731770,0.0,0.0,3000,3000,0,0,3000,Null,Null,163731770,111461,20254
163731778,0.0,0.0,3000,3000,0,0,3000,Null,Null,163731778,111461,20254
163731782,0.0,0.0,2000,2000,0,0,2000,Null,Null,163731782,111461,20254
163731785,0.0,0.0,8000,8000,0,0,8000,Null,Null,163731785,111461,20254
163731790,0.0,0.0,2000,2000,0,0,2000,Null,Null,163731790,111461,20254
163731791,0.0,0.0,2000,2000,0,0,2000,Null,Null,163731791,111461,20254
163731798,8.0,8.0,9000,9000,0,0,9000,Null,Null,163731798,111461,20254
163731866,0.0,0.0,2000,2000,0,0,2000,Null,Null,163731866,111461,20254
163731871,0.0,0.0,2500,2500,0,0,2500,Null,Null,163731871,111461,20254
163731875,0.0,0.0,3000,3000,0,0,3000,Null,Null,163731875,111461,20254
163731879,0.0,0.0,7000,7000,0,0,7000,Null,Null,163731879,111461,20254
163731881,0.0,0.0,6000,6000,0,0,6000,Null,Null,163731881,111461,20254
163731913,0.0,0.0,9500,9500,0,0,9500,Null,Null,163731913,111461,20254
163731948,0.0,0.0,3000,3000,0,0,3000,Null,Null,163731948,111461,20254
163731954,0.0,0.0,5000,5000,0,0,5000,Null,Null,163731954,111461,20254
163731958,2.0,2.0,3000,3000,0,0,3000,Null,Null,163731958,111461,20254
163731966,0.0,0.0,1500,1500,0,0,1500,Null,Null,163731966,111461,20254
163731967,0.0,0.0,5000,5000,0,0,5000,Null,Null,163731967,111461,20254
163731978,0.0,0.0,8000,8000,0,0,8000,Null,Null,163731978,111461,20254
163731979,11.0,11.0,6000,6000,0,0,6000,Null,Null,163731979,111461,20254
163731983,0.0,0.0,5000,5000,0,0,5000,Null,Null,163731983,111461,20254
163732013,0.0,0.0,8000,8000,0,0,8000,Null,Null,163732013,111461,20254
163732028,10.0,10.0,2500,2500,0,0,2500,Null,Null,163732028,111461,20254
163732033,25.0,25.0,1500,1500,0,0,1500,Null,Null,163732033,111461,20254
163732048,0.0,0.0,5000,5000,0,0,5000,Null,Null,163732048,111461,20254
163732082,0.0,0.0,3000,3000,0,0,3000,Null,Null,163732082,111461,20254
163732092,4.0,4.0,6500,6500,0,0,6500,Null,Null,163732092,111461,20254
163732109,5.0,5.0,3000,3000,0,0,3000,Null,Null,163732109,111461,20254
163732113,10.0,10.0,3000,3000,0,0,3000,Null,Null,163732113,111461,20254
163732115,5.0,5.0,1000,1000,0,0,1000,Null,Null,163732115,111461,20254
163732117,0.0,0.0,8000,8000,0,0,8000,Null,Null,163732117,111461,20254
163732121,0.0,0.0,2000,2000,0,0,2000,Null,Null,163732121,111461,20254
163732158,0.0,0.0,3000,3000,0,0,3000,Null,Null,163732158,111461,20254
163732182,0.0,0.0,4000,4000,0,0,4000,Null,Null,163732182,111461,20254
163732185,13.0,13.0,8000,8000,0,0,8000,Null,Null,163732185,111461,20254
163732191,0.0,0.0,5000,5000,0,0,5000,Null,Null,163732191,111461,20254
163732198,57.0,57.0,1500,1500,0,0,1500,Null,Null,163732198,111461,20254
163732200,0.0,0.0,8000,8000,0,0,8000,Null,Null,163732200,111461,20254
163732209,6.0,6.0,7000,7000,0,0,7000,Null,Null,163732209,111461,20254
163732233,10.0,10.0,3000,3000,0,0,3000,Null,Null,163732233,111461,20254
163732277,0.0,0.0,3000,3000,0,0,3000,Null,Null,163732277,111461,20254
163732286,0.0,0.0,7000,7000,0,0,7000,Null,Null,163732286,111461,20254
163732301,0.0,0.0,7000,7000,0,0,7000,Null,Null,163732301,111461,20254
163732302,0.0,0.0,8000,8000,0,0,8000,Null,Null,163732302,111461,20254
163732304,0.0,0.0,3000,3000,0,0,3000,Null,Null,163732304,111461,20254
163732306,10.0,10.0,4000,4000,0,0,4000,Null,Null,163732306,111461,20254
163732307,19.0,19.0,1000,1000,0,0,1000,Null,Null,163732307,111461,20254
163732312,0.0,0.0,3000,3000,0,0,3000,Null,Null,163732312,111461,20254
163732315,0.0,0.0,4000,4000,0,0,4000,Null,Null,163732315,111461,20254
163732329,10.0,10.0,3000,3000,0,0,3000,Null,Null,163732329,111461,20254
163732334,25.0,25.0,8000,8000,0,0,8000,Null,Null,163732334,111461,20254
163732354,0.0,0.0,4000,4000,0,0,4000,Null,Null,163732354,111461,20254
163732370,22.0,22.0,4000,4000,0,0,4000,Null,Null,163732370,111461,20254
163732374,15.0,15.0,5000,5000,0,0,5000,Null,Null,163732374,111461,20254
163732383,0.0,0.0,5000,5000,0,0,5000,Null,Null,163732383,111461,20254
163732397,0.0,0.0,9000,9000,0,0,9000,Null,Null,163732397,111461,20254
163732406,0.0,0.0,3000,3000,0,0,3000,Null,Null,163732406,111461,20254
163732418,0.0,0.0,2000,2000,0,0,2000,Null,Null,163732418,111461,20254
163732449,14.0,14.0,4000,4000,0,0,4000,Null,Null,163732449,111461,20254
163732453,0.0,0.0,1000,1000,0,0,1000,Null,Null,163732453,111461,20254
163732454,0.0,0.0,3000,3000,0,0,3000,Null,Null,163732454,111461,20254
163732475,10.0,10.0,2000,2000,0,0,2000,Null,Null,163732475,111461,20254
163732478,0.0,0.0,6000,6000,0,0,6000,Null,Null,163732478,111461,20254
163732482,0.0,0.0,1000,1000,0,0,1000,Null,Null,163732482,111461,20254
163732484,0.0,0.0,6000,6000,0,0,6000,Null,Null,163732484,111461,20254
163732503,5.0,5.0,6000,6000,0,0,6000,Null,Null,163732503,111461,20254
163732506,0.0,0.0,1500,1500,0,0,1500,Null,Null,163732506,111461,20254
163732513,0.0,0.0,8000,8000,0,0,8000,Null,Null,163732513,111461,20254
163732515,0.0,0.0,2500,2500,0,0,2500,Null,Null,163732515,111461,20254
163732530,19.0,19.0,9000,9000,0,0,9000,Null,Null,163732530,111461,20254
163732546,0.0,0.0,1000,1000,0,0,1000,Null,Null,163732546,111461,20254
163732563,40.0,40.0,4000,4000,0,0,4000,Null,Null,163732563,111461,20254
163732594,0.0,0.0,5000,5000,0,0,5000,Null,Null,163732594,111461,20254
163732602,0.0,0.0,6000,6000,0,0,6000,Null,Null,163732602,111461,20254
163732614,0.0,0.0,2000,2000,0,0,2000,Null,Null,163732614,111461,20254
163732615,30.0,30.0,1000,1000,0,0,1000,Null,Null,163732615,111461,20254
163732629,71.0,71.0,2000,2000,0,0,2000,Null,Null,163732629,111461,20254
163732634,9.0,9.0,5000,5000,0,0,5000,Null,Null,163732634,111461,20254
163732673,14.0,14.0,2500,2500,0,0,2500,Null,Null,163732673,111461,20254
163732679,3.0,3.0,1000,1000,0,0,1000,Null,Null,163732679,111461,20254
163732705,0.0,0.0,1500,1500,0,0,1500,Null,Null,163732705,111461,20254
163732714,0.0,0.0,8000,8000,0,0,8000,Null,Null,163732714,111461,20254
163732727,0.0,0.0,5500,5500,0,0,5500,Null,Null,163732727,111461,20254
163732765,10.0,10.0,5000,5000,0,0,5000,Null,Null,163732765,111461,20254
163732769,2.0,2.0,7000,7000,0,0,7000,Null,Null,163732769,111461,20254
163732777,0.0,0.0,5000,5000,0,0,5000,Null,Null,163732777,111461,20254
163732809,0.0,0.0,6000,6000,0,0,6000,Null,Null,163732809,111461,20254
163732822,7.0,7.0,7000,7000,0,0,7000,Null,Null,163732822,111461,20254
163732824,0.0,0.0,5000,5000,0,0,5000,Null,Null,163732824,111461,20254
163732851,0.0,0.0,4000,4000,0,0,4000,Null,Null,163732851,111461,20254
163732864,0.0,0.0,3000,3000,0,0,3000,Null,Null,163732864,111461,20254
163732878,11.0,11.0,5000,5000,0,0,5000,Null,Null,163732878,111461,20254
163732887,0.0,0.0,5000,5000,0,0,5000,Null,Null,163732887,111461,20254
163732896,0.0,0.0,3000,3000,0,0,3000,Null,Null,163732896,111461,20254
163732903,2.0,2.0,7000,7000,0,0,7000,Null,Null,163732903,111461,20254
163732907,8.0,8.0,9000,9000,0,0,9000,Null,Null,163732907,111461,20254
163732911,10.0,10.0,4000,4000,0,0,4000,Null,Null,163732911,111461,20254
163732933,36.0,36.0,3500,3500,0,0,3500,Null,Null,163732933,111461,20254
163732946,0.0,0.0,1000,1000,0,0,1000,Null,Null,163732946,111461,20254
163732955,0.0,0.0,1000,1000,0,0,1000,Null,Null,163732955,111461,20254
163732957,18.0,18.0,2500,2500,0,0,2500,Null,Null,163732957,111461,20254
163732977,0.0,0.0,2000,2000,0,0,2000,Null,Null,163732977,111461,20254
163732979,6.0,6.0,3000,3000,0,0,3000,Null,Null,163732979,111461,20254
163732993,10.0,10.0,5000,5000,0,0,5000,Null,Null,163732993,111461,20254
163732999,60.0,60.0,3000,3000,0,0,3000,Null,Null,163732999,111461,20254
163733004,35.0,35.0,2000,2000,0,0,2000,Null,Null,163733004,111461,20254
163733013,0.0,0.0,3000,3000,0,0,3000,Null,Null,163733013,111461,20254
163733016,10.0,10.0,6000,6000,0,0,6000,Null,Null,163733016,111461,20254
163733033,0.0,0.0,1500,1500,0,0,1500,Null,Null,163733033,111461,20254
163733044,0.0,0.0,5000,5000,0,0,5000,Null,Null,163733044,111461,20254
163733050,0.0,0.0,6500,6500,0,0,6500,Null,Null,163733050,111461,20254
163733053,30.0,30.0,3000,3000,0,0,3000,Null,Null,163733053,111461,20254
163733068,2.0,2.0,3000,3000,0,0,3000,Null,Null,163733068,111461,20254
163733101,0.0,0.0,5000,5000,0,0,5000,Null,Null,163733101,111461,20254
163733102,0.0,0.0,1000,1000,0,0,1000,Null,Null,163733102,111461,20254
163733103,20.0,20.0,1000,1000,0,0,1000,Null,Null,163733103,111461,20254
163733104,0.0,0.0,1500,1500,0,0,1500,Null,Null,163733104,111461,20254
163733110,0.0,0.0,3000,3000,0,0,3000,Null,Null,163733110,111461,20254
163733113,0.0,0.0,4000,4000,0,0,4000,Null,Null,163733113,111461,20254
163733116,25.0,25.0,3000,3000,0,0,3000,Null,Null,163733116,111461,20254
163733126,0.0,0.0,7000,7000,0,0,7000,Null,Null,163733126,111461,20254
163733139,25.0,25.0,3000,3000,0,0,3000,Null,Null,163733139,111461,20254
163733140,20.0,20.0,6000,6000,0,0,6000,Null,Null,163733140,111461,20254
163733158,0.0,0.0,5000,5000,0,0,5000,Null,Null,163733158,111461,20254
163733176,0.0,0.0,7000,7000,0,0,7000,Null,Null,163733176,111461,20254
163733185,15.0,15.0,7000,7000,0,0,7000,Null,Null,163733185,111461,20254
163733190,12.0,12.0,8000,8000,0,0,8000,Null,Null,163733190,111461,20254
163733216,0.0,0.0,2000,2000,0,0,2000,Null,Null,163733216,111461,20254
163733223,164.0,164.0,3000,3000,0,0,3000,Null,Null,163733223,111461,20254
163733225,6.0,6.0,8000,8000,0,0,8000,Null,Null,163733225,111461,20254
163733228,30.0,30.0,2500,2500,0,0,2500,Null,Null,163733228,111461,20254
163733241,18.0,18.0,2000,2000,0,0,2000,Null,Null,163733241,111461,20254
163733250,12.0,12.0,2000,2000,0,0,2000,Null,Null,163733250,111461,20254
163733254,0.0,0.0,5000,5000,0,0,5000,Null,Null,163733254,111461,20254
163733276,6.0,6.0,1500,1500,0,0,1500,Null,Null,163733276,111461,20254
163733294,0.0,0.0,6000,6000,0,0,6000,Null,Null,163733294,111461,20254
163733297,5.0,5.0,5000,5000,0,0,5000,Null,Null,163733297,111461,20254
163733298,36.0,36.0,3000,3000,0,0,3000,Null,Null,163733298,111461,20254
163733305,0.0,0.0,5000,5000,0,0,5000,Null,Null,163733305,111461,20254
163733309,0.0,0.0,8000,8000,0,0,8000,Null,Null,163733309,111461,20254
163733313,0.0,0.0,4000,4000,0,0,4000,Null,Null,163733313,111461,20254
163733317,67.0,67.0,7000,7000,0,0,7000,Null,Null,163733317,111461,20254
163733370,5.0,5.0,9000,9000,0,0,9000,Null,Null,163733370,111461,20254
163733372,0.0,0.0,5000,5000,0,0,5000,Null,Null,163733372,111461,20254
163733402,40.0,40.0,1000,1000,0,0,1000,Null,Null,163733402,111461,20254
163733418,0.0,0.0,3500,3500,0,0,3500,Null,Null,163733418,111461,20254
163733428,0.0,0.0,1000,1000,0,0,1000,Null,Null,163733428,111461,20254
163733433,0.0,0.0,5000,5000,0,0,5000,Null,Null,163733433,111461,20254
163733444,4.0,4.0,3000,3000,0,0,3000,Null,Null,163733444,111461,20254
163733447,0.0,0.0,5000,5000,0,0,5000,Null,Null,163733447,111461,20254
163733456,157.0,157.0,7000,7000,0,0,7000,Null,Null,163733456,111461,20254
163733506,0.0,0.0,1000,1000,0,0,1000,Null,Null,163733506,111461,20254
163733515,0.0,0.0,2500,2500,0,0,2500,Null,Null,163733515,111461,20254
163733516,0.0,0.0,2000,2000,0,0,2000,Null,Null,163733516,111461,20254
163733528,22.0,22.0,6000,6000,0,0,6000,Null,Null,163733528,111461,20254
163733532,0.0,0.0,2000,2000,0,0,2000,Null,Null,163733532,111461,20254
163733542,2.0,2.0,4000,4000,0,0,4000,Null,Null,163733542,111461,20254
163733545,8.0,8.0,8000,8000,0,0,8000,Null,Null,163733545,111461,20254
163733551,0.0,0.0,7000,7000,0,0,7000,Null,Null,163733551,111461,20254
163733553,0.0,0.0,3500,3500,0,0,3500,Null,Null,163733553,111461,20254
163733559,14.0,14.0,2500,2500,0,0,2500,Null,Null,163733559,111461,20254
163733563,0.0,0.0,3000,3000,0,0,3000,Null,Null,163733563,111461,20254
163733587,10.0,10.0,2000,2000,0,0,2000,Null,Null,163733587,111461,20254
163733610,0.0,0.0,2500,2500,0,0,2500,Null,Null,163733610,111461,20254
163733625,4.0,4.0,5000,5000,0,0,5000,Null,Null,163733625,111461,20254
163733628,0.0,0.0,5000,5000,0,0,5000,Null,Null,163733628,111461,20254
163733632,0.0,0.0,2000,2000,0,0,2000,Null,Null,163733632,111461,20254
163733644,0.0,0.0,5000,5000,0,0,5000,Null,Null,163733644,111461,20254
163733663,0.0,0.0,5000,5000,0,0,5000,Null,Null,163733663,111461,20254
163733664,0.0,0.0,4000,4000,0,0,4000,Null,Null,163733664,111461,20254
163733670,5.0,5.0,3000,3000,0,0,3000,Null,Null,163733670,111461,20254
163733675,5.0,5.0,2000,2000,0,0,2000,Null,Null,163733675,111461,20254
163733677,0.0,0.0,1500,1500,0,0,1500,Null,Null,163733677,111461,20254
163733693,0.0,0.0,5000,5000,0,0,5000,Null,Null,163733693,111461,20254
163733699,10.0,10.0,2000,2000,0,0,2000,Null,Null,163733699,111461,20254
163733700,0.0,0.0,3000,3000,0,0,3000,Null,Null,163733700,111461,20254
163733701,7.0,7.0,6500,6500,0,0,6500,Null,Null,163733701,111461,20254
163733727,0.0,0.0,4000,4000,0,0,4000,Null,Null,163733727,111461,8073
163733740,22.0,22.0,3000,3000,0,0,3000,Null,Null,163733740,111461,20254
163733750,10.0,10.0,4000,4000,0,0,4000,Null,Null,163733750,111461,20254
163733776,0.0,0.0,4000,4000,0,0,4000,Null,Null,163733776,111461,20254
163733777,1.0,1.0,8000,8000,0,0,8000,Null,Null,163733777,111461,20254
163733786,6.0,6.0,3000,3000,0,0,3000,Null,Null,163733786,111461,20254
163733798,121.0,121.0,3000,3000,0,0,3000,Null,Null,163733798,111461,20254
163733821,0.0,0.0,2000,2000,0,0,2000,Null,Null,163733821,111461,20254
163733823,0.0,0.0,5000,5000,0,0,5000,Null,Null,163733823,111461,20254
163733836,0.0,0.0,8000,8000,0,0,8000,Null,Null,163733836,111461,20254
163733838,10.0,10.0,4000,4000,0,0,4000,Null,Null,163733838,111461,20254
163733845,0.0,0.0,5000,5000,0,0,5000,Null,Null,163733845,111461,20254
163733849,0.0,0.0,5000,5000,0,0,5000,Null,Null,163733849,111461,20254
163733859,10.0,10.0,8000,8000,0,0,8000,Null,Null,163733859,111461,20254
163733873,0.0,0.0,3000,3000,0,0,3000,Null,Null,163733873,111461,20254
163733874,0.0,0.0,6000,6000,0,0,6000,Null,Null,163733874,111461,20254
163733900,0.0,0.0,5000,5000,0,0,5000,Null,Null,163733900,111461,20254
163733939,10.0,10.0,2000,2000,0,0,2000,Null,Null,163733939,111461,20254
163733942,0.0,0.0,3500,3500,0,0,3500,Null,Null,163733942,111461,20254
163733969,0.0,0.0,9500,9500,0,0,9500,Null,Null,163733969,111461,20254
163733972,0.0,0.0,1000,1000,0,0,1000,Null,Null,163733972,111461,20254
163734003,0.0,0.0,3500,3500,0,0,3500,Null,Null,163734003,111461,20254
163734008,0.0,0.0,2000,2000,0,0,2000,Null,Null,163734008,111461,20254
163734033,10.0,10.0,5000,5000,0,0,5000,Null,Null,163734033,111461,20254
163734040,4.0,4.0,8000,8000,0,0,8000,Null,Null,163734040,111461,20254
163734052,0.0,0.0,3000,3000,0,0,3000,Null,Null,163734052,111461,20254
163734060,0.0,0.0,1500,1500,0,0,1500,Null,Null,163734060,111461,20254
163734090,2.0,2.0,4000,4000,0,0,4000,Null,Null,163734090,111461,20254
163734094,0.0,0.0,2500,2500,0,0,2500,Null,Null,163734094,111461,20254
163734103,0.0,0.0,9000,9000,0,0,9000,Null,Null,163734103,111461,20254
163734104,0.0,0.0,5000,5000,0,0,5000,Null,Null,163734104,111461,20254
163734106,0.0,0.0,4000,4000,0,0,4000,Null,Null,163734106,111461,20254
163734109,0.0,0.0,7000,7000,0,0,7000,Null,Null,163734109,111461,20254
163734118,0.0,0.0,3000,3000,0,0,3000,Null,Null,163734118,111461,20254
163734123,10.0,10.0,5000,5000,0,0,5000,Null,Null,163734123,111461,1815
163734126,0.0,0.0,3000,3000,0,0,3000,Null,Null,163734126,111461,20254
163734134,3.0,3.0,5000,5000,0,0,5000,Null,Null,163734134,111461,20254
163734136,0.0,0.0,3000,3000,0,0,3000,Null,Null,163734136,111461,20254
163734143,0.0,0.0,3000,3000,0,0,3000,Null,Null,163734143,111461,20254
163734144,0.0,0.0,6500,6500,0,0,6500,Null,Null,163734144,111461,20254
163734151,0.0,0.0,3000,3000,0,0,3000,Null,Null,163734151,111461,20254
163734169,0.0,0.0,9000,9000,0,0,9000,Null,Null,163734169,111461,20254
163734178,26.0,26.0,6000,6000,0,0,6000,Null,Null,163734178,111461,20254
163734189,0.0,0.0,6000,6000,0,0,6000,Null,Null,163734189,111461,20254
163734206,1.0,1.0,7000,7000,0,0,7000,Null,Null,163734206,111461,20254
163734211,4.0,4.0,2000,2000,0,0,2000,Null,Null,163734211,111461,20254
163734228,0.0,0.0,1000,1000,0,0,1000,Null,Null,163734228,111461,8068
163734250,0.0,0.0,5000,5000,0,0,5000,Null,Null,163734250,111461,20254
163734263,0.0,0.0,1000,1000,0,0,1000,Null,Null,163734263,111461,20254
163734292,3.0,3.0,6000,6000,0,0,6000,Null,Null,163734292,111461,20254
163734298,64.0,64.0,1500,1500,0,0,1500,Null,Null,163734298,111461,20254
163734306,0.0,0.0,5000,5000,0,0,5000,Null,Null,163734306,111461,8073
163734317,40.0,40.0,2000,2000,0,0,2000,Null,Null,163734317,111461,2
163734321,5.0,5.0,6000,6000,0,0,6000,Null,Null,163734321,111461,20254
163734324,6.0,6.0,5000,5000,0,0,5000,Null,Null,163734324,111461,20254
163734326,0.0,0.0,6000,6000,0,0,6000,Null,Null,163734326,111461,20254
163734330,30.0,30.0,3000,3000,0,0,3000,Null,Null,163734330,111461,20254
163734348,0.0,0.0,3000,3000,0,0,3000,Null,Null,163734348,111461,20254
163734368,0.0,0.0,5000,5000,0,0,5000,Null,Null,163734368,111461,2
163734376,18.0,18.0,6000,6000,0,0,6000,Null,Null,163734376,111461,20254
163734383,0.0,0.0,6000,6000,0,0,6000,Null,Null,163734383,111461,20254
163734388,0.0,0.0,6000,6000,0,0,6000,Null,Null,163734388,111461,1815
163734416,0.0,0.0,6000,6000,0,0,6000,Null,Null,163734416,111461,20254
163734438,16.0,16.0,9000,9000,0,0,9000,Null,Null,163734438,111461,2
163734445,28.0,28.0,3000,3000,0,0,3000,Null,Null,163734445,111461,20254
163734453,0.0,0.0,1000,1000,0,0,1000,Null,Null,163734453,111461,20254
163734456,0.0,0.0,1500,1500,0,0,1500,Null,Null,163734456,111461,20254
163734462,0.0,0.0,9000,9000,0,0,9000,Null,Null,163734462,111461,20258
163734466,0.0,0.0,7000,7000,0,0,7000,Null,Null,163734466,111461,1815
163734524,6.0,6.0,6000,6000,0,0,6000,Null,Null,163734524,111461,20254
163734547,0.0,0.0,2000,2000,0,0,2000,Null,Null,163734547,111461,28716
163734576,0.0,0.0,1000,1000,0,0,1000,Null,Null,163734576,111461,20254
163734663,0.0,0.0,5000,5000,0,0,5000,Null,Null,163734663,111461,8073
163734665,2.0,2.0,8000,8000,0,0,8000,Null,Null,163734665,111461,1815
163734666,31.0,31.0,8000,8000,0,0,8000,Null,Null,163734666,561415,1815
163734668,5.0,5.0,3000,3000,0,0,3000,Null,Null,163734668,111461,20254
163734731,3.0,3.0,5000,5000,0,0,5000,Null,Null,163734731,111461,20254
163734741,0.0,0.0,7000,7000,0,0,7000,Null,Null,163734741,111461,1815
163734776,0.0,0.0,8000,8000,0,0,8000,Null,Null,163734776,111461,1815
163734798,0.0,0.0,8000,8000,0,0,8000,Null,Null,163734798,111461,20254
163734839,20.0,20.0,1000,1000,0,0,1000,Null,Null,163734839,111461,20254
163734841,0.0,0.0,1000,1000,0,0,1000,Null,Null,163734841,111461,20246
163734864,0.0,0.0,20000,20000,0,0,20000,Null,Null,163734864,111461,1815
163734871,0.0,0.0,7000,7000,0,0,7000,Null,Null,163734871,561415,1815
163734878,0.0,0.0,2500,2500,0,0,2500,Null,Null,163734878,111461,20254
163812063,0.0,0.0,2500,2500,0,0,2500,Null,Null,163812063,111461,2
163850036,31.0,31.0,99000,99000,0,0,99000,Null,Null,163850036,162313,28426
163875403,0.0,0.0,650000,650000,0,0,650000,Null,Null,163875403,112638,1796
163879974,0.0,0.0,0,2000,0,0,2000,Null,Null,163879974,111461,0
163887440,0.0,0.0,1999,1999,0,0,1999,Null,Null,163887440,111461,2
163900041,20.0,20.0,480000,480000,0,0,480000,Null,Null,163900041,111461,2
163902958,38.0,38.0,1900,1900,0,0,1900,Null,Null,163902958,111461,2
163902978,0.0,0.0,2500,2500,0,0,2500,Null,Null,163902978,111461,2
163903071,21.0,21.0,2100,2100,0,0,2100,Null,Null,163903071,111461,2
163903085,0.0,0.0,2200,2200,0,0,2200,Null,Null,163903085,111461,2
163903133,0.0,0.0,2500,2500,0,0,2500,Null,Null,163903133,111461,2
163907739,0.0,0.0,1600,1600,0,0,1600,Null,Null,163907739,111461,2
163911958,3.0,3.0,56250,56250,0,0,56250,Null,Null,163911958,111461,2
163914808,691.0,691.0,290000,290000,0,0,290000,Null,Null,163914808,18804,8061
163935336,53.0,53.0,120000,120000,0,0,120000,Null,Null,163935336,257333,12908
164015291,182.0,182.0,175000,139000,36000,21,175000,Null,Null,164015291,4869509,8305
164042262,100.0,100.0,159700,159700,0,0,159700,Null,Null,164042262,561415,23184
164047763,19.0,19.0,2600000,1959000,641000,25,2600000,Null,Null,164047763,218061,53348
164075199,0.0,0.0,10000,10000,0,0,10000,Null,Null,164075199,561415,15320
164075756,74.0,74.0,99000,99000,0,0,99000,Null,Null,164075756,5416059,11869
164077768,0.0,0.0,24990000,24990000,0,0,24990000,Null,Null,164077768,114527,2657
164078091,266.0,266.0,100000,65000,35000,35,100000,Null,Null,164078091,5390319,17186
164078555,122.0,122.0,229000,194650,34350,15,229000,Null,Null,164078555,5132069,23042
164158123,21.0,21.0,60000,60000,0,0,60000,Null,Null,164158123,177955,2153
164197409,14.0,14.0,35000,35000,0,0,35000,Null,Null,164197409,561415,28576
164213695,42.0,42.0,710000,710000,0,0,710000,Null,Null,164213695,18804,8061
164240361,29.0,29.0,115000,115000,0,0,115000,Null,Null,164240361,561415,2016
164242253,4.0,4.0,19000,19000,0,0,19000,Null,Null,164242253,561415,15320
164266659,73.0,73.0,98900,72000,26900,27,98900,Null,Null,164266659,5055635,8400
164268482,0.0,0.0,1000,1000,0,0,1000,Null,Null,164268482,111461,2
164268554,0.0,0.0,2000,2000,0,0,2000,Null,Null,164268554,111461,2
164275575,0.0,0.0,67990000,66000000,1990000,3,67990000,Null,Null,164275575,5232357,2324
164287589,4.0,4.0,25000,25000,0,0,25000,Null,Null,164287589,111461,2
164299519,7.0,7.0,14800,14800,0,0,14800,Null,Null,164299519,111461,2
164317484,51.0,51.0,60000,60000,0,0,60000,Null,Null,164317484,561415,2225
164318507,13.0,13.0,1180000,1180000,0,0,1180000,Null,Null,164318507,18804,8061
164318521,18.0,18.0,2190000,2190000,0,0,2190000,Null,Null,164318521,18804,8061
164318603,30.0,30.0,2050000,2050000,0,0,2050000,Null,Null,164318603,18804,8061
164321473,0.0,0.0,2000,2000,0,0,2000,Null,Null,164321473,111461,2
164336224,369.0,369.0,26000,25000,1000,4,26000,Null,Null,164336224,111461,11923
164337744,0.0,0.0,37050000,37050000,0,0,37050000,Null,Null,164337744,561415,23430
164338272,2.0,2.0,6499000,6499000,0,0,6499000,Null,Null,164338272,256827,7449
164339143,1.0,1.0,9799000,9799000,0,0,9799000,Null,Null,164339143,256827,8513
164339279,20.0,20.0,598000,299000,299000,50,598000,Null,Null,164339279,111461,8512
164339296,22.0,22.0,400000,200000,200000,50,400000,Null,Null,164339296,111461,8512
164343942,896.0,896.0,7500,7500,0,0,7500,Null,Null,164343942,4825983,8305
164348202,150.0,150.0,960000,630000,330000,34,960000,Null,Null,164348202,213321,8206
164349770,0.0,0.0,2200,2200,0,0,2200,Null,Null,164349770,111461,2
164358589,1.0,1.0,9838800,8199000,1639800,17,9838800,Null,Null,164358589,256827,8513
164361090,0.0,0.0,1000,1000,0,0,1000,Null,Null,164361090,561415,53054
164361645,0.0,0.0,4299,4299,0,0,4299,Null,Null,164361645,111461,2
164379497,0.0,0.0,22490000,22490000,0,0,22490000,Null,Null,164379497,114527,2657
164402394,0.0,0.0,22490000,22490000,0,0,22490000,Null,Null,164402394,114527,2657
164432835,23.0,23.0,1000,1000,0,0,1000,Null,Null,164432835,111461,2
164432979,129.0,129.0,1000,1000,0,0,1000,Null,Null,164432979,111461,2
164433381,771.0,771.0,154000,96000,58000,38,154000,Null,Null,164433381,19018,23238
164433563,0.0,0.0,2500,2500,0,0,2500,Null,Null,164433563,111461,2
164444757,0.0,0.0,3912000,3912000,0,0,3912000,Null,Null,164444757,25643,1795
164446865,12.0,12.0,120000,120000,0,0,120000,Null,Null,164446865,111461,49722
164458874,167.0,167.0,24000,24000,0,0,24000,Null,Null,164458874,111461,28484
164460560,0.0,0.0,2000,2000,0,0,2000,Null,Null,164460560,111461,2
164478315,194.0,194.0,30000,30000,0,0,30000,Null,Null,164478315,111461,28484
164479566,19.0,19.0,950000,808000,142000,15,950000,Null,Null,164479566,5465099,1883
164484966,0.0,0.0,86000,86000,0,0,86000,Null,Null,164484966,111461,2
164491496,0.0,0.0,16500,16500,0,0,16500,Null,Null,164491496,111461,2
164492272,1.0,1.0,1200,1200,0,0,1200,Null,Null,164492272,111461,2
164494879,0.0,0.0,3912000,3912000,0,0,3912000,Null,Null,164494879,25643,1795
164501406,0.0,0.0,2000,2000,0,0,2000,Null,Null,164501406,111461,2
164501989,0.0,0.0,110000000,110000000,0,0,110000000,Null,Null,164501989,879595,2340
164502677,3.0,3.0,140000,119000,21000,15,140000,Null,Null,164502677,5465159,11869
164537450,0.0,0.0,15000,15000,0,0,15000,Null,Null,164537450,111461,2
164537829,0.0,0.0,10000,10000,0,0,10000,Null,Null,164537829,111461,2
164538349,6.0,6.0,6000,6000,0,0,6000,Null,Null,164538349,111461,2
164538980,0.0,0.0,25000,25000,0,0,25000,Null,Null,164538980,111461,2
164539215,0.0,0.0,12000,12000,0,0,12000,Null,Null,164539215,111461,2
164540369,3.0,3.0,6000,6000,0,0,6000,Null,Null,164540369,111461,2
164540725,0.0,0.0,5000,5000,0,0,5000,Null,Null,164540725,111461,2
164559245,13.0,13.0,5000,5000,0,0,5000,Null,Null,164559245,111461,20258
164559832,0.0,0.0,4000,4000,0,0,4000,Null,Null,164559832,111461,28716
164593190,24.0,24.0,39000,32000,7000,18,39000,Null,Null,164593190,111461,2
164598013,0.0,0.0,29900000,14990000,14910000,50,29900000,Null,Null,164598013,20091,2340
164601249,31.0,31.0,1000,1000,0,0,1000,Null,Null,164601249,111461,2
164697930,0.0,0.0,8490000,5324000,3166000,37,8490000,Null,Null,164697930,18802,1794
164771128,351.0,351.0,30000,22500,7500,25,30000,Null,Null,164771128,561415,1883
164799095,1.0,1.0,1900,1900,0,0,1900,Null,Null,164799095,111461,2
164807677,187.0,187.0,135000,115000,20000,15,135000,Null,Null,164807677,561415,23184
164837244,154.0,154.0,65000,62000,3000,5,65000,Null,Null,164837244,3866781,6948
164838074,0.0,0.0,8550000,8550000,0,0,8550000,Null,Null,164838074,405211,8511
164839842,0.0,0.0,8550000,8550000,0,0,8550000,Null,Null,164839842,405211,8511
164886406,711.0,711.0,1900,1100,800,42,1900,Null,Null,164886406,111461,23024
164923596,0.0,0.0,3168000,3036000,132000,4,3168000,Null,Null,164923596,25643,1795
164937168,0.0,0.0,3168000,3036000,132000,4,3168000,Null,Null,164937168,25643,1789
164965787,46.0,46.0,1550000,957000,593000,38,1550000,Null,Null,164965787,5085219,23228
164994277,0.0,0.0,9690000,9690000,0,0,9690000,Null,Null,164994277,561415,2340
165013585,460.0,460.0,199000,199000,0,0,199000,Null,Null,165013585,111461,53190
165015319,2.0,2.0,7000,7000,0,0,7000,Null,Null,165015319,111461,2
165015371,2.0,2.0,5000,5000,0,0,5000,Null,Null,165015371,111461,2
165015680,1.0,1.0,7000,7000,0,0,7000,Null,Null,165015680,111461,2
165018079,1.0,1.0,29000,29000,0,0,29000,Null,Null,165018079,111461,2
165025009,40.0,40.0,180000,95000,85000,47,180000,Null,Null,165025009,484375,23258
165027973,43.0,43.0,215000,205000,10000,5,215000,Null,Null,165027973,111461,1838
165029589,9.0,9.0,155000,145000,10000,6,155000,Null,Null,165029589,111461,2
165029776,0.0,0.0,10000,10000,0,0,10000,Null,Null,165029776,111461,2
165045880,556.0,556.0,1050000,699000,351000,33,1050000,Null,Null,165045880,243687,1634
165109465,231.0,231.0,178000,164000,14000,8,178000,Null,Null,165109465,523789,6305
165118737,86.0,86.0,63000,63000,0,0,63000,Null,Null,165118737,111461,2
165150033,25.0,25.0,7000,7000,0,0,7000,Null,Null,165150033,111461,2
165160287,14.0,14.0,8600,4000,4600,53,8600,Null,Null,165160287,561415,15318
165205686,22.0,22.0,2250000,1249998,1000002,44,2250000,Null,Null,165205686,111461,28644
165214201,26.0,26.0,17000,17000,0,0,17000,Null,Null,165214201,111461,2
165243346,2.0,2.0,2500,2500,0,0,2500,Null,Null,165243346,111461,2685
165251200,131.0,131.0,40000,32000,8000,20,40000,Null,Null,165251200,561415,53054
165256438,5202.0,5202.0,23900,21000,2900,12,23900,Null,Null,165256438,111461,2685
165340986,0.0,0.0,2000,2000,0,0,2000,Null,Null,165340986,111461,2
165346784,2112.0,2112.0,58000,34900,23100,40,58000,Null,Null,165346784,111461,2685
165404269,1962.0,1962.0,148000,94000,54000,36,148000,Null,Null,165404269,111461,2685
165518851,276.0,276.0,188000,120000,68000,36,188000,Null,Null,165518851,561415,2685
165585662,62.0,62.0,590000,415000,175000,30,590000,Null,Null,165585662,25643,4428
165590374,87.0,87.0,278000,139000,139000,50,278000,Null,Null,165590374,5515171,8511
165598723,0.0,0.0,18000,9000,9000,50,18000,Null,Null,165598723,4647777,15318
165612478,0.0,0.0,114000000,114000000,0,0,114000000,Null,Null,165612478,561415,23276
165612575,0.0,0.0,53460000,53460000,0,0,53460000,Null,Null,165612575,111461,2
165612678,0.0,0.0,5600000,5600000,0,0,5600000,Null,Null,165612678,111461,2334
165638474,66.0,66.0,89000,71000,18000,20,89000,Null,Null,165638474,561415,7064
165667256,1.0,1.0,7000,5000,2000,29,7000,Null,Null,165667256,4869509,8305
165669944,116.0,116.0,99999,99999,0,0,99999,Null,Null,165669944,111461,2
165682442,33.0,33.0,53900,53900,0,0,53900,Null,Null,165682442,111461,2
165700071,0.0,0.0,5436000,5436000,0,0,5436000,Null,Null,165700071,25643,1795
165706743,28.0,28.0,1450,1450,0,0,1450,Null,Null,165706743,111461,2
165708760,0.0,0.0,0,1200,0,0,1200,Null,Null,165708760,111461,0
165712683,0.0,0.0,92460000,92460000,0,0,92460000,Null,Null,165712683,111461,2
165747145,0.0,0.0,2148000,2148000,0,0,2148000,Null,Null,165747145,25422,1795
165747345,0.0,0.0,50000000,50000000,0,0,50000000,Null,Null,165747345,5207831,2340
165747350,0.0,0.0,7890000,7890000,0,0,7890000,Null,Null,165747350,5207831,2340
165747354,0.0,0.0,60000000,60000000,0,0,60000000,Null,Null,165747354,5207831,2340
165747360,0.0,0.0,47500000,47500000,0,0,47500000,Null,Null,165747360,5207831,2340
165747362,0.0,0.0,62000000,62000000,0,0,62000000,Null,Null,165747362,5207831,2340
165747364,0.0,0.0,20000000,20000000,0,0,20000000,Null,Null,165747364,111461,2340
165757149,0.0,0.0,1000,1000,0,0,1000,Null,Null,165757149,111461,2
165758161,1.0,1.0,4000000,3790000,210000,5,4000000,Null,Null,165758161,4267617,8165
165758266,138.0,138.0,438000,329000,109000,25,438000,Null,Null,165758266,41048,2511
165762686,182.0,182.0,199000,199000,0,0,199000,Null,Null,165762686,373379,17162
165778547,0.0,0.0,9000,9000,0,0,9000,Null,Null,165778547,111461,2
165779321,2.0,2.0,6400,6400,0,0,6400,Null,Null,165779321,111461,2
165779498,0.0,0.0,7600,7600,0,0,7600,Null,Null,165779498,111461,2
165780717,0.0,0.0,9000,9000,0,0,9000,Null,Null,165780717,111461,2
165780763,0.0,0.0,9000,9000,0,0,9000,Null,Null,165780763,111461,2
165807250,113.0,113.0,1590000,1199000,391000,25,1590000,Null,Null,165807250,25643,8400
165808092,0.0,0.0,44000,44000,0,0,44000,Null,Null,165808092,111461,2
165845261,0.0,0.0,2500,2500,0,0,2500,Null,Null,165845261,561415,2337
165948161,16.0,16.0,99000,95000,4000,4,99000,Null,Null,165948161,618355,8309
165960440,21.0,21.0,99000,88000,11000,11,99000,Null,Null,165960440,561415,2488
165961301,33.0,33.0,299000,299000,0,0,299000,Null,Null,165961301,561415,11925
165967383,5.0,5.0,2200,2200,0,0,2200,Null,Null,165967383,111461,6305
165967494,0.0,0.0,1500,1500,0,0,1500,Null,Null,165967494,111461,23282
165969724,6.0,6.0,6000,6000,0,0,6000,Null,Null,165969724,561415,20258
165972263,0.0,0.0,2500,2500,0,0,2500,Null,Null,165972263,111461,2
165972425,32.0,32.0,20000,20000,0,0,20000,Null,Null,165972425,561415,20254
165994582,63.0,63.0,39500,39500,0,0,39500,Null,Null,165994582,4820811,5007
166014323,3.0,3.0,169000,169000,0,0,169000,Null,Null,166014323,4217099,15318
166014894,6.0,6.0,17850000,17850000,0,0,17850000,Null,Null,166014894,5740935,1815
166014895,9.0,9.0,19590000,19590000,0,0,19590000,Null,Null,166014895,5740935,2324
166014930,5.0,5.0,32110000,32110000,0,0,32110000,Null,Null,166014930,5740935,1815
166034440,121.0,121.0,23000,23000,0,0,23000,Null,Null,166034440,111461,2
166034907,0.0,0.0,5436000,5436000,0,0,5436000,Null,Null,166034907,25643,1795
166034912,0.0,0.0,3192000,3192000,0,0,3192000,Null,Null,166034912,25643,1795
166041979,0.0,0.0,3192000,3192000,0,0,3192000,Null,Null,166041979,25643,1795
166054841,0.0,0.0,14000,14000,0,0,14000,Null,Null,166054841,561415,8371
166056279,0.0,0.0,7000,7000,0,0,7000,Null,Null,166056279,111461,2
166102869,0.0,0.0,7200000,7200000,0,0,7200000,Null,Null,166102869,450153,11873
166102884,0.0,0.0,4050000,4050000,0,0,4050000,Null,Null,166102884,450153,11873
166104830,0.0,0.0,70000,70000,0,0,70000,Null,Null,166104830,111461,2
166119389,144.0,144.0,1900,1900,0,0,1900,Null,Null,166119389,111461,2
166120705,282.0,282.0,290000,290000,0,0,290000,Null,Null,166120705,542605,8220
166124677,1503.0,1503.0,129000,129000,0,0,129000,Null,Null,166124677,5527787,2334
166134928,7.0,7.0,2000,2000,0,0,2000,Null,Null,166134928,111461,23304
166135240,0.0,0.0,45000000,45000000,0,0,45000000,Null,Null,166135240,5088991,2340
166135241,0.0,0.0,49900000,49900000,0,0,49900000,Null,Null,166135241,5088991,2340
166135244,0.0,0.0,55000000,55000000,0,0,55000000,Null,Null,166135244,5088991,2340
166138577,0.0,0.0,45000000,45000000,0,0,45000000,Null,Null,166138577,111461,23112
166138852,0.0,0.0,38000000,38000000,0,0,38000000,Null,Null,166138852,111461,23112
166138920,0.0,0.0,46650000,46650000,0,0,46650000,Null,Null,166138920,111461,23112
166138944,0.0,0.0,56000000,56000000,0,0,56000000,Null,Null,166138944,111461,23112
166138969,0.0,0.0,38400000,38400000,0,0,38400000,Null,Null,166138969,111461,23112
166139531,0.0,0.0,36000000,36000000,0,0,36000000,Null,Null,166139531,111461,23112
166139585,0.0,0.0,45000000,45000000,0,0,45000000,Null,Null,166139585,111461,23112
166139687,0.0,0.0,138000000,138000000,0,0,138000000,Null,Null,166139687,111461,23112
166139689,0.0,0.0,38000000,38000000,0,0,38000000,Null,Null,166139689,111461,23112
166141919,0.0,0.0,122400000,122400000,0,0,122400000,Null,Null,166141919,111461,23112
166142325,0.0,0.0,70150000,70150000,0,0,70150000,Null,Null,166142325,111461,23112
166142359,0.0,0.0,65760000,65760000,0,0,65760000,Null,Null,166142359,111461,23112
166142405,0.0,0.0,66000000,66000000,0,0,66000000,Null,Null,166142405,111461,23112
166142467,0.0,0.0,66600000,66600000,0,0,66600000,Null,Null,166142467,111461,23112
166142576,0.0,0.0,65000000,65000000,0,0,65000000,Null,Null,166142576,111461,23112
166142639,0.0,0.0,40580000,40580000,0,0,40580000,Null,Null,166142639,111461,23112
166142643,0.0,0.0,118000000,118000000,0,0,118000000,Null,Null,166142643,111461,23112
166142671,0.0,0.0,36000000,36000000,0,0,36000000,Null,Null,166142671,111461,23112
166142679,0.0,0.0,194000000,194000000,0,0,194000000,Null,Null,166142679,111461,23112
166142721,0.0,0.0,41180000,41180000,0,0,41180000,Null,Null,166142721,111461,23112
166142802,0.0,0.0,38780000,38780000,0,0,38780000,Null,Null,166142802,111461,23112
166142869,0.0,0.0,162800000,162800000,0,0,162800000,Null,Null,166142869,111461,23112
166144428,0.0,0.0,42600000,42600000,0,0,42600000,Null,Null,166144428,111461,23112
166144808,0.0,0.0,59800000,59800000,0,0,59800000,Null,Null,166144808,111461,23112
166145231,0.0,0.0,1999,1999,0,0,1999,Null,Null,166145231,111461,2
166145516,0.0,0.0,1950,1950,0,0,1950,Null,Null,166145516,111461,2
166148836,0.0,0.0,2000,2000,0,0,2000,Null,Null,166148836,111461,2
166150288,0.0,0.0,2000,2000,0,0,2000,Null,Null,166150288,111461,2
166151541,0.0,0.0,99999,99999,0,0,99999,Null,Null,166151541,111461,2
166158975,0.0,0.0,15000,15000,0,0,15000,Null,Null,166158975,111461,2
166159210,0.0,0.0,19000,19000,0,0,19000,Null,Null,166159210,111461,2
166159234,0.0,0.0,89000,89000,0,0,89000,Null,Null,166159234,111461,2
166177255,105.0,105.0,300000,259000,41000,14,300000,Null,Null,166177255,150215,17170
166218799,0.0,0.0,1800,1800,0,0,1800,Null,Null,166218799,111461,2
166219131,0.0,0.0,1200,1200,0,0,1200,Null,Null,166219131,111461,2
166220658,0.0,0.0,2400,2400,0,0,2400,Null,Null,166220658,111461,2
166231800,1.0,1.0,11000,11000,0,0,11000,Null,Null,166231800,111461,15320
166238001,2.0,2.0,9000,9000,0,0,9000,Null,Null,166238001,561415,28486
166320772,1322.0,1322.0,119000,119000,0,0,119000,Null,Null,166320772,4254031,2971
166334294,0.0,0.0,2500,2500,0,0,2500,Null,Null,166334294,111461,2
166336004,0.0,0.0,1000,1000,0,0,1000,Null,Null,166336004,111461,2
166338930,11.0,11.0,1500,1500,0,0,1500,Null,Null,166338930,111461,2
166339822,0.0,0.0,16000,16000,0,0,16000,Null,Null,166339822,111461,2
166347133,18.0,18.0,5000,5000,0,0,5000,Null,Null,166347133,111461,2
166347568,20.0,20.0,2500,2500,0,0,2500,Null,Null,166347568,111461,2
166353976,0.0,0.0,6000,6000,0,0,6000,Null,Null,166353976,111461,2
166389506,179.0,179.0,2590000,1750000,840000,32,2590000,Null,Null,166389506,18802,1795
166409987,1.0,1.0,550000,550000,0,0,550000,Null,Null,166409987,111461,2
166410000,0.0,0.0,350000,350000,0,0,350000,Null,Null,166410000,111461,2
166410282,1.0,1.0,450000,450000,0,0,450000,Null,Null,166410282,111461,2
166410396,0.0,0.0,450000,450000,0,0,450000,Null,Null,166410396,111461,2
166410610,0.0,0.0,18000,18000,0,0,18000,Null,Null,166410610,111461,2
166411443,0.0,0.0,225000,225000,0,0,225000,Null,Null,166411443,111461,2
166417258,2.0,2.0,1000,1000,0,0,1000,Null,Null,166417258,111461,2
166417309,0.0,0.0,2500,2500,0,0,2500,Null,Null,166417309,111461,2238
166417377,0.0,0.0,2100,2100,0,0,2100,Null,Null,166417377,111461,27214
166417442,0.0,0.0,2000,2000,0,0,2000,Null,Null,166417442,111461,2
166417513,542.0,542.0,7000,7000,0,0,7000,Null,Null,166417513,4452467,8305
166418049,3.0,3.0,19999,19999,0,0,19999,Null,Null,166418049,111461,53054
166418061,2.0,2.0,25000,25000,0,0,25000,Null,Null,166418061,111461,53054
166418157,83.0,83.0,1500,1500,0,0,1500,Null,Null,166418157,111461,1883
166429951,0.0,0.0,2000,2000,0,0,2000,Null,Null,166429951,111461,2
166436082,3.0,3.0,49400,49400,0,0,49400,Null,Null,166436082,111461,15236
166436093,0.0,0.0,16150,16150,0,0,16150,Null,Null,166436093,111461,15320
166448992,37.0,37.0,110000,100000,10000,9,110000,Null,Null,166448992,252399,23352
166474550,0.0,0.0,1580,1580,0,0,1580,Null,Null,166474550,111461,2
166474730,0.0,0.0,1200,1200,0,0,1200,Null,Null,166474730,111461,2
166524322,70.0,70.0,9000,9000,0,0,9000,Null,Null,166524322,561415,20254
166526115,99.0,99.0,150000,150000,0,0,150000,Null,Null,166526115,111461,2
166532351,0.0,0.0,37223200,37223200,0,0,37223200,Null,Null,166532351,111461,2
166533430,9.0,9.0,2500,2500,0,0,2500,Null,Null,166533430,111461,2
166541143,0.0,0.0,41000000,41000000,0,0,41000000,Null,Null,166541143,561415,23104
166545922,93.0,93.0,750000,389000,361000,48,750000,Null,Null,166545922,246045,4593
166546194,265.0,265.0,1380000,799000,581000,42,1380000,Null,Null,166546194,246045,4593
166551450,0.0,0.0,2300,2000,300,13,2300,Null,Null,166551450,113680,1883
166563208,0.0,0.0,150000,150000,0,0,150000,Null,Null,166563208,561415,15318
166563372,8.0,8.0,69000,61000,8000,12,69000,Null,Null,166563372,111461,2
166563388,6.0,6.0,85000,76000,9000,11,85000,Null,Null,166563388,111461,2
166595471,629.0,629.0,90000,79000,11000,12,90000,Null,Null,166595471,276745,8227
166613831,0.0,0.0,7032000,7032000,0,0,7032000,Null,Null,166613831,25422,1795
166659124,409.0,409.0,365000,365000,0,0,365000,Null,Null,166659124,5063093,2511
166764904,173.0,173.0,9500,9500,0,0,9500,Null,Null,166764904,233189,11929
166766359,56.0,56.0,9000,9000,0,0,9000,Null,Null,166766359,5104653,11929
166917242,458.0,458.0,180000,135000,45000,25,180000,Null,Null,166917242,480737,11835
167012200,0.0,0.0,12920000,11628000,1292000,10,12920000,Null,Null,167012200,704815,15236
167015200,1.0,1.0,1990000,1090000,900000,45,1990000,Null,Null,167015200,18802,1795
167019283,365.0,365.0,360000,182000,178000,49,360000,Null,Null,167019283,4224691,2016
167019473,0.0,0.0,15800,15800,0,0,15800,Null,Null,167019473,561415,49728
167030045,269.0,269.0,145000,145000,0,0,145000,Null,Null,167030045,111461,23388
167046966,83.0,83.0,79000,71100,7900,10,79000,Null,Null,167046966,51333,2
167120148,2.0,2.0,298000,298000,0,0,298000,Null,Null,167120148,561415,15318
167129299,105.0,105.0,279000,279000,0,0,279000,Null,Null,167129299,370711,8168
167210940,0.0,0.0,6300000,6300000,0,0,6300000,Null,Null,167210940,561415,15318
167219399,0.0,0.0,13400000,12000000,1400000,10,13400000,Null,Null,167219399,18802,1795
167235662,7.0,7.0,10000,10000,0,0,10000,Null,Null,167235662,173547,15936
167267098,1.0,1.0,12900000,12900000,0,0,12900000,Null,Null,167267098,18802,1795
167272693,12.0,12.0,2300,2300,0,0,2300,Null,Null,167272693,111461,2
167272764,8.0,8.0,1000,1000,0,0,1000,Null,Null,167272764,111461,2
167316037,0.0,0.0,330000,330000,0,0,330000,Null,Null,167316037,8195109,8308
167383164,0.0,0.0,4716000,4716000,0,0,4716000,Null,Null,167383164,25422,1795
167391475,210.0,210.0,97000,97000,0,0,97000,Null,Null,167391475,245945,23588
167410522,0.0,0.0,7000,7000,0,0,7000,Null,Null,167410522,111461,2
167417986,0.0,0.0,24990,23980,1010,4,24990,Null,Null,167417986,561415,23622
167423027,85.0,85.0,262500,177000,85500,33,262500,Null,Null,167423027,243687,2488
167425319,75.0,75.0,60000,30000,30000,50,60000,Null,Null,167425319,162313,28576
167429957,25.0,25.0,119999,119999,0,0,119999,Null,Null,167429957,149308,28576
167441543,27.0,27.0,49999,38999,11000,22,49999,Null,Null,167441543,162313,28576
167442015,17.0,17.0,5000,5000,0,0,5000,Null,Null,167442015,561415,7064
167443166,297.0,297.0,300000,206000,94000,31,300000,Null,Null,167443166,5379677,23304
167443499,1.0,1.0,274000,274000,0,0,274000,Null,Null,167443499,561415,15318
167459306,7.0,7.0,11000,11000,0,0,11000,Null,Null,167459306,111461,2
167465209,26.0,26.0,499000,429000,70000,14,499000,Null,Null,167465209,112638,1796
167465704,30.0,30.0,550000,479000,71000,13,550000,Null,Null,167465704,112638,1796
167465856,6.0,6.0,549000,451000,98000,18,549000,Null,Null,167465856,112638,1796
167465972,19.0,19.0,699000,517000,182000,26,699000,Null,Null,167465972,112638,1796
167466044,47.0,47.0,750000,655000,95000,13,750000,Null,Null,167466044,112638,1796
167487636,2.0,2.0,1805,1805,0,0,1805,Null,Null,167487636,111461,2
167489472,8.0,8.0,9000,9000,0,0,9000,Null,Null,167489472,111461,2
167491333,10.0,10.0,1000,1000,0,0,1000,Null,Null,167491333,111461,2
167495996,71.0,71.0,2590000,1718000,872000,34,2590000,Null,Null,167495996,18802,1795
167512894,169.0,169.0,1000,1000,0,0,1000,Null,Null,167512894,561415,2363
167528098,745.0,745.0,300000,124000,176000,59,300000,Null,Null,167528098,4224691,4593
167528595,544.0,544.0,330000,330000,0,0,330000,Null,Null,167528595,25697,28452
167529223,0.0,0.0,1250,1250,0,0,1250,Null,Null,167529223,111461,2
167529413,0.0,0.0,1500,1500,0,0,1500,Null,Null,167529413,111461,2
167529414,7.0,7.0,1000,1000,0,0,1000,Null,Null,167529414,111461,2
167530304,0.0,0.0,1500,1500,0,0,1500,Null,Null,167530304,111461,2
167545410,41.0,41.0,185000,185000,0,0,185000,Null,Null,167545410,549763,5267
167546543,0.0,0.0,13000,13000,0,0,13000,Null,Null,167546543,111461,2
167578482,0.0,0.0,1100,1100,0,0,1100,Null,Null,167578482,111461,2
167596574,325.0,325.0,48999,27999,21000,43,48999,Null,Null,167596574,5126697,28484
167599214,1485.0,1485.0,12000,8000,4000,33,12000,Null,Null,167599214,427547,8305
167601072,79.0,79.0,7000,3500,3500,50,7000,Null,Null,167601072,111461,2
167601428,59.0,59.0,150000,75000,75000,50,150000,Null,Null,167601428,111461,2
167608339,136.0,136.0,40000,40000,0,0,40000,Null,Null,167608339,111461,2
167620449,54.0,54.0,3000,3000,0,0,3000,Null,Null,167620449,549763,6742
167631977,163.0,163.0,220000,145000,75000,34,220000,Null,Null,167631977,245945,2136
167649675,5.0,5.0,40400,18000,22400,55,40400,Null,Null,167649675,561415,15318
167658544,0.0,0.0,15000,15000,0,0,15000,Null,Null,167658544,111461,2
167749983,21.0,21.0,10090,10090,0,0,10090,Null,Null,167749983,111461,2
167750975,0.0,0.0,40500000,40500000,0,0,40500000,Null,Null,167750975,111461,2
167752412,0.0,0.0,42000000,42000000,0,0,42000000,Null,Null,167752412,111461,2
167753343,6.0,6.0,2000,2000,0,0,2000,Null,Null,167753343,111461,2
167854337,0.0,0.0,2500,2500,0,0,2500,Null,Null,167854337,111461,2
167857201,1.0,1.0,15800000,15800000,0,0,15800000,Null,Null,167857201,167287,20170
167868128,0.0,0.0,1811,1811,0,0,1811,Null,Null,167868128,111461,2
167891182,144.0,144.0,2000,2000,0,0,2000,Null,Null,167891182,561415,1634
167892577,1.0,1.0,1000,1000,0,0,1000,Null,Null,167892577,111461,2
167894944,0.0,0.0,1000,1000,0,0,1000,Null,Null,167894944,111461,2
167906500,1.0,1.0,1000,1000,0,0,1000,Null,Null,167906500,111461,2
167922686,0.0,0.0,2000,2000,0,0,2000,Null,Null,167922686,111461,2
167926077,250.0,250.0,869000,439000,430000,49,869000,Null,Null,167926077,7378235,1520
167927929,1.0,1.0,1000,1000,0,0,1000,Null,Null,167927929,111461,2
167937729,0.0,0.0,96380000,96380000,0,0,96380000,Null,Null,167937729,251809,2324
167939561,2.0,2.0,250000,125000,125000,50,250000,Null,Null,167939561,561415,15318
167951297,551.0,551.0,650000,465000,185000,28,650000,Null,Null,167951297,4878167,2340
167951307,30.0,30.0,665000,492000,173000,26,665000,Null,Null,167951307,4878167,2340
167951324,150.0,150.0,399000,320000,79000,20,399000,Null,Null,167951324,4878167,2340
167951338,53.0,53.0,189000,180000,9000,5,189000,Null,Null,167951338,4878167,2334
167952098,165.0,165.0,119000,114000,5000,4,119000,Null,Null,167952098,111461,1936
167955551,0.0,0.0,1800,1800,0,0,1800,Null,Null,167955551,111461,2
167955959,0.0,0.0,2200,2200,0,0,2200,Null,Null,167955959,111461,2
167956377,0.0,0.0,2200,2200,0,0,2200,Null,Null,167956377,111461,2
167962289,2.0,2.0,70000,70000,0,0,70000,Null,Null,167962289,111461,15320
167965667,0.0,0.0,50000,50000,0,0,50000,Null,Null,167965667,111461,15250
167981076,0.0,0.0,96800,96800,0,0,96800,Null,Null,167981076,422017,1820
168041042,0.0,0.0,2000,2000,0,0,2000,Null,Null,168041042,111461,2
168042023,62.0,62.0,65000,65000,0,0,65000,Null,Null,168042023,561415,4342
168049942,9.0,9.0,2000,2000,0,0,2000,Null,Null,168049942,111461,2
168055450,0.0,0.0,23000000,16000000,7000000,30,23000000,Null,Null,168055450,18802,1795
168061482,0.0,0.0,2000,2000,0,0,2000,Null,Null,168061482,111461,2
168061964,82.0,82.0,5000,5000,0,0,5000,Null,Null,168061964,111461,2
168062573,0.0,0.0,23000000,16000000,7000000,30,23000000,Null,Null,168062573,18802,1795
168076455,0.0,0.0,2500,2500,0,0,2500,Null,Null,168076455,561415,27180
168076498,0.0,0.0,2500,2500,0,0,2500,Null,Null,168076498,561415,27180
168076683,1.0,1.0,2000,2000,0,0,2000,Null,Null,168076683,561415,27180
168094334,0.0,0.0,12490000,8176000,4314000,35,12490000,Null,Null,168094334,18802,1795
168117331,47.0,47.0,85000,70000,15000,18,85000,Null,Null,168117331,111461,2
168153896,15.0,15.0,1100,1100,0,0,1100,Null,Null,168153896,111461,2
168179284,0.0,0.0,1700,1700,0,0,1700,Null,Null,168179284,111461,2
168181612,0.0,0.0,9000,9000,0,0,9000,Null,Null,168181612,111461,2
168183442,6.0,6.0,1999000,1238000,761000,38,1999000,Null,Null,168183442,111461,1795
168183459,80.0,80.0,99000,53000,46000,46,99000,Null,Null,168183459,21653,12908
168193548,63.0,63.0,1769000,889000,880000,50,1769000,Null,Null,168193548,4629801,2971
168226110,74.0,74.0,590000,390000,200000,34,590000,Null,Null,168226110,204385,28640
168229171,240.0,240.0,2000,2000,0,0,2000,Null,Null,168229171,561415,53054
168232230,0.0,0.0,4650000,4650000,0,0,4650000,Null,Null,168232230,456567,7449
168234975,95.0,95.0,490000,480000,10000,2,490000,Null,Null,168234975,189445,28574
168235451,0.0,0.0,2000,2000,0,0,2000,Null,Null,168235451,111461,2
168267627,0.0,0.0,6650000,6650000,0,0,6650000,Null,Null,168267627,885749,8511
168267676,0.0,0.0,12500000,12500000,0,0,12500000,Null,Null,168267676,405211,2
168267690,0.0,0.0,6190000,6190000,0,0,6190000,Null,Null,168267690,405211,2
168267737,0.0,0.0,8550000,8550000,0,0,8550000,Null,Null,168267737,405211,2
168267742,0.0,0.0,5990000,5990000,0,0,5990000,Null,Null,168267742,405211,2
168267745,0.0,0.0,6350000,6350000,0,0,6350000,Null,Null,168267745,885749,7449
168267756,0.0,0.0,6850000,6850000,0,0,6850000,Null,Null,168267756,405211,2
168267772,0.0,0.0,6650000,6650000,0,0,6650000,Null,Null,168267772,885749,8511
168267820,0.0,0.0,6000000,6000000,0,0,6000000,Null,Null,168267820,405211,2
168267823,0.0,0.0,6350000,6350000,0,0,6350000,Null,Null,168267823,405211,2
168267843,0.0,0.0,12560000,12560000,0,0,12560000,Null,Null,168267843,885749,8511
168267854,0.0,0.0,12560000,12560000,0,0,12560000,Null,Null,168267854,885749,7449
168267857,0.0,0.0,12850000,12850000,0,0,12850000,Null,Null,168267857,405211,2
168267884,0.0,0.0,6550000,6550000,0,0,6550000,Null,Null,168267884,405211,2
168267897,0.0,0.0,6150000,6150000,0,0,6150000,Null,Null,168267897,732431,8512
168267901,0.0,0.0,8660000,8660000,0,0,8660000,Null,Null,168267901,405211,2
168267917,0.0,0.0,17990000,17990000,0,0,17990000,Null,Null,168267917,885749,8511
168267927,0.0,0.0,12500000,12500000,0,0,12500000,Null,Null,168267927,405211,2
168267938,0.0,0.0,7150000,7150000,0,0,7150000,Null,Null,168267938,405211,2
168267939,0.0,0.0,12500000,12500000,0,0,12500000,Null,Null,168267939,405211,2
168267984,0.0,0.0,6550000,6550000,0,0,6550000,Null,Null,168267984,405211,2
168267997,0.0,0.0,8650000,8650000,0,0,8650000,Null,Null,168267997,885749,8511
168267998,0.0,0.0,6250000,6250000,0,0,6250000,Null,Null,168267998,405211,2
168268010,0.0,0.0,9950000,9950000,0,0,9950000,Null,Null,168268010,405211,2
168268014,0.0,0.0,7500000,7500000,0,0,7500000,Null,Null,168268014,111461,2
168268024,0.0,0.0,9850000,9850000,0,0,9850000,Null,Null,168268024,732431,8512
168268033,0.0,0.0,12500000,12500000,0,0,12500000,Null,Null,168268033,405211,2
168268045,0.0,0.0,8650000,8650000,0,0,8650000,Null,Null,168268045,885749,8511
168268061,0.0,0.0,6950000,6950000,0,0,6950000,Null,Null,168268061,405211,2
168268077,0.0,0.0,8550000,8550000,0,0,8550000,Null,Null,168268077,405211,2
168268094,0.0,0.0,5755000,5755000,0,0,5755000,Null,Null,168268094,405211,2
168268120,0.0,0.0,6550000,6550000,0,0,6550000,Null,Null,168268120,405211,2
168268141,0.0,0.0,5755000,5755000,0,0,5755000,Null,Null,168268141,111461,2
168268168,0.0,0.0,7680000,7680000,0,0,7680000,Null,Null,168268168,732431,8512
168268180,0.0,0.0,12850000,12850000,0,0,12850000,Null,Null,168268180,405211,2
168268208,0.0,0.0,6450000,6450000,0,0,6450000,Null,Null,168268208,405211,2
168268218,0.0,0.0,6550000,6550000,0,0,6550000,Null,Null,168268218,405211,2
168268229,0.0,0.0,5990000,5990000,0,0,5990000,Null,Null,168268229,405211,2
168268240,0.0,0.0,6750000,6750000,0,0,6750000,Null,Null,168268240,885749,8511
168268255,0.0,0.0,8650000,8650000,0,0,8650000,Null,Null,168268255,885749,8511
168268258,0.0,0.0,5755000,5755000,0,0,5755000,Null,Null,168268258,405211,2
168268265,0.0,0.0,5755000,5755000,0,0,5755000,Null,Null,168268265,405211,2
168268270,0.0,0.0,6850000,6850000,0,0,6850000,Null,Null,168268270,405211,2
168268341,0.0,0.0,6650000,6650000,0,0,6650000,Null,Null,168268341,405211,2
168268366,0.0,0.0,6190000,6190000,0,0,6190000,Null,Null,168268366,405211,2
168268371,0.0,0.0,6750000,6750000,0,0,6750000,Null,Null,168268371,885749,5385
168268380,0.0,0.0,6950000,6950000,0,0,6950000,Null,Null,168268380,405211,2
168268383,0.0,0.0,6650000,6650000,0,0,6650000,Null,Null,168268383,405211,2
168268403,0.0,0.0,6650000,6650000,0,0,6650000,Null,Null,168268403,885749,8511
168268409,0.0,0.0,9150000,9150000,0,0,9150000,Null,Null,168268409,405211,2
168268419,0.0,0.0,7350000,7350000,0,0,7350000,Null,Null,168268419,405211,2
168268425,0.0,0.0,6250000,6250000,0,0,6250000,Null,Null,168268425,405211,2
168268480,0.0,0.0,12850000,12850000,0,0,12850000,Null,Null,168268480,405211,2
168268488,0.0,0.0,6750000,6750000,0,0,6750000,Null,Null,168268488,885749,8511
168268535,0.0,0.0,6350000,6350000,0,0,6350000,Null,Null,168268535,405211,2
168268584,0.0,0.0,12500000,12500000,0,0,12500000,Null,Null,168268584,405211,2
168268596,0.0,0.0,6450000,6450000,0,0,6450000,Null,Null,168268596,405211,2
168268598,0.0,0.0,12850000,12850000,0,0,12850000,Null,Null,168268598,405211,2
168268603,0.0,0.0,5990000,5990000,0,0,5990000,Null,Null,168268603,405211,2
168268652,0.0,0.0,6750000,6750000,0,0,6750000,Null,Null,168268652,885749,5384
168268675,0.0,0.0,13850000,13850000,0,0,13850000,Null,Null,168268675,885749,7449
168268680,0.0,0.0,9950000,9950000,0,0,9950000,Null,Null,168268680,405211,2
168268703,0.0,0.0,6000000,6000000,0,0,6000000,Null,Null,168268703,405211,2
168268732,0.0,0.0,6250000,6250000,0,0,6250000,Null,Null,168268732,405211,2
168268744,0.0,0.0,6550000,6550000,0,0,6550000,Null,Null,168268744,405211,2
168268758,0.0,0.0,8950000,8950000,0,0,8950000,Null,Null,168268758,405211,2
168268760,0.0,0.0,9150000,9150000,0,0,9150000,Null,Null,168268760,405211,2
168268764,0.0,0.0,6750000,6750000,0,0,6750000,Null,Null,168268764,405211,2
168268840,0.0,0.0,6000000,6000000,0,0,6000000,Null,Null,168268840,405211,2
168268849,0.0,0.0,6380000,6380000,0,0,6380000,Null,Null,168268849,405211,2
168268887,0.0,0.0,6950000,6950000,0,0,6950000,Null,Null,168268887,405211,2
168268896,0.0,0.0,8860000,8860000,0,0,8860000,Null,Null,168268896,732431,8511
168268910,0.0,0.0,6550000,6550000,0,0,6550000,Null,Null,168268910,405211,2
168268959,0.0,0.0,6150000,6150000,0,0,6150000,Null,Null,168268959,732431,8512
168268965,0.0,0.0,7500000,7500000,0,0,7500000,Null,Null,168268965,111461,2
168268969,0.0,0.0,12500000,12500000,0,0,12500000,Null,Null,168268969,405211,2
168268970,0.0,0.0,12500000,12500000,0,0,12500000,Null,Null,168268970,405211,2
168268999,0.0,0.0,8950000,8950000,0,0,8950000,Null,Null,168268999,405211,2
168271224,0.0,0.0,2000,2000,0,0,2000,Null,Null,168271224,111461,2
168274181,10.0,10.0,1080000,1080000,0,0,1080000,Null,Null,168274181,694997,11881
168276021,0.0,0.0,160000,160000,0,0,160000,Null,Null,168276021,561415,15250
168282061,0.0,0.0,7668000,7348000,320000,4,7668000,Null,Null,168282061,25643,1795
168293375,0.0,0.0,20000000,13990000,6010000,30,20000000,Null,Null,168293375,5569349,2342
168304536,285.0,285.0,8990000,6990000,2000000,22,8990000,Null,Null,168304536,25643,1795
168317778,0.0,0.0,8600000,8600000,0,0,8600000,Null,Null,168317778,209651,5893
168317790,0.0,0.0,2088000,2088000,0,0,2088000,Null,Null,168317790,25422,1795
168317978,0.0,0.0,2500,2500,0,0,2500,Null,Null,168317978,111461,2
168318040,0.0,0.0,2500,2500,0,0,2500,Null,Null,168318040,111461,2
168319898,0.0,0.0,13000000,9750000,3250000,25,13000000,Null,Null,168319898,46007,8227
168320000,0.0,0.0,2088000,2088000,0,0,2088000,Null,Null,168320000,25422,1795
168333326,0.0,0.0,2300,2300,0,0,2300,Null,Null,168333326,111461,2
168333519,0.0,0.0,2200,2200,0,0,2200,Null,Null,168333519,111461,2
168368757,0.0,0.0,7500,7500,0,0,7500,Null,Null,168368757,111461,2
168466249,0.0,0.0,1200,1200,0,0,1200,Null,Null,168466249,111461,2
168494617,0.0,0.0,1400,1400,0,0,1400,Null,Null,168494617,111461,2
168503329,1.0,1.0,20000,20000,0,0,20000,Null,Null,168503329,561415,15318
168520983,5.0,5.0,2990000,2002000,988000,33,2990000,Null,Null,168520983,247549,1795
168526284,16.0,16.0,750000,671000,79000,11,750000,Null,Null,168526284,19673,1796
168535416,0.0,0.0,1299,1299,0,0,1299,Null,Null,168535416,111461,2
168541525,3.0,3.0,10100,10100,0,0,10100,Null,Null,168541525,111461,2
168542334,20.0,20.0,27000,27000,0,0,27000,Null,Null,168542334,111461,2
168550626,0.0,0.0,2000,2000,0,0,2000,Null,Null,168550626,111461,2
168562118,2531.0,2531.0,220000,150000,70000,32,220000,Null,Null,168562118,221187,1752
168562470,0.0,0.0,9000,9000,0,0,9000,Null,Null,168562470,111461,2
168563058,0.0,0.0,5000,5000,0,0,5000,Null,Null,168563058,111461,2
168563336,0.0,0.0,2500,2500,0,0,2500,Null,Null,168563336,111461,2
168582400,0.0,0.0,599000,599000,0,0,599000,Null,Null,168582400,183257,15250
168617127,0.0,0.0,0,2000,0,0,2000,Null,Null,168617127,111461,0
168657952,11.0,11.0,890000,890000,0,0,890000,Null,Null,168657952,561415,8073
168729416,0.0,0.0,7000,7000,0,0,7000,Null,Null,168729416,111461,2
168763623,110.0,110.0,90000,90000,0,0,90000,Null,Null,168763623,111461,2
168763926,138.0,138.0,59000,59000,0,0,59000,Null,Null,168763926,111461,2
168779219,686.0,686.0,32000,18600,13400,42,32000,Null,Null,168779219,5132069,53048
168794605,36.0,36.0,9900,9900,0,0,9900,Null,Null,168794605,111461,2
168843830,30.0,30.0,278000,139000,139000,50,278000,Null,Null,168843830,4259829,8511
168844555,27.0,27.0,20970000,20970000,0,0,20970000,Null,Null,168844555,18802,1795
168883231,5.0,5.0,2000,2000,0,0,2000,Null,Null,168883231,111461,2
168901625,441.0,441.0,140000,129000,11000,8,140000,Null,Null,168901625,883511,2225
168901807,0.0,0.0,1299,1299,0,0,1299,Null,Null,168901807,111461,2
168940033,4.0,4.0,29755000,29755000,0,0,29755000,Null,Null,168940033,18802,1795
168960299,164.0,164.0,40000,37000,3000,8,40000,Null,Null,168960299,456351,53074
168961989,0.0,0.0,2500,2500,0,0,2500,Null,Null,168961989,111461,2
168983521,0.0,0.0,2000,2000,0,0,2000,Null,Null,168983521,111461,2
169002114,0.0,0.0,17899000,17899000,0,0,17899000,Null,Null,169002114,561415,2340
169037944,0.0,0.0,2500,2500,0,0,2500,Null,Null,169037944,111461,2
169040772,5.0,5.0,1900,1900,0,0,1900,Null,Null,169040772,111461,2
169043683,408.0,408.0,1300,1300,0,0,1300,Null,Null,169043683,111461,2
169043847,1799.0,1799.0,3000,2500,500,17,3000,Null,Null,169043847,111461,2
169051999,0.0,0.0,1000,1000,0,0,1000,Null,Null,169051999,111461,2
169052143,1513.0,1513.0,2400,1850,550,23,2400,Null,Null,169052143,111461,1883
169065034,133.0,133.0,2000,2000,0,0,2000,Null,Null,169065034,111461,2
169067735,26.0,26.0,90000,65000,25000,28,90000,Null,Null,169067735,111461,2
169084508,0.0,0.0,26150000,26150000,0,0,26150000,Null,Null,169084508,50368,20170
169099607,31.0,31.0,3490000,2039000,1451000,42,3490000,Null,Null,169099607,18984,3428
169120887,0.0,0.0,2500,2500,0,0,2500,Null,Null,169120887,111461,2
169125939,2.0,2.0,185000,185000,0,0,185000,Null,Null,169125939,561415,15318
169135821,744.0,744.0,75600,42000,33600,44,75600,Null,Null,169135821,46703,23622
169191215,1.0,1.0,3628000,2584000,1044000,29,3628000,Null,Null,169191215,26150,8513
169191219,4.0,4.0,803000,570130,232870,29,803000,Null,Null,169191219,26150,8513
169191221,5.0,5.0,803000,599000,204000,25,803000,Null,Null,169191221,26150,8513
169191223,4.0,4.0,3628000,2719000,909000,25,3628000,Null,Null,169191223,26150,8513
169191229,3.0,3.0,803000,599000,204000,25,803000,Null,Null,169191229,26150,8513
169193353,34.0,34.0,77000,77000,0,0,77000,Null,Null,169193353,561415,28576
169194871,0.0,0.0,3500,3500,0,0,3500,Null,Null,169194871,111461,2
169196334,305.0,305.0,49000,47000,2000,4,49000,Null,Null,169196334,561415,1831
169199297,18.0,18.0,120000,120000,0,0,120000,Null,Null,169199297,111461,2
169246554,2879.0,2879.0,410000,205000,205000,50,410000,Null,Null,169246554,111461,8305
169251358,0.0,0.0,14700,14700,0,0,14700,Null,Null,169251358,111461,2
169266793,0.0,0.0,15000000,15000000,0,0,15000000,Null,Null,169266793,18802,1795
169269111,54.0,54.0,1000,1000,0,0,1000,Null,Null,169269111,111461,2
169272333,14.0,14.0,1000,1000,0,0,1000,Null,Null,169272333,111461,2
169272542,0.0,0.0,1560,1560,0,0,1560,Null,Null,169272542,111461,2
169272798,0.0,0.0,1300,1300,0,0,1300,Null,Null,169272798,111461,2
169272987,0.0,0.0,1300,1300,0,0,1300,Null,Null,169272987,111461,2
169273278,0.0,0.0,1950,1950,0,0,1950,Null,Null,169273278,111461,2
169274130,36.0,36.0,1000,1000,0,0,1000,Null,Null,169274130,111461,2
169274340,0.0,0.0,2000,2000,0,0,2000,Null,Null,169274340,111461,2
169274580,20.0,20.0,25000,16000,9000,36,25000,Null,Null,169274580,111461,2
169275254,0.0,0.0,2000,2000,0,0,2000,Null,Null,169275254,111461,2
169275832,0.0,0.0,2000,2000,0,0,2000,Null,Null,169275832,111461,2
169278008,44.0,44.0,199000,149000,50000,25,199000,Null,Null,169278008,32909,1613
169297084,0.0,0.0,10000,10000,0,0,10000,Null,Null,169297084,561415,15320
169304867,0.0,0.0,3912000,3912000,0,0,3912000,Null,Null,169304867,25643,1795
169306542,284.0,284.0,29000,29000,0,0,29000,Null,Null,169306542,5585229,1622
169311672,46.0,46.0,189000,73000,116000,61,189000,Null,Null,169311672,111461,2
169314326,0.0,0.0,25000000,22500000,2500000,10,25000000,Null,Null,169314326,18802,1794
169324398,3.0,3.0,49000,49000,0,0,49000,Null,Null,169324398,561415,15250
169336645,0.0,0.0,1950,1950,0,0,1950,Null,Null,169336645,111461,2
169337218,0.0,0.0,1950,1950,0,0,1950,Null,Null,169337218,111461,2
169337676,0.0,0.0,19500,19500,0,0,19500,Null,Null,169337676,111461,2
169354494,58.0,58.0,469000,469000,0,0,469000,Null,Null,169354494,215231,9013
169382723,0.0,0.0,1240000,1240000,0,0,1240000,Null,Null,169382723,5403099,15236
169385584,0.0,0.0,2000,2000,0,0,2000,Null,Null,169385584,561415,27214
169394511,137.0,137.0,210000,210000,0,0,210000,Null,Null,169394511,4202899,28482
169412256,0.0,0.0,9000,9000,0,0,9000,Null,Null,169412256,111461,2
169447896,31.0,31.0,355000,355000,0,0,355000,Null,Null,169447896,5063093,2511
169455304,0.0,0.0,2160,2160,0,0,2160,Null,Null,169455304,111461,2
169455380,0.0,0.0,2160,2160,0,0,2160,Null,Null,169455380,111461,2
169457923,0.0,0.0,20990000,20990000,0,0,20990000,Null,Null,169457923,18802,1794
169459378,0.0,0.0,25990000,25990000,0,0,25990000,Null,Null,169459378,18802,1794
169459856,0.0,0.0,30990000,30990000,0,0,30990000,Null,Null,169459856,18802,1794
169464835,0.0,0.0,5436000,5436000,0,0,5436000,Null,Null,169464835,25643,1795
169474956,2.0,2.0,1000,1000,0,0,1000,Null,Null,169474956,561415,27214
169503690,0.0,0.0,37320000,37320000,0,0,37320000,Null,Null,169503690,4683857,2340
169505385,0.0,0.0,42500000,42500000,0,0,42500000,Null,Null,169505385,4683857,2340
169520871,11.0,11.0,8990000,7699000,1291000,14,8990000,Null,Null,169520871,25422,1795
169536766,37.0,37.0,105000,105000,0,0,105000,Null,Null,169536766,837855,23042
169547278,0.0,0.0,83800000,83800000,0,0,83800000,Null,Null,169547278,4683857,2340
169547788,2.0,2.0,7032000,7032000,0,0,7032000,Null,Null,169547788,25422,1795
169555445,2707.0,2707.0,230000,230000,0,0,230000,Null,Null,169555445,53040,17186
169561154,251.0,251.0,458000,229000,229000,50,458000,Null,Null,169561154,63894,1634
169574682,0.0,0.0,112680000,112680000,0,0,112680000,Null,Null,169574682,4683857,2340
169577869,52.0,52.0,278000,139000,139000,50,278000,Null,Null,169577869,5515171,8512
169585264,10.0,10.0,1750000,1067500,682500,39,1750000,Null,Null,169585264,213321,3426
169594469,15.0,15.0,1990000,1540000,450000,23,1990000,Null,Null,169594469,4935523,2327
169603480,318.0,318.0,390000,219000,171000,44,390000,Null,Null,169603480,447239,1613
169604123,342.0,342.0,416000,221000,195000,47,416000,Null,Null,169604123,63894,1634
169619846,67.0,67.0,259000,189000,70000,27,259000,Null,Null,169619846,230607,27128
169623191,102.0,102.0,29000,29000,0,0,29000,Null,Null,169623191,233221,8305
169650447,0.0,0.0,7000,6930,70,1,7000,Null,Null,169650447,561415,8309
169651885,0.0,0.0,9000,9000,0,0,9000,Null,Null,169651885,111461,2
169655973,55.0,55.0,97800,97800,0,0,97800,Null,Null,169655973,111461,2
169660237,4.0,4.0,13000,13000,0,0,13000,Null,Null,169660237,111461,23258
169690966,0.0,0.0,1300,1300,0,0,1300,Null,Null,169690966,561415,23112
169729065,1.0,1.0,4000,4000,0,0,4000,Null,Null,169729065,111461,2
169734558,0.0,0.0,3192000,3192000,0,0,3192000,Null,Null,169734558,25643,1795
169735469,0.0,0.0,1000,1000,0,0,1000,Null,Null,169735469,111461,2
169744337,379.0,379.0,35000,35000,0,0,35000,Null,Null,169744337,5585229,11831
169749516,0.0,0.0,7032000,7032000,0,0,7032000,Null,Null,169749516,25422,1795
169756745,100.0,100.0,2000,2000,0,0,2000,Null,Null,169756745,111461,2
169756753,31.0,31.0,1740,1740,0,0,1740,Null,Null,169756753,111461,2
169769650,37.0,37.0,1418400,1418400,0,0,1418400,Null,Null,169769650,18804,8165
169778290,526.0,526.0,350000,299000,51000,15,350000,Null,Null,169778290,221187,1752
169809666,144.0,144.0,900000,415000,485000,54,900000,Null,Null,169809666,500047,7081
169812757,118.0,118.0,535000,396000,139000,26,535000,Null,Null,169812757,47489,3422
169816984,63.0,63.0,3000000,1510000,1490000,50,3000000,Null,Null,169816984,500047,2324
169829890,0.0,0.0,2000,2000,0,0,2000,Null,Null,169829890,111461,2
169847465,0.0,0.0,3920,1960,1960,50,3920,Null,Null,169847465,111461,2
169848307,2081.0,2081.0,66000,61000,5000,8,66000,Null,Null,169848307,523789,23588
169875622,0.0,0.0,12000,11000,1000,8,12000,Null,Null,169875622,111461,2
169897496,0.0,0.0,5000,5000,0,0,5000,Null,Null,169897496,111461,2
169898048,0.0,0.0,3500,3500,0,0,3500,Null,Null,169898048,111461,2
169898255,0.0,0.0,2000,2000,0,0,2000,Null,Null,169898255,111461,2
169898534,0.0,0.0,2000,2000,0,0,2000,Null,Null,169898534,111461,2
169900944,0.0,0.0,8000,8000,0,0,8000,Null,Null,169900944,111461,2
169919224,292.0,292.0,120000,98000,22000,18,120000,Null,Null,169919224,868633,23258
169920787,61.0,61.0,79799,79799,0,0,79799,Null,Null,169920787,111461,2
169920806,0.0,0.0,4850,4850,0,0,4850,Null,Null,169920806,111461,1815
169920812,14.0,14.0,1951,1951,0,0,1951,Null,Null,169920812,111461,2
169920853,6.0,6.0,1690,1690,0,0,1690,Null,Null,169920853,111461,2
169920856,18.0,18.0,1000,1000,0,0,1000,Null,Null,169920856,111461,2
169920872,20.0,20.0,2940,2940,0,0,2940,Null,Null,169920872,111461,1815
169920915,0.0,0.0,1000,1000,0,0,1000,Null,Null,169920915,111461,2
169920989,14.0,14.0,2931,2931,0,0,2931,Null,Null,169920989,111461,2
169920997,21.0,21.0,2450,2450,0,0,2450,Null,Null,169920997,111461,1815
169921149,4.0,4.0,4900,4900,0,0,4900,Null,Null,169921149,111461,20254
169921184,14.0,14.0,1442,1442,0,0,1442,Null,Null,169921184,111461,2
169921259,10.0,10.0,4773,4773,0,0,4773,Null,Null,169921259,111461,1815
169921284,0.0,0.0,1940,1940,0,0,1940,Null,Null,169921284,111461,1815
169921302,0.0,0.0,5811,5811,0,0,5811,Null,Null,169921302,111461,1815
169921308,32.0,32.0,3920,3920,0,0,3920,Null,Null,169921308,111461,2
169921316,0.0,0.0,3430,3430,0,0,3430,Null,Null,169921316,111461,1815
169921329,16.0,16.0,3136,3136,0,0,3136,Null,Null,169921329,111461,2
169921363,4.0,4.0,4704,4704,0,0,4704,Null,Null,169921363,111461,2
169921416,0.0,0.0,1000,1000,0,0,1000,Null,Null,169921416,111461,1815
169921422,0.0,0.0,4900,4900,0,0,4900,Null,Null,169921422,111461,2
169921430,5.0,5.0,6860,6860,0,0,6860,Null,Null,169921430,111461,2
169921444,1.0,1.0,1951,1951,0,0,1951,Null,Null,169921444,111461,2
169921448,40.0,40.0,1000,1000,0,0,1000,Null,Null,169921448,111461,2
169921474,8.0,8.0,8730,8730,0,0,8730,Null,Null,169921474,111461,2
169921534,0.0,0.0,1499,1499,0,0,1499,Null,Null,169921534,111461,1815
169921545,99.0,99.0,1951,1951,0,0,1951,Null,Null,169921545,111461,1815
169921582,0.0,0.0,4900,4900,0,0,4900,Null,Null,169921582,111461,20254
169921585,6.0,6.0,6305,6305,0,0,6305,Null,Null,169921585,111461,20254
169921590,0.0,0.0,6860,6860,0,0,6860,Null,Null,169921590,111461,1815
169921606,0.0,0.0,1000,1000,0,0,1000,Null,Null,169921606,111461,1815
169921620,0.0,0.0,6860,6860,0,0,6860,Null,Null,169921620,111461,2
169921624,39.0,39.0,1155,1155,0,0,1155,Null,Null,169921624,111461,2
169921704,30.0,30.0,5880,5880,0,0,5880,Null,Null,169921704,111461,2
169921715,18.0,18.0,4490,4490,0,0,4490,Null,Null,169921715,111461,2
169921775,22.0,22.0,1000,1000,0,0,1000,Null,Null,169921775,111461,20254
169921860,12.0,12.0,6860,6860,0,0,6860,Null,Null,169921860,111461,2
169921878,4.0,4.0,3430,3430,0,0,3430,Null,Null,169921878,111461,1815
169921880,0.0,0.0,3880,3880,0,0,3880,Null,Null,169921880,111461,2
169921966,6.0,6.0,2940,2940,0,0,2940,Null,Null,169921966,111461,2
169922013,5.0,5.0,6370,6370,0,0,6370,Null,Null,169922013,111461,20254
169922041,0.0,0.0,5880,5880,0,0,5880,Null,Null,169922041,111461,1815
169922063,0.0,0.0,1000,1000,0,0,1000,Null,Null,169922063,111461,2
169922065,0.0,0.0,1000,1000,0,0,1000,Null,Null,169922065,111461,2
169922082,1.0,1.0,7690,7690,0,0,7690,Null,Null,169922082,111461,2
169922115,0.0,0.0,2910,2910,0,0,2910,Null,Null,169922115,111461,1815
169922125,0.0,0.0,4841,4841,0,0,4841,Null,Null,169922125,111461,1815
169922180,30.0,30.0,2940,2940,0,0,2940,Null,Null,169922180,111461,1815
169922221,0.0,0.0,2901,2901,0,0,2901,Null,Null,169922221,111461,1815
169922228,9.0,9.0,1764,1764,0,0,1764,Null,Null,169922228,111461,2
169922249,0.0,0.0,4900,4900,0,0,4900,Null,Null,169922249,111461,1815
169922264,5.0,5.0,3920,3920,0,0,3920,Null,Null,169922264,111461,1815
169922366,15.0,15.0,2441,2441,0,0,2441,Null,Null,169922366,111461,2
169922378,45.0,45.0,3430,3430,0,0,3430,Null,Null,169922378,111461,1815
169922389,0.0,0.0,1470,1470,0,0,1470,Null,Null,169922389,111461,2
169922427,0.0,0.0,5390,5390,0,0,5390,Null,Null,169922427,111461,2
169922488,132.0,132.0,1000,1000,0,0,1000,Null,Null,169922488,111461,2
169922542,0.0,0.0,3880,3880,0,0,3880,Null,Null,169922542,111461,2
169922645,1.0,1.0,3911,3911,0,0,3911,Null,Null,169922645,111461,1815
169922668,18.0,18.0,2328,2328,0,0,2328,Null,Null,169922668,111461,2
169922676,30.0,30.0,5880,5880,0,0,5880,Null,Null,169922676,111461,2
169922723,15.0,15.0,20000,20000,0,0,20000,Null,Null,169922723,111461,2
169922724,42.0,42.0,1755,1755,0,0,1755,Null,Null,169922724,111461,2
169922733,0.0,0.0,1372,1372,0,0,1372,Null,Null,169922733,111461,1815
169922744,75.0,75.0,1470,1470,0,0,1470,Null,Null,169922744,111461,2
169922765,0.0,0.0,6790,6790,0,0,6790,Null,Null,169922765,111461,2
169922766,13.0,13.0,5880,5880,0,0,5880,Null,Null,169922766,111461,2
169922770,60.0,60.0,1000,1000,0,0,1000,Null,Null,169922770,111461,2
169922790,21.0,21.0,2931,2931,0,0,2931,Null,Null,169922790,111461,2
169922807,3.0,3.0,1960,1960,0,0,1960,Null,Null,169922807,111461,1815
169922811,30.0,30.0,1000,1000,0,0,1000,Null,Null,169922811,111461,2
169922832,45.0,45.0,1960,1960,0,0,1960,Null,Null,169922832,111461,2
169922881,7.0,7.0,1960,1960,0,0,1960,Null,Null,169922881,111461,2
169922909,33.0,33.0,2910,2910,0,0,2910,Null,Null,169922909,111461,2
169922929,6.0,6.0,4900,4900,0,0,4900,Null,Null,169922929,111461,2
169922983,10.0,10.0,1500,1500,0,0,1500,Null,Null,169922983,111461,20254
169922992,0.0,0.0,5820,5820,0,0,5820,Null,Null,169922992,111461,1815
169923001,4.0,4.0,5880,5880,0,0,5880,Null,Null,169923001,111461,2
169923014,0.0,0.0,6860,6860,0,0,6860,Null,Null,169923014,111461,1815
169923050,1.0,1.0,6860,6860,0,0,6860,Null,Null,169923050,111461,2
169923066,33.0,33.0,13622,13622,0,0,13622,Null,Null,169923066,111461,2
169923095,0.0,0.0,7760,7760,0,0,7760,Null,Null,169923095,111461,1815
169923110,18.0,18.0,1000,1000,0,0,1000,Null,Null,169923110,111461,2
169923241,0.0,0.0,4365,4365,0,0,4365,Null,Null,169923241,111461,1815
169923245,16.0,16.0,8245,8245,0,0,8245,Null,Null,169923245,111461,1815
169923266,0.0,0.0,1000,1000,0,0,1000,Null,Null,169923266,111461,2
169923273,16.0,16.0,4410,4410,0,0,4410,Null,Null,169923273,111461,2
169923334,31.0,31.0,1000,1000,0,0,1000,Null,Null,169923334,111461,2
169923364,0.0,0.0,1960,1960,0,0,1960,Null,Null,169923364,111461,20254
169923365,0.0,0.0,2500,2500,0,0,2500,Null,Null,169923365,111461,2
169923404,15.0,15.0,1461,1461,0,0,1461,Null,Null,169923404,111461,1815
169923418,0.0,0.0,2940,2940,0,0,2940,Null,Null,169923418,111461,20254
169923420,25.0,25.0,4900,4900,0,0,4900,Null,Null,169923420,111461,2
169923435,6.0,6.0,7840,7840,0,0,7840,Null,Null,169923435,111461,1815
169923438,91.0,91.0,2931,2931,0,0,2931,Null,Null,169923438,111461,2
169923477,20.0,20.0,2910,2910,0,0,2910,Null,Null,169923477,111461,2
169923529,0.0,0.0,1470,1470,0,0,1470,Null,Null,169923529,111461,2
169923616,0.0,0.0,3871,3871,0,0,3871,Null,Null,169923616,111461,2
169923631,50.0,50.0,1000,1000,0,0,1000,Null,Null,169923631,111461,2
169923669,2.0,2.0,3920,3920,0,0,3920,Null,Null,169923669,111461,2
169923782,0.0,0.0,9310,9310,0,0,9310,Null,Null,169923782,111461,1815
169923792,0.0,0.0,7563,7563,0,0,7563,Null,Null,169923792,111461,2
169923804,86.0,86.0,1000,1000,0,0,1000,Null,Null,169923804,111461,1815
169923826,0.0,0.0,2940,2940,0,0,2940,Null,Null,169923826,111461,2
169923905,13.0,13.0,7840,7840,0,0,7840,Null,Null,169923905,111461,2
169923915,0.0,0.0,8689,8689,0,0,8689,Null,Null,169923915,111461,2
169923954,2.0,2.0,4850,4850,0,0,4850,Null,Null,169923954,111461,2
169923957,25.0,25.0,5900,5900,0,0,5900,Null,Null,169923957,111461,2
169924015,4.0,4.0,3690,3690,0,0,3690,Null,Null,169924015,111461,2
169924066,12.0,12.0,2940,2940,0,0,2940,Null,Null,169924066,111461,2
169924079,0.0,0.0,1000,1000,0,0,1000,Null,Null,169924079,111461,1815
169924103,0.0,0.0,2910,2910,0,0,2910,Null,Null,169924103,111461,1815
169924109,0.0,0.0,5880,5880,0,0,5880,Null,Null,169924109,111461,2
169924190,11.0,11.0,3920,3920,0,0,3920,Null,Null,169924190,111461,2
169924226,4.0,4.0,7275,7275,0,0,7275,Null,Null,169924226,111461,2
169924325,7.0,7.0,1000,1000,0,0,1000,Null,Null,169924325,111461,1815
169924356,0.0,0.0,9310,9310,0,0,9310,Null,Null,169924356,111461,2
169924388,0.0,0.0,6860,6860,0,0,6860,Null,Null,169924388,111461,1815
169924468,0.0,0.0,2450,2450,0,0,2450,Null,Null,169924468,111461,2
169924516,0.0,0.0,1960,1960,0,0,1960,Null,Null,169924516,111461,2
169924567,0.0,0.0,1000,1000,0,0,1000,Null,Null,169924567,111461,20254
169924579,0.0,0.0,8000,8000,0,0,8000,Null,Null,169924579,111461,1815
169924580,13.0,13.0,4900,4900,0,0,4900,Null,Null,169924580,111461,2
169924617,0.0,0.0,1960,1960,0,0,1960,Null,Null,169924617,111461,2
169924719,2.0,2.0,1960,1960,0,0,1960,Null,Null,169924719,111461,2
169924721,11.0,11.0,3450,3450,0,0,3450,Null,Null,169924721,111461,2
169924742,3.0,3.0,2940,2940,0,0,2940,Null,Null,169924742,111461,2
169924793,25.0,25.0,3920,3920,0,0,3920,Null,Null,169924793,111461,28432
169924818,36.0,36.0,1960,1960,0,0,1960,Null,Null,169924818,111461,2
169924830,0.0,0.0,4890,4890,0,0,4890,Null,Null,169924830,111461,2
169924836,0.0,0.0,7275,7275,0,0,7275,Null,Null,169924836,111461,1815
169924837,86.0,86.0,1000,1000,0,0,1000,Null,Null,169924837,111461,2
169924923,0.0,0.0,5811,5811,0,0,5811,Null,Null,169924923,111461,20254
169925055,0.0,0.0,3395,3395,0,0,3395,Null,Null,169925055,111461,1815
169925058,20.0,20.0,6860,6860,0,0,6860,Null,Null,169925058,111461,1815
169925086,2.0,2.0,4850,4850,0,0,4850,Null,Null,169925086,111461,1815
169925103,0.0,0.0,5326,5326,0,0,5326,Null,Null,169925103,111461,1815
169925185,4.0,4.0,3911,3911,0,0,3911,Null,Null,169925185,111461,2
169925222,30.0,30.0,1000,1000,0,0,1000,Null,Null,169925222,111461,20254
169925234,3.0,3.0,5900,5900,0,0,5900,Null,Null,169925234,111461,2
169925246,1.0,1.0,3911,3911,0,0,3911,Null,Null,169925246,111461,1815
169925278,0.0,0.0,1960,1960,0,0,1960,Null,Null,169925278,111461,1815
169925338,0.0,0.0,2646,2646,0,0,2646,Null,Null,169925338,111461,1815
169925386,26.0,26.0,6860,6860,0,0,6860,Null,Null,169925386,111461,20254
169925414,2.0,2.0,5880,5880,0,0,5880,Null,Null,169925414,111461,1815
169925477,0.0,0.0,3871,3871,0,0,3871,Null,Null,169925477,111461,1815
169925504,0.0,0.0,8820,8820,0,0,8820,Null,Null,169925504,111461,1815
169925510,0.0,0.0,4365,4365,0,0,4365,Null,Null,169925510,111461,2
169925601,10.0,10.0,1960,1960,0,0,1960,Null,Null,169925601,111461,20254
169925602,0.0,0.0,7840,7840,0,0,7840,Null,Null,169925602,111461,2
169925613,0.0,0.0,2901,2901,0,0,2901,Null,Null,169925613,111461,20254
169925630,0.0,0.0,7840,7840,0,0,7840,Null,Null,169925630,111461,2
169925688,5.0,5.0,2425,2425,0,0,2425,Null,Null,169925688,111461,2
169925689,33.0,33.0,2931,2931,0,0,2931,Null,Null,169925689,111461,2
169925700,0.0,0.0,4850,4850,0,0,4850,Null,Null,169925700,111461,2
169925705,15.0,15.0,3920,3920,0,0,3920,Null,Null,169925705,111461,2
169925740,20.0,20.0,5880,5880,0,0,5880,Null,Null,169925740,111461,1815
169925815,0.0,0.0,6851,6851,0,0,6851,Null,Null,169925815,111461,1815
169925839,19.0,19.0,8820,8820,0,0,8820,Null,Null,169925839,111461,2
169925864,195.0,195.0,2940,2940,0,0,2940,Null,Null,169925864,111461,1815
169925903,1.0,1.0,1000,1000,0,0,1000,Null,Null,169925903,111461,2
169925924,20.0,20.0,5326,5326,0,0,5326,Null,Null,169925924,111461,1815
169925925,0.0,0.0,5820,5820,0,0,5820,Null,Null,169925925,111461,1815
169925934,0.0,0.0,2901,2901,0,0,2901,Null,Null,169925934,111461,20254
169925956,0.0,0.0,4900,4900,0,0,4900,Null,Null,169925956,111461,1815
169925974,0.0,0.0,8245,8245,0,0,8245,Null,Null,169925974,111461,2
169925981,2.0,2.0,6790,6790,0,0,6790,Null,Null,169925981,111461,2
169925995,0.0,0.0,4891,4891,0,0,4891,Null,Null,169925995,111461,1815
169925997,17.0,17.0,7350,7350,0,0,7350,Null,Null,169925997,111461,2
169926072,0.0,0.0,7831,7831,0,0,7831,Null,Null,169926072,111461,8073
169926084,1.0,1.0,8820,8820,0,0,8820,Null,Null,169926084,111461,2
169926108,0.0,0.0,4365,4365,0,0,4365,Null,Null,169926108,111461,1815
169926185,0.0,0.0,5820,5820,0,0,5820,Null,Null,169926185,111461,1815
169926206,55.0,55.0,6860,6860,0,0,6860,Null,Null,169926206,111461,2
169926255,399.0,399.0,1000,1000,0,0,1000,Null,Null,169926255,111461,1815
169926266,1.0,1.0,1470,1470,0,0,1470,Null,Null,169926266,111461,2
169926279,0.0,0.0,2940,2940,0,0,2940,Null,Null,169926279,111461,1815
169926301,0.0,0.0,9310,9310,0,0,9310,Null,Null,169926301,111461,1815
169926302,4.0,4.0,3920,3920,0,0,3920,Null,Null,169926302,111461,2
169926316,0.0,0.0,1000,1000,0,0,1000,Null,Null,169926316,111461,2
169926433,2.0,2.0,1960,1960,0,0,1960,Null,Null,169926433,111461,2
169926434,0.0,0.0,5871,5871,0,0,5871,Null,Null,169926434,111461,2
169926460,0.0,0.0,6370,6370,0,0,6370,Null,Null,169926460,111461,2
169926499,0.0,0.0,2939,2939,0,0,2939,Null,Null,169926499,111461,2
169926541,16.0,16.0,8820,8820,0,0,8820,Null,Null,169926541,111461,2
169926558,10.0,10.0,3813,3813,0,0,3813,Null,Null,169926558,111461,2
169926598,14.0,14.0,5880,5880,0,0,5880,Null,Null,169926598,111461,2
169926675,0.0,0.0,6851,6851,0,0,6851,Null,Null,169926675,111461,1815
169926686,0.0,0.0,3880,3880,0,0,3880,Null,Null,169926686,111461,1815
169926738,0.0,0.0,3880,3880,0,0,3880,Null,Null,169926738,111461,1815
169926757,8.0,8.0,4900,4900,0,0,4900,Null,Null,169926757,111461,1815
169926786,0.0,0.0,5880,5880,0,0,5880,Null,Null,169926786,111461,2
169926798,2.0,2.0,1372,1372,0,0,1372,Null,Null,169926798,111461,2
169926829,4.0,4.0,8820,8820,0,0,8820,Null,Null,169926829,111461,2
169926833,0.0,0.0,5820,5820,0,0,5820,Null,Null,169926833,111461,1815
169926844,4.0,4.0,6999,6999,0,0,6999,Null,Null,169926844,111461,1815
169926846,0.0,0.0,1470,1470,0,0,1470,Null,Null,169926846,111461,1815
169926853,36.0,36.0,1000,1000,0,0,1000,Null,Null,169926853,111461,1815
169926870,0.0,0.0,6851,6851,0,0,6851,Null,Null,169926870,111461,1815
169926971,0.0,0.0,1960,1960,0,0,1960,Null,Null,169926971,111461,2
169926978,59.0,59.0,1000,1000,0,0,1000,Null,Null,169926978,111461,2
169927060,0.0,0.0,4850,4850,0,0,4850,Null,Null,169927060,111461,1815
169927064,0.0,0.0,2352,2352,0,0,2352,Null,Null,169927064,111461,1815
169927115,0.0,0.0,3395,3395,0,0,3395,Null,Null,169927115,111461,1815
169927203,0.0,0.0,6790,6790,0,0,6790,Null,Null,169927203,111461,1815
169927228,85.0,85.0,1500,1500,0,0,1500,Null,Null,169927228,111461,1815
169927232,0.0,0.0,5390,5390,0,0,5390,Null,Null,169927232,111461,20254
169927291,35.0,35.0,2646,2646,0,0,2646,Null,Null,169927291,111461,2
169927358,22.0,22.0,4841,4841,0,0,4841,Null,Null,169927358,111461,1815
169927362,20.0,20.0,1960,1960,0,0,1960,Null,Null,169927362,111461,1815
169927436,3.0,3.0,3331,3331,0,0,3331,Null,Null,169927436,111461,2
169927490,17.0,17.0,3880,3880,0,0,3880,Null,Null,169927490,111461,20254
169927501,0.0,0.0,3960,3960,0,0,3960,Null,Null,169927501,111461,1815
169927517,0.0,0.0,3386,3386,0,0,3386,Null,Null,169927517,111461,1815
169927536,0.0,0.0,3871,3871,0,0,3871,Null,Null,169927536,111461,1815
169927567,59.0,59.0,1960,1960,0,0,1960,Null,Null,169927567,111461,2
169927569,0.0,0.0,3920,3920,0,0,3920,Null,Null,169927569,111461,2
169927619,43.0,43.0,1764,1764,0,0,1764,Null,Null,169927619,111461,2
169927697,230.0,230.0,1000,1000,0,0,1000,Null,Null,169927697,111461,1815
169927713,0.0,0.0,8730,8730,0,0,8730,Null,Null,169927713,111461,1815
169927735,5.0,5.0,6860,6860,0,0,6860,Null,Null,169927735,111461,1815
169927746,0.0,0.0,3920,3920,0,0,3920,Null,Null,169927746,111461,1815
169927757,0.0,0.0,7840,7840,0,0,7840,Null,Null,169927757,111461,1815
169927758,7.0,7.0,1000,1000,0,0,1000,Null,Null,169927758,111461,1815
169927760,1.0,1.0,2450,2450,0,0,2450,Null,Null,169927760,111461,2
169927829,0.0,0.0,2441,2441,0,0,2441,Null,Null,169927829,111461,2
169927848,6.0,6.0,7500,7500,0,0,7500,Null,Null,169927848,111461,2
169927884,0.0,0.0,3822,3822,0,0,3822,Null,Null,169927884,111461,20254
169927887,0.0,0.0,1951,1951,0,0,1951,Null,Null,169927887,111461,1815
169927889,0.0,0.0,3900,3900,0,0,3900,Null,Null,169927889,111461,1815
169927900,0.0,0.0,4850,4850,0,0,4850,Null,Null,169927900,111461,28432
169927936,32.0,32.0,1960,1960,0,0,1960,Null,Null,169927936,111461,1815
169928130,0.0,0.0,1940,1940,0,0,1940,Null,Null,169928130,111461,2
169928133,3.0,3.0,7350,7350,0,0,7350,Null,Null,169928133,111461,1815
169928141,10.0,10.0,5880,5880,0,0,5880,Null,Null,169928141,111461,2
169928143,0.0,0.0,3421,3421,0,0,3421,Null,Null,169928143,111461,2
169928147,15.0,15.0,2000,2000,0,0,2000,Null,Null,169928147,111461,20254
169928168,0.0,0.0,1470,1470,0,0,1470,Null,Null,169928168,111461,2
169928240,0.0,0.0,14691,14691,0,0,14691,Null,Null,169928240,111461,2
169928250,0.0,0.0,2842,2842,0,0,2842,Null,Null,169928250,111461,2
169928290,0.0,0.0,1951,1951,0,0,1951,Null,Null,169928290,111461,2
169928307,0.0,0.0,8721,8721,0,0,8721,Null,Null,169928307,111461,1815
169928364,0.0,0.0,8730,8730,0,0,8730,Null,Null,169928364,111461,2
169928372,52.0,52.0,1000,1000,0,0,1000,Null,Null,169928372,111461,2
169928405,0.0,0.0,8730,8730,0,0,8730,Null,Null,169928405,111461,1815
169928426,0.0,0.0,2910,2910,0,0,2910,Null,Null,169928426,111461,1815
169928462,0.0,0.0,1000,1000,0,0,1000,Null,Null,169928462,111461,2
169928548,0.0,0.0,3911,3911,0,0,3911,Null,Null,169928548,111461,20246
169928583,13.0,13.0,1000,1000,0,0,1000,Null,Null,169928583,111461,1815
169928612,0.0,0.0,5880,5880,0,0,5880,Null,Null,169928612,111461,1815
169928622,0.0,0.0,4900,4900,0,0,4900,Null,Null,169928622,111461,2
169928648,0.0,0.0,6860,6860,0,0,6860,Null,Null,169928648,111461,2
169928771,7.0,7.0,1000,1000,0,0,1000,Null,Null,169928771,111461,2
169928794,5.0,5.0,1000,1000,0,0,1000,Null,Null,169928794,111461,2
169928838,0.0,0.0,3920,3920,0,0,3920,Null,Null,169928838,111461,20254
169928852,6.0,6.0,6860,6860,0,0,6860,Null,Null,169928852,111461,2
169928874,1.0,1.0,1000,1000,0,0,1000,Null,Null,169928874,111461,1815
169928879,2.0,2.0,2931,2931,0,0,2931,Null,Null,169928879,111461,2
169928884,20.0,20.0,9215,9215,0,0,9215,Null,Null,169928884,111461,2
169928910,6.0,6.0,4841,4841,0,0,4841,Null,Null,169928910,111461,2
169928995,26.0,26.0,1940,1940,0,0,1940,Null,Null,169928995,111461,2
169929033,23.0,23.0,1940,1940,0,0,1940,Null,Null,169929033,111461,2
169929113,40.0,40.0,1000,1000,0,0,1000,Null,Null,169929113,111461,1815
169929129,17.0,17.0,4900,4900,0,0,4900,Null,Null,169929129,111461,2
169929203,4.0,4.0,5871,5871,0,0,5871,Null,Null,169929203,111461,2
169929426,801.0,801.0,1000,1000,0,0,1000,Null,Null,169929426,111461,1815
169929484,0.0,0.0,5820,5820,0,0,5820,Null,Null,169929484,111461,1815
169929504,0.0,0.0,1000,1000,0,0,1000,Null,Null,169929504,111461,2
169929555,0.0,0.0,2931,2931,0,0,2931,Null,Null,169929555,111461,2
169929562,13.0,13.0,3386,3386,0,0,3386,Null,Null,169929562,111461,26658
169929621,9.0,9.0,1469,1469,0,0,1469,Null,Null,169929621,111461,2
169929646,16.0,16.0,4900,4900,0,0,4900,Null,Null,169929646,111461,2
169929735,20.0,20.0,3880,3880,0,0,3880,Null,Null,169929735,111461,1815
169929764,3.0,3.0,6790,6790,0,0,6790,Null,Null,169929764,111461,1815
169929777,0.0,0.0,8330,8330,0,0,8330,Null,Null,169929777,111461,1815
169929848,0.0,0.0,1951,1951,0,0,1951,Null,Null,169929848,111461,1815
169929855,0.0,0.0,4900,4900,0,0,4900,Null,Null,169929855,111461,2
169929863,34.0,34.0,2940,2940,0,0,2940,Null,Null,169929863,111461,2
169929865,0.0,0.0,2800,2800,0,0,2800,Null,Null,169929865,111461,2
169929874,0.0,0.0,6370,6370,0,0,6370,Null,Null,169929874,111461,2
169929896,5.0,5.0,8820,8820,0,0,8820,Null,Null,169929896,111461,2
169929940,5.0,5.0,1000,1000,0,0,1000,Null,Null,169929940,111461,2
169929969,0.0,0.0,6790,6790,0,0,6790,Null,Null,169929969,111461,1815
169929982,0.0,0.0,1000,1000,0,0,1000,Null,Null,169929982,111461,1815
169930049,0.0,0.0,1000,1000,0,0,1000,Null,Null,169930049,111461,20254
169930095,10.0,10.0,1000,1000,0,0,1000,Null,Null,169930095,111461,2
169930133,21.0,21.0,7840,7840,0,0,7840,Null,Null,169930133,111461,2
169930204,4.0,4.0,2425,2425,0,0,2425,Null,Null,169930204,111461,2
169930222,0.0,0.0,14691,14691,0,0,14691,Null,Null,169930222,111461,2
169930287,0.0,0.0,7760,7760,0,0,7760,Null,Null,169930287,111461,1815
169930320,0.0,0.0,5811,5811,0,0,5811,Null,Null,169930320,111461,20254
169930330,3.0,3.0,2450,2450,0,0,2450,Null,Null,169930330,111461,2
169930348,5.0,5.0,3880,3880,0,0,3880,Null,Null,169930348,111461,1815
169930355,2.0,2.0,5702,5702,0,0,5702,Null,Null,169930355,111461,2
169930363,19.0,19.0,1000,1000,0,0,1000,Null,Null,169930363,111461,1815
169930424,0.0,0.0,2910,2910,0,0,2910,Null,Null,169930424,111461,1815
169930431,0.0,0.0,2328,2328,0,0,2328,Null,Null,169930431,111461,2
169930507,70.0,70.0,7500,7500,0,0,7500,Null,Null,169930507,111461,2
169930582,0.0,0.0,2000,2000,0,0,2000,Null,Null,169930582,111461,2
169931321,192.0,192.0,2000,2000,0,0,2000,Null,Null,169931321,111461,2
169931914,0.0,0.0,1900,1900,0,0,1900,Null,Null,169931914,111461,2
169935739,0.0,0.0,1500,1500,0,0,1500,Null,Null,169935739,111461,2
169936556,0.0,0.0,30000,15000,15000,50,30000,Null,Null,169936556,111461,2
169978766,4432.0,4432.0,32220,17900,14320,44,32220,Null,Null,169978766,46703,53186
170024993,1.0,1.0,14124000,10500000,3624000,26,14124000,Null,Null,170024993,242001,11935
170032241,34.0,34.0,300000,300000,0,0,300000,Null,Null,170032241,111461,2
170066594,101.0,101.0,129000,122000,7000,5,129000,Null,Null,170066594,163213,8305
170066619,149.0,149.0,9000,7000,2000,22,9000,Null,Null,170066619,163213,8305
170098255,0.0,0.0,6598000,6598000,0,0,6598000,Null,Null,170098255,5641569,11873
170098887,59.0,59.0,5000000,4090000,910000,18,5000000,Null,Null,170098887,114527,2657
170105289,1.0,1.0,10170000,7715000,2455000,24,10170000,Null,Null,170105289,242001,11933
170105386,189.0,189.0,165000,135000,30000,18,165000,Null,Null,170105386,18802,1820
170105796,0.0,0.0,25000,25000,0,0,25000,Null,Null,170105796,111461,2
170107628,0.0,0.0,2400,2400,0,0,2400,Null,Null,170107628,111461,2
170148395,50.0,50.0,78000,78000,0,0,78000,Null,Null,170148395,561415,28576
170165658,14.0,14.0,368000,368000,0,0,368000,Null,Null,170165658,5178283,8061
170165701,42.0,42.0,388000,388000,0,0,388000,Null,Null,170165701,5178283,8061
170167264,61.0,61.0,388000,388000,0,0,388000,Null,Null,170167264,5178283,8061
170241713,0.0,0.0,13000,13000,0,0,13000,Null,Null,170241713,111461,2
170241799,1.0,1.0,39900,39900,0,0,39900,Null,Null,170241799,111461,2
170245480,0.0,0.0,12500,12500,0,0,12500,Null,Null,170245480,111461,2
170246363,0.0,0.0,18000,18000,0,0,18000,Null,Null,170246363,111461,2
170250973,2.0,2.0,1900,1900,0,0,1900,Null,Null,170250973,111461,2685
170295839,2.0,2.0,15000,15000,0,0,15000,Null,Null,170295839,111461,2
170296199,0.0,0.0,15000,15000,0,0,15000,Null,Null,170296199,111461,2
170296380,1.0,1.0,15000,15000,0,0,15000,Null,Null,170296380,111461,2
170296382,0.0,0.0,6000,6000,0,0,6000,Null,Null,170296382,111461,2
170296384,0.0,0.0,12000,12000,0,0,12000,Null,Null,170296384,111461,2
170296485,1.0,1.0,15000,15000,0,0,15000,Null,Null,170296485,111461,2
170296638,1.0,1.0,15000,15000,0,0,15000,Null,Null,170296638,111461,2
170296647,0.0,0.0,12000,12000,0,0,12000,Null,Null,170296647,111461,2
170296769,0.0,0.0,12000,12000,0,0,12000,Null,Null,170296769,111461,2
170296923,0.0,0.0,12000,12000,0,0,12000,Null,Null,170296923,111461,2
170296955,0.0,0.0,12000,12000,0,0,12000,Null,Null,170296955,111461,2
170297821,88.0,88.0,167000,155000,12000,7,167000,Null,Null,170297821,364765,1813
170300461,0.0,0.0,5000,5000,0,0,5000,Null,Null,170300461,111461,2
170312089,34.0,34.0,20000,9000,11000,55,20000,Null,Null,170312089,561415,28674
170324185,0.0,0.0,5498000,5498000,0,0,5498000,Null,Null,170324185,243687,1634
170325261,0.0,0.0,5498000,5498000,0,0,5498000,Null,Null,170325261,19018,1634
170330521,0.0,0.0,5498000,5498000,0,0,5498000,Null,Null,170330521,243687,1634
170331236,0.0,0.0,68540000,45236000,23304000,34,68540000,Null,Null,170331236,183111,23376
170334689,315.0,315.0,189000,83000,106000,56,189000,Null,Null,170334689,302375,1838
170336806,0.0,0.0,2000,2000,0,0,2000,Null,Null,170336806,111461,23246
170338160,1.0,1.0,10490000,7690000,2800000,27,10490000,Null,Null,170338160,25643,1795
170338314,0.0,0.0,15000000,15000000,0,0,15000000,Null,Null,170338314,18802,1795
170338325,64.0,64.0,299000,199000,100000,33,299000,Null,Null,170338325,302375,1832
170338332,10.0,10.0,25000,12000,13000,52,25000,Null,Null,170338332,561415,15250
170338375,0.0,0.0,26500000,26500000,0,0,26500000,Null,Null,170338375,2157697,2340
170340186,0.0,0.0,37990000,37990000,0,0,37990000,Null,Null,170340186,2157697,2340
170340192,0.0,0.0,37800000,37800000,0,0,37800000,Null,Null,170340192,2157697,2340
170340198,0.0,0.0,40000000,40000000,0,0,40000000,Null,Null,170340198,2157697,2340
170346955,0.0,0.0,12900000,12900000,0,0,12900000,Null,Null,170346955,18802,1795
170347036,15.0,15.0,8839,8839,0,0,8839,Null,Null,170347036,111461,6742
170353976,0.0,0.0,15000000,12000000,3000000,20,15000000,Null,Null,170353976,18802,1795
170354187,0.0,0.0,1000,1000,0,0,1000,Null,Null,170354187,111461,2
170356063,1.0,1.0,5498000,5498000,0,0,5498000,Null,Null,170356063,19018,1634
170372445,26.0,26.0,30000,10000,20000,67,30000,Null,Null,170372445,111461,2
170372648,1.0,1.0,439000,439000,0,0,439000,Null,Null,170372648,111461,2
170373042,3.0,3.0,428000,398000,30000,7,428000,Null,Null,170373042,111461,2
170373444,0.0,0.0,40000,10000,30000,75,40000,Null,Null,170373444,111461,2
170373471,2.0,2.0,1315000,1285000,30000,2,1315000,Null,Null,170373471,111461,15318
170374012,2.0,2.0,250000,220000,30000,12,250000,Null,Null,170374012,111461,2
170389407,0.0,0.0,1300,1300,0,0,1300,Null,Null,170389407,111461,2
170403557,0.0,0.0,1500,1500,0,0,1500,Null,Null,170403557,111461,2
170404501,15.0,15.0,109000,109000,0,0,109000,Null,Null,170404501,111461,2
170404655,56.0,56.0,100000,76000,24000,24,100000,Null,Null,170404655,163213,8305
170424248,3.0,3.0,35000,15000,20000,57,35000,Null,Null,170424248,561415,15250
170425580,258.0,258.0,595000,458000,137000,23,595000,Null,Null,170425580,930377,17460
170432194,0.0,0.0,1999,1999,0,0,1999,Null,Null,170432194,111461,2
170444484,18900.0,18900.0,218000,170000,48000,22,218000,Null,Null,170444484,86206,1583
170445143,498.0,498.0,380000,297000,83000,22,380000,Null,Null,170445143,86206,3422
170445180,13935.0,13935.0,218000,178000,40000,18,218000,Null,Null,170445180,86206,11605
170446767,1.0,1.0,2000,2000,0,0,2000,Null,Null,170446767,111461,2
170448099,28.0,28.0,882000,729000,153000,17,882000,Null,Null,170448099,112638,1796
170449059,11.0,11.0,489000,479220,9780,2,489000,Null,Null,170449059,112638,1796
170453889,37.0,37.0,1000,990,10,1,1000,Null,Null,170453889,111461,2
170485852,77.0,77.0,80000,60000,20000,25,80000,Null,Null,170485852,561415,23366
170491702,135.0,135.0,63700,48000,15700,25,63700,Null,Null,170491702,4408565,17186
170496556,9.0,9.0,54000,54000,0,0,54000,Null,Null,170496556,561415,15318
170497077,0.0,0.0,1000,1000,0,0,1000,Null,Null,170497077,111461,53074
170497096,40.0,40.0,1000,1000,0,0,1000,Null,Null,170497096,111461,2363
170497245,19.0,19.0,329000,299000,30000,9,329000,Null,Null,170497245,18804,2334
170497385,588.0,588.0,9990000,7090000,2900000,29,9990000,Null,Null,170497385,18802,1795
170498309,3.0,3.0,720000,545000,175000,24,720000,Null,Null,170498309,183257,15250
170499588,0.0,0.0,21500000,21500000,0,0,21500000,Null,Null,170499588,167287,6653
170510212,0.0,0.0,81000000,56700000,24300000,30,81000000,Null,Null,170510212,111461,2
170510240,0.0,0.0,55000000,38500000,16500000,30,55000000,Null,Null,170510240,111461,2
170510301,0.0,0.0,96000000,67200000,28800000,30,96000000,Null,Null,170510301,111461,2
170510360,0.0,0.0,51800000,36260000,15540000,30,51800000,Null,Null,170510360,111461,23576
170510620,0.0,0.0,109200000,76440000,32760000,30,109200000,Null,Null,170510620,111461,23576
170510737,0.0,0.0,89180000,62426000,26754000,30,89180000,Null,Null,170510737,111461,2
170510936,0.0,0.0,55000000,38500000,16500000,30,55000000,Null,Null,170510936,111461,2
170511086,0.0,0.0,72200000,50540000,21660000,30,72200000,Null,Null,170511086,111461,23576
170511106,0.0,0.0,96000000,67200000,28800000,30,96000000,Null,Null,170511106,111461,2
170511225,0.0,0.0,81200000,56840000,24360000,30,81200000,Null,Null,170511225,111461,23576
170511279,0.0,0.0,96000000,67200000,28800000,30,96000000,Null,Null,170511279,111461,2
170511378,0.0,0.0,96000000,67200000,28800000,30,96000000,Null,Null,170511378,111461,2
170511413,0.0,0.0,54000000,37800000,16200000,30,54000000,Null,Null,170511413,111461,2
170511433,0.0,0.0,99190000,69433000,29757000,30,99190000,Null,Null,170511433,111461,2
170511487,0.0,0.0,96000000,67200000,28800000,30,96000000,Null,Null,170511487,111461,2
170511584,0.0,0.0,90090000,63063000,27027000,30,90090000,Null,Null,170511584,111461,2
170511587,0.0,0.0,89180000,62426000,26754000,30,89180000,Null,Null,170511587,111461,2
170543370,52.0,52.0,900000,526000,374000,42,900000,Null,Null,170543370,500047,7081
170580388,1.0,1.0,4000000,3759000,241000,6,4000000,Null,Null,170580388,18802,1795
170581659,1.0,1.0,5690000,5690000,0,0,5690000,Null,Null,170581659,18802,1795
170619626,0.0,0.0,14999,14999,0,0,14999,Null,Null,170619626,111461,2
170653845,0.0,0.0,9000,9000,0,0,9000,Null,Null,170653845,111461,2
170674029,5.0,5.0,1000,1000,0,0,1000,Null,Null,170674029,111461,2
170727266,42.0,42.0,660000,660000,0,0,660000,Null,Null,170727266,18804,8061
170727305,23.0,23.0,880000,880000,0,0,880000,Null,Null,170727305,18804,8061
170739445,25.0,25.0,95000,64000,31000,33,95000,Null,Null,170739445,212647,27128
170742038,6.0,6.0,9690,9690,0,0,9690,Null,Null,170742038,111461,2
170742056,183.0,183.0,1743,1743,0,0,1743,Null,Null,170742056,111461,1883
170742239,0.0,0.0,2352,2352,0,0,2352,Null,Null,170742239,111461,2
170742250,0.0,0.0,2000,2000,0,0,2000,Null,Null,170742250,111461,2
170742365,0.0,0.0,2000,2000,0,0,2000,Null,Null,170742365,561415,1974
170742747,1.0,1.0,1000,1000,0,0,1000,Null,Null,170742747,111461,2
170742828,0.0,0.0,1900,1900,0,0,1900,Null,Null,170742828,111461,2
170743010,0.0,0.0,1500,1500,0,0,1500,Null,Null,170743010,111461,2
170743274,0.0,0.0,1000,1000,0,0,1000,Null,Null,170743274,111461,2
170743713,0.0,0.0,1560,1560,0,0,1560,Null,Null,170743713,111461,2
170743962,0.0,0.0,1040,1040,0,0,1040,Null,Null,170743962,111461,2
170743986,0.0,0.0,2470,2470,0,0,2470,Null,Null,170743986,111461,2
170744274,0.0,0.0,1040,1040,0,0,1040,Null,Null,170744274,111461,2
170744516,0.0,0.0,1992,1992,0,0,1992,Null,Null,170744516,111461,2
170744755,25.0,25.0,1040,1040,0,0,1040,Null,Null,170744755,111461,2
170744987,0.0,0.0,2490,2490,0,0,2490,Null,Null,170744987,111461,2
170754653,0.0,0.0,43000,43000,0,0,43000,Null,Null,170754653,111461,2
170763508,0.0,0.0,2200,2200,0,0,2200,Null,Null,170763508,111461,2
170764088,2.0,2.0,2400,2400,0,0,2400,Null,Null,170764088,111461,2
170764129,0.0,0.0,2000,2000,0,0,2000,Null,Null,170764129,111461,2
170764429,1.0,1.0,2000,2000,0,0,2000,Null,Null,170764429,111461,2
170764513,0.0,0.0,1600,1600,0,0,1600,Null,Null,170764513,111461,2
170764525,0.0,0.0,2000,2000,0,0,2000,Null,Null,170764525,111461,2
170764789,0.0,0.0,2500,2500,0,0,2500,Null,Null,170764789,111461,2
170765151,0.0,0.0,1500,1500,0,0,1500,Null,Null,170765151,111461,2
170765198,7.0,7.0,2500,2500,0,0,2500,Null,Null,170765198,111461,2
170765377,0.0,0.0,1600,1600,0,0,1600,Null,Null,170765377,111461,2
170765675,1.0,1.0,2500,2500,0,0,2500,Null,Null,170765675,111461,2
170768436,82.0,82.0,160000,160000,0,0,160000,Null,Null,170768436,22095,1631
170770907,486.0,486.0,250000,160000,90000,36,250000,Null,Null,170770907,5150243,8305
170775086,0.0,0.0,9800,9800,0,0,9800,Null,Null,170775086,111461,2
170775712,1.0,1.0,3468000,3468000,0,0,3468000,Null,Null,170775712,25422,1795
170781870,0.0,0.0,7650000,6885000,765000,10,7650000,Null,Null,170781870,704815,15318
170781928,0.0,0.0,7150000,6435000,715000,10,7150000,Null,Null,170781928,704815,15318
170813015,0.0,0.0,45990000,45990000,0,0,45990000,Null,Null,170813015,561415,11858
170820908,1808.0,1808.0,15000,11900,3100,21,15000,Null,Null,170820908,5527787,7064
170858524,0.0,0.0,9000,9000,0,0,9000,Null,Null,170858524,111461,2
170868237,0.0,0.0,1999,1999,0,0,1999,Null,Null,170868237,111461,2
170900301,0.0,0.0,2000,2000,0,0,2000,Null,Null,170900301,111461,2
170926046,9.0,9.0,249999,249999,0,0,249999,Null,Null,170926046,111461,2
170963038,83.0,83.0,35000,35000,0,0,35000,Null,Null,170963038,4842843,8602
170984400,0.0,0.0,1479,1479,0,0,1479,Null,Null,170984400,111461,2
170984712,0.0,0.0,1530,1530,0,0,1530,Null,Null,170984712,111461,2
170984777,0.0,0.0,1248,1248,0,0,1248,Null,Null,170984777,111461,2
170984913,2.0,2.0,9690,9690,0,0,9690,Null,Null,170984913,111461,2
170984921,17.0,17.0,1000,1000,0,0,1000,Null,Null,170984921,111461,2
170985046,20.0,20.0,1743,1743,0,0,1743,Null,Null,170985046,111461,2
170985054,0.0,0.0,1040,1040,0,0,1040,Null,Null,170985054,111461,2
170985154,0.0,0.0,1000,1000,0,0,1000,Null,Null,170985154,111461,2
170985249,0.0,0.0,1900,1900,0,0,1900,Null,Null,170985249,111461,2
170985260,0.0,0.0,2000,2000,0,0,2000,Null,Null,170985260,111461,2
170985405,0.0,0.0,2000,2000,0,0,2000,Null,Null,170985405,111461,2
170985435,0.0,0.0,2375,2375,0,0,2375,Null,Null,170985435,111461,2
170985440,0.0,0.0,1040,1040,0,0,1040,Null,Null,170985440,111461,2
170985442,0.0,0.0,1040,1040,0,0,1040,Null,Null,170985442,111461,2
170985477,111.0,111.0,1500,1500,0,0,1500,Null,Null,170985477,561415,2760
170985799,0.0,0.0,2352,2352,0,0,2352,Null,Null,170985799,111461,2
170986047,0.0,0.0,1040,1040,0,0,1040,Null,Null,170986047,111461,2
170986093,6.0,6.0,1992,1992,0,0,1992,Null,Null,170986093,111461,2
170986444,0.0,0.0,2470,2470,0,0,2470,Null,Null,170986444,111461,2
170986591,15.0,15.0,2295,2295,0,0,2295,Null,Null,170986591,111461,2
170986750,0.0,0.0,2490,2490,0,0,2490,Null,Null,170986750,111461,2
170986906,27.0,27.0,1000,1000,0,0,1000,Null,Null,170986906,111461,1883
170987387,9.0,9.0,1479,1479,0,0,1479,Null,Null,170987387,111461,2
170987484,0.0,0.0,1000,1000,0,0,1000,Null,Null,170987484,111461,2
170988245,6.0,6.0,1560,1560,0,0,1560,Null,Null,170988245,111461,2
170988657,0.0,0.0,2500,2500,0,0,2500,Null,Null,170988657,111461,2
170988954,0.0,0.0,1040,1040,0,0,1040,Null,Null,170988954,111461,2
171035068,51.0,51.0,2000,2000,0,0,2000,Null,Null,171035068,111461,2
171035171,1.0,1.0,1700,1700,0,0,1700,Null,Null,171035171,111461,2
171035196,2.0,2.0,1200,1200,0,0,1200,Null,Null,171035196,111461,2
171035214,3.0,3.0,2200,2200,0,0,2200,Null,Null,171035214,111461,2
171035227,5.0,5.0,1600,1600,0,0,1600,Null,Null,171035227,111461,2
171035246,2.0,2.0,2300,2300,0,0,2300,Null,Null,171035246,111461,2
171035286,0.0,0.0,1400,1400,0,0,1400,Null,Null,171035286,111461,2
171050057,131.0,131.0,155000,155000,0,0,155000,Null,Null,171050057,561415,28596
171099160,141.0,141.0,189000,145000,44000,23,189000,Null,Null,171099160,230607,6305
171101318,1126.0,1126.0,2500,2200,300,12,2500,Null,Null,171101318,561415,2514
171104824,91.0,91.0,68000,65000,3000,4,68000,Null,Null,171104824,561415,1622
171116896,206.0,206.0,201600,196000,5600,3,201600,Null,Null,171116896,21269,1613
171116898,151.0,151.0,175000,153000,22000,13,175000,Null,Null,171116898,21269,1613
171118015,0.0,0.0,1050,1050,0,0,1050,Null,Null,171118015,111461,2
171124663,0.0,0.0,150000000,150000000,0,0,150000000,Null,Null,171124663,561415,12590
171126769,0.0,0.0,2000,2000,0,0,2000,Null,Null,171126769,111461,2
171127018,0.0,0.0,2000,2000,0,0,2000,Null,Null,171127018,111461,2
171127169,0.0,0.0,1500,1500,0,0,1500,Null,Null,171127169,111461,2
171127205,5.0,5.0,1000,1000,0,0,1000,Null,Null,171127205,111461,2
171127335,0.0,0.0,1500,1500,0,0,1500,Null,Null,171127335,111461,1883
171134017,21.0,21.0,71984,71984,0,0,71984,Null,Null,171134017,111461,2
171151924,2.0,2.0,18000,18000,0,0,18000,Null,Null,171151924,111461,2
171169353,0.0,0.0,8390000,8390000,0,0,8390000,Null,Null,171169353,18802,1795
171170808,1.0,1.0,590000,299000,291000,49,590000,Null,Null,171170808,4647777,15250
171174936,1.0,1.0,11950000,11950000,0,0,11950000,Null,Null,171174936,50307,8067
171177882,17.0,17.0,385000,296000,89000,23,385000,Null,Null,171177882,149978,11869
171183734,185.0,185.0,139000,125000,14000,10,139000,Null,Null,171183734,21651,5006
171190775,1.0,1.0,799000,799000,0,0,799000,Null,Null,171190775,4960305,1795
171198348,276.0,276.0,2450000,1480000,970000,40,2450000,Null,Null,171198348,561415,4381
171209317,0.0,0.0,10000,10000,0,0,10000,Null,Null,171209317,111461,2
171209417,0.0,0.0,650000,650000,0,0,650000,Null,Null,171209417,111461,2
171210436,0.0,0.0,1300000,1300000,0,0,1300000,Null,Null,171210436,111461,2
171210833,412.0,412.0,120000,120000,0,0,120000,Null,Null,171210833,192731,8305
171215288,0.0,0.0,17899000,17899000,0,0,17899000,Null,Null,171215288,162957,1803
171215324,0.0,0.0,47999000,47999000,0,0,47999000,Null,Null,171215324,162957,1803
171217349,19.0,19.0,99000,97000,2000,2,99000,Null,Null,171217349,166419,28576
171249203,1.0,1.0,419000,419000,0,0,419000,Null,Null,171249203,561415,49722
171277126,0.0,0.0,2377,2377,0,0,2377,Null,Null,171277126,111461,2
171319644,361.0,361.0,199000,185000,14000,7,199000,Null,Null,171319644,4554495,23622
171320447,0.0,0.0,40400,18000,22400,55,40400,Null,Null,171320447,561415,15318
171328449,131.0,131.0,328000,212000,116000,35,328000,Null,Null,171328449,79682,11835
171333138,10.0,10.0,1195000,1195000,0,0,1195000,Null,Null,171333138,561415,2784
171434962,25.0,25.0,2500,2500,0,0,2500,Null,Null,171434962,111461,2
171435025,60.0,60.0,1700,1700,0,0,1700,Null,Null,171435025,111461,2
171435086,25.0,25.0,2000,2000,0,0,2000,Null,Null,171435086,111461,2
171435567,41.0,41.0,1500,1500,0,0,1500,Null,Null,171435567,111461,2
171437108,54.0,54.0,2699,2429,270,10,2699,Null,Null,171437108,111461,1883
171438376,0.0,0.0,2300,2300,0,0,2300,Null,Null,171438376,111461,2
171470149,0.0,0.0,599000,599000,0,0,599000,Null,Null,171470149,63894,1634
171495446,524.0,524.0,150000,150000,0,0,150000,Null,Null,171495446,4655707,3426
171495457,865.0,865.0,250000,130000,120000,48,250000,Null,Null,171495457,4655707,3426
171496324,1986.0,1986.0,10000,6000,4000,40,10000,Null,Null,171496324,5334123,2685
171525935,0.0,0.0,125000,125000,0,0,125000,Null,Null,171525935,111461,15250
171545541,59.0,59.0,5500000,4296000,1204000,22,5500000,Null,Null,171545541,114527,1815
171556536,0.0,0.0,37500000,37500000,0,0,37500000,Null,Null,171556536,561415,23104
171564906,4224.0,4224.0,218000,187000,31000,14,218000,Null,Null,171564906,112885,1613
171579723,5.0,5.0,1999,1999,0,0,1999,Null,Null,171579723,111461,2
171585987,205.0,205.0,18000,18000,0,0,18000,Null,Null,171585987,561415,53190
171592667,0.0,0.0,4680000,4680000,0,0,4680000,Null,Null,171592667,25422,1795
171611750,26.0,26.0,365000,259000,106000,29,365000,Null,Null,171611750,508909,1601
171624233,600.0,600.0,1000,1000,0,0,1000,Null,Null,171624233,561415,53054
171625495,3.0,3.0,168000,168000,0,0,168000,Null,Null,171625495,561415,15318
171653465,0.0,0.0,78000,78000,0,0,78000,Null,Null,171653465,111461,2
171653510,4.0,4.0,150000,150000,0,0,150000,Null,Null,171653510,111461,49722
171653582,1.0,1.0,240000,240000,0,0,240000,Null,Null,171653582,111461,49722
171653732,2.0,2.0,77000,77000,0,0,77000,Null,Null,171653732,111461,49722
171657026,0.0,0.0,41300000,41300000,0,0,41300000,Null,Null,171657026,4558659,2340
171657209,930.0,930.0,260000,225000,35000,13,260000,Null,Null,171657209,18802,1820
171658636,0.0,0.0,66980000,66980000,0,0,66980000,Null,Null,171658636,4558659,2340
171665401,0.0,0.0,12699000,12699000,0,0,12699000,Null,Null,171665401,111461,2324
171668729,167.0,167.0,105000,78000,27000,26,105000,Null,Null,171668729,561415,23446
171685825,5.0,5.0,790000,790000,0,0,790000,Null,Null,171685825,19673,1796
171692870,102.0,102.0,149000,129000,20000,13,149000,Null,Null,171692870,32909,11821
171735468,6.0,6.0,45000,45000,0,0,45000,Null,Null,171735468,111461,2
171745893,0.0,0.0,2000,2000,0,0,2000,Null,Null,171745893,111461,2
171790566,1.0,1.0,2000,2000,0,0,2000,Null,Null,171790566,111461,2
171790598,28.0,28.0,2000,2000,0,0,2000,Null,Null,171790598,111461,2
171791601,4.0,4.0,110000,110000,0,0,110000,Null,Null,171791601,111461,49722
171791622,7.0,7.0,120000,120000,0,0,120000,Null,Null,171791622,111461,49722
171817118,42.0,42.0,295000,295000,0,0,295000,Null,Null,171817118,226333,23048
171852890,2.0,2.0,689000,689000,0,0,689000,Null,Null,171852890,112638,1796
171865309,55.0,55.0,59000,59000,0,0,59000,Null,Null,171865309,4408565,17186
171865978,1.0,1.0,8000,8000,0,0,8000,Null,Null,171865978,111461,2
171889281,0.0,0.0,870000,870000,0,0,870000,Null,Null,171889281,19673,1796
171897574,46.0,46.0,4390000,3090000,1300000,30,4390000,Null,Null,171897574,25422,1795
171925541,30.0,30.0,2500,2500,0,0,2500,Null,Null,171925541,111461,2
171932006,14.0,14.0,2000,2000,0,0,2000,Null,Null,171932006,111461,1883
171934203,91.0,91.0,9990000,6940000,3050000,31,9990000,Null,Null,171934203,18802,1795
171935217,1.0,1.0,8000,8000,0,0,8000,Null,Null,171935217,111461,2
171936351,0.0,0.0,1500,1500,0,0,1500,Null,Null,171936351,111461,2
171937434,2.0,2.0,1475000,885000,590000,40,1475000,Null,Null,171937434,25501,8170
171939157,515.0,515.0,249000,178000,71000,29,249000,Null,Null,171939157,18984,1831
171949837,133.0,133.0,4999000,4499000,500000,10,4999000,Null,Null,171949837,18984,28618
171999283,0.0,0.0,232000,232000,0,0,232000,Null,Null,171999283,111461,2
172001933,16.0,16.0,2690000,1718000,972000,36,2690000,Null,Null,172001933,18802,1795
172002426,308.0,308.0,67000,39000,28000,42,67000,Null,Null,172002426,4820811,5006
172068921,0.0,0.0,15570000,15570000,0,0,15570000,Null,Null,172068921,243913,12876
172070057,6.0,6.0,59000,59000,0,0,59000,Null,Null,172070057,561415,15318
172111074,307.0,307.0,335000,309000,26000,8,335000,Null,Null,172111074,523789,23658
172123123,29.0,29.0,182300,182300,0,0,182300,Null,Null,172123123,111461,2
172123932,0.0,0.0,36400000,36400000,0,0,36400000,Null,Null,172123932,111461,23446
172142322,270.0,270.0,1500,1500,0,0,1500,Null,Null,172142322,561415,53054
172142332,0.0,0.0,6670000,5999000,671000,10,6670000,Null,Null,172142332,4647777,15318
172146754,809.0,809.0,250000,179000,71000,28,250000,Null,Null,172146754,625265,28574
172155438,0.0,0.0,7100000,7100000,0,0,7100000,Null,Null,172155438,111461,2
172156670,16.0,16.0,2000,2000,0,0,2000,Null,Null,172156670,111461,2
172156734,70.0,70.0,2490,2490,0,0,2490,Null,Null,172156734,111461,2
172156826,112.0,112.0,1500,1500,0,0,1500,Null,Null,172156826,111461,1883
172156998,46.0,46.0,1000,1000,0,0,1000,Null,Null,172156998,111461,2
172157007,22.0,22.0,1500,1500,0,0,1500,Null,Null,172157007,111461,2
172157195,0.0,0.0,2000,2000,0,0,2000,Null,Null,172157195,111461,2
172157217,0.0,0.0,7000,7000,0,0,7000,Null,Null,172157217,111461,2
172157257,63.0,63.0,1000,1000,0,0,1000,Null,Null,172157257,111461,2
172157553,47.0,47.0,79900,79900,0,0,79900,Null,Null,172157553,111461,2
172157576,0.0,0.0,4500,4500,0,0,4500,Null,Null,172157576,111461,2
172160182,0.0,0.0,7032000,7032000,0,0,7032000,Null,Null,172160182,25422,1795
172178476,41.0,41.0,5690000,4239000,1451000,26,5690000,Null,Null,172178476,18802,1795
172205400,0.0,0.0,1700,1700,0,0,1700,Null,Null,172205400,111461,2
172237348,16.0,16.0,125000,125000,0,0,125000,Null,Null,172237348,111461,2
172249252,4.0,4.0,250000,185000,65000,26,250000,Null,Null,172249252,111461,2
172268977,2.0,2.0,38000,28000,10000,26,38000,Null,Null,172268977,111461,2
172303081,464.0,464.0,76000,76000,0,0,76000,Null,Null,172303081,5310209,3426
172303189,1.0,1.0,2969000,2969000,0,0,2969000,Null,Null,172303189,25643,1795
172309326,0.0,0.0,4190000,3759000,431000,10,4190000,Null,Null,172309326,18802,1795
172313085,68.0,68.0,650000,628000,22000,3,650000,Null,Null,172313085,189445,28596
172313857,1.0,1.0,2990000,1850000,1140000,38,2990000,Null,Null,172313857,247549,1795
172314506,20.0,20.0,1500,1500,0,0,1500,Null,Null,172314506,111461,53054
172319352,1.0,1.0,2489000,1850000,639000,26,2489000,Null,Null,172319352,247549,1795
172319632,4.0,4.0,5000,5000,0,0,5000,Null,Null,172319632,111461,1622
172328621,2.0,2.0,15990000,15990000,0,0,15990000,Null,Null,172328621,114527,2657
172329599,24.0,24.0,2199000,1823000,376000,17,2199000,Null,Null,172329599,25422,1795
172335599,26.0,26.0,2699000,2120000,579000,21,2699000,Null,Null,172335599,25422,1795
172340817,47.0,47.0,38000,38000,0,0,38000,Null,Null,172340817,111461,23134
172341289,58.0,58.0,790000,751000,39000,5,790000,Null,Null,172341289,189445,28596
172348196,4.0,4.0,58000,58000,0,0,58000,Null,Null,172348196,111461,15250
172348944,56.0,56.0,25000,25000,0,0,25000,Null,Null,172348944,111461,1634
172360891,7.0,7.0,304000,304000,0,0,304000,Null,Null,172360891,21651,12908
172406172,0.0,0.0,5000,5000,0,0,5000,Null,Null,172406172,111461,2
172441152,36.0,36.0,189000,189000,0,0,189000,Null,Null,172441152,111461,2
172452184,0.0,0.0,2200,2200,0,0,2200,Null,Null,172452184,111461,2
172452978,0.0,0.0,2200,2200,0,0,2200,Null,Null,172452978,111461,2
172453092,0.0,0.0,2200,2200,0,0,2200,Null,Null,172453092,111461,2
172474755,0.0,0.0,175000,175000,0,0,175000,Null,Null,172474755,111461,15320
172482244,1.0,1.0,169000,150000,19000,11,169000,Null,Null,172482244,111461,15250
172482370,1.0,1.0,439000,439000,0,0,439000,Null,Null,172482370,111461,15250
172485794,9.0,9.0,525000,525000,0,0,525000,Null,Null,172485794,5653553,49724
172529464,20.0,20.0,2498,2498,0,0,2498,Null,Null,172529464,111461,2
172537996,0.0,0.0,2220000,2220000,0,0,2220000,Null,Null,172537996,31978,8061
172548709,1.0,1.0,50000,50000,0,0,50000,Null,Null,172548709,111461,2
172555765,0.0,0.0,3468000,3468000,0,0,3468000,Null,Null,172555765,25422,1795
172587038,0.0,0.0,5200000,5200000,0,0,5200000,Null,Null,172587038,875757,11885
172589109,19.0,19.0,3649000,3068000,581000,16,3649000,Null,Null,172589109,25422,1795
172631252,13.0,13.0,20000,2000,18000,90,20000,Null,Null,172631252,111461,15318
172670979,0.0,0.0,13400000,12000000,1400000,10,13400000,Null,Null,172670979,18802,1795
172678406,14.0,14.0,2590000,2200000,390000,15,2590000,Null,Null,172678406,208841,2340
172702169,26.0,26.0,120000,78000,42000,35,120000,Null,Null,172702169,4246951,8602
172705838,0.0,0.0,14000,14000,0,0,14000,Null,Null,172705838,111461,2
172706024,0.0,0.0,14000,14000,0,0,14000,Null,Null,172706024,111461,2
172707255,0.0,0.0,17000,17000,0,0,17000,Null,Null,172707255,111461,2
172707297,0.0,0.0,15000,15000,0,0,15000,Null,Null,172707297,111461,2
172707466,0.0,0.0,14000,14000,0,0,14000,Null,Null,172707466,111461,2
172709177,2262.0,2262.0,25000,15000,10000,40,25000,Null,Null,172709177,5334123,6948
172800186,228.0,228.0,4590000,3890000,700000,15,4590000,Null,Null,172800186,208841,2340
172812534,150.0,150.0,1000,1000,0,0,1000,Null,Null,172812534,111461,2
172813310,0.0,0.0,1310,1310,0,0,1310,Null,Null,172813310,111461,2
172816107,17.0,17.0,236000,99000,137000,58,236000,Null,Null,172816107,33652,3177
172826900,0.0,0.0,4190000,3759000,431000,10,4190000,Null,Null,172826900,18802,1795
172828932,133.0,133.0,898000,898000,0,0,898000,Null,Null,172828932,111461,8512
172828967,26.0,26.0,5690000,4299000,1391000,24,5690000,Null,Null,172828967,18802,1795
172833589,95.0,95.0,2999000,2099000,900000,30,2999000,Null,Null,172833589,18984,5264
172851284,168.0,168.0,890000,484000,406000,46,890000,Null,Null,172851284,402501,2659
172851717,148.0,148.0,978000,978000,0,0,978000,Null,Null,172851717,111461,7449
172907871,144.0,144.0,938000,938000,0,0,938000,Null,Null,172907871,111461,7449
172916600,237.0,237.0,2000,2000,0,0,2000,Null,Null,172916600,111461,23416
172917839,153.0,153.0,90000,65000,25000,28,90000,Null,Null,172917839,111461,23678
172920927,4.0,4.0,430000,430000,0,0,430000,Null,Null,172920927,112638,1796
172940012,764.0,764.0,199000,199000,0,0,199000,Null,Null,172940012,5272071,2511
172940390,3.0,3.0,5500,3000,2500,45,5500,Null,Null,172940390,111461,7064
172948732,0.0,0.0,27490000,27490000,0,0,27490000,Null,Null,172948732,114527,2657
172949669,3.0,3.0,32000,32000,0,0,32000,Null,Null,172949669,111461,15236
172949839,0.0,0.0,8500000,8500000,0,0,8500000,Null,Null,172949839,18802,1795
172950048,375.0,375.0,251000,231000,20000,8,251000,Null,Null,172950048,523789,6305
172952420,0.0,0.0,6300000,6300000,0,0,6300000,Null,Null,172952420,621115,11863
172952703,27.0,27.0,1000,1000,0,0,1000,Null,Null,172952703,111461,23134
172952854,0.0,0.0,1950,1950,0,0,1950,Null,Null,172952854,111461,23134
172953355,0.0,0.0,2000,2000,0,0,2000,Null,Null,172953355,111461,2
172953579,7.0,7.0,1500,1500,0,0,1500,Null,Null,172953579,111461,2
172953823,0.0,0.0,1500,1500,0,0,1500,Null,Null,172953823,111461,2
172953891,0.0,0.0,2000,2000,0,0,2000,Null,Null,172953891,111461,2
172953929,0.0,0.0,2000,2000,0,0,2000,Null,Null,172953929,111461,2
172954012,0.0,0.0,2000,2000,0,0,2000,Null,Null,172954012,111461,2
172954266,0.0,0.0,1500,1500,0,0,1500,Null,Null,172954266,111461,2
172954329,20.0,20.0,1500,1500,0,0,1500,Null,Null,172954329,111461,2
173002304,163.0,163.0,699000,699000,0,0,699000,Null,Null,173002304,111461,7449
173010766,0.0,0.0,2250,2250,0,0,2250,Null,Null,173010766,111461,2
173037555,12.0,12.0,117785,117785,0,0,117785,Null,Null,173037555,111461,2
173039740,0.0,0.0,20000000,20000000,0,0,20000000,Null,Null,173039740,621115,11873
173056037,18.0,18.0,112500,112500,0,0,112500,Null,Null,173056037,111461,2
173058453,711.0,711.0,899000,569000,330000,37,899000,Null,Null,173058453,18984,1838
173058719,24.0,24.0,5000,5000,0,0,5000,Null,Null,173058719,111461,8167
173076436,44.0,44.0,21900,21900,0,0,21900,Null,Null,173076436,111461,15318
173076445,2.0,2.0,12900,12900,0,0,12900,Null,Null,173076445,111461,15318
173084229,74.0,74.0,13000,13000,0,0,13000,Null,Null,173084229,4647777,15318
173098042,0.0,0.0,10000,10000,0,0,10000,Null,Null,173098042,111461,2
173116627,15.0,15.0,59000,59000,0,0,59000,Null,Null,173116627,111461,28588
173126834,173.0,173.0,380000,195000,185000,49,380000,Null,Null,173126834,5313735,8305
173127769,1.0,1.0,153000,153000,0,0,153000,Null,Null,173127769,111461,15236
173128851,0.0,0.0,1798000,899000,899000,50,1798000,Null,Null,173128851,111461,15318
173130549,0.0,0.0,15000,15000,0,0,15000,Null,Null,173130549,111461,2
173137800,222.0,222.0,1050000,880000,170000,16,1050000,Null,Null,173137800,18802,1820
173151383,2318.0,2318.0,53900,53900,0,0,53900,Null,Null,173151383,3748887,3877
173164746,103.0,103.0,122000,105000,17000,14,122000,Null,Null,173164746,4554495,53186
173174394,28.0,28.0,140000,120000,20000,14,140000,Null,Null,173174394,21271,11835
173176966,0.0,0.0,245000,245000,0,0,245000,Null,Null,173176966,18984,1838
173176970,0.0,0.0,490000,490000,0,0,490000,Null,Null,173176970,18984,4880
173177001,0.0,0.0,165000,165000,0,0,165000,Null,Null,173177001,18984,5263
173177002,0.0,0.0,316000,316000,0,0,316000,Null,Null,173177002,18984,28638
173177019,0.0,0.0,350000,350000,0,0,350000,Null,Null,173177019,18984,28696
173187991,0.0,0.0,1500,1500,0,0,1500,Null,Null,173187991,111461,2
173190909,0.0,0.0,3600,3600,0,0,3600,Null,Null,173190909,111461,2
173190982,0.0,0.0,18850,18850,0,0,18850,Null,Null,173190982,111461,15320
173204814,2.0,2.0,10000,10000,0,0,10000,Null,Null,173204814,111461,2
173205160,1.0,1.0,7668000,7348000,320000,4,7668000,Null,Null,173205160,25643,1795
173206800,67.0,67.0,315000,192000,123000,39,315000,Null,Null,173206800,33652,3177
173211404,2511.0,2511.0,1618200,899000,719200,44,1618200,Null,Null,173211404,46703,4381
173224731,761.0,761.0,299000,219000,80000,27,299000,Null,Null,173224731,5527787,8225
173235604,0.0,0.0,12400,12400,0,0,12400,Null,Null,173235604,111461,15250
173267011,68.0,68.0,499000,499000,0,0,499000,Null,Null,173267011,18802,28576
173273752,2.0,2.0,1087,1087,0,0,1087,Null,Null,173273752,111461,2
173283219,69.0,69.0,61000,61000,0,0,61000,Null,Null,173283219,610895,2136
173289064,28.0,28.0,10000,10000,0,0,10000,Null,Null,173289064,111461,8167
173303229,0.0,0.0,7000,7000,0,0,7000,Null,Null,173303229,111461,2
173347593,267.0,267.0,2000,2000,0,0,2000,Null,Null,173347593,111461,23416
173359789,123.0,123.0,59000,59000,0,0,59000,Null,Null,173359789,111461,53190
173360901,307.0,307.0,340000,239000,101000,30,340000,Null,Null,173360901,275197,11827
173360950,44.0,44.0,450000,299000,151000,34,450000,Null,Null,173360950,275197,11827
173362622,1.0,1.0,14500,14500,0,0,14500,Null,Null,173362622,111461,15318
173387789,46.0,46.0,5690000,5690000,0,0,5690000,Null,Null,173387789,147856,28856
173390458,0.0,0.0,15000000,15000000,0,0,15000000,Null,Null,173390458,18802,1795
173399574,65.0,65.0,88000,88000,0,0,88000,Null,Null,173399574,111461,23184
173407737,0.0,0.0,39900000,39900000,0,0,39900000,Null,Null,173407737,111461,1883
173407851,0.0,0.0,36000000,36000000,0,0,36000000,Null,Null,173407851,111461,2
173424963,20.0,20.0,38000,38000,0,0,38000,Null,Null,173424963,111461,5566
173427678,75.0,75.0,2200,2200,0,0,2200,Null,Null,173427678,111461,2392
173433796,108.0,108.0,8000,8000,0,0,8000,Null,Null,173433796,111461,6948
173433806,411.0,411.0,30000,30000,0,0,30000,Null,Null,173433806,111461,2337
173435623,6.0,6.0,140000,140000,0,0,140000,Null,Null,173435623,111461,2
173461557,0.0,0.0,3012000,2794000,218000,7,3012000,Null,Null,173461557,25643,1795
173463044,2.0,2.0,153000,153000,0,0,153000,Null,Null,173463044,111461,15250
173463371,64.0,64.0,340000,340000,0,0,340000,Null,Null,173463371,202607,4413
173463443,162.0,162.0,650000,618000,32000,5,650000,Null,Null,173463443,202607,17170
173464495,512.0,512.0,360000,342000,18000,5,360000,Null,Null,173464495,202607,1609
173469753,409.0,409.0,1440000,1260000,180000,13,1440000,Null,Null,173469753,223153,11859
173469991,0.0,0.0,15480000,15480000,0,0,15480000,Null,Null,173469991,164793,7273
173472760,219.0,219.0,1630000,1440000,190000,12,1630000,Null,Null,173472760,5180961,11881
173475017,8.0,8.0,387000,387000,0,0,387000,Null,Null,173475017,18984,3428
173481045,0.0,0.0,12490000,12490000,0,0,12490000,Null,Null,173481045,114527,2657
173484024,29.0,29.0,2390000,2390000,0,0,2390000,Null,Null,173484024,4966875,12864
173486409,0.0,0.0,5450000,4900000,550000,10,5450000,Null,Null,173486409,5700191,11935
173486419,0.0,0.0,7550000,6800000,750000,10,7550000,Null,Null,173486419,5700191,11935
173486950,0.0,0.0,7550000,6800000,750000,10,7550000,Null,Null,173486950,5700191,2340
173487569,0.0,0.0,5950000,4490000,1460000,25,5950000,Null,Null,173487569,5700191,2340
173487572,0.0,0.0,23000000,15000000,8000000,35,23000000,Null,Null,173487572,5700191,2340
173487577,0.0,0.0,42000000,27000000,15000000,36,42000000,Null,Null,173487577,5700191,2340
173487815,0.0,0.0,9999,9999,0,0,9999,Null,Null,173487815,111461,49726
173487827,1.0,1.0,130000,130000,0,0,130000,Null,Null,173487827,111461,49722
173487914,1.0,1.0,149000,149000,0,0,149000,Null,Null,173487914,111461,49722
173488711,0.0,0.0,5350000,4800000,550000,10,5350000,Null,Null,173488711,5700191,2340
173488810,1.0,1.0,12490000,12490000,0,0,12490000,Null,Null,173488810,114527,2657
173488844,0.0,0.0,12490000,12490000,0,0,12490000,Null,Null,173488844,114527,2657
173489713,0.0,0.0,12490000,12490000,0,0,12490000,Null,Null,173489713,114527,2657
173492210,8.0,8.0,2500,2500,0,0,2500,Null,Null,173492210,152553,53074
173537018,2.0,2.0,12000,12000,0,0,12000,Null,Null,173537018,4647777,15318
173551136,1.0,1.0,10000,10000,0,0,10000,Null,Null,173551136,706667,11875
173551161,10.0,10.0,8900,8900,0,0,8900,Null,Null,173551161,706667,11873
173552275,4.0,4.0,1000,1000,0,0,1000,Null,Null,173552275,111461,2
173557858,58.0,58.0,2050000,2050000,0,0,2050000,Null,Null,173557858,147856,1794
173573236,5.0,5.0,59000,59000,0,0,59000,Null,Null,173573236,111461,28580
173589479,16.0,16.0,140000,140000,0,0,140000,Null,Null,173589479,111461,15250
173600339,226.0,226.0,170000,150000,20000,12,170000,Null,Null,173600339,734429,17186
173609360,216.0,216.0,1950000,1390000,560000,29,1950000,Null,Null,173609360,4250493,4381
173617193,3.0,3.0,150000,61000,89000,59,150000,Null,Null,173617193,111461,15250
173627786,106.0,106.0,350000,184000,166000,47,350000,Null,Null,173627786,314675,8400
173632748,98.0,98.0,150000,115000,35000,23,150000,Null,Null,173632748,4820811,5995
173636676,103.0,103.0,135000,105000,30000,22,135000,Null,Null,173636676,4820811,5995
173665555,17.0,17.0,2000,2000,0,0,2000,Null,Null,173665555,111461,53070
173671943,183.0,183.0,70000,32000,38000,54,70000,Null,Null,173671943,111461,23416
173711552,0.0,0.0,3192000,3192000,0,0,3192000,Null,Null,173711552,25643,1795
173712024,0.0,0.0,3012000,2794000,218000,7,3012000,Null,Null,173712024,25643,1795
173717336,132.0,132.0,24000,24000,0,0,24000,Null,Null,173717336,111461,23622
173731609,6.0,6.0,8390,8390,0,0,8390,Null,Null,173731609,111461,28480
173731655,51.0,51.0,250000,171978,78022,31,250000,Null,Null,173731655,111461,28596
173744230,276.0,276.0,215000,156000,59000,27,215000,Null,Null,173744230,861765,8305
173754971,41.0,41.0,118999,118999,0,0,118999,Null,Null,173754971,111461,53074
173759698,0.0,0.0,22000,22000,0,0,22000,Null,Null,173759698,111461,15318
173761453,123.0,123.0,600000,600000,0,0,600000,Null,Null,173761453,257373,1641
173764269,2.0,2.0,3985000,3985000,0,0,3985000,Null,Null,173764269,18802,1795
173764601,142.0,142.0,5690000,4110000,1580000,28,5690000,Null,Null,173764601,18802,1795
173764867,92.0,92.0,89000,89000,0,0,89000,Null,Null,173764867,18420,1820
173768326,127.0,127.0,65000,65000,0,0,65000,Null,Null,173768326,21653,5007
173797168,0.0,0.0,155000,155000,0,0,155000,Null,Null,173797168,111461,23242
173800279,308.0,308.0,95000,95000,0,0,95000,Null,Null,173800279,155308,4593
173804200,1.0,1.0,117949,117949,0,0,117949,Null,Null,173804200,111461,1978
173807661,0.0,0.0,17000,8500,8500,50,17000,Null,Null,173807661,111461,11831
173813491,0.0,0.0,10000,5000,5000,50,10000,Null,Null,173813491,111461,8202
173820029,68.0,68.0,90000,45000,45000,50,90000,Null,Null,173820029,111461,18888
173820035,22.0,22.0,110000,55000,55000,50,110000,Null,Null,173820035,111461,18888
173854188,8.0,8.0,26000,26000,0,0,26000,Null,Null,173854188,41391,53190
173854434,222.0,222.0,120000,82000,38000,32,120000,Null,Null,173854434,861765,8305
173858509,0.0,0.0,14000000,8940000,5060000,36,14000000,Null,Null,173858509,46007,8227
173946654,149.0,149.0,149000,84000,65000,44,149000,Null,Null,173946654,111461,23392
173946836,8.0,8.0,8000000,7360000,640000,8,8000000,Null,Null,173946836,174699,8511
173947400,43.0,43.0,350000,350000,0,0,350000,Null,Null,173947400,165313,2
173948886,0.0,0.0,12850000,12850000,0,0,12850000,Null,Null,173948886,5255587,7079
173969995,1.0,1.0,4590000,4590000,0,0,4590000,Null,Null,173969995,208841,2340
173970090,0.0,0.0,3500000,3500000,0,0,3500000,Null,Null,173970090,208841,2340
173970814,78.0,78.0,339000,183000,156000,46,339000,Null,Null,173970814,4685459,2225
173971270,114.0,114.0,1284000,764000,520000,40,1284000,Null,Null,173971270,204895,6305
173972990,137.0,137.0,339000,280000,59000,17,339000,Null,Null,173972990,4685459,2225
173983274,10.0,10.0,378000,378000,0,0,378000,Null,Null,173983274,25547,1813
173985409,71.0,71.0,150000,135000,15000,10,150000,Null,Null,173985409,612965,8305
174000599,8.0,8.0,590000,286000,304000,52,590000,Null,Null,174000599,204385,8400
174004203,1598.0,1598.0,2005000,1309000,696000,35,2005000,Null,Null,174004203,160211,3422
174023708,18.0,18.0,24000,11000,13000,54,24000,Null,Null,174023708,111461,15318
174025064,0.0,0.0,6350000,6350000,0,0,6350000,Null,Null,174025064,111461,15318
174027811,0.0,0.0,10000,5000,5000,50,10000,Null,Null,174027811,111461,8167
174045175,1450.0,1450.0,185000,160000,25000,14,185000,Null,Null,174045175,112882,3422
174045178,748.0,748.0,185000,160000,25000,14,185000,Null,Null,174045178,112882,3422
174049747,34.0,34.0,3500,3500,0,0,3500,Null,Null,174049747,111461,28480
174055062,0.0,0.0,14000,9500,4500,32,14000,Null,Null,174055062,31581,1601
174055103,0.0,0.0,14000,9500,4500,32,14000,Null,Null,174055103,31581,1601
174055109,0.0,0.0,14000,9500,4500,32,14000,Null,Null,174055109,31581,1601
174055120,0.0,0.0,14000,9500,4500,32,14000,Null,Null,174055120,31581,1601
174055133,328.0,328.0,30000,15000,15000,50,30000,Null,Null,174055133,111461,20244
174055187,0.0,0.0,14000,9500,4500,32,14000,Null,Null,174055187,31581,1601
174067758,0.0,0.0,8070000,8070000,0,0,8070000,Null,Null,174067758,18802,1795
174068024,0.0,0.0,5000,5000,0,0,5000,Null,Null,174068024,111461,15320
174071723,495.0,495.0,181000,173000,8000,4,181000,Null,Null,174071723,164391,17186
174071724,31.0,31.0,270000,219000,51000,19,270000,Null,Null,174071724,22013,17174
174072489,12.0,12.0,129000,129000,0,0,129000,Null,Null,174072489,111461,53190
174085242,11.0,11.0,699000,589000,110000,16,699000,Null,Null,174085242,112638,1796
174085836,320.0,320.0,350000,175000,175000,50,350000,Null,Null,174085836,63894,1634
174091883,0.0,0.0,48000000,36000000,12000000,25,48000000,Null,Null,174091883,111461,6511
174096489,46.0,46.0,15000,14800,200,1,15000,Null,Null,174096489,4408565,28674
174096853,42.0,42.0,50000,47500,2500,5,50000,Null,Null,174096853,193683,8305
174105667,0.0,0.0,9000,9000,0,0,9000,Null,Null,174105667,4974141,1601
174106184,0.0,0.0,7000,7000,0,0,7000,Null,Null,174106184,4974141,1601
174106204,0.0,0.0,9000,9000,0,0,9000,Null,Null,174106204,4974141,1601
174106677,0.0,0.0,9000,9000,0,0,9000,Null,Null,174106677,4974141,1601
174106763,3.0,3.0,9000,9000,0,0,9000,Null,Null,174106763,4974141,1601
174106809,0.0,0.0,9000,9000,0,0,9000,Null,Null,174106809,4974141,1601
174107101,0.0,0.0,9000,9000,0,0,9000,Null,Null,174107101,4974141,1601
174107285,0.0,0.0,6000,6000,0,0,6000,Null,Null,174107285,48381,1601
174107339,0.0,0.0,9000,9000,0,0,9000,Null,Null,174107339,4974141,1601
174107391,0.0,0.0,7000,7000,0,0,7000,Null,Null,174107391,4974141,1601
174107460,0.0,0.0,9000,9000,0,0,9000,Null,Null,174107460,4974141,1601
174115036,14.0,14.0,1200000,1116000,84000,7,1200000,Null,Null,174115036,839911,11857
174121424,330.0,330.0,239000,239000,0,0,239000,Null,Null,174121424,18984,1838
174128094,246.0,246.0,350000,239000,111000,32,350000,Null,Null,174128094,111461,23376
174134461,88.0,88.0,1999,1999,0,0,1999,Null,Null,174134461,111461,2363
174137835,0.0,0.0,272000,272000,0,0,272000,Null,Null,174137835,20271,3428
174151623,737.0,737.0,18000,15000,3000,17,18000,Null,Null,174151623,5163185,8305
174162754,25.0,25.0,655000,519000,136000,21,655000,Null,Null,174162754,19018,11941
174173157,51.0,51.0,42000,33000,9000,21,42000,Null,Null,174173157,198557,1627
174174636,0.0,0.0,10000000,10000000,0,0,10000000,Null,Null,174174636,111461,15936
174181848,241.0,241.0,590000,263000,327000,55,590000,Null,Null,174181848,204385,8400
174181994,0.0,0.0,15000,15000,0,0,15000,Null,Null,174181994,111461,15320
174182060,2.0,2.0,200000,200000,0,0,200000,Null,Null,174182060,111461,15320
174182067,33.0,33.0,400000,400000,0,0,400000,Null,Null,174182067,111461,15320
174182150,32.0,32.0,400000,400000,0,0,400000,Null,Null,174182150,111461,15320
174182203,42.0,42.0,250000,250000,0,0,250000,Null,Null,174182203,111461,15320
174216383,183.0,183.0,39000,39000,0,0,39000,Null,Null,174216383,480737,11835
174222507,226.0,226.0,3200000,1995000,1205000,38,3200000,Null,Null,174222507,631569,2340
174230196,0.0,0.0,27300000,27300000,0,0,27300000,Null,Null,174230196,50331,11518
174231613,8.0,8.0,323000,323000,0,0,323000,Null,Null,174231613,5710507,20174
174236741,1879.0,1879.0,56000,29000,27000,48,56000,Null,Null,174236741,48077,1883
174255805,2.0,2.0,95000,95000,0,0,95000,Null,Null,174255805,111461,15236
174255813,8.0,8.0,59000,59000,0,0,59000,Null,Null,174255813,111461,2
174255837,0.0,0.0,75000,75000,0,0,75000,Null,Null,174255837,111461,15320
174256107,10.0,10.0,69000,69000,0,0,69000,Null,Null,174256107,111461,2
174258453,25.0,25.0,1000,1000,0,0,1000,Null,Null,174258453,111461,2
174259453,5.0,5.0,129000,129000,0,0,129000,Null,Null,174259453,111461,2
174262175,432.0,432.0,200000,124000,76000,38,200000,Null,Null,174262175,5085219,27128
174292759,1.0,1.0,120000,120000,0,0,120000,Null,Null,174292759,111461,15250
174294588,103.0,103.0,200000,92000,108000,54,200000,Null,Null,174294588,500047,28458
174299634,191.0,191.0,250000,149000,101000,40,250000,Null,Null,174299634,484375,23258
174300848,30.0,30.0,210000,188500,21500,10,210000,Null,Null,174300848,111461,2
174317008,114.0,114.0,250000,172000,78000,31,250000,Null,Null,174317008,5085219,27128
174317115,1.0,1.0,1698000,1698000,0,0,1698000,Null,Null,174317115,26150,8512
174372002,0.0,0.0,42430000,42430000,0,0,42430000,Null,Null,174372002,148220,2154
174372094,0.0,0.0,44130000,44130000,0,0,44130000,Null,Null,174372094,148220,2154
174372125,0.0,0.0,46430000,46430000,0,0,46430000,Null,Null,174372125,148220,2154
174379382,6.0,6.0,9900,9900,0,0,9900,Null,Null,174379382,111461,8224
174401372,0.0,0.0,3590000,3590000,0,0,3590000,Null,Null,174401372,5723205,11845
174419400,9.0,9.0,229000,229000,0,0,229000,Null,Null,174419400,25422,2324
174419861,161.0,161.0,640000,489000,151000,24,640000,Null,Null,174419861,19246,1838
174422886,0.0,0.0,6800000,6371000,429000,6,6800000,Null,Null,174422886,18802,1795
174428676,0.0,0.0,1500,1500,0,0,1500,Null,Null,174428676,111461,8167
174430089,69.0,69.0,54000,54000,0,0,54000,Null,Null,174430089,111461,23362
174430600,0.0,0.0,19000,19000,0,0,19000,Null,Null,174430600,111461,2
174490279,310.0,310.0,599000,599000,0,0,599000,Null,Null,174490279,18984,1838
174502547,196.0,196.0,629000,619000,10000,2,629000,Null,Null,174502547,737521,4381
174510703,207.0,207.0,349000,339000,10000,3,349000,Null,Null,174510703,18802,12908
174529251,10.0,10.0,95000,95000,0,0,95000,Null,Null,174529251,111461,49722
174531254,0.0,0.0,17940,17940,0,0,17940,Null,Null,174531254,111461,2
174531259,0.0,0.0,18200,18200,0,0,18200,Null,Null,174531259,111461,2
174531275,0.0,0.0,17410,17410,0,0,17410,Null,Null,174531275,111461,2
174549828,1.0,1.0,149000,109000,40000,27,149000,Null,Null,174549828,111461,2514
174552049,0.0,0.0,14000,14000,0,0,14000,Null,Null,174552049,111461,2
174588230,51.0,51.0,490000,259000,231000,47,490000,Null,Null,174588230,25643,12908
174589577,1.0,1.0,32782000,32782000,0,0,32782000,Null,Null,174589577,18802,1795
174593799,172.0,172.0,229000,124000,105000,46,229000,Null,Null,174593799,199239,1838
174593826,1453.0,1453.0,39000,24000,15000,38,39000,Null,Null,174593826,199239,1831
174593840,660.0,660.0,230000,91000,139000,60,230000,Null,Null,174593840,199239,1838
174593860,1029.0,1029.0,299000,147000,152000,51,299000,Null,Null,174593860,199239,1838
174593880,186.0,186.0,159000,76000,83000,52,159000,Null,Null,174593880,199239,1838
174597131,0.0,0.0,3199000,1699000,1500000,47,3199000,Null,Null,174597131,222659,5384
174597730,2.0,2.0,3199000,1599000,1600000,50,3199000,Null,Null,174597730,222659,5385
174598949,7.0,7.0,24912000,24912000,0,0,24912000,Null,Null,174598949,18802,1795
174599533,19.0,19.0,26223000,26223000,0,0,26223000,Null,Null,174599533,18802,1795
174599595,29.0,29.0,410000,398000,12000,3,410000,Null,Null,174599595,18984,3428
174600606,0.0,0.0,2200,2200,0,0,2200,Null,Null,174600606,111461,2
174600617,2.0,2.0,3199000,1599000,1600000,50,3199000,Null,Null,174600617,222659,5385
174604032,0.0,0.0,4190000,3759000,431000,10,4190000,Null,Null,174604032,18802,1795
174606528,0.0,0.0,9600000,6538000,3062000,32,9600000,Null,Null,174606528,416127,8227
174609283,216.0,216.0,250000,157000,93000,37,250000,Null,Null,174609283,201089,23660
174614074,334.0,334.0,55000,55000,0,0,55000,Null,Null,174614074,189471,8602
174618568,427.0,427.0,945000,518000,427000,45,945000,Null,Null,174618568,5718283,23030
174619828,565.0,565.0,296000,239000,57000,19,296000,Null,Null,174619828,5718283,23030
174624532,0.0,0.0,0,1320,0,0,1320,Null,Null,174624532,111461,0
174630782,1.0,1.0,5263000,4565000,698000,13,5263000,Null,Null,174630782,18802,1795
174638458,1263.0,1263.0,13000,9000,4000,31,13000,Null,Null,174638458,236471,8305
174641534,0.0,0.0,8000,8000,0,0,8000,Null,Null,174641534,111461,2
174641609,0.0,0.0,3900,3900,0,0,3900,Null,Null,174641609,111461,20254
174641711,0.0,0.0,8000,8000,0,0,8000,Null,Null,174641711,111461,2
174641917,0.0,0.0,4000,4000,0,0,4000,Null,Null,174641917,111461,2
174641967,0.0,0.0,3980,3980,0,0,3980,Null,Null,174641967,111461,2
174642089,2.0,2.0,7600,7600,0,0,7600,Null,Null,174642089,111461,2
174642294,3.0,3.0,2850,2850,0,0,2850,Null,Null,174642294,111461,2
174642353,0.0,0.0,7600,7600,0,0,7600,Null,Null,174642353,111461,2
174642387,0.0,0.0,1900,1900,0,0,1900,Null,Null,174642387,111461,2
174642396,0.0,0.0,1900,1900,0,0,1900,Null,Null,174642396,111461,2
174642452,0.0,0.0,1891,1891,0,0,1891,Null,Null,174642452,111461,2
174649410,0.0,0.0,5436000,5436000,0,0,5436000,Null,Null,174649410,25643,1795
174655326,0.0,0.0,63500000,63500000,0,0,63500000,Null,Null,174655326,167287,20170
174674004,109.0,109.0,60000,60000,0,0,60000,Null,Null,174674004,111461,28674
174818562,0.0,0.0,9000,9000,0,0,9000,Null,Null,174818562,111461,2
174818988,4.0,4.0,6000,6000,0,0,6000,Null,Null,174818988,111461,2
174818994,142.0,142.0,6000,6000,0,0,6000,Null,Null,174818994,111461,2
174819430,5.0,5.0,4000,4000,0,0,4000,Null,Null,174819430,111461,2
174819439,6.0,6.0,7000,7000,0,0,7000,Null,Null,174819439,111461,2
174819512,1.0,1.0,4000,4000,0,0,4000,Null,Null,174819512,111461,2
174819703,11.0,11.0,134000,134000,0,0,134000,Null,Null,174819703,111461,2
174819918,3.0,3.0,5000,5000,0,0,5000,Null,Null,174819918,111461,2
174820062,0.0,0.0,6000,6000,0,0,6000,Null,Null,174820062,111461,2
174820075,0.0,0.0,4000,4000,0,0,4000,Null,Null,174820075,111461,2
174820225,4.0,4.0,69000,69000,0,0,69000,Null,Null,174820225,111461,2
174820523,3.0,3.0,17000,17000,0,0,17000,Null,Null,174820523,111461,2
174829842,197.0,197.0,379000,325000,54000,14,379000,Null,Null,174829842,5559863,17170
174830540,115.0,115.0,75000,75000,0,0,75000,Null,Null,174830540,4973949,28430
174834852,42.0,42.0,342000,342000,0,0,342000,Null,Null,174834852,52207,1583
174835209,0.0,0.0,40000,10000,30000,75,40000,Null,Null,174835209,111461,15320
174837542,78.0,78.0,1000,1000,0,0,1000,Null,Null,174837542,111461,2
174837635,36.0,36.0,1000,1000,0,0,1000,Null,Null,174837635,111461,2
174837651,37.0,37.0,1000,1000,0,0,1000,Null,Null,174837651,111461,2
174838962,25.0,25.0,1000,1000,0,0,1000,Null,Null,174838962,111461,2
174839138,2.0,2.0,1500,1500,0,0,1500,Null,Null,174839138,111461,2
174841103,0.0,0.0,36800000,27600000,9200000,25,36800000,Null,Null,174841103,167287,20170
174843561,10.0,10.0,2490000,2490000,0,0,2490000,Null,Null,174843561,18641,2324
174843789,0.0,0.0,14490000,14490000,0,0,14490000,Null,Null,174843789,18641,2324
174847460,345.0,345.0,79000,79000,0,0,79000,Null,Null,174847460,4973949,28430
174848651,6.0,6.0,28400000,16990000,11410000,40,28400000,Null,Null,174848651,5222401,2340
174849944,183.0,183.0,1800,1800,0,0,1800,Null,Null,174849944,111461,53074
174849989,26.0,26.0,2500,2500,0,0,2500,Null,Null,174849989,111461,53074
174850057,49.0,49.0,1800,1800,0,0,1800,Null,Null,174850057,111461,53074
174850167,0.0,0.0,1900,1900,0,0,1900,Null,Null,174850167,111461,53074
174850652,0.0,0.0,14500,14500,0,0,14500,Null,Null,174850652,111461,2
174850681,1.0,1.0,500000,500000,0,0,500000,Null,Null,174850681,111461,2
174851398,0.0,0.0,10000,9000,1000,10,10000,Null,Null,174851398,111461,15318
174851864,51.0,51.0,149000,149000,0,0,149000,Null,Null,174851864,149308,28578
174851883,1.0,1.0,29900000,14990000,14910000,50,29900000,Null,Null,174851883,20091,2340
174878310,446.0,446.0,4000,2240,1760,44,4000,Null,Null,174878310,859921,2363
174888871,0.0,0.0,7000,7000,0,0,7000,Null,Null,174888871,111461,2
174897090,271.0,271.0,24000,24000,0,0,24000,Null,Null,174897090,5706641,6305
174919293,0.0,0.0,3900,2000,1900,49,3900,Null,Null,174919293,111461,2
174919307,3.0,3.0,3900,2000,1900,49,3900,Null,Null,174919307,111461,2
174919357,0.0,0.0,3900,2000,1900,49,3900,Null,Null,174919357,111461,2
174919380,0.0,0.0,3900,2000,1900,49,3900,Null,Null,174919380,111461,2
174919396,1.0,1.0,3900,2000,1900,49,3900,Null,Null,174919396,111461,2
174944729,5.0,5.0,65000,48000,17000,26,65000,Null,Null,174944729,111461,2
175097295,143.0,143.0,114000,95000,19000,17,114000,Null,Null,175097295,50800,11835
175097308,151.0,151.0,95000,79000,16000,17,95000,Null,Null,175097308,50807,11833
175097319,64.0,64.0,114000,95000,19000,17,114000,Null,Null,175097319,50800,11835
175097321,309.0,309.0,125000,101000,24000,19,125000,Null,Null,175097321,50807,11835
175097324,78.0,78.0,110000,91100,18900,17,110000,Null,Null,175097324,50807,11833
175097336,57.0,57.0,74000,61000,13000,18,74000,Null,Null,175097336,50807,11833
175097338,121.0,121.0,44000,37000,7000,16,44000,Null,Null,175097338,50807,11833
175104946,806.0,806.0,445000,390000,55000,12,445000,Null,Null,175104946,18802,1820
175147005,0.0,0.0,7000000,6371000,629000,9,7000000,Null,Null,175147005,18802,1795
175147417,291.0,291.0,51600,51600,0,0,51600,Null,Null,175147417,191339,2225
175150138,0.0,0.0,90000,83900,6100,7,90000,Null,Null,175150138,111461,2
175151557,0.0,0.0,125000,125000,0,0,125000,Null,Null,175151557,111461,2
175151980,29.0,29.0,465000,465000,0,0,465000,Null,Null,175151980,5380019,3426
175153892,269.0,269.0,99000,96800,2200,2,99000,Null,Null,175153892,50807,11835
175153894,140.0,140.0,112000,88000,24000,21,112000,Null,Null,175153894,50807,11835
175153905,134.0,134.0,74000,59000,15000,20,74000,Null,Null,175153905,50807,11835
175162131,2.0,2.0,103000,103000,0,0,103000,Null,Null,175162131,111461,4380
175167980,0.0,0.0,7150000,5362500,1787500,25,7150000,Null,Null,175167980,416127,8227
175168512,60.0,60.0,189000,189000,0,0,189000,Null,Null,175168512,867031,2657
175182904,0.0,0.0,1299,1299,0,0,1299,Null,Null,175182904,111461,2
175193488,5458.0,5458.0,238000,186000,52000,22,238000,Null,Null,175193488,86206,11605
175211839,157.0,157.0,11900,11900,0,0,11900,Null,Null,175211839,111461,2
175213936,5.0,5.0,80000,21000,59000,74,80000,Null,Null,175213936,111461,15320
175424720,0.0,0.0,76000000,76000000,0,0,76000000,Null,Null,175424720,111461,23112
175424808,0.0,0.0,108000000,108000000,0,0,108000000,Null,Null,175424808,111461,23112
175432514,1.0,1.0,22490000,22490000,0,0,22490000,Null,Null,175432514,114527,2657
175433029,0.0,0.0,22490000,22490000,0,0,22490000,Null,Null,175433029,114527,2657
175433126,0.0,0.0,22490000,22490000,0,0,22490000,Null,Null,175433126,114527,2657
175434036,70.0,70.0,10000,5000,5000,50,10000,Null,Null,175434036,111461,15318
175434247,6.0,6.0,18000,9000,9000,50,18000,Null,Null,175434247,111461,15320
175434743,16.0,16.0,14000,7000,7000,50,14000,Null,Null,175434743,111461,15320
175434860,0.0,0.0,16000,8000,8000,50,16000,Null,Null,175434860,111461,8198
175436928,0.0,0.0,22490000,22490000,0,0,22490000,Null,Null,175436928,114527,8516
175448937,0.0,0.0,20290000,20290000,0,0,20290000,Null,Null,175448937,114527,2657
175458190,0.0,0.0,21490000,21490000,0,0,21490000,Null,Null,175458190,114527,2657
175464675,0.0,0.0,22990000,22990000,0,0,22990000,Null,Null,175464675,114527,2657
175464779,0.0,0.0,22990000,22990000,0,0,22990000,Null,Null,175464779,114527,8516
175525962,71.0,71.0,96000,96000,0,0,96000,Null,Null,175525962,111461,1634
175547164,0.0,0.0,2500,2500,0,0,2500,Null,Null,175547164,111461,18876
175646667,0.0,0.0,2500,2500,0,0,2500,Null,Null,175646667,111461,2
175646669,0.0,0.0,7500,7500,0,0,7500,Null,Null,175646669,111461,2
175646673,2.0,2.0,3500,3500,0,0,3500,Null,Null,175646673,111461,2
175646678,0.0,0.0,3500,3500,0,0,3500,Null,Null,175646678,111461,2
175646679,0.0,0.0,5000,5000,0,0,5000,Null,Null,175646679,111461,8073
175646680,0.0,0.0,2500,2500,0,0,2500,Null,Null,175646680,111461,2
175646683,0.0,0.0,7500,7500,0,0,7500,Null,Null,175646683,111461,2
175646686,0.0,0.0,6000,6000,0,0,6000,Null,Null,175646686,111461,2
175646688,5.0,5.0,4000,4000,0,0,4000,Null,Null,175646688,111461,2
175646691,0.0,0.0,5000,5000,0,0,5000,Null,Null,175646691,111461,2
175646694,5.0,5.0,7500,7500,0,0,7500,Null,Null,175646694,111461,2
175646696,0.0,0.0,7000,7000,0,0,7000,Null,Null,175646696,111461,2
175646703,0.0,0.0,8000,8000,0,0,8000,Null,Null,175646703,111461,2
175646704,0.0,0.0,3000,3000,0,0,3000,Null,Null,175646704,111461,2
175646729,0.0,0.0,3800,3800,0,0,3800,Null,Null,175646729,111461,2
175646734,0.0,0.0,5000,5000,0,0,5000,Null,Null,175646734,111461,1815
175646738,0.0,0.0,6000,6000,0,0,6000,Null,Null,175646738,111461,2
175646747,1.0,1.0,7500,7500,0,0,7500,Null,Null,175646747,111461,2
175646765,3.0,3.0,6000,6000,0,0,6000,Null,Null,175646765,111461,2
175646774,0.0,0.0,7500,7500,0,0,7500,Null,Null,175646774,111461,2
175646786,0.0,0.0,2500,2500,0,0,2500,Null,Null,175646786,111461,2
175646827,6.0,6.0,5000,5000,0,0,5000,Null,Null,175646827,111461,2
175646837,10.0,10.0,3500,3500,0,0,3500,Null,Null,175646837,111461,2
175646871,4.0,4.0,5000,5000,0,0,5000,Null,Null,175646871,111461,2
175646878,1.0,1.0,5000,5000,0,0,5000,Null,Null,175646878,111461,2
175646923,5.0,5.0,5000,5000,0,0,5000,Null,Null,175646923,111461,2
175646934,7.0,7.0,5000,5000,0,0,5000,Null,Null,175646934,111461,2
175646973,5.0,5.0,5000,5000,0,0,5000,Null,Null,175646973,111461,2
175646981,2.0,2.0,5000,5000,0,0,5000,Null,Null,175646981,111461,2
175646995,0.0,0.0,7000,7000,0,0,7000,Null,Null,175646995,111461,2
175647414,0.0,0.0,9000000,9000000,0,0,9000000,Null,Null,175647414,111461,2
175772412,0.0,0.0,20500000,17700000,2800000,14,20500000,Null,Null,175772412,18802,1794
175780484,1.0,1.0,2140,2140,0,0,2140,Null,Null,175780484,111461,2
175780489,0.0,0.0,1070,1070,0,0,1070,Null,Null,175780489,111461,2
175781007,30.0,30.0,1070,1070,0,0,1070,Null,Null,175781007,111461,2
175781228,0.0,0.0,1605,1605,0,0,1605,Null,Null,175781228,111461,2
175781459,0.0,0.0,2140,2140,0,0,2140,Null,Null,175781459,111461,2
175781479,0.0,0.0,1500,1500,0,0,1500,Null,Null,175781479,111461,2
175781512,0.0,0.0,2340,2340,0,0,2340,Null,Null,175781512,111461,2
175781569,2.0,2.0,1070,1070,0,0,1070,Null,Null,175781569,111461,2
175781625,0.0,0.0,2140,2140,0,0,2140,Null,Null,175781625,111461,2
175781791,1.0,1.0,1070,1070,0,0,1070,Null,Null,175781791,111461,2
175782025,0.0,0.0,2354,2354,0,0,2354,Null,Null,175782025,111461,2
175782543,2.0,2.0,1070,1070,0,0,1070,Null,Null,175782543,111461,2
175782559,0.0,0.0,2140,2140,0,0,2140,Null,Null,175782559,111461,2
175782761,0.0,0.0,2220,2220,0,0,2220,Null,Null,175782761,111461,2
175782887,0.0,0.0,2340,2340,0,0,2340,Null,Null,175782887,111461,2
175783068,0.0,0.0,1605,1605,0,0,1605,Null,Null,175783068,111461,2
175783144,0.0,0.0,2140,2140,0,0,2140,Null,Null,175783144,111461,2
175783147,1.0,1.0,1070,1070,0,0,1070,Null,Null,175783147,111461,2
175783493,0.0,0.0,1070,1070,0,0,1070,Null,Null,175783493,111461,2
175783513,1.0,1.0,1070,1070,0,0,1070,Null,Null,175783513,111461,2
175783641,0.0,0.0,2140,2140,0,0,2140,Null,Null,175783641,111461,2
175783890,0.0,0.0,1605,1605,0,0,1605,Null,Null,175783890,111461,2
175784928,0.0,0.0,1926,1926,0,0,1926,Null,Null,175784928,111461,2
175785245,0.0,0.0,1070,1070,0,0,1070,Null,Null,175785245,111461,2
175785393,0.0,0.0,2100,2100,0,0,2100,Null,Null,175785393,111461,2
175792762,2.0,2.0,15999,15999,0,0,15999,Null,Null,175792762,111461,2
175814174,152.0,152.0,130000,130000,0,0,130000,Null,Null,175814174,612965,8305
175814558,48.0,48.0,105000,78750,26250,25,105000,Null,Null,175814558,612965,8305
175816474,2.0,2.0,2000,2000,0,0,2000,Null,Null,175816474,111461,27172
175830977,0.0,0.0,38700000,38700000,0,0,38700000,Null,Null,175830977,3730433,23050
175834101,0.0,0.0,5388000,4476000,912000,17,5388000,Null,Null,175834101,79682,1520
175843845,10.0,10.0,175000,175000,0,0,175000,Null,Null,175843845,111461,49722
175845367,363.0,363.0,9990000,7290000,2700000,27,9990000,Null,Null,175845367,18802,1795
175846954,0.0,0.0,5388000,5388000,0,0,5388000,Null,Null,175846954,79682,1520
175847070,1.0,1.0,4500000,3375000,1125000,25,4500000,Null,Null,175847070,508313,2340
175847074,0.0,0.0,11460000,9487000,1973000,17,11460000,Null,Null,175847074,18802,1794
175850953,0.0,0.0,86700000,86700000,0,0,86700000,Null,Null,175850953,4558659,2340
175851126,0.0,0.0,8000000,5324000,2676000,33,8000000,Null,Null,175851126,18802,1794
175857602,0.0,0.0,4600000,4370000,230000,5,4600000,Null,Null,175857602,111461,11943
175873576,0.0,0.0,4350000,4350000,0,0,4350000,Null,Null,175873576,111461,11943
175873617,0.0,0.0,4350000,4350000,0,0,4350000,Null,Null,175873617,111461,11943
175950305,0.0,0.0,253000,253000,0,0,253000,Null,Null,175950305,111461,15250
175967811,1.0,1.0,9500000,8176000,1324000,14,9500000,Null,Null,175967811,18802,1795
175972553,21.0,21.0,45000,16000,29000,64,45000,Null,Null,175972553,111461,15250
175979500,0.0,0.0,6000,6000,0,0,6000,Null,Null,175979500,830359,2
175998609,29.0,29.0,248000,248000,0,0,248000,Null,Null,175998609,18991,1832
175999930,0.0,0.0,9900,9900,0,0,9900,Null,Null,175999930,111461,2
176018156,1.0,1.0,39000,39000,0,0,39000,Null,Null,176018156,111461,15250
176036536,1.0,1.0,7490000,6390000,1100000,15,7490000,Null,Null,176036536,25643,1795
176045940,0.0,0.0,15000,15000,0,0,15000,Null,Null,176045940,111461,15320
176048170,152.0,152.0,550000,440000,110000,20,550000,Null,Null,176048170,4282483,11897
176058986,493.0,493.0,60000,39000,21000,35,60000,Null,Null,176058986,706667,11857
176067939,0.0,0.0,1000,800,200,20,1000,Null,Null,176067939,111461,2337
176071770,26.0,26.0,58800,58800,0,0,58800,Null,Null,176071770,111461,2
176071845,2.0,2.0,1000,1000,0,0,1000,Null,Null,176071845,111461,2
176071848,6.0,6.0,198000,198000,0,0,198000,Null,Null,176071848,111461,2
176071891,5.0,5.0,50000,50000,0,0,50000,Null,Null,176071891,111461,2
176071922,1.0,1.0,198000,198000,0,0,198000,Null,Null,176071922,111461,2
176071962,8.0,8.0,135000,135000,0,0,135000,Null,Null,176071962,111461,2
176072035,0.0,0.0,169200,169200,0,0,169200,Null,Null,176072035,111461,2
176072057,0.0,0.0,17000,17000,0,0,17000,Null,Null,176072057,111461,2
176072099,18.0,18.0,59000,59000,0,0,59000,Null,Null,176072099,111461,2
176072127,1.0,1.0,68000,68000,0,0,68000,Null,Null,176072127,111461,2
176072237,5.0,5.0,200000,200000,0,0,200000,Null,Null,176072237,111461,2
176072560,2.0,2.0,168000,168000,0,0,168000,Null,Null,176072560,111461,2
176072664,2.0,2.0,19000,19000,0,0,19000,Null,Null,176072664,111461,2
176072893,13.0,13.0,99000,99000,0,0,99000,Null,Null,176072893,111461,2
176072939,10.0,10.0,200000,200000,0,0,200000,Null,Null,176072939,111461,2
176073123,11.0,11.0,135000,135000,0,0,135000,Null,Null,176073123,111461,2
176073182,10.0,10.0,19000,19000,0,0,19000,Null,Null,176073182,111461,2
176073189,4.0,4.0,25000,25000,0,0,25000,Null,Null,176073189,111461,2
176073267,2.0,2.0,108000,108000,0,0,108000,Null,Null,176073267,111461,2
176073326,6.0,6.0,69000,69000,0,0,69000,Null,Null,176073326,111461,2
176073541,5.0,5.0,96000,96000,0,0,96000,Null,Null,176073541,111461,2
176073667,31.0,31.0,59000,59000,0,0,59000,Null,Null,176073667,111461,2
176073859,55.0,55.0,59000,59000,0,0,59000,Null,Null,176073859,111461,2
176073994,13.0,13.0,59000,59000,0,0,59000,Null,Null,176073994,111461,2
176074126,11.0,11.0,88000,88000,0,0,88000,Null,Null,176074126,111461,2
176074165,6.0,6.0,84000,84000,0,0,84000,Null,Null,176074165,111461,2
176074228,6.0,6.0,200000,200000,0,0,200000,Null,Null,176074228,111461,2
176074309,32.0,32.0,88110,88110,0,0,88110,Null,Null,176074309,111461,2
176074423,0.0,0.0,68000,68000,0,0,68000,Null,Null,176074423,111461,2
176074495,3.0,3.0,99000,99000,0,0,99000,Null,Null,176074495,111461,2
176074596,1.0,1.0,596000,298000,298000,50,596000,Null,Null,176074596,111461,15318
176076047,930.0,930.0,5900,5900,0,0,5900,Null,Null,176076047,111461,2685
176082185,78.0,78.0,45000,45000,0,0,45000,Null,Null,176082185,4973949,28574
176082449,2.0,2.0,45000,45000,0,0,45000,Null,Null,176082449,111461,2
176083984,0.0,0.0,2500,2500,0,0,2500,Null,Null,176083984,111461,3179
176084449,3.0,3.0,1500,1500,0,0,1500,Null,Null,176084449,111461,2363
176085874,0.0,0.0,500000,93000,407000,81,500000,Null,Null,176085874,5727919,2685
176097930,30.0,30.0,6000000,3660000,2340000,39,6000000,Null,Null,176097930,508313,2340
176098197,170.0,170.0,189000,125000,64000,34,189000,Null,Null,176098197,429751,13878
176099221,4.0,4.0,175000,175000,0,0,175000,Null,Null,176099221,111461,49722
176141280,0.0,0.0,34800,17400,17400,50,34800,Null,Null,176141280,111461,15318
176143601,69.0,69.0,207000,207000,0,0,207000,Null,Null,176143601,111461,2
176147996,0.0,0.0,0,169000,0,0,169000,Null,Null,176147996,5406107,0
176153671,1.0,1.0,9000,9000,0,0,9000,Null,Null,176153671,487729,11929
176157006,5.0,5.0,2000,2000,0,0,2000,Null,Null,176157006,111461,53186
176157117,7.0,7.0,2000,2000,0,0,2000,Null,Null,176157117,111461,2363
176162229,26.0,26.0,360000,360000,0,0,360000,Null,Null,176162229,111461,5566
176166393,0.0,0.0,7490000,7490000,0,0,7490000,Null,Null,176166393,508761,11935
176167460,1.0,1.0,6490000,6490000,0,0,6490000,Null,Null,176167460,508761,11935
176168884,0.0,0.0,5990000,5990000,0,0,5990000,Null,Null,176168884,508761,11935
176169718,0.0,0.0,9490000,9490000,0,0,9490000,Null,Null,176169718,508761,11935
176170219,0.0,0.0,6790000,6790000,0,0,6790000,Null,Null,176170219,508761,11935
176200463,21.0,21.0,119000,119000,0,0,119000,Null,Null,176200463,197655,28480
176209630,1.0,1.0,1535,1535,0,0,1535,Null,Null,176209630,111461,2
176224259,9.0,9.0,492000,393600,98400,20,492000,Null,Null,176224259,26150,8513
176224263,9.0,9.0,492000,393600,98400,20,492000,Null,Null,176224263,26150,8513
176228560,99.0,99.0,1900,1900,0,0,1900,Null,Null,176228560,111461,2
176261729,1.0,1.0,1000,1000,0,0,1000,Null,Null,176261729,111461,2363
176284262,1.0,1.0,65000,65000,0,0,65000,Null,Null,176284262,111461,27546
176285303,1.0,1.0,456000,456000,0,0,456000,Null,Null,176285303,112638,1796
176294770,646.0,646.0,598000,283000,315000,53,598000,Null,Null,176294770,199239,8400
176298983,1.0,1.0,5000000,4000000,1000000,20,5000000,Null,Null,176298983,508313,2340
176301258,0.0,0.0,2000,2000,0,0,2000,Null,Null,176301258,111461,2
176309057,56.0,56.0,450000,350000,100000,22,450000,Null,Null,176309057,52207,17170
176417604,238.0,238.0,49000,39000,10000,20,49000,Null,Null,176417604,111461,28674
176418273,0.0,0.0,1000,1000,0,0,1000,Null,Null,176418273,111461,2
176432052,0.0,0.0,3760000,3760000,0,0,3760000,Null,Null,176432052,5728045,11849
176435276,200.0,200.0,250000,157000,93000,37,250000,Null,Null,176435276,5085219,27128
176438844,0.0,0.0,2088000,2088000,0,0,2088000,Null,Null,176438844,25422,1795
176438846,0.0,0.0,2568000,2568000,0,0,2568000,Null,Null,176438846,25422,1795
176438848,0.0,0.0,5436000,5436000,0,0,5436000,Null,Null,176438848,25643,1795
176438850,0.0,0.0,3012000,3012000,0,0,3012000,Null,Null,176438850,25643,1795
176438852,0.0,0.0,7688000,7450000,238000,3,7688000,Null,Null,176438852,25643,1795
176438858,0.0,0.0,3192000,3192000,0,0,3192000,Null,Null,176438858,25643,1795
176438864,0.0,0.0,2088000,2088000,0,0,2088000,Null,Null,176438864,25422,1795
176443080,0.0,0.0,6500000,6500000,0,0,6500000,Null,Null,176443080,5725937,17170
176450835,0.0,0.0,35000,35000,0,0,35000,Null,Null,176450835,630163,17186
176450840,0.0,0.0,99000,99000,0,0,99000,Null,Null,176450840,8195701,5900
176450905,0.0,0.0,75000,75000,0,0,75000,Null,Null,176450905,7272031,3426
176450978,0.0,0.0,75000,75000,0,0,75000,Null,Null,176450978,7272031,3426
176451003,0.0,0.0,95000,95000,0,0,95000,Null,Null,176451003,7272031,8223
176451005,0.0,0.0,190000,190000,0,0,190000,Null,Null,176451005,8195701,3424
176451083,0.0,0.0,99000,99000,0,0,99000,Null,Null,176451083,8195701,3424
176451277,0.0,0.0,195000,195000,0,0,195000,Null,Null,176451277,7272031,11817
176451343,0.0,0.0,88000,88000,0,0,88000,Null,Null,176451343,7272031,11731
176451459,0.0,0.0,75000,75000,0,0,75000,Null,Null,176451459,7272031,5872
176451556,0.0,0.0,115000,115000,0,0,115000,Null,Null,176451556,7272031,11821
176451563,0.0,0.0,99000,99000,0,0,99000,Null,Null,176451563,7272031,11825
176451624,0.0,0.0,95000,95000,0,0,95000,Null,Null,176451624,8195701,17186
176451792,17.0,17.0,2049000,1099000,950000,46,2049000,Null,Null,176451792,46703,2759
176453629,28.0,28.0,159000,159000,0,0,159000,Null,Null,176453629,111461,28484
176463533,0.0,0.0,899000,593340,305660,34,899000,Null,Null,176463533,5724829,8511
176473440,4.0,4.0,492000,418200,73800,15,492000,Null,Null,176473440,26150,8513
176481144,0.0,0.0,1000,1000,0,0,1000,Null,Null,176481144,111461,2
176505874,1.0,1.0,150000,150000,0,0,150000,Null,Null,176505874,111461,15318
176509785,211.0,211.0,159000,159000,0,0,159000,Null,Null,176509785,4307205,2334
176509885,34.0,34.0,15000,9000,6000,40,15000,Null,Null,176509885,111461,12294
176510594,19.0,19.0,90000,90000,0,0,90000,Null,Null,176510594,111461,1831
176522078,4.0,4.0,50000,39000,11000,22,50000,Null,Null,176522078,111461,2
176529842,0.0,0.0,2000,2000,0,0,2000,Null,Null,176529842,111461,2363
176530481,141.0,141.0,400000,279000,121000,30,400000,Null,Null,176530481,697923,23392
176530967,24.0,24.0,129000,129000,0,0,129000,Null,Null,176530967,111461,20244
176545164,620.0,620.0,340000,323000,17000,5,340000,Null,Null,176545164,202607,17184
176549137,0.0,0.0,110000000,110000000,0,0,110000000,Null,Null,176549137,879595,2340
176553844,3.0,3.0,9000,9000,0,0,9000,Null,Null,176553844,50278,1601
176553856,0.0,0.0,9000,9000,0,0,9000,Null,Null,176553856,50278,1601
176553884,0.0,0.0,9000,9000,0,0,9000,Null,Null,176553884,50278,1601
176553904,3.0,3.0,9000,9000,0,0,9000,Null,Null,176553904,50278,1601
176553930,0.0,0.0,9000,9000,0,0,9000,Null,Null,176553930,50278,1601
176553938,1.0,1.0,9000,9000,0,0,9000,Null,Null,176553938,50278,1601
176554059,378.0,378.0,39000,28000,11000,28,39000,Null,Null,176554059,706667,11873
176560036,0.0,0.0,6770000,6770000,0,0,6770000,Null,Null,176560036,405211,8511
176561622,27.0,27.0,10999,7779,3220,29,10999,Null,Null,176561622,111461,5007
176592358,246.0,246.0,210000,191000,19000,9,210000,Null,Null,176592358,41048,23832
176598080,237.0,237.0,412000,254000,158000,38,412000,Null,Null,176598080,48077,1936
176598081,1238.0,1238.0,605000,300000,305000,50,605000,Null,Null,176598081,48077,1936
176606120,0.0,0.0,6350000,6350000,0,0,6350000,Null,Null,176606120,732431,8512
176615085,21.0,21.0,25000,25000,0,0,25000,Null,Null,176615085,143213,28576
176623969,0.0,0.0,7350000,7350000,0,0,7350000,Null,Null,176623969,405211,8511
176661950,99.0,99.0,2500000,1390000,1110000,44,2500000,Null,Null,176661950,79682,1520
176672113,0.0,0.0,0,49500,5500,0,49500,Null,Null,176672113,112887,0
176672117,732.0,732.0,68000,59000,9000,13,68000,Null,Null,176672117,112887,1583
176673388,0.0,0.0,8000,8000,0,0,8000,Null,Null,176673388,111461,2
176675161,138.0,138.0,350000,234000,116000,33,350000,Null,Null,176675161,213321,8206
176677477,0.0,0.0,64000,64000,0,0,64000,Null,Null,176677477,111461,23216
176686490,0.0,0.0,8960000,4480000,4480000,50,8960000,Null,Null,176686490,111461,15318
176690008,0.0,0.0,2000,2000,0,0,2000,Null,Null,176690008,111461,2
176711333,0.0,0.0,9000,9000,0,0,9000,Null,Null,176711333,111461,2
176713246,0.0,0.0,11500000,9016000,2484000,22,11500000,Null,Null,176713246,18802,1795
176718538,153.0,153.0,150000,150000,0,0,150000,Null,Null,176718538,111461,1831
176725031,3.0,3.0,32000,32000,0,0,32000,Null,Null,176725031,111461,15320
176725520,9.0,9.0,45000,45000,0,0,45000,Null,Null,176725520,111461,28578
176727998,10.0,10.0,95000,95000,0,0,95000,Null,Null,176727998,111461,8519
176728708,8.0,8.0,448900,448900,0,0,448900,Null,Null,176728708,111461,6305
176731719,29.0,29.0,59286,53897,5389,9,59286,Null,Null,176731719,111461,28574
176732400,1.0,1.0,180000,180000,0,0,180000,Null,Null,176732400,111461,15318
176734294,194.0,194.0,25000,25000,0,0,25000,Null,Null,176734294,111461,3710
176747159,12.0,12.0,3900,2000,1900,49,3900,Null,Null,176747159,111461,2
176747717,0.0,0.0,22000,22000,0,0,22000,Null,Null,176747717,111461,2
176747780,1.0,1.0,29000,29000,0,0,29000,Null,Null,176747780,111461,2
176747801,2.0,2.0,51000,51000,0,0,51000,Null,Null,176747801,111461,2
176747855,2.0,2.0,69000,69000,0,0,69000,Null,Null,176747855,111461,15320
176751493,28.0,28.0,99000,75000,24000,24,99000,Null,Null,176751493,21653,12294
176752662,682.0,682.0,122000,122000,0,0,122000,Null,Null,176752662,155563,28484
176756454,821.0,821.0,394200,219000,175200,44,394200,Null,Null,176756454,46703,8170
176764055,0.0,0.0,6453000,3490000,2963000,46,6453000,Null,Null,176764055,5719677,53350
176779920,9.0,9.0,1140,1140,0,0,1140,Null,Null,176779920,111461,2363
176781127,0.0,0.0,45000,45000,0,0,45000,Null,Null,176781127,111461,2
176782616,0.0,0.0,2500,2500,0,0,2500,Null,Null,176782616,111461,2
176783560,0.0,0.0,1500,1500,0,0,1500,Null,Null,176783560,111461,2
176789242,59.0,59.0,3568000,3568000,0,0,3568000,Null,Null,176789242,4558659,2162
176789715,24.0,24.0,5068000,5068000,0,0,5068000,Null,Null,176789715,4558659,11933
176798707,0.0,0.0,2500,2500,0,0,2500,Null,Null,176798707,111461,2
176799999,1447.0,1447.0,160000,88000,72000,45,160000,Null,Null,176799999,5334123,23622
176800193,0.0,0.0,1500,1500,0,0,1500,Null,Null,176800193,111461,2
176804898,8.0,8.0,139000,139000,0,0,139000,Null,Null,176804898,111461,2
176805022,199.0,199.0,39000,39000,0,0,39000,Null,Null,176805022,111461,23416
176805088,115.0,115.0,79000,79000,0,0,79000,Null,Null,176805088,111461,23416
176818582,4.0,4.0,255000,255000,0,0,255000,Null,Null,176818582,111461,2
176819126,0.0,0.0,4500,4500,0,0,4500,Null,Null,176819126,111461,2
176819324,4.0,4.0,12000,12000,0,0,12000,Null,Null,176819324,111461,2
176898787,37.0,37.0,694000,694000,0,0,694000,Null,Null,176898787,18984,1838
176899932,2552.0,2552.0,910000,583000,327000,36,910000,Null,Null,176899932,18984,1838
176903003,77.0,77.0,1718000,1259000,459000,27,1718000,Null,Null,176903003,18984,5267
176909016,0.0,0.0,3300000,3300000,0,0,3300000,Null,Null,176909016,281391,1794
176926369,1.0,1.0,5990000,5990000,0,0,5990000,Null,Null,176926369,208841,2340
176946607,103.0,103.0,300000,300000,0,0,300000,Null,Null,176946607,111461,5531
177027949,0.0,0.0,1680,1680,0,0,1680,Null,Null,177027949,111461,27214
177058336,8.0,8.0,42900,42900,0,0,42900,Null,Null,177058336,111461,2
177060038,309.0,309.0,96000,62000,34000,35,96000,Null,Null,177060038,198555,1616
177081678,305.0,305.0,38000,19000,19000,50,38000,Null,Null,177081678,111461,18888
177081696,153.0,153.0,130000,65000,65000,50,130000,Null,Null,177081696,111461,18888
177092412,37.0,37.0,250000,250000,0,0,250000,Null,Null,177092412,111461,15320
177117380,0.0,0.0,10500000,7875000,2625000,25,10500000,Null,Null,177117380,416127,17170
177136273,0.0,0.0,10000,10000,0,0,10000,Null,Null,177136273,111461,2
177140565,99.0,99.0,209000,209000,0,0,209000,Null,Null,177140565,143006,1634
177141832,68.0,68.0,8490000,5740000,2750000,32,8490000,Null,Null,177141832,18802,1795
177155519,0.0,0.0,4339000,3948490,390510,9,4339000,Null,Null,177155519,168731,1637
177158038,0.0,0.0,10000,10000,0,0,10000,Null,Null,177158038,5307459,2
177158049,0.0,0.0,10000,10000,0,0,10000,Null,Null,177158049,5307459,2
177158200,0.0,0.0,15000,15000,0,0,15000,Null,Null,177158200,5307459,2
177163490,0.0,0.0,4339000,4339000,0,0,4339000,Null,Null,177163490,168731,1637
177169121,0.0,0.0,649000,649000,0,0,649000,Null,Null,177169121,48865,2
177190811,0.0,0.0,4190000,4190000,0,0,4190000,Null,Null,177190811,18804,2334
177196981,2.0,2.0,199000,105000,94000,47,199000,Null,Null,177196981,541293,1634
177199915,0.0,0.0,15900000,15900000,0,0,15900000,Null,Null,177199915,939519,11516
177275120,36.0,36.0,46000,24000,22000,48,46000,Null,Null,177275120,21653,12294
177276350,0.0,0.0,9000,9000,0,0,9000,Null,Null,177276350,111461,8205
177277049,0.0,0.0,2000,2000,0,0,2000,Null,Null,177277049,111461,2363
177277874,0.0,0.0,1500,1500,0,0,1500,Null,Null,177277874,111461,23282
177280805,0.0,0.0,4352000,4352000,0,0,4352000,Null,Null,177280805,5191813,53350
177280810,0.0,0.0,4352000,4352000,0,0,4352000,Null,Null,177280810,5191813,53350
177280813,0.0,0.0,3561000,3561000,0,0,3561000,Null,Null,177280813,5191813,17174
177280836,1.0,1.0,4352000,4352000,0,0,4352000,Null,Null,177280836,5191813,53350
177280950,35.0,35.0,280000,183000,97000,35,280000,Null,Null,177280950,741117,6305
177281115,0.0,0.0,5581000,5581000,0,0,5581000,Null,Null,177281115,5191813,17170
177281119,1.0,1.0,4352000,4352000,0,0,4352000,Null,Null,177281119,5191813,53350
177286235,432.0,432.0,400000,215000,185000,46,400000,Null,Null,177286235,5313735,8305
177315507,5.0,5.0,890000,840000,50000,6,890000,Null,Null,177315507,173547,15250
177320502,0.0,0.0,26900000,26900000,0,0,26900000,Null,Null,177320502,939519,11516
177320723,14.0,14.0,19000,19000,0,0,19000,Null,Null,177320723,198287,2
177320768,7.0,7.0,950000,850000,100000,11,950000,Null,Null,177320768,173547,15250
177337039,174.0,174.0,129000,58000,71000,55,129000,Null,Null,177337039,302375,1837
177343384,536.0,536.0,8990000,5790000,3200000,36,8990000,Null,Null,177343384,25643,1795
177344420,204.0,204.0,150000,98000,52000,35,150000,Null,Null,177344420,33652,3177
177349819,0.0,0.0,9900,9900,0,0,9900,Null,Null,177349819,111461,2
177424215,559.0,559.0,322200,322200,0,0,322200,Null,Null,177424215,46703,8170
177446155,4.0,4.0,760000,715000,45000,6,760000,Null,Null,177446155,173547,15250
177456215,0.0,0.0,2000,2000,0,0,2000,Null,Null,177456215,111461,1622
177461728,0.0,0.0,45000000,45000000,0,0,45000000,Null,Null,177461728,111461,23072
177467643,14.0,14.0,780000,690000,90000,12,780000,Null,Null,177467643,173547,15250
177488107,18.0,18.0,145000,145000,0,0,145000,Null,Null,177488107,362883,8513
177488137,5.0,5.0,450000,390000,60000,13,450000,Null,Null,177488137,173547,15318
177493784,12.0,12.0,450000,385000,65000,14,450000,Null,Null,177493784,173547,15318
177497239,13.0,13.0,3600000,3600000,0,0,3600000,Null,Null,177497239,153733,53350
177533869,10.0,10.0,8900,8900,0,0,8900,Null,Null,177533869,111461,2
177545817,3.0,3.0,4990000,3490000,1500000,30,4990000,Null,Null,177545817,247549,1795
177545957,7.0,7.0,10080,5040,5040,50,10080,Null,Null,177545957,111461,15320
177546230,19.0,19.0,9800,9800,0,0,9800,Null,Null,177546230,111461,28480
177546311,40.0,40.0,15000,7500,7500,50,15000,Null,Null,177546311,111461,8197
177546325,14.0,14.0,10000,5000,5000,50,10000,Null,Null,177546325,111461,15318
177546397,1.0,1.0,1500,1500,0,0,1500,Null,Null,177546397,111461,23112
177548270,157.0,157.0,220000,220000,0,0,220000,Null,Null,177548270,150002,1838
177591562,100.0,100.0,208000,145000,63000,30,208000,Null,Null,177591562,79682,1627
177610565,1062.0,1062.0,258000,129000,129000,50,258000,Null,Null,177610565,5003355,2018
177613972,87.0,87.0,890000,890000,0,0,890000,Null,Null,177613972,4502107,8400
177616359,72.0,72.0,250000,169000,81000,32,250000,Null,Null,177616359,202071,1631
177627604,0.0,0.0,2000,2000,0,0,2000,Null,Null,177627604,111461,2
177627611,80.0,80.0,1200,1200,0,0,1200,Null,Null,177627611,111461,2
177627618,20.0,20.0,1900,1900,0,0,1900,Null,Null,177627618,111461,2
177627669,37.0,37.0,1000,1000,0,0,1000,Null,Null,177627669,111461,2
177628415,1.0,1.0,1500,1500,0,0,1500,Null,Null,177628415,111461,2
177628440,153.0,153.0,63000,43000,20000,32,63000,Null,Null,177628440,79682,11833
177643008,12.0,12.0,15000,15000,0,0,15000,Null,Null,177643008,111461,15318
177650088,0.0,0.0,22000000,22000000,0,0,22000000,Null,Null,177650088,939519,28862
177653793,0.0,0.0,0,9480000,0,0,9480000,Null,Null,177653793,148698,0
177677796,33.0,33.0,1027000,790000,237000,23,1027000,Null,Null,177677796,243693,12908
177678893,179.0,179.0,4000,4000,0,0,4000,Null,Null,177678893,111461,18876
177702143,0.0,0.0,2499,2499,0,0,2499,Null,Null,177702143,111461,2
177704508,0.0,0.0,4000,4000,0,0,4000,Null,Null,177704508,111461,8205
177705463,74.0,74.0,42000,42000,0,0,42000,Null,Null,177705463,5406107,1883
177736573,14.0,14.0,250000,247500,2500,1,250000,Null,Null,177736573,111461,23112
177736783,0.0,0.0,12990000,11990000,1000000,8,12990000,Null,Null,177736783,27398,2340
177736788,60.0,60.0,245000,245000,0,0,245000,Null,Null,177736788,4307205,2971
177736998,5.0,5.0,1500,1500,0,0,1500,Null,Null,177736998,111461,2
177744787,0.0,0.0,56000000,56000000,0,0,56000000,Null,Null,177744787,939519,11516
177746939,175.0,175.0,11990000,8410000,3580000,30,11990000,Null,Null,177746939,18802,1795
177750875,88.0,88.0,695000,499000,196000,28,695000,Null,Null,177750875,52207,3426
177751243,18.0,18.0,25000,25000,0,0,25000,Null,Null,177751243,111461,8201
177754981,0.0,0.0,2100,2100,0,0,2100,Null,Null,177754981,111461,2
177763616,6.0,6.0,109000,109000,0,0,109000,Null,Null,177763616,111461,20492
177780420,165.0,165.0,68000,68000,0,0,68000,Null,Null,177780420,873101,23800
177780685,0.0,0.0,8162000,5898000,2264000,28,8162000,Null,Null,177780685,26150,8513
177780687,0.0,0.0,13596000,10197000,3399000,25,13596000,Null,Null,177780687,26150,8513
177780907,167.0,167.0,68000,68000,0,0,68000,Null,Null,177780907,873101,23800
177781721,127.0,127.0,68000,68000,0,0,68000,Null,Null,177781721,873101,23800
177782750,7.0,7.0,142000,142000,0,0,142000,Null,Null,177782750,362883,27544
177809138,66.0,66.0,19000,19000,0,0,19000,Null,Null,177809138,111461,28480
177814405,0.0,0.0,3468000,3468000,0,0,3468000,Null,Null,177814405,25422,1795
177814407,0.0,0.0,6990000,6990000,0,0,6990000,Null,Null,177814407,18802,1795
177814836,83.0,83.0,79000,79000,0,0,79000,Null,Null,177814836,4973949,20244
177896035,4.0,4.0,50400,50400,0,0,50400,Null,Null,177896035,111461,2
177896058,1.0,1.0,50000,50000,0,0,50000,Null,Null,177896058,111461,2
177896439,4.0,4.0,35000,35000,0,0,35000,Null,Null,177896439,111461,2
177896565,7.0,7.0,84000,84000,0,0,84000,Null,Null,177896565,111461,2
177901126,85.0,85.0,1000,1000,0,0,1000,Null,Null,177901126,111461,2
177902234,0.0,0.0,1900,1900,0,0,1900,Null,Null,177902234,111461,2
177902513,0.0,0.0,2500,2500,0,0,2500,Null,Null,177902513,111461,2
177903039,0.0,0.0,2500,2500,0,0,2500,Null,Null,177903039,111461,2
177904073,0.0,0.0,1900,1900,0,0,1900,Null,Null,177904073,111461,2
177911621,490.0,490.0,249000,181000,68000,27,249000,Null,Null,177911621,870157,8198
177911890,21.0,21.0,65000,65000,0,0,65000,Null,Null,177911890,111461,28434
177924150,77.0,77.0,1200000,1200000,0,0,1200000,Null,Null,177924150,517485,23376
177924699,0.0,0.0,50000000,50000000,0,0,50000000,Null,Null,177924699,111461,12590
177942308,27.0,27.0,3900000,2530000,1370000,35,3900000,Null,Null,177942308,160667,28618
177962658,46.0,46.0,18000,11300,6700,37,18000,Null,Null,177962658,886923,8305
177969021,265.0,265.0,590000,590000,0,0,590000,Null,Null,177969021,212371,2225
177984432,0.0,0.0,1900,1900,0,0,1900,Null,Null,177984432,111461,2
177991553,113.0,113.0,2000,2000,0,0,2000,Null,Null,177991553,111461,27180
177998620,180.0,180.0,16000,8000,8000,50,16000,Null,Null,177998620,301583,8305
177999483,0.0,0.0,1299,1299,0,0,1299,Null,Null,177999483,111461,2
177999497,0.0,0.0,80000,44000,36000,45,80000,Null,Null,177999497,111461,23042
178000116,0.0,0.0,11200000,9016000,2184000,20,11200000,Null,Null,178000116,18802,1795
178011804,3.0,3.0,110000,110000,0,0,110000,Null,Null,178011804,111461,15236
178013971,2.0,2.0,499000,368000,131000,26,499000,Null,Null,178013971,5048343,2020
178026990,1.0,1.0,13000,13000,0,0,13000,Null,Null,178026990,111461,2
178027025,31.0,31.0,21000,21000,0,0,21000,Null,Null,178027025,111461,2
178027547,15.0,15.0,50000,50000,0,0,50000,Null,Null,178027547,111461,2
178027582,1.0,1.0,19000,19000,0,0,19000,Null,Null,178027582,111461,2
178027613,0.0,0.0,11000,11000,0,0,11000,Null,Null,178027613,111461,2
178027639,7.0,7.0,99000,99000,0,0,99000,Null,Null,178027639,111461,2
178027654,20.0,20.0,17000,17000,0,0,17000,Null,Null,178027654,111461,49728
178027740,19.0,19.0,109000,109000,0,0,109000,Null,Null,178027740,111461,2
178027838,7.0,7.0,130000,130000,0,0,130000,Null,Null,178027838,111461,2
178028064,1.0,1.0,16000,16000,0,0,16000,Null,Null,178028064,111461,2
178028093,13.0,13.0,9000,9000,0,0,9000,Null,Null,178028093,111461,2
178028145,2.0,2.0,19000,19000,0,0,19000,Null,Null,178028145,111461,49728
178028214,1.0,1.0,19000,19000,0,0,19000,Null,Null,178028214,111461,49728
178028235,10.0,10.0,15000,15000,0,0,15000,Null,Null,178028235,111461,49728
178028347,4.0,4.0,12000,12000,0,0,12000,Null,Null,178028347,111461,49728
178028363,9.0,9.0,99000,99000,0,0,99000,Null,Null,178028363,111461,2
178028396,3.0,3.0,18000,18000,0,0,18000,Null,Null,178028396,111461,49728
178028400,19.0,19.0,20000,20000,0,0,20000,Null,Null,178028400,111461,49728
178028408,0.0,0.0,16000,16000,0,0,16000,Null,Null,178028408,111461,2
178028629,1.0,1.0,12000,12000,0,0,12000,Null,Null,178028629,111461,49728
178028632,6.0,6.0,14000,14000,0,0,14000,Null,Null,178028632,111461,2
178028652,17.0,17.0,12000,12000,0,0,12000,Null,Null,178028652,111461,49728
178029231,14.0,14.0,160000,160000,0,0,160000,Null,Null,178029231,111461,2
178029709,19.0,19.0,13000,13000,0,0,13000,Null,Null,178029709,111461,2
178029922,12.0,12.0,49000,49000,0,0,49000,Null,Null,178029922,111461,2
178029964,15.0,15.0,132000,132000,0,0,132000,Null,Null,178029964,111461,2
178030256,5.0,5.0,169000,169000,0,0,169000,Null,Null,178030256,111461,2
178030326,10.0,10.0,15000,15000,0,0,15000,Null,Null,178030326,111461,2
178030578,0.0,0.0,11000,11000,0,0,11000,Null,Null,178030578,111461,2
178030739,0.0,0.0,15000,15000,0,0,15000,Null,Null,178030739,111461,2
178037877,25.0,25.0,180000,109000,71000,39,180000,Null,Null,178037877,7242233,12908
178037925,32.0,32.0,320000,175000,145000,45,320000,Null,Null,178037925,7242233,5006
178037930,8.0,8.0,950000,950000,0,0,950000,Null,Null,178037930,7242233,12908
178037991,8.0,8.0,540000,248000,292000,54,540000,Null,Null,178037991,7242233,5006
178037997,12.0,12.0,300000,250000,50000,17,300000,Null,Null,178037997,7242233,12294
178043531,5.0,5.0,4300000,3655000,645000,15,4300000,Null,Null,178043531,508313,2340
178053476,0.0,0.0,260000,260000,0,0,260000,Null,Null,178053476,111461,2
178068438,1120.0,1120.0,78000,78000,0,0,78000,Null,Null,178068438,746615,1883
178085580,1.0,1.0,21900000,19270000,2630000,12,21900000,Null,Null,178085580,20215,2324
178093045,119.0,119.0,299000,168000,131000,44,299000,Null,Null,178093045,5707797,2334
178095640,0.0,0.0,18900000,18900000,0,0,18900000,Null,Null,178095640,20215,2324
178096746,0.0,0.0,14399000,14399000,0,0,14399000,Null,Null,178096746,153444,28862
178098878,0.0,0.0,16800000,16800000,0,0,16800000,Null,Null,178098878,153444,28862
178099383,2.0,2.0,20800000,20800000,0,0,20800000,Null,Null,178099383,153444,28862
178102398,0.0,0.0,21400000,21400000,0,0,21400000,Null,Null,178102398,50331,11518
178107482,0.0,0.0,24300000,24300000,0,0,24300000,Null,Null,178107482,50331,11518
178108181,1.0,1.0,145000,145000,0,0,145000,Null,Null,178108181,111461,2
178114650,0.0,0.0,26900000,26900000,0,0,26900000,Null,Null,178114650,4558659,2340
178221155,4.0,4.0,9800,9800,0,0,9800,Null,Null,178221155,111461,11935
178221195,15.0,15.0,37000,37000,0,0,37000,Null,Null,178221195,111461,2154
178225997,0.0,0.0,36480000,36480000,0,0,36480000,Null,Null,178225997,3730433,23050
178228196,0.0,0.0,4140000,4140000,0,0,4140000,Null,Null,178228196,111461,2340
178228245,0.0,0.0,112900000,112900000,0,0,112900000,Null,Null,178228245,4558659,2340
178228305,0.0,0.0,4140000,4140000,0,0,4140000,Null,Null,178228305,111461,2340
178228728,0.0,0.0,3900000,3900000,0,0,3900000,Null,Null,178228728,660863,17170
178228731,0.0,0.0,5100000,5100000,0,0,5100000,Null,Null,178228731,660863,53350
178228746,0.0,0.0,4700000,4700000,0,0,4700000,Null,Null,178228746,660863,8206
178228750,0.0,0.0,4200000,4200000,0,0,4200000,Null,Null,178228750,660863,3426
178228753,0.0,0.0,5100000,5100000,0,0,5100000,Null,Null,178228753,660863,17170
178229083,0.0,0.0,117100000,117100000,0,0,117100000,Null,Null,178229083,4558659,2340
178297539,92.0,92.0,77000,61000,16000,21,77000,Null,Null,178297539,47663,11827
178302264,70.0,70.0,77000,61000,16000,21,77000,Null,Null,178302264,47663,11827
178303913,0.0,0.0,58900000,58900000,0,0,58900000,Null,Null,178303913,939519,28862
178304684,2.0,2.0,71500,71500,0,0,71500,Null,Null,178304684,111461,2
178304738,0.0,0.0,9100,9100,0,0,9100,Null,Null,178304738,111461,2
178313297,84.0,84.0,2500,2500,0,0,2500,Null,Null,178313297,111461,18876
178314738,2.0,2.0,34000,17000,17000,50,34000,Null,Null,178314738,111461,15318
178315261,1.0,1.0,34000,17000,17000,50,34000,Null,Null,178315261,111461,15318
178316055,170.0,170.0,66000,66000,0,0,66000,Null,Null,178316055,111461,53054
178321097,158.0,158.0,14900,14900,0,0,14900,Null,Null,178321097,5585229,7064
178324327,0.0,0.0,9000,9000,0,0,9000,Null,Null,178324327,111461,2
178462936,0.0,0.0,399000,399000,0,0,399000,Null,Null,178462936,19018,1634
178462940,176.0,176.0,790000,689000,101000,13,790000,Null,Null,178462940,19018,1634
178462954,144.0,144.0,990000,859000,131000,13,990000,Null,Null,178462954,19018,1634
178462956,30.0,30.0,895000,799000,96000,11,895000,Null,Null,178462956,19018,2334
178470661,0.0,0.0,25000000,25000000,0,0,25000000,Null,Null,178470661,939519,28860
178476052,0.0,0.0,9950000,9950000,0,0,9950000,Null,Null,178476052,405211,8511
178481690,0.0,0.0,6770000,6770000,0,0,6770000,Null,Null,178481690,405211,8511
178482157,0.0,0.0,36000000,36000000,0,0,36000000,Null,Null,178482157,939519,28860
178488025,0.0,0.0,8500,8000,500,6,8500,Null,Null,178488025,111461,2173
178505973,6.0,6.0,12000,12000,0,0,12000,Null,Null,178505973,111461,15250
178505976,0.0,0.0,14000,14000,0,0,14000,Null,Null,178505976,111461,15250
178505989,5.0,5.0,10000,10000,0,0,10000,Null,Null,178505989,111461,15250
178505995,3.0,3.0,15000,15000,0,0,15000,Null,Null,178505995,111461,15318
178505996,0.0,0.0,18000,18000,0,0,18000,Null,Null,178505996,111461,15250
178506050,9.0,9.0,12000,12000,0,0,12000,Null,Null,178506050,111461,15318
178506057,1.0,1.0,12900,12900,0,0,12900,Null,Null,178506057,111461,15250
178506090,1.0,1.0,16900,16900,0,0,16900,Null,Null,178506090,111461,15250
178506139,3.0,3.0,14000,14000,0,0,14000,Null,Null,178506139,111461,15318
178506141,0.0,0.0,18000,18000,0,0,18000,Null,Null,178506141,111461,15318
178506145,1.0,1.0,18000,18000,0,0,18000,Null,Null,178506145,111461,15250
178506149,0.0,0.0,14000,14000,0,0,14000,Null,Null,178506149,111461,15250
178506289,0.0,0.0,14900,14900,0,0,14900,Null,Null,178506289,111461,15250
178506299,3.0,3.0,32000,32000,0,0,32000,Null,Null,178506299,111461,5384
178506364,0.0,0.0,16000,16000,0,0,16000,Null,Null,178506364,111461,15250
178506419,0.0,0.0,12000,12000,0,0,12000,Null,Null,178506419,111461,15250
178506447,0.0,0.0,18000,18000,0,0,18000,Null,Null,178506447,111461,15250
178506455,1.0,1.0,15900,15900,0,0,15900,Null,Null,178506455,111461,15250
178506460,0.0,0.0,16000,16000,0,0,16000,Null,Null,178506460,111461,15936
178506474,0.0,0.0,12000,12000,0,0,12000,Null,Null,178506474,111461,15318
178506477,0.0,0.0,17000,17000,0,0,17000,Null,Null,178506477,111461,15250
178506513,3.0,3.0,24000,24000,0,0,24000,Null,Null,178506513,111461,8513
178506525,0.0,0.0,18000,18000,0,0,18000,Null,Null,178506525,111461,15250
178506529,2.0,2.0,15900,15900,0,0,15900,Null,Null,178506529,111461,15318
178506562,0.0,0.0,17000,17000,0,0,17000,Null,Null,178506562,111461,15250
178506638,4.0,4.0,37000,37000,0,0,37000,Null,Null,178506638,111461,5384
178506676,5.0,5.0,8000,8000,0,0,8000,Null,Null,178506676,111461,15250
178506696,0.0,0.0,14000,14000,0,0,14000,Null,Null,178506696,111461,27546
178506698,11.0,11.0,3000,3000,0,0,3000,Null,Null,178506698,111461,15318
178506722,3.0,3.0,18000,18000,0,0,18000,Null,Null,178506722,111461,15250
178506739,2.0,2.0,38000,38000,0,0,38000,Null,Null,178506739,111461,8516
178506853,11.0,11.0,19000,19000,0,0,19000,Null,Null,178506853,111461,15250
178506979,2.0,2.0,27000,27000,0,0,27000,Null,Null,178506979,111461,8516
178506992,1.0,1.0,14000,14000,0,0,14000,Null,Null,178506992,111461,15250
178507027,1.0,1.0,15900,15900,0,0,15900,Null,Null,178507027,111461,15250
178507166,2.0,2.0,18000,18000,0,0,18000,Null,Null,178507166,111461,15250
178507244,2.0,2.0,60000,60000,0,0,60000,Null,Null,178507244,111461,5384
178507260,11.0,11.0,17000,17000,0,0,17000,Null,Null,178507260,111461,15318
178507265,17.0,17.0,42000,42000,0,0,42000,Null,Null,178507265,111461,8513
178507266,2.0,2.0,14000,14000,0,0,14000,Null,Null,178507266,111461,15250
178507294,4.0,4.0,44000,44000,0,0,44000,Null,Null,178507294,111461,8513
178511335,0.0,0.0,18000,18000,0,0,18000,Null,Null,178511335,111461,15250
178511343,6.0,6.0,18000,18000,0,0,18000,Null,Null,178511343,111461,15320
178511434,4.0,4.0,32000,32000,0,0,32000,Null,Null,178511434,111461,5384
178511467,0.0,0.0,13000,13000,0,0,13000,Null,Null,178511467,111461,49724
178511483,1.0,1.0,12000,12000,0,0,12000,Null,Null,178511483,111461,15318
178511578,0.0,0.0,5000,5000,0,0,5000,Null,Null,178511578,111461,49724
178511587,19.0,19.0,2000,2000,0,0,2000,Null,Null,178511587,111461,49728
178511630,0.0,0.0,5500,5500,0,0,5500,Null,Null,178511630,111461,15318
178511643,13.0,13.0,12000,12000,0,0,12000,Null,Null,178511643,111461,15250
178511826,0.0,0.0,16900,16900,0,0,16900,Null,Null,178511826,111461,2
178511889,1.0,1.0,13000,13000,0,0,13000,Null,Null,178511889,111461,2
178511944,9.0,9.0,32000,32000,0,0,32000,Null,Null,178511944,111461,2
178512137,2.0,2.0,18000,18000,0,0,18000,Null,Null,178512137,111461,2
178515846,8.0,8.0,129000,123000,6000,5,129000,Null,Null,178515846,111461,28596
178559102,85.0,85.0,99000,89000,10000,10,99000,Null,Null,178559102,111461,2685
178559959,374.0,374.0,180000,180000,0,0,180000,Null,Null,178559959,5211293,1583
178575037,15.0,15.0,2690000,1619000,1071000,40,2690000,Null,Null,178575037,19673,1795
178575135,0.0,0.0,40000000,38500000,1500000,4,40000000,Null,Null,178575135,111461,12590
178584469,1.0,1.0,21999000,16990000,5009000,23,21999000,Null,Null,178584469,204665,2340
178588753,57.0,57.0,265000,240000,25000,9,265000,Null,Null,178588753,4936133,11905
178594987,0.0,0.0,3390000,3390000,0,0,3390000,Null,Null,178594987,4885445,2340
178596776,4.0,4.0,2500,2500,0,0,2500,Null,Null,178596776,111461,27214
178605756,24.0,24.0,39000,39000,0,0,39000,Null,Null,178605756,5076287,20244
178606785,0.0,0.0,19416000,17700000,1716000,9,19416000,Null,Null,178606785,18802,1794
178607570,0.0,0.0,24041000,22500000,1541000,6,24041000,Null,Null,178607570,18802,1794
178711314,0.0,0.0,12200000,12200000,0,0,12200000,Null,Null,178711314,414885,2342
178725018,122.0,122.0,300000,300000,0,0,300000,Null,Null,178725018,241131,11911
178735812,1.0,1.0,25000,6000,19000,76,25000,Null,Null,178735812,111461,28732
178737463,263.0,263.0,75000,75000,0,0,75000,Null,Null,178737463,5126697,28484
178762645,30.0,30.0,1490000,990000,500000,34,1490000,Null,Null,178762645,18802,12908
178767632,123.0,123.0,980000,499000,481000,49,980000,Null,Null,178767632,18802,28460
178769718,80.0,80.0,1500000,926000,574000,38,1500000,Null,Null,178769718,632677,4381
178776748,3.0,3.0,10000,10000,0,0,10000,Null,Null,178776748,111461,15318
178777136,4.0,4.0,8000,8000,0,0,8000,Null,Null,178777136,111461,15318
178777341,1.0,1.0,10000,10000,0,0,10000,Null,Null,178777341,111461,15320
178778996,3.0,3.0,109000,109000,0,0,109000,Null,Null,178778996,111461,2
178779312,22.0,22.0,55000,55000,0,0,55000,Null,Null,178779312,111461,15318
178779805,17.0,17.0,109000,109000,0,0,109000,Null,Null,178779805,111461,15250
178780108,14.0,14.0,55000,55000,0,0,55000,Null,Null,178780108,111461,15250
178780299,20.0,20.0,48000,48000,0,0,48000,Null,Null,178780299,111461,2
178780377,2.0,2.0,18000,18000,0,0,18000,Null,Null,178780377,111461,15320
178783625,149.0,149.0,50000,50000,0,0,50000,Null,Null,178783625,5706641,23258
178787431,54.0,54.0,100000,59000,41000,41,100000,Null,Null,178787431,886549,27128
178828480,65.0,65.0,145000,123250,21750,15,145000,Null,Null,178828480,542605,11825
178832745,101.0,101.0,35000,35000,0,0,35000,Null,Null,178832745,4534193,11935
178913467,54.0,54.0,275000,275000,0,0,275000,Null,Null,178913467,4777435,23800
178951652,0.0,0.0,8390000,8390000,0,0,8390000,Null,Null,178951652,18802,1795
178956993,82.0,82.0,145000,125000,20000,14,145000,Null,Null,178956993,111461,2238
178957406,143.0,143.0,120000,92000,28000,23,120000,Null,Null,178957406,111461,23678
178957758,23.0,23.0,249000,249000,0,0,249000,Null,Null,178957758,4958627,2324
179063461,196.0,196.0,189000,169000,20000,11,189000,Null,Null,179063461,111461,2685
179095587,0.0,0.0,68000000,57800000,10200000,15,68000000,Null,Null,179095587,111461,4381
179104983,0.0,0.0,3399000,3399000,0,0,3399000,Null,Null,179104983,215947,8227
179138352,0.0,0.0,2500,2500,0,0,2500,Null,Null,179138352,111461,2
179138523,0.0,0.0,1500,1500,0,0,1500,Null,Null,179138523,111461,2363
179141545,255.0,255.0,205000,205000,0,0,205000,Null,Null,179141545,111461,8305
179143162,49.0,49.0,245000,220000,25000,10,245000,Null,Null,179143162,223155,11905
179158076,0.0,0.0,4000000,4000000,0,0,4000000,Null,Null,179158076,111461,11885
179158441,0.0,0.0,8500,8500,0,0,8500,Null,Null,179158441,111461,8205
179206395,1.0,1.0,1987000,1987000,0,0,1987000,Null,Null,179206395,111461,15250
179226516,1.0,1.0,65000,65000,0,0,65000,Null,Null,179226516,111461,2
179229024,97.0,97.0,1000000,1000000,0,0,1000000,Null,Null,179229024,2630119,28444
179234820,1.0,1.0,3500000,3500000,0,0,3500000,Null,Null,179234820,18802,1795
179238315,26.0,26.0,1400,1400,0,0,1400,Null,Null,179238315,111461,2337
179367675,49.0,49.0,22900,22900,0,0,22900,Null,Null,179367675,111461,2
179398529,0.0,0.0,3000,3000,0,0,3000,Null,Null,179398529,111461,2
179405551,1.0,1.0,1900,1900,0,0,1900,Null,Null,179405551,111461,2
179405567,3.0,3.0,2500,2500,0,0,2500,Null,Null,179405567,111461,2
179405573,4.0,4.0,1000,1000,0,0,1000,Null,Null,179405573,111461,2
179405618,1.0,1.0,2000,2000,0,0,2000,Null,Null,179405618,111461,2
179405633,0.0,0.0,1900,1900,0,0,1900,Null,Null,179405633,111461,2
179405730,0.0,0.0,1999,1999,0,0,1999,Null,Null,179405730,111461,2
179405853,22.0,22.0,1500,1500,0,0,1500,Null,Null,179405853,111461,2
179405916,0.0,0.0,2500,2500,0,0,2500,Null,Null,179405916,111461,2
179406344,0.0,0.0,2500,2500,0,0,2500,Null,Null,179406344,111461,2
179406387,0.0,0.0,2500,2500,0,0,2500,Null,Null,179406387,111461,2
179406414,0.0,0.0,2500,2500,0,0,2500,Null,Null,179406414,111461,2
179406423,0.0,0.0,1350,1350,0,0,1350,Null,Null,179406423,111461,2
179406496,0.0,0.0,2500,2500,0,0,2500,Null,Null,179406496,111461,2
179406651,8.0,8.0,1000,990,10,1,1000,Null,Null,179406651,111461,2
179406841,0.0,0.0,2500,2500,0,0,2500,Null,Null,179406841,111461,2
179406878,2.0,2.0,1500,1500,0,0,1500,Null,Null,179406878,111461,2
179438711,4.0,4.0,2690000,1717000,973000,36,2690000,Null,Null,179438711,19673,1795
179444874,141.0,141.0,150000,79000,71000,47,150000,Null,Null,179444874,625265,28574
179489918,1.0,1.0,200000,200000,0,0,200000,Null,Null,179489918,111461,15250
179489992,0.0,0.0,20000000,11880000,8120000,41,20000000,Null,Null,179489992,18802,1795
179509170,0.0,0.0,11990000,11990000,0,0,11990000,Null,Null,179509170,520883,20170
179520546,75.0,75.0,14500,14500,0,0,14500,Null,Null,179520546,111461,53074
179520583,0.0,0.0,6310000,5552800,757200,12,6310000,Null,Null,179520583,305739,8227
179520587,0.0,0.0,8410000,7400800,1009200,12,8410000,Null,Null,179520587,305739,8227
179520588,0.0,0.0,4380000,3854400,525600,12,4380000,Null,Null,179520588,305739,8227
179520684,0.0,0.0,6480000,5702400,777600,12,6480000,Null,Null,179520684,305739,8227
179527005,65.0,65.0,350000,309000,41000,12,350000,Null,Null,179527005,5181283,28480
179541784,137.0,137.0,199000,159000,40000,20,199000,Null,Null,179541784,21651,28458
179547641,385.0,385.0,4990000,3500000,1490000,30,4990000,Null,Null,179547641,147856,28856
179549014,0.0,0.0,25000000,25000000,0,0,25000000,Null,Null,179549014,111461,28398
179573066,24.0,24.0,250000,250000,0,0,250000,Null,Null,179573066,4307205,1832
179578872,0.0,0.0,1900,1900,0,0,1900,Null,Null,179578872,111461,2
179580530,0.0,0.0,1900,1900,0,0,1900,Null,Null,179580530,111461,2
179581645,50.0,50.0,55000,55000,0,0,55000,Null,Null,179581645,111461,2
179581951,3.0,3.0,1750,1750,0,0,1750,Null,Null,179581951,111461,2
179582007,0.0,0.0,2030,2030,0,0,2030,Null,Null,179582007,111461,2
179589103,33.0,33.0,3599000,3099000,500000,14,3599000,Null,Null,179589103,25422,1795
179591105,0.0,0.0,3912000,3912000,0,0,3912000,Null,Null,179591105,25643,1795
179688107,48.0,48.0,15000,15000,0,0,15000,Null,Null,179688107,745957,2153
179688143,59.0,59.0,41900,41900,0,0,41900,Null,Null,179688143,745957,2153
179689651,36.0,36.0,17000,17000,0,0,17000,Null,Null,179689651,4281839,23800
179717941,17.0,17.0,33990000,33990000,0,0,33990000,Null,Null,179717941,18802,1795
179720304,0.0,0.0,38000000,38000000,0,0,38000000,Null,Null,179720304,111461,23104
179745307,0.0,0.0,23400000,23400000,0,0,23400000,Null,Null,179745307,167443,28870
179745913,0.0,0.0,28400000,22490000,5910000,21,28400000,Null,Null,179745913,167443,28870
179746885,0.0,0.0,2000,2000,0,0,2000,Null,Null,179746885,111461,2
179747259,1.0,1.0,4000,4000,0,0,4000,Null,Null,179747259,111461,2
179747400,0.0,0.0,6900,6900,0,0,6900,Null,Null,179747400,111461,2
179747890,4.0,4.0,4500,4500,0,0,4500,Null,Null,179747890,111461,2
179748065,93.0,93.0,5000,5000,0,0,5000,Null,Null,179748065,111461,2
179748286,1.0,1.0,6500,6500,0,0,6500,Null,Null,179748286,111461,2
179752602,0.0,0.0,45500000,45500000,0,0,45500000,Null,Null,179752602,111461,2
179753588,0.0,0.0,7000000,6371000,629000,9,7000000,Null,Null,179753588,18802,1795
179754447,0.0,0.0,2500,2500,0,0,2500,Null,Null,179754447,111461,2
179754839,1.0,1.0,200000,169000,31000,16,200000,Null,Null,179754839,632589,13878
179754879,442.0,442.0,21900,21900,0,0,21900,Null,Null,179754879,632589,13878
179756671,1.0,1.0,210000,105000,105000,50,210000,Null,Null,179756671,111461,49724
179789010,5.0,5.0,7000,7000,0,0,7000,Null,Null,179789010,111461,2173
179795085,91.0,91.0,259000,259000,0,0,259000,Null,Null,179795085,7276487,1623
179796258,0.0,0.0,2500,2500,0,0,2500,Null,Null,179796258,111461,2
179796554,0.0,0.0,2500,2500,0,0,2500,Null,Null,179796554,111461,2
179806284,1.0,1.0,2000,2000,0,0,2000,Null,Null,179806284,111461,2
179911051,60.0,60.0,140000,140000,0,0,140000,Null,Null,179911051,302375,28644
179928870,1.0,1.0,358000,179000,179000,50,358000,Null,Null,179928870,111461,49724
179930421,0.0,0.0,99000,99000,0,0,99000,Null,Null,179930421,111461,49724
179930704,1.0,1.0,3190000,2020000,1170000,37,3190000,Null,Null,179930704,19673,1795
179944385,0.0,0.0,4998,4998,0,0,4998,Null,Null,179944385,111461,28484
179944607,126.0,126.0,89000,89000,0,0,89000,Null,Null,179944607,5272071,28480
179951358,19.0,19.0,239000,239000,0,0,239000,Null,Null,179951358,4539407,28682
179951915,25.0,25.0,238000,134000,104000,44,238000,Null,Null,179951915,111461,8309
179952303,3.0,3.0,561000,561000,0,0,561000,Null,Null,179952303,111461,2136
179978792,83.0,83.0,99000,99000,0,0,99000,Null,Null,179978792,111461,28698
179980123,192.0,192.0,198000,151000,47000,24,198000,Null,Null,179980123,21266,8212
179980125,9108.0,9108.0,156000,139000,17000,11,156000,Null,Null,179980125,21266,2
179983154,0.0,0.0,19000,19000,0,0,19000,Null,Null,179983154,111461,2
179988643,6584.0,6584.0,139400,135000,4400,3,139400,Null,Null,179988643,21266,2
179988645,855.0,855.0,159000,136000,23000,14,159000,Null,Null,179988645,21266,8308
179992491,144.0,144.0,159000,98000,61000,38,159000,Null,Null,179992491,4539407,20244
179992983,114.0,114.0,53000,26000,27000,51,53000,Null,Null,179992983,111461,23416
179993009,210.0,210.0,36000,18000,18000,50,36000,Null,Null,179993009,111461,23416
179993013,94.0,94.0,47000,23000,24000,51,47000,Null,Null,179993013,111461,53054
179993053,24.0,24.0,95000,47500,47500,50,95000,Null,Null,179993053,111461,53054
179993100,105.0,105.0,89000,42000,47000,53,89000,Null,Null,179993100,111461,23416
179993138,48.0,48.0,35000,16000,19000,54,35000,Null,Null,179993138,111461,5450
179993179,96.0,96.0,25000,12000,13000,52,25000,Null,Null,179993179,111461,23416
179993218,122.0,122.0,89000,44000,45000,51,89000,Null,Null,179993218,111461,23416
179993226,11.0,11.0,19000,9000,10000,53,19000,Null,Null,179993226,111461,23416
179993260,271.0,271.0,47000,23000,24000,51,47000,Null,Null,179993260,111461,23416
179993273,42.0,42.0,40000,19000,21000,53,40000,Null,Null,179993273,111461,23416
179993278,280.0,280.0,34000,17000,17000,50,34000,Null,Null,179993278,111461,23416
179993349,71.0,71.0,36000,18000,18000,50,36000,Null,Null,179993349,111461,23416
180002729,55.0,55.0,250000,225000,25000,10,250000,Null,Null,180002729,111461,28486
180015966,1.0,1.0,398000,218999,179001,45,398000,Null,Null,180015966,402501,2659
180047443,0.0,0.0,1500,1500,0,0,1500,Null,Null,180047443,111461,23340
180104227,10.0,10.0,12000,12000,0,0,12000,Null,Null,180104227,21437,2
180104927,0.0,0.0,88000,88000,0,0,88000,Null,Null,180104927,21437,2
180105022,16.0,16.0,58000,58000,0,0,58000,Null,Null,180105022,21437,2
180226023,152.0,152.0,360000,325000,35000,10,360000,Null,Null,180226023,273281,11753
180230927,94.0,94.0,206000,206000,0,0,206000,Null,Null,180230927,111461,23544
180233307,1.0,1.0,129000,129000,0,0,129000,Null,Null,180233307,111461,49722
180236553,243.0,243.0,350000,285000,65000,19,350000,Null,Null,180236553,242713,1752
180293819,8.0,8.0,4000,4000,0,0,4000,Null,Null,180293819,111461,1819
180303300,110.0,110.0,460000,435000,25000,5,460000,Null,Null,180303300,273281,11753
180304059,1.0,1.0,17000,17000,0,0,17000,Null,Null,180304059,21437,2
180304135,0.0,0.0,1000,1000,0,0,1000,Null,Null,180304135,111461,27240
180304594,8.0,8.0,2000,2000,0,0,2000,Null,Null,180304594,111461,2363
180317665,0.0,0.0,2000,2000,0,0,2000,Null,Null,180317665,111461,23042
180320197,0.0,0.0,34200000,34200000,0,0,34200000,Null,Null,180320197,5710451,20170
180322092,1.0,1.0,82665,82665,0,0,82665,Null,Null,180322092,21437,2
180325774,27.0,27.0,228160,159712,68448,30,228160,Null,Null,180325774,111461,53190
180343370,40.0,40.0,2000,1980,20,1,2000,Null,Null,180343370,111461,53074
180343478,0.0,0.0,12399000,12399000,0,0,12399000,Null,Null,180343478,157941,28862
180364934,2.0,2.0,13900000,13900000,0,0,13900000,Null,Null,180364934,18641,28392
180378151,897.0,897.0,579000,300000,279000,48,579000,Null,Null,180378151,48077,1936
180380510,0.0,0.0,11672000,8754000,2918000,25,11672000,Null,Null,180380510,26150,8513
180380512,0.0,0.0,11228000,8421000,2807000,25,11228000,Null,Null,180380512,26150,8513
180381025,61.0,61.0,136000,99000,37000,27,136000,Null,Null,180381025,5647959,3710
180381390,34.0,34.0,2990000,2990000,0,0,2990000,Null,Null,180381390,147856,28856
180388788,0.0,0.0,2500,2500,0,0,2500,Null,Null,180388788,111461,2
180394221,1.0,1.0,12000,12000,0,0,12000,Null,Null,180394221,111461,15250
180402189,68.0,68.0,750000,702000,48000,6,750000,Null,Null,180402189,189445,28596
180576002,0.0,0.0,12000,12000,0,0,12000,Null,Null,180576002,111461,15320
180590962,176.0,176.0,50000,50000,0,0,50000,Null,Null,180590962,892751,1634
180596573,5.0,5.0,450000,235000,215000,48,450000,Null,Null,180596573,111461,49724
180720287,1.0,1.0,17000,17000,0,0,17000,Null,Null,180720287,111461,2
180742108,0.0,0.0,1080000,1080000,0,0,1080000,Null,Null,180742108,111461,23168
180742115,0.0,0.0,845000,845000,0,0,845000,Null,Null,180742115,111461,23168
180742141,0.0,0.0,1030000,1030000,0,0,1030000,Null,Null,180742141,111461,23168
180742157,0.0,0.0,845000,845000,0,0,845000,Null,Null,180742157,111461,23168
180742186,0.0,0.0,1080000,1080000,0,0,1080000,Null,Null,180742186,111461,23168
180742214,0.0,0.0,1769000,1769000,0,0,1769000,Null,Null,180742214,111461,3515
180746646,210.0,210.0,7000000,3699000,3301000,47,7000000,Null,Null,180746646,5254613,4381
180749402,2.0,2.0,79000,79000,0,0,79000,Null,Null,180749402,111461,2
180848312,2.0,2.0,18900,18900,0,0,18900,Null,Null,180848312,111461,15318
180848825,5.0,5.0,1000,1000,0,0,1000,Null,Null,180848825,111461,49728
180852683,0.0,0.0,15000,15000,0,0,15000,Null,Null,180852683,111461,15250
180854178,4.0,4.0,685000,685000,0,0,685000,Null,Null,180854178,469547,15236
180868721,0.0,0.0,15000000,15000000,0,0,15000000,Null,Null,180868721,111461,11935
180937395,0.0,0.0,2500,2500,0,0,2500,Null,Null,180937395,111461,2
180937897,0.0,0.0,15000,15000,0,0,15000,Null,Null,180937897,111461,2
180944993,0.0,0.0,2000,2000,0,0,2000,Null,Null,180944993,111461,2
180955315,0.0,0.0,9000,9000,0,0,9000,Null,Null,180955315,111461,8198
180965038,0.0,0.0,2000,2000,0,0,2000,Null,Null,180965038,111461,2
180967717,0.0,0.0,6450000,6450000,0,0,6450000,Null,Null,180967717,405211,8511
180967996,1.0,1.0,162972,162972,0,0,162972,Null,Null,180967996,111461,2225
180973794,42.0,42.0,330000,280000,50000,15,330000,Null,Null,180973794,203901,3422
180992533,0.0,0.0,30000,30000,0,0,30000,Null,Null,180992533,111461,15318
180992721,0.0,0.0,220000,220000,0,0,220000,Null,Null,180992721,223295,8512
180992757,0.0,0.0,175000,175000,0,0,175000,Null,Null,180992757,223295,8512
180992835,0.0,0.0,14999,14999,0,0,14999,Null,Null,180992835,111461,49726
180996245,3.0,3.0,25000,18956,6044,24,25000,Null,Null,180996245,111461,1815
180999617,1.0,1.0,35000,25000,10000,29,35000,Null,Null,180999617,111461,1883
181096368,0.0,0.0,178999,178999,0,0,178999,Null,Null,181096368,111461,2
181097570,90.0,90.0,750000,713000,37000,5,750000,Null,Null,181097570,64932,53350
181097571,181.0,181.0,700000,665000,35000,5,700000,Null,Null,181097571,64932,3422
181113191,0.0,0.0,7550000,7550000,0,0,7550000,Null,Null,181113191,405211,8511
181113297,0.0,0.0,7550000,7550000,0,0,7550000,Null,Null,181113297,405211,8511
181120173,104.0,104.0,168000,161000,7000,4,168000,Null,Null,181120173,7308379,1936
181123580,0.0,0.0,37870000,37870000,0,0,37870000,Null,Null,181123580,111461,23642
181131152,0.0,0.0,43990000,42000000,1990000,5,43990000,Null,Null,181131152,5232357,2324
181132972,0.0,0.0,51990000,49000000,2990000,6,51990000,Null,Null,181132972,5232357,2324
181133300,115.0,115.0,159000,159000,0,0,159000,Null,Null,181133300,197443,13878
181135341,1.0,1.0,4950000,4950000,0,0,4950000,Null,Null,181135341,111461,2340
181146601,0.0,0.0,2000,2000,0,0,2000,Null,Null,181146601,111461,2
181151849,351.0,351.0,65000,65000,0,0,65000,Null,Null,181151849,111461,27180
181184637,0.0,0.0,2000,2000,0,0,2000,Null,Null,181184637,111461,2238
181210082,0.0,0.0,14000,14000,0,0,14000,Null,Null,181210082,111461,15320
181215491,0.0,0.0,6550000,6550000,0,0,6550000,Null,Null,181215491,405211,8511
181215537,0.0,0.0,11900,11900,0,0,11900,Null,Null,181215537,779129,1601
181216830,0.0,0.0,4290000,2990000,1300000,30,4290000,Null,Null,181216830,49994,1795
181216965,0.0,0.0,1299,1299,0,0,1299,Null,Null,181216965,111461,2
181217570,0.0,0.0,7000,6000,1000,14,7000,Null,Null,181217570,111461,2
181223364,288.0,288.0,229000,148000,81000,35,229000,Null,Null,181223364,230607,27128
181232965,0.0,0.0,11000000,11000000,0,0,11000000,Null,Null,181232965,625577,8511
181252097,0.0,0.0,40000,40000,0,0,40000,Null,Null,181252097,111461,23446
181252105,0.0,0.0,750000,750000,0,0,750000,Null,Null,181252105,111461,23446
181252110,0.0,0.0,22500,22500,0,0,22500,Null,Null,181252110,111461,23446
181252112,0.0,0.0,399000,399000,0,0,399000,Null,Null,181252112,111461,23446
181252114,0.0,0.0,399000,399000,0,0,399000,Null,Null,181252114,111461,23446
181264344,11.0,11.0,4990000,4990000,0,0,4990000,Null,Null,181264344,112735,1795
181266509,6.0,6.0,5990000,5990000,0,0,5990000,Null,Null,181266509,169013,1795
181268388,0.0,0.0,2000,2000,0,0,2000,Null,Null,181268388,111461,2
181269050,0.0,0.0,2000,2000,0,0,2000,Null,Null,181269050,111461,2
181269278,0.0,0.0,2000,2000,0,0,2000,Null,Null,181269278,111461,2
181269728,0.0,0.0,2000,2000,0,0,2000,Null,Null,181269728,111461,2
181270330,0.0,0.0,2000,2000,0,0,2000,Null,Null,181270330,111461,2
181361146,0.0,0.0,36160000,36160000,0,0,36160000,Null,Null,181361146,111461,23642
181361773,141.0,141.0,219000,202000,17000,8,219000,Null,Null,181361773,523789,4380
181361823,262.0,262.0,95000,69000,26000,27,95000,Null,Null,181361823,111461,5531
181362898,0.0,0.0,3500,3500,0,0,3500,Null,Null,181362898,111461,8198
181407756,10.0,10.0,580000,290000,290000,50,580000,Null,Null,181407756,111461,8512
181410158,736.0,736.0,349000,322000,27000,8,349000,Null,Null,181410158,523789,4381
181447786,235.0,235.0,175000,175000,0,0,175000,Null,Null,181447786,857381,5531
181448785,13.0,13.0,80000,80000,0,0,80000,Null,Null,181448785,111461,15250
181449675,5.0,5.0,117000,117000,0,0,117000,Null,Null,181449675,41391,53190
181452535,87.0,87.0,790000,551000,239000,30,790000,Null,Null,181452535,111684,1796
181452677,22.0,22.0,2400000,2160000,240000,10,2400000,Null,Null,181452677,33203,8168
181454623,36.0,36.0,200000,98000,102000,51,200000,Null,Null,181454623,7247787,12908
181454786,64.0,64.0,49000,49000,0,0,49000,Null,Null,181454786,111461,2238
181456477,48.0,48.0,115000,115000,0,0,115000,Null,Null,181456477,111461,23346
181503298,0.0,0.0,4716000,4716000,0,0,4716000,Null,Null,181503298,25422,1795
181503319,1.0,1.0,14345000,14345000,0,0,14345000,Null,Null,181503319,153444,28860
181503592,145.0,145.0,175000,175000,0,0,175000,Null,Null,181503592,5706641,12590
181517965,0.0,0.0,8990000,8990000,0,0,8990000,Null,Null,181517965,18802,1795
181563631,76.0,76.0,130000,99000,31000,24,130000,Null,Null,181563631,111461,1831
181565677,15.0,15.0,27000,13500,13500,50,27000,Null,Null,181565677,111461,15318
181567709,48.0,48.0,80000,75000,5000,6,80000,Null,Null,181567709,179387,23702
181680005,15.0,15.0,85000,84150,850,1,85000,Null,Null,181680005,111461,28616
181680992,0.0,0.0,67000000,67000000,0,0,67000000,Null,Null,181680992,111461,23708
181681023,118.0,118.0,68000,68000,0,0,68000,Null,Null,181681023,18984,1837
181689010,0.0,0.0,2000,2000,0,0,2000,Null,Null,181689010,111461,2
181689028,0.0,0.0,2000,2000,0,0,2000,Null,Null,181689028,111461,2
181698959,0.0,0.0,169000,169000,0,0,169000,Null,Null,181698959,111454,12908
181699053,0.0,0.0,2088000,2088000,0,0,2088000,Null,Null,181699053,25422,1795
181699058,0.0,0.0,8500000,6704000,1796000,21,8500000,Null,Null,181699058,18802,1795
181699076,0.0,0.0,15000000,12000000,3000000,20,15000000,Null,Null,181699076,18802,1795
181699158,1.0,1.0,5590000,5590000,0,0,5590000,Null,Null,181699158,25422,1795
181699208,0.0,0.0,8000000,5324000,2676000,33,8000000,Null,Null,181699208,18802,1794
181699210,0.0,0.0,2508000,2508000,0,0,2508000,Null,Null,181699210,25422,1795
181699258,0.0,0.0,3012000,2794000,218000,7,3012000,Null,Null,181699258,25643,1795
181699278,0.0,0.0,4716000,4716000,0,0,4716000,Null,Null,181699278,25422,1795
181699289,0.0,0.0,5436000,5436000,0,0,5436000,Null,Null,181699289,25643,1796
181699314,0.0,0.0,7668000,7348000,320000,4,7668000,Null,Null,181699314,25643,1795
181699331,0.0,0.0,9600000,9600000,0,0,9600000,Null,Null,181699331,18802,1795
181699369,0.0,0.0,3912000,3912000,0,0,3912000,Null,Null,181699369,25643,1795
181699370,0.0,0.0,3468000,3468000,0,0,3468000,Null,Null,181699370,25422,1795
181703864,131.0,131.0,280000,165000,115000,41,280000,Null,Null,181703864,111461,23376
181710045,0.0,0.0,3400000,3400000,0,0,3400000,Null,Null,181710045,111461,2340
181710245,278.0,278.0,280000,165000,115000,41,280000,Null,Null,181710245,111461,23376
181752598,0.0,0.0,10000000,10000000,0,0,10000000,Null,Null,181752598,111461,8167
181777109,1.0,1.0,16000,16000,0,0,16000,Null,Null,181777109,111461,49728
181782208,0.0,0.0,11500000,11500000,0,0,11500000,Null,Null,181782208,111461,8167
181789271,14.0,14.0,8000,8000,0,0,8000,Null,Null,181789271,248191,13878
181794227,0.0,0.0,15000,15000,0,0,15000,Null,Null,181794227,111461,15250
181797889,4.0,4.0,18500,18500,0,0,18500,Null,Null,181797889,111461,15318
181799682,3.0,3.0,335498,304999,30499,9,335498,Null,Null,181799682,411559,28596
181807788,0.0,0.0,16700000,16700000,0,0,16700000,Null,Null,181807788,111461,8167
181809412,11.0,11.0,26400,12000,14400,55,26400,Null,Null,181809412,111461,15318
181810152,604.0,604.0,250000,189000,61000,24,250000,Null,Null,181810152,5534927,11893
181810188,602.0,602.0,299000,235000,64000,21,299000,Null,Null,181810188,5534927,11879
181906786,101.0,101.0,1190000,699000,491000,41,1190000,Null,Null,181906786,25422,2334
181907418,20.0,20.0,321000,321000,0,0,321000,Null,Null,181907418,111461,4381
181909427,355.0,355.0,1112000,549000,563000,51,1112000,Null,Null,181909427,48077,2136
181916832,0.0,0.0,30000,16500,13500,45,30000,Null,Null,181916832,4647777,15318
181916922,10.0,10.0,2000,2000,0,0,2000,Null,Null,181916922,111461,2
181916995,12.0,12.0,2000,2000,0,0,2000,Null,Null,181916995,111461,2
181917091,12.0,12.0,1950,1950,0,0,1950,Null,Null,181917091,111461,23446
181918564,0.0,0.0,5990000,5990000,0,0,5990000,Null,Null,181918564,112735,1795
181920513,0.0,0.0,6200000,4441000,1759000,28,6200000,Null,Null,181920513,46007,8227
181927718,11.0,11.0,1950000,1950000,0,0,1950000,Null,Null,181927718,18804,8061
181927736,14.0,14.0,1750000,1750000,0,0,1750000,Null,Null,181927736,18804,8061
181927774,13.0,13.0,1120000,1120000,0,0,1120000,Null,Null,181927774,18804,8061
181927801,41.0,41.0,1530000,1530000,0,0,1530000,Null,Null,181927801,18804,8061
181928189,24.0,24.0,1530000,1530000,0,0,1530000,Null,Null,181928189,18804,8061
181928208,38.0,38.0,950000,950000,0,0,950000,Null,Null,181928208,18804,8061
181928619,52.0,52.0,950000,950000,0,0,950000,Null,Null,181928619,18804,8061
181934310,24.0,24.0,950000,950000,0,0,950000,Null,Null,181934310,218061,11943
181934312,203.0,203.0,250000,179000,71000,28,250000,Null,Null,181934312,5147565,28482
181977398,33.0,33.0,960000,960000,0,0,960000,Null,Null,181977398,18804,8061
181979168,0.0,0.0,5000,5000,0,0,5000,Null,Null,181979168,111461,2
181980475,7.0,7.0,4800,4800,0,0,4800,Null,Null,181980475,111461,8167
181988661,7.0,7.0,120000,75000,45000,38,120000,Null,Null,181988661,111461,23184
181989367,0.0,0.0,85000,66000,19000,22,85000,Null,Null,181989367,111461,2488
181992004,1.0,1.0,109000,109000,0,0,109000,Null,Null,181992004,111461,2514
181997176,142.0,142.0,138000,138000,0,0,138000,Null,Null,181997176,4187373,20182
181997911,0.0,0.0,8100000,8100000,0,0,8100000,Null,Null,181997911,111461,15318
181998903,0.0,0.0,5600000,5600000,0,0,5600000,Null,Null,181998903,111461,11935
181999745,0.0,0.0,17330000,17330000,0,0,17330000,Null,Null,181999745,111461,11933
182086311,10.0,10.0,99000,99000,0,0,99000,Null,Null,182086311,149308,28578
182089408,0.0,0.0,13720000,13720000,0,0,13720000,Null,Null,182089408,111461,11933
182100325,8.0,8.0,118000,118000,0,0,118000,Null,Null,182100325,111461,1630
182114550,0.0,0.0,4000,4000,0,0,4000,Null,Null,182114550,111461,2
182114585,0.0,0.0,8500,8500,0,0,8500,Null,Null,182114585,111461,20174
182114628,0.0,0.0,1500,1500,0,0,1500,Null,Null,182114628,111461,2
182114666,0.0,0.0,8000,8000,0,0,8000,Null,Null,182114666,111461,2
182114672,0.0,0.0,6000,6000,0,0,6000,Null,Null,182114672,111461,2
182114711,1.0,1.0,5000,5000,0,0,5000,Null,Null,182114711,111461,2
182114742,2.0,2.0,7000,7000,0,0,7000,Null,Null,182114742,111461,2
182114766,0.0,0.0,5000,5000,0,0,5000,Null,Null,182114766,111461,2
182114814,10.0,10.0,7000,7000,0,0,7000,Null,Null,182114814,111461,2
182114816,16.0,16.0,6000,6000,0,0,6000,Null,Null,182114816,111461,2
182114835,28.0,28.0,9000,9000,0,0,9000,Null,Null,182114835,111461,2
182114837,0.0,0.0,4000,4000,0,0,4000,Null,Null,182114837,111461,2
182114898,7.0,7.0,6000,6000,0,0,6000,Null,Null,182114898,111461,2
182114966,2.0,2.0,6500,6500,0,0,6500,Null,Null,182114966,111461,2
182114982,8.0,8.0,5000,5000,0,0,5000,Null,Null,182114982,111461,2
182115003,1.0,1.0,8000,8000,0,0,8000,Null,Null,182115003,111461,2
182115072,4.0,4.0,6000,6000,0,0,6000,Null,Null,182115072,111461,2
182115094,0.0,0.0,7000,7000,0,0,7000,Null,Null,182115094,111461,2
182115150,31.0,31.0,7000,7000,0,0,7000,Null,Null,182115150,111461,2
182115200,2.0,2.0,8000,8000,0,0,8000,Null,Null,182115200,111461,2
182115961,2.0,2.0,7000,7000,0,0,7000,Null,Null,182115961,111461,2
182122986,0.0,0.0,5985000,5985000,0,0,5985000,Null,Null,182122986,157347,2340
182143146,2.0,2.0,15000,9800,5200,35,15000,Null,Null,182143146,111461,8205
182153835,0.0,0.0,2500,2500,0,0,2500,Null,Null,182153835,111461,2
182154137,0.0,0.0,2030,2030,0,0,2030,Null,Null,182154137,111461,2
182155987,0.0,0.0,1900,1900,0,0,1900,Null,Null,182155987,111461,2
182303950,0.0,0.0,3980000,3550000,430000,11,3980000,Null,Null,182303950,33203,11925
182314499,20.0,20.0,1980,1980,0,0,1980,Null,Null,182314499,111461,2
182458025,0.0,0.0,6150000,6150000,0,0,6150000,Null,Null,182458025,732431,8511
182458036,0.0,0.0,6630000,6630000,0,0,6630000,Null,Null,182458036,464767,53350
182460104,23.0,23.0,499000,309000,190000,38,499000,Null,Null,182460104,314675,28454
182462918,0.0,0.0,7860000,7860000,0,0,7860000,Null,Null,182462918,732431,8511
182464742,348.0,348.0,174000,149000,25000,14,174000,Null,Null,182464742,21266,8308
182478348,0.0,0.0,9850000,9850000,0,0,9850000,Null,Null,182478348,732431,8511
182479062,0.0,0.0,9850000,9850000,0,0,9850000,Null,Null,182479062,610057,8511
182479213,0.0,0.0,9850000,9850000,0,0,9850000,Null,Null,182479213,732431,8511
182482770,1.0,1.0,7254000,6528600,725400,10,7254000,Null,Null,182482770,26150,8513
182485782,1.0,1.0,5990000,4790000,1200000,20,5990000,Null,Null,182485782,208841,2340
182487120,129.0,129.0,30000,25000,5000,17,30000,Null,Null,182487120,63747,23024
182547982,0.0,0.0,12000000,12000000,0,0,12000000,Null,Null,182547982,7304169,8305
182551087,104.0,104.0,380000,269000,111000,29,380000,Null,Null,182551087,314675,2324
182553479,130.0,130.0,199000,89000,110000,55,199000,Null,Null,182553479,314675,1813
182557839,35.0,35.0,335000,335000,0,0,335000,Null,Null,182557839,111461,23246
182558874,1.0,1.0,15500000,15500000,0,0,15500000,Null,Null,182558874,228187,11943
182602992,791.0,791.0,29000,19000,10000,34,29000,Null,Null,182602992,111461,2685
182603396,1.0,1.0,41200,19000,22200,54,41200,Null,Null,182603396,111461,15318
182709717,576.0,576.0,225000,225000,0,0,225000,Null,Null,182709717,111461,53186
182729311,62.0,62.0,1618000,1618000,0,0,1618000,Null,Null,182729311,471591,23394
182729880,0.0,0.0,2000,2000,0,0,2000,Null,Null,182729880,111461,23432
182730464,10.0,10.0,2000,2000,0,0,2000,Null,Null,182730464,111461,2337
182730647,0.0,0.0,1500,1500,0,0,1500,Null,Null,182730647,111461,2363
182732464,0.0,0.0,4500000,4500000,0,0,4500000,Null,Null,182732464,7289267,2340
182739517,143.0,143.0,150000,150000,0,0,150000,Null,Null,182739517,4202899,28482
182739935,1.0,1.0,11900000,11900000,0,0,11900000,Null,Null,182739935,7289267,2340
182740952,0.0,0.0,8600000,7726000,874000,10,8600000,Null,Null,182740952,412709,11845
182742792,1.0,1.0,10750000,8815000,1935000,18,10750000,Null,Null,182742792,412709,11845
182743074,2.0,2.0,6750000,5600000,1150000,17,6750000,Null,Null,182743074,412709,11847
182743078,0.0,0.0,8950000,7339000,1611000,18,8950000,Null,Null,182743078,412709,11845
182743079,0.0,0.0,4490000,3726700,763300,17,4490000,Null,Null,182743079,412709,11845
182743082,0.0,0.0,7160000,6014400,1145600,16,7160000,Null,Null,182743082,412709,11845
182743090,0.0,0.0,5400000,4428000,972000,18,5400000,Null,Null,182743090,412709,11847
182751489,0.0,0.0,4200,4200,0,0,4200,Null,Null,182751489,111461,2
182752340,14.0,14.0,8400,8400,0,0,8400,Null,Null,182752340,111461,2
182753305,0.0,0.0,7200,7200,0,0,7200,Null,Null,182753305,111461,2
182756521,0.0,0.0,65000000,65000000,0,0,65000000,Null,Null,182756521,111461,23112
182756667,0.0,0.0,40000000,40000000,0,0,40000000,Null,Null,182756667,111461,23104
182782186,62.0,62.0,449000,449000,0,0,449000,Null,Null,182782186,471591,1883
182785240,4.0,4.0,15000,15000,0,0,15000,Null,Null,182785240,111461,2
182785554,0.0,0.0,16000,16000,0,0,16000,Null,Null,182785554,111461,2
182785606,8.0,8.0,19000,19000,0,0,19000,Null,Null,182785606,111461,2
182785790,1.0,1.0,145000,145000,0,0,145000,Null,Null,182785790,111461,2
182785817,7.0,7.0,22000,22000,0,0,22000,Null,Null,182785817,111461,2
182785978,2.0,2.0,55000,55000,0,0,55000,Null,Null,182785978,111461,2
182786132,1.0,1.0,19000,19000,0,0,19000,Null,Null,182786132,111461,2
182786661,314.0,314.0,115000,61000,54000,47,115000,Null,Null,182786661,4401579,53186
182787194,272.0,272.0,133000,133000,0,0,133000,Null,Null,182787194,4202899,2140
182797654,9.0,9.0,3490000,2370000,1120000,32,3490000,Null,Null,182797654,18641,8400
182800028,0.0,0.0,390000,390000,0,0,390000,Null,Null,182800028,111461,4381
182805374,125.0,125.0,2490000,2110000,380000,15,2490000,Null,Null,182805374,20215,8400
182833187,48.0,48.0,89000,89000,0,0,89000,Null,Null,182833187,4539407,28482
182846664,0.0,0.0,1500,1500,0,0,1500,Null,Null,182846664,111461,2
182850853,2.0,2.0,33998,16999,16999,50,33998,Null,Null,182850853,111461,28576
182969590,0.0,0.0,420000,420000,0,0,420000,Null,Null,182969590,111461,2
182971940,1409.0,1409.0,520000,269000,251000,48,520000,Null,Null,182971940,48077,1936
183034117,7.0,7.0,5500,5500,0,0,5500,Null,Null,183034117,111461,2
183034124,0.0,0.0,3659000,3659000,0,0,3659000,Null,Null,183034124,111461,2
183037690,1.0,1.0,30000,30000,0,0,30000,Null,Null,183037690,21437,49728
183037703,18.0,18.0,100000,100000,0,0,100000,Null,Null,183037703,111461,49722
183038438,116.0,116.0,169000,169000,0,0,169000,Null,Null,183038438,520061,27180
183041535,2.0,2.0,49000,49000,0,0,49000,Null,Null,183041535,111461,2
183050044,0.0,0.0,6909000,6218100,690900,10,6909000,Null,Null,183050044,26150,8513
183057936,79.0,79.0,18285,18285,0,0,18285,Null,Null,183057936,111461,2514
183076377,323.0,323.0,75000,72750,2250,3,75000,Null,Null,183076377,612965,8305
183081591,0.0,0.0,3540000,3540000,0,0,3540000,Null,Null,183081591,111461,2340
183092736,16.0,16.0,239000,239000,0,0,239000,Null,Null,183092736,7288833,1813
183101210,153.0,153.0,2500,2500,0,0,2500,Null,Null,183101210,111461,2392
183111772,196.0,196.0,99000,99000,0,0,99000,Null,Null,183111772,4973949,28428
183119284,248.0,248.0,85000,85000,0,0,85000,Null,Null,183119284,4973949,20244
183244223,1.0,1.0,1800,1800,0,0,1800,Null,Null,183244223,111461,53074
183251555,267.0,267.0,1699000,869000,830000,49,1699000,Null,Null,183251555,5250541,2340
183288799,0.0,0.0,1500,1500,0,0,1500,Null,Null,183288799,111461,2
183288904,0.0,0.0,2500,2500,0,0,2500,Null,Null,183288904,111461,2
183330021,2479.0,2479.0,10990000,6990000,4000000,36,10990000,Null,Null,183330021,17827,1789
183332264,0.0,0.0,8990,8990,0,0,8990,Null,Null,183332264,111461,28434
183332329,0.0,0.0,10900,10900,0,0,10900,Null,Null,183332329,111461,20258
183335921,280.0,280.0,20000,20000,0,0,20000,Null,Null,183335921,111461,2514
183338350,3.0,3.0,555000,555000,0,0,555000,Null,Null,183338350,111461,8513
183338374,9.0,9.0,295000,295000,0,0,295000,Null,Null,183338374,111461,8513
183341178,0.0,0.0,2500,2500,0,0,2500,Null,Null,183341178,111461,2
183343915,22.0,22.0,17100,17100,0,0,17100,Null,Null,183343915,111461,2
183351053,12.0,12.0,5000,5000,0,0,5000,Null,Null,183351053,111461,2
183351124,1.0,1.0,1000,1000,0,0,1000,Null,Null,183351124,111461,2
183351164,0.0,0.0,1000,1000,0,0,1000,Null,Null,183351164,111461,2
183351183,69.0,69.0,1000,1000,0,0,1000,Null,Null,183351183,111461,2
183351550,0.0,0.0,11999,11999,0,0,11999,Null,Null,183351550,111461,2
183351851,0.0,0.0,1999,1999,0,0,1999,Null,Null,183351851,111461,2
183351892,0.0,0.0,1000,1000,0,0,1000,Null,Null,183351892,111461,2
183351957,0.0,0.0,999,999,0,0,999,Null,Null,183351957,111461,2
183352107,0.0,0.0,2000,2000,0,0,2000,Null,Null,183352107,111461,2
183352137,0.0,0.0,1997,1997,0,0,1997,Null,Null,183352137,111461,1883
183352177,0.0,0.0,9000,9000,0,0,9000,Null,Null,183352177,111461,2
183352215,122.0,122.0,1000,1000,0,0,1000,Null,Null,183352215,111461,2
183352228,0.0,0.0,998,998,0,0,998,Null,Null,183352228,111461,1973
183352235,0.0,0.0,1999,1999,0,0,1999,Null,Null,183352235,111461,2
183352680,0.0,0.0,1000,1000,0,0,1000,Null,Null,183352680,111461,2
183352865,0.0,0.0,1000,1000,0,0,1000,Null,Null,183352865,111461,23052
183352888,8.0,8.0,890000,449000,441000,50,890000,Null,Null,183352888,46363,5384
183355874,148.0,148.0,98000,51000,47000,48,98000,Null,Null,183355874,111461,1634
183484134,27.0,27.0,590000,560000,30000,5,590000,Null,Null,183484134,215231,5267
183488628,506.0,506.0,430000,223000,207000,48,430000,Null,Null,183488628,48077,2225
183502178,0.0,0.0,8000,8000,0,0,8000,Null,Null,183502178,111461,8201
183502190,0.0,0.0,35000,35000,0,0,35000,Null,Null,183502190,111461,8201
183502212,0.0,0.0,8000,8000,0,0,8000,Null,Null,183502212,111461,8201
183502973,272.0,272.0,79000,79000,0,0,79000,Null,Null,183502973,21651,5006
183513216,212.0,212.0,1999000,1299000,700000,35,1999000,Null,Null,183513216,18984,1838
183527320,86.0,86.0,189000,181000,8000,4,189000,Null,Null,183527320,111461,28596
183530018,15.0,15.0,165000,165000,0,0,165000,Null,Null,183530018,887567,8223
183530430,67.0,67.0,5000,5000,0,0,5000,Null,Null,183530430,111461,8202
183533576,12.0,12.0,5000,5000,0,0,5000,Null,Null,183533576,111461,8202
183538050,77.0,77.0,5000,5000,0,0,5000,Null,Null,183538050,111461,8202
183539170,169.0,169.0,5000,5000,0,0,5000,Null,Null,183539170,111461,8202
183539934,6.0,6.0,2800,2800,0,0,2800,Null,Null,183539934,111461,8205
183540004,148.0,148.0,30000,30000,0,0,30000,Null,Null,183540004,111461,23588
183540361,8.0,8.0,2000,2000,0,0,2000,Null,Null,183540361,111461,1622
183544236,804.0,804.0,45000,27000,18000,40,45000,Null,Null,183544236,32909,2347
183544836,0.0,0.0,3415000,2350000,1065000,31,3415000,Null,Null,183544836,870947,8227
183547355,31.0,31.0,759000,759000,0,0,759000,Null,Null,183547355,111461,2759
183547987,134.0,134.0,1600000,809000,791000,49,1600000,Null,Null,183547987,4524605,1626
183551516,1.0,1.0,4550000,4499000,51000,1,4550000,Null,Null,183551516,875757,11885
183551640,39.0,39.0,259000,259000,0,0,259000,Null,Null,183551640,111461,2324
183553192,89.0,89.0,300000,290000,10000,3,300000,Null,Null,183553192,33203,2340
183554032,95.0,95.0,269000,269000,0,0,269000,Null,Null,183554032,111461,4381
183554140,11936.0,11936.0,229000,195000,34000,15,229000,Null,Null,183554140,86206,1583
183554528,0.0,0.0,28710000,28710000,0,0,28710000,Null,Null,183554528,324501,2340
183558378,215.0,215.0,199000,119000,80000,40,199000,Null,Null,183558378,7308373,17162
183559491,64.0,64.0,74000,54000,20000,27,74000,Null,Null,183559491,4246951,8602
183559913,31.0,31.0,313497,279000,34497,11,313497,Null,Null,183559913,5319853,26652
183567183,25.0,25.0,2500,2500,0,0,2500,Null,Null,183567183,111461,8205
183567306,32.0,32.0,4000,4000,0,0,4000,Null,Null,183567306,111461,1622
183683285,0.0,0.0,8000,8000,0,0,8000,Null,Null,183683285,111461,28716
183685613,0.0,0.0,8000,8000,0,0,8000,Null,Null,183685613,111461,2
183689410,2.0,2.0,15000,15000,0,0,15000,Null,Null,183689410,111461,15318
183690183,0.0,0.0,6850000,6850000,0,0,6850000,Null,Null,183690183,405211,8511
183690537,0.0,0.0,6850000,6850000,0,0,6850000,Null,Null,183690537,405211,8511
183690559,8.0,8.0,9500,9500,0,0,9500,Null,Null,183690559,111461,1622
183690918,0.0,0.0,6850000,6850000,0,0,6850000,Null,Null,183690918,405211,8511
183692046,0.0,0.0,6850000,6850000,0,0,6850000,Null,Null,183692046,405211,8511
183692751,0.0,0.0,6850000,6850000,0,0,6850000,Null,Null,183692751,405211,8511
183699811,0.0,0.0,6850000,6850000,0,0,6850000,Null,Null,183699811,405211,8511
183701089,0.0,0.0,1322000,991500,330500,25,1322000,Null,Null,183701089,26150,8516
183719013,32.0,32.0,569000,399000,170000,30,569000,Null,Null,183719013,886169,2334
183725262,0.0,0.0,5185000,5185000,0,0,5185000,Null,Null,183725262,520283,1601
183726025,0.0,0.0,4000000,4000000,0,0,4000000,Null,Null,183726025,5400307,3426
183727708,1.0,1.0,5400000,5400000,0,0,5400000,Null,Null,183727708,5400307,8227
183731773,137.0,137.0,895000,486000,409000,46,895000,Null,Null,183731773,259989,1601
183737004,150.0,150.0,4450000,3799000,651000,15,4450000,Null,Null,183737004,218061,8165
183896276,3.0,3.0,180000,180000,0,0,180000,Null,Null,183896276,149256,28580
183901526,0.0,0.0,18000,18000,0,0,18000,Null,Null,183901526,111461,15250
183901816,1.0,1.0,19000,19000,0,0,19000,Null,Null,183901816,111461,15250
183902131,0.0,0.0,19000,19000,0,0,19000,Null,Null,183902131,111461,15250
183902151,0.0,0.0,15000,15000,0,0,15000,Null,Null,183902151,111461,15250
183906996,0.0,0.0,30950000,30950000,0,0,30950000,Null,Null,183906996,112914,7449
183907039,0.0,0.0,21080000,21080000,0,0,21080000,Null,Null,183907039,223635,5384
183907622,719.0,719.0,85000,45000,40000,47,85000,Null,Null,183907622,4820811,23036
183907727,29.0,29.0,78000,39000,39000,50,78000,Null,Null,183907727,111461,18888
183909586,672.0,672.0,4000,1000,3000,75,4000,Null,Null,183909586,111461,20222
183910539,185.0,185.0,35000,35000,0,0,35000,Null,Null,183910539,453229,5900
183915534,106.0,106.0,120000,70000,50000,42,120000,Null,Null,183915534,111461,2
183917471,69.0,69.0,59000,59000,0,0,59000,Null,Null,183917471,111461,28578
183920963,85.0,85.0,3390000,3390000,0,0,3390000,Null,Null,183920963,144779,8400
183920971,1.0,1.0,12990000,12990000,0,0,12990000,Null,Null,183920971,144779,2324
184036446,13722.0,13722.0,12990000,10590000,2400000,18,12990000,Null,Null,184036446,17827,1795
184042484,273.0,273.0,400000,204000,196000,49,400000,Null,Null,184042484,4655707,53350
184056231,35.0,35.0,5000,5000,0,0,5000,Null,Null,184056231,111461,8202
184059211,5305.0,5305.0,24990000,16490000,8500000,34,24990000,Null,Null,184059211,17827,1795
184064357,0.0,0.0,11990000,11390000,600000,5,11990000,Null,Null,184064357,18641,8067
184064383,1.0,1.0,99000,99000,0,0,99000,Null,Null,184064383,111461,2
184068099,0.0,0.0,16000,16000,0,0,16000,Null,Null,184068099,111461,15250
184070540,0.0,0.0,17000,17000,0,0,17000,Null,Null,184070540,111461,15250
184070601,3.0,3.0,5400,5400,0,0,5400,Null,Null,184070601,111461,49724
184070604,51.0,51.0,12000,12000,0,0,12000,Null,Null,184070604,111461,49724
184070734,10.0,10.0,25000,25000,0,0,25000,Null,Null,184070734,111461,49724
184070757,3.0,3.0,45000,45000,0,0,45000,Null,Null,184070757,111461,49724
184070791,1.0,1.0,10000,10000,0,0,10000,Null,Null,184070791,111461,49724
184070797,0.0,0.0,10000,10000,0,0,10000,Null,Null,184070797,111461,49724
184070808,2.0,2.0,9600,9600,0,0,9600,Null,Null,184070808,111461,49724
184070861,1.0,1.0,8000,8000,0,0,8000,Null,Null,184070861,111461,49724
184070947,0.0,0.0,56000,56000,0,0,56000,Null,Null,184070947,111461,49724
184071015,4.0,4.0,2500000,2500000,0,0,2500000,Null,Null,184071015,111461,49724
184071056,1.0,1.0,6500000,6500000,0,0,6500000,Null,Null,184071056,111461,49724
184071078,3.0,3.0,60000,60000,0,0,60000,Null,Null,184071078,111461,49724
184071079,3.0,3.0,80000,80000,0,0,80000,Null,Null,184071079,111461,49724
184071098,36.0,36.0,10000,10000,0,0,10000,Null,Null,184071098,111461,49724
184071114,0.0,0.0,15000,15000,0,0,15000,Null,Null,184071114,111461,49724
184071143,5.0,5.0,45000,45000,0,0,45000,Null,Null,184071143,111461,49724
184071148,0.0,0.0,10000,10000,0,0,10000,Null,Null,184071148,111461,49724
184073473,6.0,6.0,28000,28000,0,0,28000,Null,Null,184073473,111461,15320
184076146,0.0,0.0,589999,589999,0,0,589999,Null,Null,184076146,111454,2324
184080709,1.0,1.0,17000,17000,0,0,17000,Null,Null,184080709,111461,15320
184082079,0.0,0.0,6750000,6750000,0,0,6750000,Null,Null,184082079,405211,8511
184082554,0.0,0.0,6750000,6750000,0,0,6750000,Null,Null,184082554,405211,8511
184084675,0.0,0.0,6750000,6750000,0,0,6750000,Null,Null,184084675,405211,8511
184085296,0.0,0.0,6750000,6750000,0,0,6750000,Null,Null,184085296,405211,8511
184091959,22.0,22.0,178900,178900,0,0,178900,Null,Null,184091959,111461,2
184098200,179.0,179.0,27000,15000,12000,44,27000,Null,Null,184098200,111461,53186
184100933,0.0,0.0,6750000,6750000,0,0,6750000,Null,Null,184100933,405211,8511
184121459,0.0,0.0,59500000,59500000,0,0,59500000,Null,Null,184121459,167287,7079
184123491,140.0,140.0,70000,70000,0,0,70000,Null,Null,184123491,111461,2685
184126392,0.0,0.0,90000,90000,0,0,90000,Null,Null,184126392,111461,1936
184133122,0.0,0.0,360000,360000,0,0,360000,Null,Null,184133122,111461,15318
184133938,0.0,0.0,2000,2000,0,0,2000,Null,Null,184133938,111461,1883
184218797,0.0,0.0,62500000,33250000,29250000,47,62500000,Null,Null,184218797,324501,2340
184219451,0.0,0.0,1840,1840,0,0,1840,Null,Null,184219451,111461,2
184240180,1.0,1.0,12200000,12200000,0,0,12200000,Null,Null,184240180,5710451,1803
184242467,0.0,0.0,15000,15000,0,0,15000,Null,Null,184242467,885693,15320
184242566,35.0,35.0,107000,78000,29000,27,107000,Null,Null,184242566,4738431,1831
184245954,108.0,108.0,95000,88900,6100,6,95000,Null,Null,184245954,111461,27240
184247506,247.0,247.0,95000,89000,6000,6,95000,Null,Null,184247506,111461,2514
184248127,308.0,308.0,14990000,11490000,3500000,23,14990000,Null,Null,184248127,17827,1794
184253251,556.0,556.0,18990000,13490000,5500000,29,18990000,Null,Null,184253251,17827,1794
184282609,0.0,0.0,47000,47000,0,0,47000,Null,Null,184282609,111461,23042
184282768,178.0,178.0,174000,174000,0,0,174000,Null,Null,184282768,5272071,23032
184294765,0.0,0.0,44500000,44500000,0,0,44500000,Null,Null,184294765,5095895,2324
184296596,0.0,0.0,9426000,8483400,942600,10,9426000,Null,Null,184296596,26150,8513
184298357,0.0,0.0,6500,6500,0,0,6500,Null,Null,184298357,111461,2
184304614,0.0,0.0,355000,355000,0,0,355000,Null,Null,184304614,20271,5267
184310443,0.0,0.0,70000,70000,0,0,70000,Null,Null,184310443,362481,28486
184342423,3.0,3.0,17000,17000,0,0,17000,Null,Null,184342423,111461,2
184410025,9.0,9.0,39000,39000,0,0,39000,Null,Null,184410025,111461,49722
184410513,101.0,101.0,1349000,1290000,59000,4,1349000,Null,Null,184410513,18984,1838
184415252,912.0,912.0,80000,69000,11000,14,80000,Null,Null,184415252,5534927,1630
184416996,1231.0,1231.0,280000,266000,14000,5,280000,Null,Null,184416996,202607,13878
184417199,34.0,34.0,1500000,1500000,0,0,1500000,Null,Null,184417199,423053,8512
184422367,4.0,4.0,19000,19000,0,0,19000,Null,Null,184422367,111461,15236
184424516,1.0,1.0,135900,135900,0,0,135900,Null,Null,184424516,885693,15236
184424813,28.0,28.0,155000,151900,3100,2,155000,Null,Null,184424813,195495,3804
184438368,3.0,3.0,15000,15000,0,0,15000,Null,Null,184438368,111461,15320
184438501,50.0,50.0,20000,19000,1000,5,20000,Null,Null,184438501,4269901,23036
184449631,7.0,7.0,6000,6000,0,0,6000,Null,Null,184449631,4403473,8309
184475889,4.0,4.0,149000,149000,0,0,149000,Null,Null,184475889,47882,8513
184475904,4.0,4.0,169000,169000,0,0,169000,Null,Null,184475904,47882,8513
184475913,26.0,26.0,169000,169000,0,0,169000,Null,Null,184475913,47882,8513
184475923,10.0,10.0,139000,139000,0,0,139000,Null,Null,184475923,47882,8513
184476147,11947.0,11947.0,238000,202000,36000,15,238000,Null,Null,184476147,86206,1583
184476152,0.0,0.0,3850000,3850000,0,0,3850000,Null,Null,184476152,111461,11943
184476362,10063.0,10063.0,238000,202000,36000,15,238000,Null,Null,184476362,86206,1583
184492473,24.0,24.0,180000,120000,60000,33,180000,Null,Null,184492473,568747,4428
184499928,6.0,6.0,9999,9999,0,0,9999,Null,Null,184499928,111461,49726
184518592,188.0,188.0,290000,159000,131000,45,290000,Null,Null,184518592,4401579,23362
184519325,69.0,69.0,139000,139000,0,0,139000,Null,Null,184519325,111461,5995
184519521,122.0,122.0,450000,249000,201000,45,450000,Null,Null,184519521,4401579,23362
184521772,675.0,675.0,19000,19000,0,0,19000,Null,Null,184521772,111461,18876
184573164,0.0,0.0,129000,117977,11023,9,129000,Null,Null,184573164,149308,28576
184588367,0.0,0.0,2000,2000,0,0,2000,Null,Null,184588367,111461,8167
184594767,7.0,7.0,66000,66000,0,0,66000,Null,Null,184594767,111461,23184
184597199,69.0,69.0,950000,759000,191000,20,950000,Null,Null,184597199,3985581,2340
184600381,0.0,0.0,58470000,58470000,0,0,58470000,Null,Null,184600381,218967,8073
184603392,11.0,11.0,49000,49000,0,0,49000,Null,Null,184603392,111461,5384
184614885,0.0,0.0,59800000,31900000,27900000,47,59800000,Null,Null,184614885,324501,2340
184619547,47.0,47.0,3800000,3499000,301000,8,3800000,Null,Null,184619547,18804,1626
184629719,5.0,5.0,78499,78499,0,0,78499,Null,Null,184629719,21651,4593
184634334,0.0,0.0,19900000,17325000,2575000,13,19900000,Null,Null,184634334,85862,2340
184634787,0.0,0.0,77600000,58200000,19400000,25,77600000,Null,Null,184634787,85862,2340
184670158,12.0,12.0,118757,118757,0,0,118757,Null,Null,184670158,149308,28576
184683091,0.0,0.0,12000,12000,0,0,12000,Null,Null,184683091,111461,2
184683178,0.0,0.0,13000,13000,0,0,13000,Null,Null,184683178,111461,2
184683194,0.0,0.0,5000,5000,0,0,5000,Null,Null,184683194,111461,2
184683324,0.0,0.0,15000,15000,0,0,15000,Null,Null,184683324,111461,2
184683339,0.0,0.0,10000,10000,0,0,10000,Null,Null,184683339,111461,2
184683350,0.0,0.0,19000,19000,0,0,19000,Null,Null,184683350,111461,2
184683352,0.0,0.0,11000,11000,0,0,11000,Null,Null,184683352,111461,2
184689674,254.0,254.0,1500,1500,0,0,1500,Null,Null,184689674,864561,2685
184696247,26.0,26.0,4290000,3090000,1200000,28,4290000,Null,Null,184696247,247549,1795
184698299,607.0,607.0,9900,9900,0,0,9900,Null,Null,184698299,111461,23416
184698393,43.0,43.0,74000,74000,0,0,74000,Null,Null,184698393,50034,5995
184762661,1.0,1.0,12000,12000,0,0,12000,Null,Null,184762661,111461,2
184767648,2778.0,2778.0,55000,27500,27500,50,55000,Null,Null,184767648,143130,8602
184768998,66.0,66.0,49000,48020,980,2,49000,Null,Null,184768998,145914,28716
184770907,0.0,0.0,9000,9000,0,0,9000,Null,Null,184770907,111461,28736
184770998,0.0,0.0,9000,9000,0,0,9000,Null,Null,184770998,111461,5566
184771084,4.0,4.0,9000,9000,0,0,9000,Null,Null,184771084,111461,5566
184771162,0.0,0.0,8000,8000,0,0,8000,Null,Null,184771162,111461,26658
184771183,0.0,0.0,8000,8000,0,0,8000,Null,Null,184771183,111461,20174
184771294,0.0,0.0,9000,9000,0,0,9000,Null,Null,184771294,111461,20174
184771349,13.0,13.0,7500,7500,0,0,7500,Null,Null,184771349,111461,8073
184771369,0.0,0.0,9000,9000,0,0,9000,Null,Null,184771369,111461,28718
184771397,0.0,0.0,9000,9000,0,0,9000,Null,Null,184771397,111461,28718
184771436,0.0,0.0,9000,9000,0,0,9000,Null,Null,184771436,111461,28480
184771555,0.0,0.0,9000,9000,0,0,9000,Null,Null,184771555,111461,5566
184771585,0.0,0.0,9000,9000,0,0,9000,Null,Null,184771585,111461,20174
184771628,2.0,2.0,9000,9000,0,0,9000,Null,Null,184771628,111461,5566
184771666,1.0,1.0,9000,9000,0,0,9000,Null,Null,184771666,111461,20174
184772104,2.0,2.0,9000,9000,0,0,9000,Null,Null,184772104,111461,5566
184781244,38.0,38.0,350000,350000,0,0,350000,Null,Null,184781244,7245323,1815
184783198,62.0,62.0,159000,95000,64000,40,159000,Null,Null,184783198,111461,28460
184784643,10.0,10.0,39000,39000,0,0,39000,Null,Null,184784643,111461,28578
184785594,0.0,0.0,15000,15000,0,0,15000,Null,Null,184785594,111461,27544
184785781,5.0,5.0,119200,119200,0,0,119200,Null,Null,184785781,208867,2266
184785998,0.0,0.0,6000000,6000000,0,0,6000000,Null,Null,184785998,111461,15318
184786033,0.0,0.0,7900000,7900000,0,0,7900000,Null,Null,184786033,111461,15318
184793101,169.0,169.0,1750000,895000,855000,49,1750000,Null,Null,184793101,631569,2340
184793501,3.0,3.0,48628,48628,0,0,48628,Null,Null,184793501,111461,15320
184794255,0.0,0.0,2500,2500,0,0,2500,Null,Null,184794255,111461,2
184794389,131.0,131.0,119000,119000,0,0,119000,Null,Null,184794389,111461,2
184799863,0.0,0.0,18140000,18140000,0,0,18140000,Null,Null,184799863,180151,8064
184807905,91.0,91.0,449000,449000,0,0,449000,Null,Null,184807905,3985581,2020
184814915,0.0,0.0,34000,17000,17000,50,34000,Null,Null,184814915,4647777,15318
184817789,72.0,72.0,65000,47000,18000,28,65000,Null,Null,184817789,111461,53048
184829996,76.0,76.0,72000,72000,0,0,72000,Null,Null,184829996,5043271,2153
184830502,20.0,20.0,2000,2000,0,0,2000,Null,Null,184830502,111461,2266
184833507,1.0,1.0,95000,65000,30000,32,95000,Null,Null,184833507,111461,27546
184893980,40.0,40.0,2400,2400,0,0,2400,Null,Null,184893980,111461,11858
184894911,10.0,10.0,2400,2400,0,0,2400,Null,Null,184894911,111461,11858
184898024,1.0,1.0,9000,4000,5000,56,9000,Null,Null,184898024,111461,8193
184904932,10.0,10.0,990000,549000,441000,45,990000,Null,Null,184904932,46363,5384
184907824,0.0,0.0,15000,15000,0,0,15000,Null,Null,184907824,111461,49726
184915910,172.0,172.0,150000,105000,45000,30,150000,Null,Null,184915910,4820811,23834
184918702,3.0,3.0,240000,240000,0,0,240000,Null,Null,184918702,111461,49724
184928433,1.0,1.0,1598000,950000,648000,41,1598000,Null,Null,184928433,111461,5385
184970361,3.0,3.0,22800,22800,0,0,22800,Null,Null,184970361,111461,2
184970373,1.0,1.0,13300,13300,0,0,13300,Null,Null,184970373,111461,2
184970389,6.0,6.0,18050,18050,0,0,18050,Null,Null,184970389,111461,2
184970428,0.0,0.0,16150,16150,0,0,16150,Null,Null,184970428,111461,2
184982194,1.0,1.0,59000,59000,0,0,59000,Null,Null,184982194,111461,2
185000209,0.0,0.0,19000,19000,0,0,19000,Null,Null,185000209,111461,2
185004559,315.0,315.0,47000,47000,0,0,47000,Null,Null,185004559,5706641,3177
185023595,11.0,11.0,6669,6669,0,0,6669,Null,Null,185023595,111461,28434
185024795,1.0,1.0,131000,131000,0,0,131000,Null,Null,185024795,47882,5384
185046273,0.0,0.0,7150000,3900000,3250000,45,7150000,Null,Null,185046273,416127,8227
185077932,197.0,197.0,180000,162000,18000,10,180000,Null,Null,185077932,283595,11829
185077941,70.0,70.0,390000,347100,42900,11,390000,Null,Null,185077941,283595,11829
185096114,185.0,185.0,499000,348000,151000,30,499000,Null,Null,185096114,5385323,17170
185096403,50.0,50.0,2500,2000,500,20,2500,Null,Null,185096403,273763,23416
185124161,307.0,307.0,8000,3000,5000,63,8000,Null,Null,185124161,111461,53048
185206447,106.0,106.0,28000,15000,13000,46,28000,Null,Null,185206447,111461,23258
185227592,38.0,38.0,19000,19000,0,0,19000,Null,Null,185227592,111461,53074
185274604,9.0,9.0,28999,28999,0,0,28999,Null,Null,185274604,111461,2363
185334349,119.0,119.0,1088000,525000,563000,52,1088000,Null,Null,185334349,464405,23346
185334997,70.0,70.0,350000,299000,51000,15,350000,Null,Null,185334997,312329,20182
185338789,27.0,27.0,210000,179000,31000,15,210000,Null,Null,185338789,7304183,23048
185351183,252.0,252.0,89000,89000,0,0,89000,Null,Null,185351183,7357661,8217
185380271,292.0,292.0,203000,172550,30450,15,203000,Null,Null,185380271,5382095,23702
185380385,121.0,121.0,180000,90000,90000,50,180000,Null,Null,185380385,7337473,17162
185409375,55.0,55.0,99000,99000,0,0,99000,Null,Null,185409375,4973949,20244
185409722,9.0,9.0,219000,219000,0,0,219000,Null,Null,185409722,7288833,1813
185409732,218.0,218.0,199000,199000,0,0,199000,Null,Null,185409732,18604,5531
185438523,206.0,206.0,450000,304000,146000,32,450000,Null,Null,185438523,868633,23622
185445301,2.0,2.0,29600,14800,14800,50,29600,Null,Null,185445301,111461,15318
185487255,0.0,0.0,5000000,5000000,0,0,5000000,Null,Null,185487255,186463,1634
185490042,0.0,0.0,4000000,4000000,0,0,4000000,Null,Null,185490042,186463,1634
185497120,0.0,0.0,4000000,4000000,0,0,4000000,Null,Null,185497120,186463,1634
185498441,0.0,0.0,6800000,6800000,0,0,6800000,Null,Null,185498441,186463,1634
185498699,0.0,0.0,3350000,3350000,0,0,3350000,Null,Null,185498699,186463,1634
185500902,0.0,0.0,3600000,3600000,0,0,3600000,Null,Null,185500902,186463,1634
185502285,0.0,0.0,3350000,3350000,0,0,3350000,Null,Null,185502285,186463,1634
185514069,0.0,0.0,3350000,3350000,0,0,3350000,Null,Null,185514069,186463,1634
185521438,0.0,0.0,3500000,3500000,0,0,3500000,Null,Null,185521438,186463,1634
185528130,0.0,0.0,4500000,4500000,0,0,4500000,Null,Null,185528130,186463,1634
185545963,1.0,1.0,20900000,20900000,0,0,20900000,Null,Null,185545963,52315,2
185548481,0.0,0.0,4500000,4500000,0,0,4500000,Null,Null,185548481,186463,1634
185553370,0.0,0.0,3600000,3600000,0,0,3600000,Null,Null,185553370,186463,1634
185557285,4.0,4.0,6900000,6555000,345000,5,6900000,Null,Null,185557285,111461,2340
185558151,0.0,0.0,3550000,3550000,0,0,3550000,Null,Null,185558151,186463,1634
185560721,0.0,0.0,3690000,3690000,0,0,3690000,Null,Null,185560721,186463,1634
185563178,0.0,0.0,3650000,3650000,0,0,3650000,Null,Null,185563178,186463,1634
185566291,0.0,0.0,3950000,3950000,0,0,3950000,Null,Null,185566291,186463,1634
185568100,0.0,0.0,3950000,3950000,0,0,3950000,Null,Null,185568100,186463,1634
185592480,0.0,0.0,2590000,1750000,840000,32,2590000,Null,Null,185592480,111461,2657
185612916,0.0,0.0,19995000,19995000,0,0,19995000,Null,Null,185612916,426805,2340
185627170,9.0,9.0,1558000,1240000,318000,20,1558000,Null,Null,185627170,146479,8400
185651509,0.0,0.0,10000,10000,0,0,10000,Null,Null,185651509,288079,11873
185653590,426.0,426.0,235000,235000,0,0,235000,Null,Null,185653590,697923,23352
185654658,69.0,69.0,55000,55000,0,0,55000,Null,Null,185654658,821321,6948
185656901,98.0,98.0,65000,56000,9000,14,65000,Null,Null,185656901,592131,27180
185657560,17.0,17.0,24000,24000,0,0,24000,Null,Null,185657560,111461,15236
185679316,1.0,1.0,220000,220000,0,0,220000,Null,Null,185679316,111461,15250
185684882,0.0,0.0,1890000,1750000,140000,7,1890000,Null,Null,185684882,111461,2657
185711074,22.0,22.0,2500,2500,0,0,2500,Null,Null,185711074,111461,2
185717624,0.0,0.0,18900000,15900000,3000000,16,18900000,Null,Null,185717624,20215,8067
185743628,269.0,269.0,220000,132000,88000,40,220000,Null,Null,185743628,5334123,2016
185755283,1.0,1.0,9860000,9860000,0,0,9860000,Null,Null,185755283,183637,28856
185756654,1199.0,1199.0,65000,49000,16000,25,65000,Null,Null,185756654,7368293,23022
185756969,804.0,804.0,75000,39000,36000,48,75000,Null,Null,185756969,7368293,2238
185782595,258.0,258.0,20000,10500,9500,48,20000,Null,Null,185782595,111461,2685
185840847,0.0,0.0,47800000,47800000,0,0,47800000,Null,Null,185840847,167287,11518
185842330,0.0,0.0,2000,2000,0,0,2000,Null,Null,185842330,111461,2363
185842825,0.0,0.0,2000,2000,0,0,2000,Null,Null,185842825,111461,8197
185848119,3.0,3.0,55000,42000,13000,24,55000,Null,Null,185848119,111461,28576
185869969,1.0,1.0,10000,10000,0,0,10000,Null,Null,185869969,111461,2
185876610,1.0,1.0,7000,7000,0,0,7000,Null,Null,185876610,111461,28484
185887807,2.0,2.0,18990000,18990000,0,0,18990000,Null,Null,185887807,7355445,1795
185889460,0.0,0.0,3570000,3570000,0,0,3570000,Null,Null,185889460,536905,1616
185889699,0.0,0.0,3660000,3660000,0,0,3660000,Null,Null,185889699,536905,8216
185889772,1.0,1.0,1850000,1850000,0,0,1850000,Null,Null,185889772,111461,4380
185895171,371.0,371.0,469000,469000,0,0,469000,Null,Null,185895171,41048,2136
185895479,0.0,0.0,69000000,34500000,34500000,50,69000000,Null,Null,185895479,85862,2340
185910067,22.0,22.0,51000,51000,0,0,51000,Null,Null,185910067,111461,2
185910176,1459.0,1459.0,85000,85000,0,0,85000,Null,Null,185910176,5063093,2514
185916705,0.0,0.0,26500000,26500000,0,0,26500000,Null,Null,185916705,167287,7079
185918556,0.0,0.0,16000,16000,0,0,16000,Null,Null,185918556,111461,2
185921271,1.0,1.0,390000,270000,120000,31,390000,Null,Null,185921271,183257,15236
185946121,63.0,63.0,790000,790000,0,0,790000,Null,Null,185946121,215231,5267
185946335,0.0,0.0,10290000,7350000,2940000,29,10290000,Null,Null,185946335,405211,8511
185965881,0.0,0.0,10290000,7350000,2940000,29,10290000,Null,Null,185965881,405211,8511
185965963,0.0,0.0,10290000,7350000,2940000,29,10290000,Null,Null,185965963,405211,8511
185966153,0.0,0.0,10290000,7350000,2940000,29,10290000,Null,Null,185966153,405211,8511
185966421,0.0,0.0,10710000,7650000,3060000,29,10710000,Null,Null,185966421,405211,8511
185967572,1.0,1.0,150000,150000,0,0,150000,Null,Null,185967572,149308,28576
185969019,1.0,1.0,1479000,1479000,0,0,1479000,Null,Null,185969019,18802,2324
185992099,70.0,70.0,650000,650000,0,0,650000,Null,Null,185992099,189445,28596
185992274,26.0,26.0,290000,276000,14000,5,290000,Null,Null,185992274,189445,20244
186060445,0.0,0.0,18000,18000,0,0,18000,Null,Null,186060445,111461,2
186060480,0.0,0.0,18000,18000,0,0,18000,Null,Null,186060480,111461,2
186060534,0.0,0.0,15000,15000,0,0,15000,Null,Null,186060534,111461,2
186060631,0.0,0.0,10800,10800,0,0,10800,Null,Null,186060631,111461,2
186060664,0.0,0.0,14000,14000,0,0,14000,Null,Null,186060664,111461,2
186060733,0.0,0.0,18900,18900,0,0,18900,Null,Null,186060733,111461,2
186060743,0.0,0.0,13500,13500,0,0,13500,Null,Null,186060743,111461,2
186060790,0.0,0.0,13500,13500,0,0,13500,Null,Null,186060790,111461,2
186060813,0.0,0.0,13500,13500,0,0,13500,Null,Null,186060813,111461,2
186060816,1.0,1.0,9000,9000,0,0,9000,Null,Null,186060816,111461,2
186060822,1.0,1.0,18000,18000,0,0,18000,Null,Null,186060822,111461,2
186060894,0.0,0.0,18000,18000,0,0,18000,Null,Null,186060894,111461,2
186061117,0.0,0.0,15000,15000,0,0,15000,Null,Null,186061117,111461,2
186061222,0.0,0.0,19000,19000,0,0,19000,Null,Null,186061222,111461,2
186061442,0.0,0.0,22500,22500,0,0,22500,Null,Null,186061442,111461,2
186061497,0.0,0.0,11891,11891,0,0,11891,Null,Null,186061497,111461,2
186061574,1.0,1.0,88000,88000,0,0,88000,Null,Null,186061574,111461,2
186061582,0.0,0.0,11891,11891,0,0,11891,Null,Null,186061582,111461,2
186061670,2.0,2.0,13500,13500,0,0,13500,Null,Null,186061670,111461,2
186061749,0.0,0.0,14000,14000,0,0,14000,Null,Null,186061749,111461,2
186061760,2.0,2.0,13500,13500,0,0,13500,Null,Null,186061760,111461,2
186061806,3.0,3.0,13500,13500,0,0,13500,Null,Null,186061806,111461,2
186061813,1.0,1.0,10000,10000,0,0,10000,Null,Null,186061813,111461,2
186061818,2.0,2.0,14000,14000,0,0,14000,Null,Null,186061818,111461,2
186061920,0.0,0.0,18000,18000,0,0,18000,Null,Null,186061920,111461,2
186062008,4.0,4.0,10000,10000,0,0,10000,Null,Null,186062008,111461,2
186062014,1.0,1.0,18000,18000,0,0,18000,Null,Null,186062014,111461,2
186062261,0.0,0.0,19000,19000,0,0,19000,Null,Null,186062261,111461,2
186062267,0.0,0.0,18000,18000,0,0,18000,Null,Null,186062267,111461,2
186062389,0.0,0.0,14000,14000,0,0,14000,Null,Null,186062389,111461,2
186062390,0.0,0.0,10800,10800,0,0,10800,Null,Null,186062390,111461,2
186062472,0.0,0.0,14000,14000,0,0,14000,Null,Null,186062472,111461,2
186062521,0.0,0.0,19811,19811,0,0,19811,Null,Null,186062521,111461,2
186062538,0.0,0.0,13500,13500,0,0,13500,Null,Null,186062538,111461,2
186062605,0.0,0.0,10800,10800,0,0,10800,Null,Null,186062605,111461,2
186062627,0.0,0.0,9000,9000,0,0,9000,Null,Null,186062627,111461,2
186062629,0.0,0.0,14000,14000,0,0,14000,Null,Null,186062629,111461,2
186062653,0.0,0.0,18000,18000,0,0,18000,Null,Null,186062653,111461,2
186062710,0.0,0.0,14000,14000,0,0,14000,Null,Null,186062710,111461,2
186062751,0.0,0.0,7000,7000,0,0,7000,Null,Null,186062751,111461,2
186062784,0.0,0.0,9000,9000,0,0,9000,Null,Null,186062784,111461,2
186062831,0.0,0.0,13500,13500,0,0,13500,Null,Null,186062831,111461,2
186062833,0.0,0.0,19000,19000,0,0,19000,Null,Null,186062833,111461,2
186062884,0.0,0.0,11891,11891,0,0,11891,Null,Null,186062884,111461,2
186062923,0.0,0.0,9000,9000,0,0,9000,Null,Null,186062923,111461,2
186063073,0.0,0.0,25000,25000,0,0,25000,Null,Null,186063073,111461,2
186063127,0.0,0.0,23771,23771,0,0,23771,Null,Null,186063127,111461,2
186063186,0.0,0.0,14000,14000,0,0,14000,Null,Null,186063186,111461,2
186063222,1.0,1.0,16500,16500,0,0,16500,Null,Null,186063222,111461,2
186063271,0.0,0.0,18000,18000,0,0,18000,Null,Null,186063271,111461,2
186063364,0.0,0.0,15851,15851,0,0,15851,Null,Null,186063364,111461,2
186063400,0.0,0.0,9000,9000,0,0,9000,Null,Null,186063400,111461,2
186063447,0.0,0.0,15851,15851,0,0,15851,Null,Null,186063447,111461,2
186063456,0.0,0.0,13500,13500,0,0,13500,Null,Null,186063456,111461,2
186063527,0.0,0.0,10000,10000,0,0,10000,Null,Null,186063527,111461,2
186063561,0.0,0.0,18000,18000,0,0,18000,Null,Null,186063561,111461,2
186063587,0.0,0.0,18000,18000,0,0,18000,Null,Null,186063587,111461,2
186063606,0.0,0.0,18000,18000,0,0,18000,Null,Null,186063606,111461,2
186063656,0.0,0.0,9000,9000,0,0,9000,Null,Null,186063656,111461,2
186063661,0.0,0.0,3971,3971,0,0,3971,Null,Null,186063661,111461,2
186063680,0.0,0.0,9000,9000,0,0,9000,Null,Null,186063680,111461,2
186063743,0.0,0.0,14000,14000,0,0,14000,Null,Null,186063743,111461,2
186063754,0.0,0.0,9000,9000,0,0,9000,Null,Null,186063754,111461,2
186063762,0.0,0.0,9000,9000,0,0,9000,Null,Null,186063762,111461,2
186063800,2.0,2.0,14000,14000,0,0,14000,Null,Null,186063800,111461,2
186063856,6.0,6.0,13500,13500,0,0,13500,Null,Null,186063856,111461,2
186063865,0.0,0.0,7200,7200,0,0,7200,Null,Null,186063865,111461,2
186063876,0.0,0.0,10800,10800,0,0,10800,Null,Null,186063876,111461,2
186063902,2.0,2.0,27731,27731,0,0,27731,Null,Null,186063902,111461,2
186063939,1.0,1.0,13500,13500,0,0,13500,Null,Null,186063939,111461,2
186064035,0.0,0.0,15851,15851,0,0,15851,Null,Null,186064035,111461,2
186064068,7.0,7.0,45000,45000,0,0,45000,Null,Null,186064068,111461,2
186064134,0.0,0.0,14000,14000,0,0,14000,Null,Null,186064134,111461,2
186064184,0.0,0.0,14000,14000,0,0,14000,Null,Null,186064184,111461,2
186064219,0.0,0.0,18000,18000,0,0,18000,Null,Null,186064219,111461,2
186064240,0.0,0.0,15851,15851,0,0,15851,Null,Null,186064240,111461,2
186069362,2.0,2.0,5280000,3959000,1321000,25,5280000,Null,Null,186069362,26150,8513
186078818,0.0,0.0,69999900,69999900,0,0,69999900,Null,Null,186078818,183153,2
186085673,472.0,472.0,64500,64500,0,0,64500,Null,Null,186085673,111461,23592
186087681,99.0,99.0,79000,54000,25000,32,79000,Null,Null,186087681,111461,8167
186087706,0.0,0.0,17900000,17900000,0,0,17900000,Null,Null,186087706,939519,5566
186090055,5.0,5.0,160000,160000,0,0,160000,Null,Null,186090055,111461,49722
186094219,1272.0,1272.0,14110,14110,0,0,14110,Null,Null,186094219,111461,2685
186103420,8.0,8.0,25000,18000,7000,28,25000,Null,Null,186103420,111461,23258
186104892,9.0,9.0,48601,48601,0,0,48601,Null,Null,186104892,111461,15320
186104908,0.0,0.0,2390000,2390000,0,0,2390000,Null,Null,186104908,18802,8067
186104914,3.0,3.0,49809,49809,0,0,49809,Null,Null,186104914,111461,15320
186105316,13.0,13.0,69000,69000,0,0,69000,Null,Null,186105316,111461,12908
186107374,33.0,33.0,2300000,1500000,800000,35,2300000,Null,Null,186107374,51302,2327
186111230,11.0,11.0,790000,399000,391000,49,790000,Null,Null,186111230,246045,28460
186112265,0.0,0.0,7150000,5362500,1787500,25,7150000,Null,Null,186112265,416127,8227
186118417,0.0,0.0,2200,2200,0,0,2200,Null,Null,186118417,111461,2
186142362,176.0,176.0,230000,230000,0,0,230000,Null,Null,186142362,5706641,5995
186148059,0.0,0.0,3500000,3500000,0,0,3500000,Null,Null,186148059,18802,1795
186149961,1.0,1.0,3990000,2817000,1173000,29,3990000,Null,Null,186149961,18802,1794
186176304,7.0,7.0,18999,18999,0,0,18999,Null,Null,186176304,111461,49726
186187295,13.0,13.0,74999,74999,0,0,74999,Null,Null,186187295,111461,53074
186189057,0.0,0.0,6000,6000,0,0,6000,Null,Null,186189057,111461,2
186189336,0.0,0.0,9000,9000,0,0,9000,Null,Null,186189336,111461,2
186190098,8.0,8.0,12000,12000,0,0,12000,Null,Null,186190098,111461,28484
186193079,53.0,53.0,449000,279000,170000,38,449000,Null,Null,186193079,5055635,2324
186199392,162.0,162.0,679000,329000,350000,52,679000,Null,Null,186199392,5055635,2324
186200874,0.0,0.0,19000,19000,0,0,19000,Null,Null,186200874,111461,2
186200898,0.0,0.0,69000,69000,0,0,69000,Null,Null,186200898,111461,2
186200926,1.0,1.0,5000,5000,0,0,5000,Null,Null,186200926,111461,2
186201017,0.0,0.0,4895,4895,0,0,4895,Null,Null,186201017,111461,2
186201033,45.0,45.0,15000,15000,0,0,15000,Null,Null,186201033,111461,2
186201301,0.0,0.0,10000,10000,0,0,10000,Null,Null,186201301,111461,2
186201378,0.0,0.0,15000,15000,0,0,15000,Null,Null,186201378,111461,2
186201425,0.0,0.0,19000,19000,0,0,19000,Null,Null,186201425,111461,2
186201440,0.0,0.0,19000,19000,0,0,19000,Null,Null,186201440,111461,2
186202011,0.0,0.0,4500000,4500000,0,0,4500000,Null,Null,186202011,7356237,2
186202015,0.0,0.0,4000000,4000000,0,0,4000000,Null,Null,186202015,7356237,2
186202169,9.0,9.0,360000,136000,224000,62,360000,Null,Null,186202169,111461,1883
186202319,0.0,0.0,3000,3000,0,0,3000,Null,Null,186202319,111461,2
186202350,0.0,0.0,5000,5000,0,0,5000,Null,Null,186202350,111461,2
186202399,0.0,0.0,14000,14000,0,0,14000,Null,Null,186202399,111461,2
186202409,0.0,0.0,9000,9000,0,0,9000,Null,Null,186202409,111461,2
186202445,0.0,0.0,21990000,21990000,0,0,21990000,Null,Null,186202445,18802,8067
186202861,1.0,1.0,1900,1900,0,0,1900,Null,Null,186202861,111461,2
186208082,20.0,20.0,169000,169000,0,0,169000,Null,Null,186208082,111461,23388
186208450,0.0,0.0,4000000,4000000,0,0,4000000,Null,Null,186208450,228293,1634
186208453,0.0,0.0,5000000,5000000,0,0,5000000,Null,Null,186208453,228293,1634
186208708,1.0,1.0,12480000,12480000,0,0,12480000,Null,Null,186208708,18802,8067
186208929,2.0,2.0,65000,65000,0,0,65000,Null,Null,186208929,111461,15250
186210038,159.0,159.0,1399000,659000,740000,53,1399000,Null,Null,186210038,5055635,5267
186211099,0.0,0.0,6010000,6010000,0,0,6010000,Null,Null,186211099,111643,5385
186211518,0.0,0.0,6010000,6010000,0,0,6010000,Null,Null,186211518,111643,5385
186215984,13.0,13.0,200000,200000,0,0,200000,Null,Null,186215984,274953,8512
186216038,0.0,0.0,6010000,6010000,0,0,6010000,Null,Null,186216038,111643,5385
186217510,0.0,0.0,6010000,6010000,0,0,6010000,Null,Null,186217510,111643,5385
186218227,0.0,0.0,14990000,14990000,0,0,14990000,Null,Null,186218227,18802,8067
186231924,0.0,0.0,6010000,6010000,0,0,6010000,Null,Null,186231924,111643,5385
186237353,0.0,0.0,5000,5000,0,0,5000,Null,Null,186237353,111461,2
186237475,0.0,0.0,15000,15000,0,0,15000,Null,Null,186237475,111461,2
186237636,0.0,0.0,9000,9000,0,0,9000,Null,Null,186237636,111461,2
186242839,39.0,39.0,250000,250000,0,0,250000,Null,Null,186242839,7304183,2971
186243876,426.0,426.0,75000,75000,0,0,75000,Null,Null,186243876,216511,1520
186243913,0.0,0.0,7540000,7540000,0,0,7540000,Null,Null,186243913,26150,8513
186244083,221.0,221.0,75000,75000,0,0,75000,Null,Null,186244083,216511,1520
186244189,5103.0,5103.0,109000,75000,34000,31,109000,Null,Null,186244189,216511,1520
186248771,537.0,537.0,185000,99000,86000,46,185000,Null,Null,186248771,5534927,2
186251538,5.0,5.0,139999,98999,41000,29,139999,Null,Null,186251538,149308,28576
186253037,1150.0,1150.0,195000,129000,66000,34,195000,Null,Null,186253037,4766405,2
186254300,328.0,328.0,79000,49000,30000,38,79000,Null,Null,186254300,697923,23346
186254331,55.0,55.0,30000,19000,11000,37,30000,Null,Null,186254331,111461,8371
186256010,721.0,721.0,45000,39000,6000,13,45000,Null,Null,186256010,697923,23370
186262906,106.0,106.0,78000,78000,0,0,78000,Null,Null,186262906,111461,23622
186264232,7.0,7.0,55000,32000,23000,42,55000,Null,Null,186264232,111461,53048
186270101,669.0,669.0,1300000,980000,320000,25,1300000,Null,Null,186270101,110481,1520
186270829,889.0,889.0,1250000,980000,270000,22,1250000,Null,Null,186270829,110481,1520
186276424,24.0,24.0,60000,60000,0,0,60000,Null,Null,186276424,146202,4428
186276689,0.0,0.0,4300000,4085000,215000,5,4300000,Null,Null,186276689,187341,17170
186279182,61.0,61.0,5000,5000,0,0,5000,Null,Null,186279182,111461,8202
186285922,114.0,114.0,950000,548000,402000,42,950000,Null,Null,186285922,19018,2334
186287039,14.0,14.0,130999,130999,0,0,130999,Null,Null,186287039,111461,2
186287166,3.0,3.0,279000,279000,0,0,279000,Null,Null,186287166,111461,2
186288869,466.0,466.0,1200000,945000,255000,21,1200000,Null,Null,186288869,110481,1520
186290770,0.0,0.0,39000000,39000000,0,0,39000000,Null,Null,186290770,4235555,2340
186299491,0.0,0.0,14500000,14500000,0,0,14500000,Null,Null,186299491,4235555,2340
186309376,1120.0,1120.0,430000,349000,81000,19,430000,Null,Null,186309376,110481,1520
186312477,0.0,0.0,11228000,10105200,1122800,10,11228000,Null,Null,186312477,26150,8513
186312866,0.0,0.0,30000000,30000000,0,0,30000000,Null,Null,186312866,4235555,2340
186321179,12.0,12.0,2000,2000,0,0,2000,Null,Null,186321179,111461,2
186322473,0.0,0.0,2450,2450,0,0,2450,Null,Null,186322473,111461,2
186322526,0.0,0.0,1500,1500,0,0,1500,Null,Null,186322526,111461,2
186348775,934.0,934.0,460000,230000,230000,50,460000,Null,Null,186348775,3955813,1883
186348861,0.0,0.0,490000,490000,0,0,490000,Null,Null,186348861,20271,1838
186348890,0.0,0.0,239000,239000,0,0,239000,Null,Null,186348890,20271,5263
186348894,0.0,0.0,619000,619000,0,0,619000,Null,Null,186348894,18984,1838
186348922,0.0,0.0,490000,490000,0,0,490000,Null,Null,186348922,25422,12294
186349021,0.0,0.0,219000,219000,0,0,219000,Null,Null,186349021,18984,28694
186349029,0.0,0.0,219000,219000,0,0,219000,Null,Null,186349029,25422,12294
186349117,0.0,0.0,990000,990000,0,0,990000,Null,Null,186349117,18984,1813
186349281,0.0,0.0,490000,490000,0,0,490000,Null,Null,186349281,20271,28638
186349299,0.0,0.0,590000,590000,0,0,590000,Null,Null,186349299,18984,1813
186349300,0.0,0.0,690000,690000,0,0,690000,Null,Null,186349300,20271,4428
186349353,0.0,0.0,795000,795000,0,0,795000,Null,Null,186349353,18984,1838
186349427,0.0,0.0,399000,399000,0,0,399000,Null,Null,186349427,18984,1838
186349494,0.0,0.0,239000,239000,0,0,239000,Null,Null,186349494,25422,12918
186349495,0.0,0.0,299000,299000,0,0,299000,Null,Null,186349495,20271,5263
186349523,0.0,0.0,1790000,1790000,0,0,1790000,Null,Null,186349523,20271,4880
186349535,0.0,0.0,690000,690000,0,0,690000,Null,Null,186349535,18984,20182
186349618,0.0,0.0,490000,490000,0,0,490000,Null,Null,186349618,18984,4880
186349654,0.0,0.0,290000,290000,0,0,290000,Null,Null,186349654,20271,4428
186349661,0.0,0.0,450000,450000,0,0,450000,Null,Null,186349661,20271,4880
186349663,0.0,0.0,890000,890000,0,0,890000,Null,Null,186349663,20271,1838
186349669,0.0,0.0,590000,590000,0,0,590000,Null,Null,186349669,18984,1836
186349685,0.0,0.0,369000,369000,0,0,369000,Null,Null,186349685,25422,8170
186349721,0.0,0.0,299000,299000,0,0,299000,Null,Null,186349721,25422,12908
186349756,0.0,0.0,89000,89000,0,0,89000,Null,Null,186349756,18984,1837
186349840,0.0,0.0,139000,139000,0,0,139000,Null,Null,186349840,25422,12294
186349900,0.0,0.0,369000,369000,0,0,369000,Null,Null,186349900,18984,1838
186349923,0.0,0.0,459000,459000,0,0,459000,Null,Null,186349923,18984,1836
186349989,0.0,0.0,190000,190000,0,0,190000,Null,Null,186349989,18984,5263
186350009,0.0,0.0,649000,649000,0,0,649000,Null,Null,186350009,18984,4880
186350011,0.0,0.0,569000,569000,0,0,569000,Null,Null,186350011,25422,8170
186350053,0.0,0.0,3190000,3190000,0,0,3190000,Null,Null,186350053,18984,1813
186350071,0.0,0.0,590000,590000,0,0,590000,Null,Null,186350071,25422,28454
186350089,0.0,0.0,229000,229000,0,0,229000,Null,Null,186350089,20271,5263
186350107,0.0,0.0,1850000,1850000,0,0,1850000,Null,Null,186350107,18984,1813
186350109,0.0,0.0,990000,990000,0,0,990000,Null,Null,186350109,18984,1836
186350115,0.0,0.0,239000,239000,0,0,239000,Null,Null,186350115,25422,20256
186359295,534.0,534.0,30000,19000,11000,37,30000,Null,Null,186359295,111461,15318
186364916,14.0,14.0,100000,100000,0,0,100000,Null,Null,186364916,4664633,28682
186434710,3921.0,3921.0,250000,198000,52000,21,250000,Null,Null,186434710,110481,1520
186439626,152.0,152.0,391000,289000,102000,26,391000,Null,Null,186439626,217549,11799
186483545,91.0,91.0,180000,69000,111000,62,180000,Null,Null,186483545,24831,2514
186484684,6.0,6.0,376000,376000,0,0,376000,Null,Null,186484684,111461,2136
186489030,9.0,9.0,150000,150000,0,0,150000,Null,Null,186489030,167237,1583
186490163,10.0,10.0,9000,9000,0,0,9000,Null,Null,186490163,111461,20254
186493506,0.0,0.0,1843000,1290000,553000,30,1843000,Null,Null,186493506,46363,8512
186494469,0.0,0.0,57000,57000,0,0,57000,Null,Null,186494469,111461,53074
186501762,170.0,170.0,180000,95000,85000,47,180000,Null,Null,186501762,484375,23258
186523456,3.0,3.0,2500,2500,0,0,2500,Null,Null,186523456,111461,2
186530649,10.0,10.0,12848000,12848000,0,0,12848000,Null,Null,186530649,5740935,1815
186538629,0.0,0.0,24500000,24500000,0,0,24500000,Null,Null,186538629,4235555,2340
186540721,371.0,371.0,391000,292000,99000,25,391000,Null,Null,186540721,217549,8192
186553970,0.0,0.0,93500000,93500000,0,0,93500000,Null,Null,186553970,198963,11518
186554008,44.0,44.0,25000,25000,0,0,25000,Null,Null,186554008,111461,2685
186554869,12.0,12.0,5700,5700,0,0,5700,Null,Null,186554869,111461,7064
186554945,0.0,0.0,6000,6000,0,0,6000,Null,Null,186554945,111461,7064
186555776,206.0,206.0,20000,20000,0,0,20000,Null,Null,186555776,5706641,2363
186557908,227.0,227.0,25000,25000,0,0,25000,Null,Null,186557908,5706641,53074
186558014,1715.0,1715.0,20000,20000,0,0,20000,Null,Null,186558014,5706641,2363
186559536,0.0,0.0,9499000,9499000,0,0,9499000,Null,Null,186559536,111461,2340
186577344,2.0,2.0,1900,1900,0,0,1900,Null,Null,186577344,111461,1883
186577985,0.0,0.0,29000000,29000000,0,0,29000000,Null,Null,186577985,426805,2340
186580952,0.0,0.0,1500,1500,0,0,1500,Null,Null,186580952,111461,53054
186581102,0.0,0.0,1500,1500,0,0,1500,Null,Null,186581102,111461,53054
186582177,0.0,0.0,27900,27900,0,0,27900,Null,Null,186582177,111461,2685
186582337,0.0,0.0,70000000,70000000,0,0,70000000,Null,Null,186582337,426805,2340
186584249,0.0,0.0,70000,49000,21000,30,70000,Null,Null,186584249,111461,2
186584343,224.0,224.0,389000,179000,210000,54,389000,Null,Null,186584343,5055635,5531
186590679,24.0,24.0,200000,200000,0,0,200000,Null,Null,186590679,111461,15250
186591556,1.0,1.0,14500000,14500000,0,0,14500000,Null,Null,186591556,233903,1795
186605790,0.0,0.0,8162000,7345800,816200,10,8162000,Null,Null,186605790,26150,8513
186606653,55.0,55.0,123000,93000,30000,24,123000,Null,Null,186606653,41048,1984
186615349,0.0,0.0,9000,9000,0,0,9000,Null,Null,186615349,111461,20222
186619460,325.0,325.0,391000,292000,99000,25,391000,Null,Null,186619460,217549,8192
186619685,3.0,3.0,75998,37999,37999,50,75998,Null,Null,186619685,546943,28486
186619847,378.0,378.0,24000,24000,0,0,24000,Null,Null,186619847,520061,1883
186627908,1671.0,1671.0,280000,189000,91000,33,280000,Null,Null,186627908,111461,23660
186639878,10.0,10.0,40000,23000,17000,43,40000,Null,Null,186639878,111461,15250
186645870,237.0,237.0,171000,95000,76000,44,171000,Null,Null,186645870,46703,23712
186654717,103.0,103.0,24000,24000,0,0,24000,Null,Null,186654717,5706641,2363
186654745,3.0,3.0,17850000,17850000,0,0,17850000,Null,Null,186654745,5740935,2971
186676214,0.0,0.0,10000,5000,5000,50,10000,Null,Null,186676214,111461,8167
186676765,55.0,55.0,35000,18000,17000,49,35000,Null,Null,186676765,111461,15318
186693022,328.0,328.0,225000,139000,86000,38,225000,Null,Null,186693022,7368293,2234
186705945,3.0,3.0,220000,144944,75056,34,220000,Null,Null,186705945,21651,5006
186740493,0.0,0.0,25950000,25950000,0,0,25950000,Null,Null,186740493,198963,8067
186741731,12.0,12.0,9500,9500,0,0,9500,Null,Null,186741731,111461,7064
186749929,0.0,0.0,80000,80000,0,0,80000,Null,Null,186749929,111461,8519
186762861,0.0,0.0,3850000,3850000,0,0,3850000,Null,Null,186762861,111461,11935
186803187,0.0,0.0,2000,2000,0,0,2000,Null,Null,186803187,111461,23078
186815151,0.0,0.0,67000000,58000000,9000000,13,67000000,Null,Null,186815151,7322743,4381
186817067,0.0,0.0,1560000,1560000,0,0,1560000,Null,Null,186817067,18802,8067
186862075,369.0,369.0,49000,47000,2000,4,49000,Null,Null,186862075,7367633,23276
186872917,100.0,100.0,645000,450000,195000,30,645000,Null,Null,186872917,7373129,8170
186875354,11.0,11.0,1040,1040,0,0,1040,Null,Null,186875354,111461,23056
186879900,699.0,699.0,315000,159000,156000,50,315000,Null,Null,186879900,4259821,2234
186883908,138.0,138.0,29000,25000,4000,14,29000,Null,Null,186883908,5132069,2685
186907112,229.0,229.0,85000,55900,29100,34,85000,Null,Null,186907112,52724,1815
186914971,78.0,78.0,579000,281000,298000,51,579000,Null,Null,186914971,4254031,8400
186952130,83.0,83.0,635000,305000,330000,52,635000,Null,Null,186952130,196271,8400
186970196,64.0,64.0,125000,125000,0,0,125000,Null,Null,186970196,111461,28596
186981554,0.0,0.0,7800,7800,0,0,7800,Null,Null,186981554,111461,28480
186991942,846.0,846.0,160125,99001,61124,38,160125,Null,Null,186991942,848485,1883
187010064,1.0,1.0,380000,380000,0,0,380000,Null,Null,187010064,111461,15318
187012642,0.0,0.0,18000,18000,0,0,18000,Null,Null,187012642,111461,2
187012666,0.0,0.0,18000,18000,0,0,18000,Null,Null,187012666,111461,2
187012667,0.0,0.0,18000,18000,0,0,18000,Null,Null,187012667,111461,2
187012671,0.0,0.0,18000,18000,0,0,18000,Null,Null,187012671,111461,2
187012706,8.0,8.0,18000,18000,0,0,18000,Null,Null,187012706,111461,2
187012707,23.0,23.0,15000,15000,0,0,15000,Null,Null,187012707,111461,2
187012710,0.0,0.0,18000,18000,0,0,18000,Null,Null,187012710,111461,2
187012719,0.0,0.0,18000,18000,0,0,18000,Null,Null,187012719,111461,2
187012726,0.0,0.0,18000,18000,0,0,18000,Null,Null,187012726,111461,2
187012740,0.0,0.0,5999,5999,0,0,5999,Null,Null,187012740,111461,2
187012841,13.0,13.0,1999,1999,0,0,1999,Null,Null,187012841,111461,2
187012864,1.0,1.0,18000,18000,0,0,18000,Null,Null,187012864,111461,2
187012895,14.0,14.0,2399,2399,0,0,2399,Null,Null,187012895,111461,2
187012929,6.0,6.0,2999,2999,0,0,2999,Null,Null,187012929,111461,2
187012932,0.0,0.0,15000,15000,0,0,15000,Null,Null,187012932,111461,2
187012936,7.0,7.0,2999,2999,0,0,2999,Null,Null,187012936,111461,2
187012942,0.0,0.0,3599,3599,0,0,3599,Null,Null,187012942,111461,2
187012961,0.0,0.0,10000,10000,0,0,10000,Null,Null,187012961,111461,2
187013043,7.0,7.0,10000,10000,0,0,10000,Null,Null,187013043,111461,2
187013064,2.0,2.0,23999,23999,0,0,23999,Null,Null,187013064,111461,2
187013116,0.0,0.0,15000,15000,0,0,15000,Null,Null,187013116,111461,2
187013134,0.0,0.0,15000,15000,0,0,15000,Null,Null,187013134,111461,2
187013233,0.0,0.0,23999,23999,0,0,23999,Null,Null,187013233,111461,2
187013262,0.0,0.0,15000,15000,0,0,15000,Null,Null,187013262,111461,2
187013266,0.0,0.0,10000,10000,0,0,10000,Null,Null,187013266,111461,2
187013295,0.0,0.0,15500,15500,0,0,15500,Null,Null,187013295,111461,2
187013364,0.0,0.0,10000,10000,0,0,10000,Null,Null,187013364,111461,2
187013426,14.0,14.0,5999,5999,0,0,5999,Null,Null,187013426,111461,2
187013520,0.0,0.0,18000,18000,0,0,18000,Null,Null,187013520,111461,2
187013537,0.0,0.0,6999,6999,0,0,6999,Null,Null,187013537,111461,2
187013576,0.0,0.0,18000,18000,0,0,18000,Null,Null,187013576,111461,2
187013596,0.0,0.0,18000,18000,0,0,18000,Null,Null,187013596,111461,2
187013643,3.0,3.0,15000,15000,0,0,15000,Null,Null,187013643,111461,2
187013670,0.0,0.0,15000,15000,0,0,15000,Null,Null,187013670,111461,2
187013736,0.0,0.0,15000,15000,0,0,15000,Null,Null,187013736,111461,2
187013749,11.0,11.0,12000,12000,0,0,12000,Null,Null,187013749,111461,2
187013771,1.0,1.0,25000,25000,0,0,25000,Null,Null,187013771,111461,2
187013772,1.0,1.0,20000,20000,0,0,20000,Null,Null,187013772,111461,2
187013807,0.0,0.0,15500,15500,0,0,15500,Null,Null,187013807,111461,2
187013829,0.0,0.0,4999,4999,0,0,4999,Null,Null,187013829,111461,2
187013883,0.0,0.0,18000,18000,0,0,18000,Null,Null,187013883,111461,2
187013916,0.0,0.0,15000,15000,0,0,15000,Null,Null,187013916,111461,2
187013921,0.0,0.0,18000,18000,0,0,18000,Null,Null,187013921,111461,2
187013968,3.0,3.0,12000,12000,0,0,12000,Null,Null,187013968,111461,2
187014037,0.0,0.0,15000,15000,0,0,15000,Null,Null,187014037,111461,2
187014038,15.0,15.0,98000,98000,0,0,98000,Null,Null,187014038,111461,2
187014060,0.0,0.0,15000,15000,0,0,15000,Null,Null,187014060,111461,2
187014104,0.0,0.0,15000,15000,0,0,15000,Null,Null,187014104,111461,2
187014181,0.0,0.0,5999,5999,0,0,5999,Null,Null,187014181,111461,2
187014185,0.0,0.0,18000,18000,0,0,18000,Null,Null,187014185,111461,2
187014201,31.0,31.0,2999,2999,0,0,2999,Null,Null,187014201,111461,2
187014205,0.0,0.0,18000,18000,0,0,18000,Null,Null,187014205,111461,2
187014291,2.0,2.0,18000,18000,0,0,18000,Null,Null,187014291,111461,2
187014328,0.0,0.0,10000,10000,0,0,10000,Null,Null,187014328,111461,2
187014460,0.0,0.0,18000,18000,0,0,18000,Null,Null,187014460,111461,2
187014497,3.0,3.0,15500,15500,0,0,15500,Null,Null,187014497,111461,2
187014508,1.0,1.0,42000,42000,0,0,42000,Null,Null,187014508,111461,2
187014554,0.0,0.0,12000,12000,0,0,12000,Null,Null,187014554,111461,2
187014561,0.0,0.0,9800,9800,0,0,9800,Null,Null,187014561,111461,2
187014580,0.0,0.0,15500,15500,0,0,15500,Null,Null,187014580,111461,2
187014821,2.0,2.0,15000,15000,0,0,15000,Null,Null,187014821,111461,2
187014861,1.0,1.0,83999,83999,0,0,83999,Null,Null,187014861,111461,2
187014901,0.0,0.0,18000,18000,0,0,18000,Null,Null,187014901,111461,2
187014956,0.0,0.0,3599,3599,0,0,3599,Null,Null,187014956,111461,2
187015009,0.0,0.0,6860,6860,0,0,6860,Null,Null,187015009,111461,2
187015020,4.0,4.0,9800,9800,0,0,9800,Null,Null,187015020,111461,2
187058636,44.0,44.0,2000,1000,1000,50,2000,Null,Null,187058636,5132069,2685
187099028,92.0,92.0,75000,75000,0,0,75000,Null,Null,187099028,21282,11833
187181825,1.0,1.0,1500,1500,0,0,1500,Null,Null,187181825,111461,1883
187184291,115.0,115.0,35000,35000,0,0,35000,Null,Null,187184291,5063093,53074
187251358,1.0,1.0,6900000,6555000,345000,5,6900000,Null,Null,187251358,33203,8170
187254759,0.0,0.0,4190000,3450000,740000,18,4190000,Null,Null,187254759,18802,1795
187266104,289.0,289.0,4990000,3990000,1000000,20,4990000,Null,Null,187266104,162007,1795
187274479,30.0,30.0,105000,105000,0,0,105000,Null,Null,187274479,48398,11817
187283939,137.0,137.0,197000,185000,12000,6,197000,Null,Null,187283939,454327,5872
187328684,0.0,0.0,10000,5599,4401,44,10000,Null,Null,187328684,111461,20222
187328802,0.0,0.0,2500,2500,0,0,2500,Null,Null,187328802,111461,2337
187329091,0.0,0.0,2000,2000,0,0,2000,Null,Null,187329091,111461,2685
187512713,94.0,94.0,45000,45000,0,0,45000,Null,Null,187512713,5706641,3177
187513094,1.0,1.0,17000,17000,0,0,17000,Null,Null,187513094,111461,49728
187513909,0.0,0.0,19000,19000,0,0,19000,Null,Null,187513909,111461,49726
187597380,175.0,175.0,799000,631000,168000,21,799000,Null,Null,187597380,5385323,17170
187598496,0.0,0.0,5500000,5500000,0,0,5500000,Null,Null,187598496,426805,2340
187601167,592.0,592.0,32000,32000,0,0,32000,Null,Null,187601167,111461,23238
187602729,0.0,0.0,0,10000,0,0,10000,Null,Null,187602729,111461,0
187603532,15.0,15.0,1000,1000,0,0,1000,Null,Null,187603532,111461,2
187604447,80.0,80.0,163898,148999,14899,9,163898,Null,Null,187604447,111461,23708
187608312,345.0,345.0,680000,363000,317000,47,680000,Null,Null,187608312,7359327,23392
187622280,38.0,38.0,1890000,1245000,645000,34,1890000,Null,Null,187622280,508871,27170
187624021,1.0,1.0,224000,100000,124000,55,224000,Null,Null,187624021,111461,15318
187636657,1830.0,1830.0,45000,45000,0,0,45000,Null,Null,187636657,5063093,53074
187637065,27.0,27.0,3600000,3600000,0,0,3600000,Null,Null,187637065,200189,11845
187642364,844.0,844.0,32900,32900,0,0,32900,Null,Null,187642364,111461,23242
187657388,124.0,124.0,59000,59000,0,0,59000,Null,Null,187657388,4973949,20244
187659203,1.0,1.0,22000,11000,11000,50,22000,Null,Null,187659203,4647777,15318
187662120,233.0,233.0,399000,219000,180000,45,399000,Null,Null,187662120,111461,8167
187730872,0.0,0.0,1000,1000,0,0,1000,Null,Null,187730872,111461,2
187746399,0.0,0.0,7900,7900,0,0,7900,Null,Null,187746399,111461,7064
187746693,59.0,59.0,64000,64000,0,0,64000,Null,Null,187746693,111461,51698
187764887,143.0,143.0,265000,265000,0,0,265000,Null,Null,187764887,4011099,2514
187816688,38.0,38.0,1355000,1199000,156000,12,1355000,Null,Null,187816688,19018,2334
187828549,22.0,22.0,620000,620000,0,0,620000,Null,Null,187828549,189445,28596
187829576,246.0,246.0,40000,25000,15000,38,40000,Null,Null,187829576,111461,23370
187837238,0.0,0.0,12000,12000,0,0,12000,Null,Null,187837238,111461,2
187839061,0.0,0.0,4000,4000,0,0,4000,Null,Null,187839061,111461,2
187845877,17.0,17.0,399000,289000,110000,28,399000,Null,Null,187845877,111461,2340
187867190,99.0,99.0,5000,3000,2000,40,5000,Null,Null,187867190,4720599,2805
187871096,73.0,73.0,1000000,900000,100000,10,1000000,Null,Null,187871096,64932,17170
187886393,0.0,0.0,10180000,10180000,0,0,10180000,Null,Null,187886393,860053,15318
187888722,86.0,86.0,165000,165000,0,0,165000,Null,Null,187888722,111461,27240
187891242,0.0,0.0,7380000,7380000,0,0,7380000,Null,Null,187891242,860053,15250
187896024,85.0,85.0,1390000,990000,400000,29,1390000,Null,Null,187896024,196181,2657
187938785,207.0,207.0,395000,375000,20000,5,395000,Null,Null,187938785,19018,2334
187939675,48.0,48.0,81000,81000,0,0,81000,Null,Null,187939675,111461,20250
187940553,0.0,0.0,9200000,9200000,0,0,9200000,Null,Null,187940553,860053,15250
187943026,0.0,0.0,12900000,12900000,0,0,12900000,Null,Null,187943026,860053,15250
187954641,0.0,0.0,21990000,13490000,8500000,39,21990000,Null,Null,187954641,18802,1795
187955862,0.0,0.0,21990000,13490000,8500000,39,21990000,Null,Null,187955862,18802,1795
187997179,162.0,162.0,6000,5900,100,2,6000,Null,Null,187997179,111461,1883
188008859,1.0,1.0,15000,15000,0,0,15000,Null,Null,188008859,7367417,49726
188030974,0.0,0.0,6990000,6990000,0,0,6990000,Null,Null,188030974,112735,1794
188043025,0.0,0.0,25990000,15990000,10000000,38,25990000,Null,Null,188043025,18802,1795
188044095,0.0,0.0,15990000,15990000,0,0,15990000,Null,Null,188044095,18802,1795
188044562,34.0,34.0,99000,99000,0,0,99000,Null,Null,188044562,4973949,20244
188050401,0.0,0.0,16000000,12000000,4000000,25,16000000,Null,Null,188050401,416127,8227
188080564,47.0,47.0,99000,99000,0,0,99000,Null,Null,188080564,162313,28484
188095843,0.0,0.0,65500000,65500000,0,0,65500000,Null,Null,188095843,433227,1520
188127351,0.0,0.0,25025000,16000000,9025000,36,25025000,Null,Null,188127351,18802,1795
188127813,313.0,313.0,945000,743000,202000,21,945000,Null,Null,188127813,114333,11845
188142886,20.0,20.0,1300,1300,0,0,1300,Null,Null,188142886,111461,23112
188164530,7.0,7.0,54000,27000,27000,50,54000,Null,Null,188164530,111461,15318
188189367,3.0,3.0,37835,37835,0,0,37835,Null,Null,188189367,111461,15320
188189424,1.0,1.0,54478,54478,0,0,54478,Null,Null,188189424,111461,15320
188189494,6.0,6.0,23884,23884,0,0,23884,Null,Null,188189494,111461,15320
188210320,0.0,0.0,1300,1300,0,0,1300,Null,Null,188210320,111461,2
188210525,0.0,0.0,3000,3000,0,0,3000,Null,Null,188210525,111461,2
188211469,32.0,32.0,2500,2500,0,0,2500,Null,Null,188211469,111461,2266
188213916,17.0,17.0,5000,4950,50,1,5000,Null,Null,188213916,111461,8305
188229392,1.0,1.0,250000,250000,0,0,250000,Null,Null,188229392,111461,15320
188230119,1.0,1.0,60255,60255,0,0,60255,Null,Null,188230119,111461,15320
188230276,0.0,0.0,14862,14862,0,0,14862,Null,Null,188230276,111461,15320
188230312,0.0,0.0,18886,18886,0,0,18886,Null,Null,188230312,111461,15320
188278246,79.0,79.0,45000,45000,0,0,45000,Null,Null,188278246,4973949,28428
188302612,107.0,107.0,99000,99000,0,0,99000,Null,Null,188302612,4973949,20244
188310209,0.0,0.0,26000000,26000000,0,0,26000000,Null,Null,188310209,433227,1520
188351196,1.0,1.0,11800000,11800000,0,0,11800000,Null,Null,188351196,749425,7079
188375633,204.0,204.0,345000,345000,0,0,345000,Null,Null,188375633,7368293,23832
188375839,566.0,566.0,59000,46000,13000,22,59000,Null,Null,188375839,4554495,2685
188376036,0.0,0.0,11300000,11187000,113000,1,11300000,Null,Null,188376036,167287,8073
188377253,31.0,31.0,55000,55000,0,0,55000,Null,Null,188377253,111461,49728
188377255,9.0,9.0,45000,45000,0,0,45000,Null,Null,188377255,111461,49728
188378647,95.0,95.0,27000,27000,0,0,27000,Null,Null,188378647,111461,49728
188379989,113.0,113.0,150000,150000,0,0,150000,Null,Null,188379989,7304183,3177
188386281,0.0,0.0,8000,8000,0,0,8000,Null,Null,188386281,111461,2
188386396,0.0,0.0,5000,5000,0,0,5000,Null,Null,188386396,111461,2
188409977,0.0,0.0,60000000,60000000,0,0,60000000,Null,Null,188409977,606305,27240
188427620,56.0,56.0,40000,15000,25000,63,40000,Null,Null,188427620,111461,2363
188428438,1.0,1.0,4658,4658,0,0,4658,Null,Null,188428438,111461,2363
188445944,114.0,114.0,135000,135000,0,0,135000,Null,Null,188445944,5043271,1634
188447585,12.0,12.0,2400,2000,400,17,2400,Null,Null,188447585,111461,8305
188447759,40.0,40.0,69000,35000,34000,49,69000,Null,Null,188447759,111461,6511
188447920,321.0,321.0,39000,39000,0,0,39000,Null,Null,188447920,3748887,3877
188453613,1.0,1.0,280000,280000,0,0,280000,Null,Null,188453613,111461,15318
188474170,262.0,262.0,38000,38000,0,0,38000,Null,Null,188474170,821321,3177
188481929,0.0,0.0,2200,2200,0,0,2200,Null,Null,188481929,111461,18876
188482266,8.0,8.0,59000,59000,0,0,59000,Null,Null,188482266,111461,2
188482376,1.0,1.0,25000,25000,0,0,25000,Null,Null,188482376,111461,2
188482533,3.0,3.0,25000,25000,0,0,25000,Null,Null,188482533,111461,2
188482815,3.0,3.0,52000,52000,0,0,52000,Null,Null,188482815,111461,2
188487005,1.0,1.0,990000,990000,0,0,990000,Null,Null,188487005,111461,2340
188528195,95.0,95.0,250000,129000,121000,48,250000,Null,Null,188528195,4655707,3426
188541839,3.0,3.0,199000,199000,0,0,199000,Null,Null,188541839,7367417,49722
188543973,0.0,0.0,5146000,4565000,581000,11,5146000,Null,Null,188543973,18802,1795
188545496,881.0,881.0,99000,94000,5000,5,99000,Null,Null,188545496,202607,5900
188551514,51.0,51.0,360000,360000,0,0,360000,Null,Null,188551514,160479,10423
188561534,34.0,34.0,950000,900000,50000,5,950000,Null,Null,188561534,202607,53350
188565088,110.0,110.0,2990000,2630000,360000,12,2990000,Null,Null,188565088,20215,2324
188576500,0.0,0.0,22900000,14900000,8000000,35,22900000,Null,Null,188576500,20091,2340
188576770,235.0,235.0,18000,18000,0,0,18000,Null,Null,188576770,111461,23032
188634529,22.0,22.0,299000,199000,100000,33,299000,Null,Null,188634529,929841,23010
188654888,5.0,5.0,10000,10000,0,0,10000,Null,Null,188654888,111461,15320
188654890,0.0,0.0,17000,17000,0,0,17000,Null,Null,188654890,111461,15320
188685608,209.0,209.0,3299000,3299000,0,0,3299000,Null,Null,188685608,18984,1838
188686488,0.0,0.0,3990000,3990000,0,0,3990000,Null,Null,188686488,18984,5264
188697551,25.0,25.0,55000,55000,0,0,55000,Null,Null,188697551,111461,2
188698092,1.0,1.0,5690000,4390000,1300000,23,5690000,Null,Null,188698092,18802,1795
188698703,0.0,0.0,5146000,4565000,581000,11,5146000,Null,Null,188698703,18802,1795
188701070,17.0,17.0,68000,49000,19000,28,68000,Null,Null,188701070,5132069,3177
188701072,0.0,0.0,4190000,3759000,431000,10,4190000,Null,Null,188701072,18802,1795
188712695,0.0,0.0,14682000,13213800,1468200,10,14682000,Null,Null,188712695,26150,8513
188712838,33.0,33.0,340000,340000,0,0,340000,Null,Null,188712838,726687,8223
188767619,387.0,387.0,299000,261000,38000,13,299000,Null,Null,188767619,262161,1623
188785720,4.0,4.0,99000,99000,0,0,99000,Null,Null,188785720,111461,2
188832700,228.0,228.0,275000,275000,0,0,275000,Null,Null,188832700,283985,11827
188832832,0.0,0.0,8390000,8390000,0,0,8390000,Null,Null,188832832,18802,1795
188832981,0.0,0.0,8390000,8390000,0,0,8390000,Null,Null,188832981,18802,1795
188833417,0.0,0.0,8390000,8390000,0,0,8390000,Null,Null,188833417,18802,1795
188833574,0.0,0.0,9600000,9600000,0,0,9600000,Null,Null,188833574,18802,1795
188833594,96.0,96.0,169000,162240,6760,4,169000,Null,Null,188833594,7375869,8309
188833794,0.0,0.0,6800000,6371000,429000,6,6800000,Null,Null,188833794,18802,1795
188833923,0.0,0.0,6800000,6371000,429000,6,6800000,Null,Null,188833923,18802,1795
188834089,0.0,0.0,6800000,6371000,429000,6,6800000,Null,Null,188834089,18802,1795
188834734,0.0,0.0,7000000,6371000,629000,9,7000000,Null,Null,188834734,18802,1795
188835531,0.0,0.0,3468000,3468000,0,0,3468000,Null,Null,188835531,25422,1795
188837747,0.0,0.0,3468000,3468000,0,0,3468000,Null,Null,188837747,25422,1795
188844932,0.0,0.0,4716000,4716000,0,0,4716000,Null,Null,188844932,25422,1795
188845278,0.0,0.0,4716000,4716000,0,0,4716000,Null,Null,188845278,25422,1795
188845405,0.0,0.0,150000,150000,0,0,150000,Null,Null,188845405,111461,15318
188845474,0.0,0.0,8900000,8900000,0,0,8900000,Null,Null,188845474,416127,53350
188845542,91.0,91.0,79000,79000,0,0,79000,Null,Null,188845542,111461,23416
188846657,5.0,5.0,299999,299999,0,0,299999,Null,Null,188846657,186713,28732
188846950,0.0,0.0,4716000,4716000,0,0,4716000,Null,Null,188846950,25422,1795
188857087,64.0,64.0,49000,29000,20000,41,49000,Null,Null,188857087,709163,27128
188868071,0.0,0.0,7032000,7032000,0,0,7032000,Null,Null,188868071,25422,1795
188870406,0.0,0.0,7032000,7032000,0,0,7032000,Null,Null,188870406,25422,1795
188896772,1.0,1.0,38000,38000,0,0,38000,Null,Null,188896772,111461,15236
188907040,98.0,98.0,38000,38000,0,0,38000,Null,Null,188907040,111461,20492
188919548,338.0,338.0,45000,45000,0,0,45000,Null,Null,188919548,894177,23304
188927387,4.0,4.0,800000,499000,301000,38,800000,Null,Null,188927387,111461,49724
188928205,73.0,73.0,6780000,3390000,3390000,50,6780000,Null,Null,188928205,18802,2657
188937533,0.0,0.0,1900,1900,0,0,1900,Null,Null,188937533,111461,2
188937561,0.0,0.0,1100,1100,0,0,1100,Null,Null,188937561,111461,2
188937857,0.0,0.0,1500,1500,0,0,1500,Null,Null,188937857,111461,2
188941352,47.0,47.0,255000,255000,0,0,255000,Null,Null,188941352,5043271,1819
188947051,0.0,0.0,9990000,7655000,2335000,23,9990000,Null,Null,188947051,7376347,8167
188947220,0.0,0.0,5490000,4142000,1348000,25,5490000,Null,Null,188947220,7376347,5905
188947354,0.0,0.0,5490000,4142000,1348000,25,5490000,Null,Null,188947354,7376347,5905
188947700,1.0,1.0,5490000,4142000,1348000,25,5490000,Null,Null,188947700,7376347,5905
188947824,0.0,0.0,7380000,5655000,1725000,23,7380000,Null,Null,188947824,7376347,8167
188948039,0.0,0.0,8000000,5324000,2676000,33,8000000,Null,Null,188948039,18802,1794
188948062,179.0,179.0,35000,35000,0,0,35000,Null,Null,188948062,579381,23052
188948646,0.0,0.0,8000000,5324000,2676000,33,8000000,Null,Null,188948646,18802,1794
188950307,20.0,20.0,85314,42657,42657,50,85314,Null,Null,188950307,111461,28574
188964498,101.0,101.0,330000,330000,0,0,330000,Null,Null,188964498,726687,11821
188992178,0.0,0.0,1040,1040,0,0,1040,Null,Null,188992178,111461,23056
188992568,59.0,59.0,135000,135000,0,0,135000,Null,Null,188992568,5043271,1634
189010575,0.0,0.0,2500,2500,0,0,2500,Null,Null,189010575,111461,2
189083468,1.0,1.0,15512000,15512000,0,0,15512000,Null,Null,189083468,7377583,5566
189100140,4.0,4.0,199000,199000,0,0,199000,Null,Null,189100140,7367417,49722
189144082,0.0,0.0,3850000,3850000,0,0,3850000,Null,Null,189144082,111461,11935
189155103,0.0,0.0,11200000,11200000,0,0,11200000,Null,Null,189155103,287013,12876
189170495,44.0,44.0,120000,120000,0,0,120000,Null,Null,189170495,111461,8602
189171164,110.0,110.0,120000,120000,0,0,120000,Null,Null,189171164,111461,8602
189179180,11.0,11.0,139000,139000,0,0,139000,Null,Null,189179180,254939,5995
189189139,110.0,110.0,269000,269000,0,0,269000,Null,Null,189189139,165403,8170
189190807,135.0,135.0,1250000,1129000,121000,10,1250000,Null,Null,189190807,26689,53350
189204598,0.0,0.0,8162000,7345800,816200,10,8162000,Null,Null,189204598,26150,8513
189208326,429.0,429.0,149000,149000,0,0,149000,Null,Null,189208326,5706641,3877
189233242,50.0,50.0,1769000,785000,984000,56,1769000,Null,Null,189233242,4629801,4429
189235204,141.0,141.0,65000,36000,29000,45,65000,Null,Null,189235204,5203971,2685
189251716,36.0,36.0,380000,380000,0,0,380000,Null,Null,189251716,276747,17162
189264081,0.0,0.0,13310000,13310000,0,0,13310000,Null,Null,189264081,550159,28870
189337142,5.0,5.0,79000,49000,30000,38,79000,Null,Null,189337142,111461,8167
189337252,34.0,34.0,5000,5000,0,0,5000,Null,Null,189337252,111461,1819
189337681,441.0,441.0,249000,191000,58000,23,249000,Null,Null,189337681,262161,17180
189339700,184.0,184.0,1000,1000,0,0,1000,Null,Null,189339700,879749,1594
189339895,67.0,67.0,39900,39900,0,0,39900,Null,Null,189339895,111461,2018
189363615,91.0,91.0,49000,24000,25000,51,49000,Null,Null,189363615,302375,1831
189365202,35.0,35.0,5000,5000,0,0,5000,Null,Null,189365202,879749,1625
189365360,103.0,103.0,1000,1000,0,0,1000,Null,Null,189365360,111461,2392
189373783,144.0,144.0,2399000,1299000,1100000,46,2399000,Null,Null,189373783,46703,1883
189380652,0.0,0.0,19000,19000,0,0,19000,Null,Null,189380652,111461,15250
189387524,0.0,0.0,9200000,9200000,0,0,9200000,Null,Null,189387524,860053,2
189388878,14.0,14.0,220000,135000,85000,39,220000,Null,Null,189388878,7294187,1936
189390196,131.0,131.0,309000,169000,140000,45,309000,Null,Null,189390196,111461,3175
189391175,0.0,0.0,24900000,24900000,0,0,24900000,Null,Null,189391175,50331,11518
189420338,0.0,0.0,1200,1200,0,0,1200,Null,Null,189420338,111461,20254
189420503,23.0,23.0,99000,99000,0,0,99000,Null,Null,189420503,25697,28450
189441842,9.0,9.0,4500,4500,0,0,4500,Null,Null,189441842,111461,2
189441957,1.0,1.0,3500,3500,0,0,3500,Null,Null,189441957,111461,2
189443696,6.0,6.0,15000,15000,0,0,15000,Null,Null,189443696,111461,2
189461061,29.0,29.0,3180000,2800000,380000,12,3180000,Null,Null,189461061,5181029,11879
189461576,0.0,0.0,1500,1500,0,0,1500,Null,Null,189461576,111461,2
189461647,41.0,41.0,1000,1000,0,0,1000,Null,Null,189461647,111461,2
189462003,0.0,0.0,1900,1900,0,0,1900,Null,Null,189462003,111461,2
189462261,0.0,0.0,4500,4500,0,0,4500,Null,Null,189462261,111461,20254
189466001,2.0,2.0,2890000,2169000,721000,25,2890000,Null,Null,189466001,25422,1795
189468133,0.0,0.0,16000000,16000000,0,0,16000000,Null,Null,189468133,111461,11925
189471309,5.0,5.0,3990000,3190000,800000,20,3990000,Null,Null,189471309,208841,2340
189474023,257.0,257.0,990000,790000,200000,20,990000,Null,Null,189474023,111454,28454
189475053,19.0,19.0,60000,55000,5000,8,60000,Null,Null,189475053,5097509,23416
189491110,1.0,1.0,250000,250000,0,0,250000,Null,Null,189491110,111461,15318
189491402,1.0,1.0,18000,18000,0,0,18000,Null,Null,189491402,111461,15250
189491499,0.0,0.0,13000,13000,0,0,13000,Null,Null,189491499,111461,15936
189491539,1.0,1.0,13000,13000,0,0,13000,Null,Null,189491539,111461,15936
189491905,1401.0,1401.0,90000,62000,28000,31,90000,Null,Null,189491905,505265,1883
189492088,813.0,813.0,125000,117000,8000,6,125000,Null,Null,189492088,505265,1883
189533690,0.0,0.0,38000000,24900000,13100000,34,38000000,Null,Null,189533690,184543,2340
189535010,0.0,0.0,2500,2500,0,0,2500,Null,Null,189535010,111461,23134
189535808,1.0,1.0,2500,2500,0,0,2500,Null,Null,189535808,111461,23134
189536204,1.0,1.0,18900000,14900000,4000000,21,18900000,Null,Null,189536204,184543,2340
189536320,0.0,0.0,19900000,12861000,7039000,35,19900000,Null,Null,189536320,184543,2340
189552500,241.0,241.0,33000,33000,0,0,33000,Null,Null,189552500,821321,6948
189568098,179.0,179.0,499000,255000,244000,49,499000,Null,Null,189568098,31627,1936
189568106,150.0,150.0,359000,118000,241000,67,359000,Null,Null,189568106,31627,1936
189580427,64.0,64.0,239000,239000,0,0,239000,Null,Null,189580427,18984,1838
189587133,1.0,1.0,10560000,10560000,0,0,10560000,Null,Null,189587133,298425,11905
189587135,2.0,2.0,5120000,5120000,0,0,5120000,Null,Null,189587135,298425,11905
189587136,3.0,3.0,5280000,5280000,0,0,5280000,Null,Null,189587136,298425,11905
189587139,1.0,1.0,6720000,6720000,0,0,6720000,Null,Null,189587139,298425,11905
189587140,1.0,1.0,3520000,3520000,0,0,3520000,Null,Null,189587140,298425,11905
189587143,0.0,0.0,7040000,7040000,0,0,7040000,Null,Null,189587143,298425,11905
189587144,4.0,4.0,3360000,3360000,0,0,3360000,Null,Null,189587144,298425,11905
189587151,0.0,0.0,10080000,10080000,0,0,10080000,Null,Null,189587151,298425,11905
189587155,0.0,0.0,3520000,3520000,0,0,3520000,Null,Null,189587155,298425,11905
189588520,44.0,44.0,3220000,1213000,2007000,62,3220000,Null,Null,189588520,41048,2136
189588901,0.0,0.0,17875200,17875200,0,0,17875200,Null,Null,189588901,40960,20254
189589332,0.0,0.0,18916200,18916200,0,0,18916200,Null,Null,189589332,40960,20254
189592897,0.0,0.0,5971000,5971000,0,0,5971000,Null,Null,189592897,26150,8513
189595006,3.0,3.0,13900000,13900000,0,0,13900000,Null,Null,189595006,111461,8215
189595093,0.0,0.0,12900000,11800000,1100000,9,12900000,Null,Null,189595093,20215,8066
189595821,147.0,147.0,18500000,9990000,8510000,46,18500000,Null,Null,189595821,5222401,2340
189596611,0.0,0.0,66000000,66000000,0,0,66000000,Null,Null,189596611,7380365,4381
189596867,144.0,144.0,500000,330000,170000,34,500000,Null,Null,189596867,7380365,23660
189596869,1.0,1.0,48000000,44500000,3500000,7,48000000,Null,Null,189596869,7380365,4381
189598462,2.0,2.0,11900000,11900000,0,0,11900000,Null,Null,189598462,111461,1805
189634105,0.0,0.0,94000,94000,0,0,94000,Null,Null,189634105,111461,1984
189635395,0.0,0.0,2000,2000,0,0,2000,Null,Null,189635395,111461,23446
189658085,11009.0,11009.0,4490000,3550000,940000,21,4490000,Null,Null,189658085,25643,1795
189676848,3.0,3.0,40000,40000,0,0,40000,Null,Null,189676848,111461,49722
189677315,0.0,0.0,2556000,2556000,0,0,2556000,Null,Null,189677315,25422,1795
189680960,10.0,10.0,59000,59000,0,0,59000,Null,Null,189680960,111461,49722
189681084,0.0,0.0,9800000,9800000,0,0,9800000,Null,Null,189681084,111461,49724
189685611,15.0,15.0,249000,135000,114000,46,249000,Null,Null,189685611,21651,5006
189694096,1.0,1.0,750000,750000,0,0,750000,Null,Null,189694096,7368683,23236
189696719,9.0,9.0,5950000,3589000,2361000,40,5950000,Null,Null,189696719,150437,53350
189697854,0.0,0.0,12888888,12888888,0,0,12888888,Null,Null,189697854,893943,7079
189700428,2.0,2.0,155000,155000,0,0,155000,Null,Null,189700428,4627197,8400
189701020,31.0,31.0,250000,195000,55000,22,250000,Null,Null,189701020,21651,5006
189740106,13.0,13.0,1000,1000,0,0,1000,Null,Null,189740106,111461,5450
189751920,4.0,4.0,139000,129000,10000,7,139000,Null,Null,189751920,111461,8516
189757740,2.0,2.0,2000,2000,0,0,2000,Null,Null,189757740,111461,5450
189757898,7.0,7.0,2000,2000,0,0,2000,Null,Null,189757898,111461,5450
189849768,109.0,109.0,105000,105000,0,0,105000,Null,Null,189849768,5706641,53074
189885397,12.0,12.0,599000,499000,100000,17,599000,Null,Null,189885397,697923,23392
189896968,7.0,7.0,195000,195000,0,0,195000,Null,Null,189896968,111461,49726
189924143,6.0,6.0,10000,10000,0,0,10000,Null,Null,189924143,111461,2
189924206,0.0,0.0,17000,17000,0,0,17000,Null,Null,189924206,111461,2
189924231,0.0,0.0,10000,10000,0,0,10000,Null,Null,189924231,111461,2
189932634,0.0,0.0,3192000,3192000,0,0,3192000,Null,Null,189932634,25643,1795
189932777,0.0,0.0,12900000,12900000,0,0,12900000,Null,Null,189932777,25422,1795
189932809,0.0,0.0,9600000,9600000,0,0,9600000,Null,Null,189932809,18802,1795
189934829,0.0,0.0,4190000,3759000,431000,10,4190000,Null,Null,189934829,18802,1795
189934885,0.0,0.0,7668000,7348000,320000,4,7668000,Null,Null,189934885,25643,1795
189935254,0.0,0.0,3500000,3500000,0,0,3500000,Null,Null,189935254,18802,1795
189936448,0.0,0.0,3450000,3450000,0,0,3450000,Null,Null,189936448,111461,8167
189936525,0.0,0.0,5650000,5650000,0,0,5650000,Null,Null,189936525,111461,2340
189936565,0.0,0.0,5650000,5650000,0,0,5650000,Null,Null,189936565,111461,8167
189937184,0.0,0.0,12900000,12900000,0,0,12900000,Null,Null,189937184,18802,1795
189937243,0.0,0.0,7000000,6371000,629000,9,7000000,Null,Null,189937243,18802,1795
189937468,0.0,0.0,11500000,9016000,2484000,22,11500000,Null,Null,189937468,18802,1795
189938284,0.0,0.0,61000000,61000000,0,0,61000000,Null,Null,189938284,606305,27212
189941128,0.0,0.0,1000000,1000000,0,0,1000000,Null,Null,189941128,4920829,11885
189973724,32.0,32.0,10000,7000,3000,30,10000,Null,Null,189973724,111461,8197
189999009,6.0,6.0,10000,9900,100,1,10000,Null,Null,189999009,111461,8197
190086553,149.0,149.0,59000,59000,0,0,59000,Null,Null,190086553,4973949,28426
190093953,119.0,119.0,25000,25000,0,0,25000,Null,Null,190093953,4973949,28426
190106576,0.0,0.0,6010000,6010000,0,0,6010000,Null,Null,190106576,111643,49722
190109903,0.0,0.0,6500000,6500000,0,0,6500000,Null,Null,190109903,625577,7449
190109961,0.0,0.0,3690000,3690000,0,0,3690000,Null,Null,190109961,18802,1795
190110118,0.0,0.0,6500000,6500000,0,0,6500000,Null,Null,190110118,625577,7449
190119235,985.0,985.0,184000,164000,20000,11,184000,Null,Null,190119235,21274,8217
190125218,0.0,0.0,52000000,52000000,0,0,52000000,Null,Null,190125218,150630,23290
190125250,2.0,2.0,188000,188000,0,0,188000,Null,Null,190125250,111461,2
190127835,12.0,12.0,60000,60000,0,0,60000,Null,Null,190127835,111461,28482
190152933,4.0,4.0,79000,79000,0,0,79000,Null,Null,190152933,111461,15318
190156105,34.0,34.0,38000,38000,0,0,38000,Null,Null,190156105,111461,28430
190156705,13.0,13.0,9000,9000,0,0,9000,Null,Null,190156705,111461,11831
190181201,13.0,13.0,150000,150000,0,0,150000,Null,Null,190181201,111461,49722
190229653,11.0,11.0,13000,13000,0,0,13000,Null,Null,190229653,111461,15320
190229916,3.0,3.0,3390000,3390000,0,0,3390000,Null,Null,190229916,162957,20170
190238002,2.0,2.0,52000,52000,0,0,52000,Null,Null,190238002,111461,15318
190238864,0.0,0.0,1440000,1282000,158000,11,1440000,Null,Null,190238864,111461,49724
190239268,0.0,0.0,4300000,4300000,0,0,4300000,Null,Null,190239268,111461,11885
190240726,394.0,394.0,79000,79000,0,0,79000,Null,Null,190240726,549763,1831
190252110,70.0,70.0,22000,22000,0,0,22000,Null,Null,190252110,111461,3990
190253687,22.0,22.0,240000,240000,0,0,240000,Null,Null,190253687,111461,2
190254514,10.0,10.0,12000,7800,4200,35,12000,Null,Null,190254514,477953,8305
190289032,0.0,0.0,41999000,37497000,4502000,11,41999000,Null,Null,190289032,18985,4428
190290564,0.0,0.0,12900,9900,3000,23,12900,Null,Null,190290564,477953,8305
190290656,2.0,2.0,110000,99000,11000,10,110000,Null,Null,190290656,111461,15236
190298523,0.0,0.0,26300000,26300000,0,0,26300000,Null,Null,190298523,198963,8067
190300577,399.0,399.0,40000,29000,11000,28,40000,Null,Null,190300577,111461,53186
190302353,0.0,0.0,28000,12000,16000,57,28000,Null,Null,190302353,111461,2
190318941,0.0,0.0,9000,9000,0,0,9000,Null,Null,190318941,111461,2334
190321013,95.0,95.0,200000,179000,21000,11,200000,Null,Null,190321013,111461,53186
190322459,1.0,1.0,173999,173999,0,0,173999,Null,Null,190322459,111461,53054
190337269,29.0,29.0,320000,153000,167000,52,320000,Null,Null,190337269,111454,12908
190338701,3.0,3.0,12690000,12690000,0,0,12690000,Null,Null,190338701,114527,2657
190354127,27.0,27.0,399000,399000,0,0,399000,Null,Null,190354127,157347,2340
190378922,7.0,7.0,180135,135001,45134,25,180135,Null,Null,190378922,848485,5995
190460539,2.0,2.0,13990000,12491000,1499000,11,13990000,Null,Null,190460539,18985,2977
190464209,7.0,7.0,12990000,11605000,1385000,11,12990000,Null,Null,190464209,18985,2977
190468258,0.0,0.0,39000,39000,0,0,39000,Null,Null,190468258,111461,15236
190472560,357.0,357.0,270000,135000,135000,50,270000,Null,Null,190472560,477953,8305
190489303,2266.0,2266.0,15800,7900,7900,50,15800,Null,Null,190489303,477953,8305
190490501,25.0,25.0,2000,2000,0,0,2000,Null,Null,190490501,111461,3710
190491180,165.0,165.0,85000,85000,0,0,85000,Null,Null,190491180,7356423,23134
190506536,124.0,124.0,39000,39000,0,0,39000,Null,Null,190506536,4973949,28484
190508053,513.0,513.0,200000,160000,40000,20,200000,Null,Null,190508053,631569,2340
190509670,0.0,0.0,5230000,5230000,0,0,5230000,Null,Null,190509670,111461,11885
190510917,141.0,141.0,119000,119000,0,0,119000,Null,Null,190510917,111461,23362
190511342,25.0,25.0,80000,49000,31000,39,80000,Null,Null,190511342,7368683,23244
190513977,0.0,0.0,3960000,3881000,79000,2,3960000,Null,Null,190513977,283219,11871
190515420,1.0,1.0,12000,12000,0,0,12000,Null,Null,190515420,111461,15320
190515934,18.0,18.0,99000,99000,0,0,99000,Null,Null,190515934,111461,49722
190516241,6.0,6.0,119000,119000,0,0,119000,Null,Null,190516241,111461,49722
190516295,0.0,0.0,3850000,3850000,0,0,3850000,Null,Null,190516295,111461,11885
190517164,20.0,20.0,170000,170000,0,0,170000,Null,Null,190517164,111461,49722
190517393,5.0,5.0,40000,40000,0,0,40000,Null,Null,190517393,162313,28592
190519566,19.0,19.0,75000,75000,0,0,75000,Null,Null,190519566,52207,1583
190530084,10.0,10.0,30990000,30990000,0,0,30990000,Null,Null,190530084,18802,1795
190542002,0.0,0.0,3240000,3240000,0,0,3240000,Null,Null,190542002,25422,1795
190542051,1594.0,1594.0,18000,10500,7500,42,18000,Null,Null,190542051,111461,2685
190543389,0.0,0.0,15900000,15900000,0,0,15900000,Null,Null,190543389,712435,28870
190544267,5.0,5.0,4490000,3869000,621000,14,4490000,Null,Null,190544267,25643,1795
190544300,46.0,46.0,72000,72000,0,0,72000,Null,Null,190544300,111461,2018
190547041,3.0,3.0,2890000,2136000,754000,26,2890000,Null,Null,190547041,25422,1795
190551312,1.0,1.0,58000,58000,0,0,58000,Null,Null,190551312,21437,49728
190551677,13.0,13.0,20000,20000,0,0,20000,Null,Null,190551677,21437,49728
190553620,115.0,115.0,65000,65000,0,0,65000,Null,Null,190553620,5706641,2685
190555866,7.0,7.0,49000,49000,0,0,49000,Null,Null,190555866,111461,15320
190558337,0.0,0.0,5263000,4565000,698000,13,5263000,Null,Null,190558337,18802,1795
190558349,1.0,1.0,11500000,9016000,2484000,22,11500000,Null,Null,190558349,18802,1795
190558358,0.0,0.0,3500000,3500000,0,0,3500000,Null,Null,190558358,18802,1795
190565076,121.0,121.0,159000,159000,0,0,159000,Null,Null,190565076,4973949,20244
190565283,1.0,1.0,18000,18000,0,0,18000,Null,Null,190565283,111461,15250
190565313,0.0,0.0,18000,18000,0,0,18000,Null,Null,190565313,111461,15250
190569944,0.0,0.0,9900,9900,0,0,9900,Null,Null,190569944,111461,5905
190582098,11.0,11.0,6490000,6490000,0,0,6490000,Null,Null,190582098,18604,1794
190589797,168.0,168.0,368000,368000,0,0,368000,Null,Null,190589797,5272071,23436
190601866,0.0,0.0,12000000,12000000,0,0,12000000,Null,Null,190601866,111461,11885
190602137,229.0,229.0,39000,39000,0,0,39000,Null,Null,190602137,4973949,28430
190630816,27.0,27.0,305000,289000,16000,5,305000,Null,Null,190630816,332519,17170
190632304,37.0,37.0,4500,2500,2000,44,4500,Null,Null,190632304,154455,18876
190632315,0.0,0.0,2160,1200,960,44,2160,Null,Null,190632315,154455,53058
190633437,34.0,34.0,350000,332000,18000,5,350000,Null,Null,190633437,332519,17170
190635453,0.0,0.0,50400000,48888000,1512000,3,50400000,Null,Null,190635453,111461,23634
190641506,340.0,340.0,380000,361000,19000,5,380000,Null,Null,190641506,332519,1583
190641510,323.0,323.0,285000,270000,15000,5,285000,Null,Null,190641510,332519,1583
190641512,78.0,78.0,145000,136000,9000,6,145000,Null,Null,190641512,332519,1583
190645308,95.0,95.0,380000,361000,19000,5,380000,Null,Null,190645308,332519,1583
190645315,65.0,65.0,285000,270000,15000,5,285000,Null,Null,190645315,332519,1583
190657950,48.0,48.0,179000,178000,1000,1,179000,Null,Null,190657950,7288833,2019
190670482,0.0,0.0,37859000,37859000,0,0,37859000,Null,Null,190670482,611709,23270
190696132,0.0,0.0,10000,10000,0,0,10000,Null,Null,190696132,111461,8205
190698242,2.0,2.0,8000,8000,0,0,8000,Null,Null,190698242,111461,8165
190698246,2.0,2.0,4900,4900,0,0,4900,Null,Null,190698246,111461,8165
190701486,0.0,0.0,4284000,4284000,0,0,4284000,Null,Null,190701486,25643,1795
190701745,0.0,0.0,62765000,62765000,0,0,62765000,Null,Null,190701745,4558659,2340
190702241,0.0,0.0,11271000,9016000,2255000,20,11271000,Null,Null,190702241,18802,1795
190702391,0.0,0.0,11500000,9016000,2484000,22,11500000,Null,Null,190702391,18802,1795
190702606,0.0,0.0,11271000,9016000,2255000,20,11271000,Null,Null,190702606,18802,1795
190725129,0.0,0.0,140000000,140000000,0,0,140000000,Null,Null,190725129,4558659,2340
190726748,675.0,675.0,3000,1800,1200,40,3000,Null,Null,190726748,154455,2363
190738003,0.0,0.0,1899,1899,0,0,1899,Null,Null,190738003,111461,2363
190757937,78.0,78.0,128700,99000,29700,23,128700,Null,Null,190757937,4408565,28674
190791221,124.0,124.0,54000,54000,0,0,54000,Null,Null,190791221,745957,2153
190792770,15.0,15.0,34088,34088,0,0,34088,Null,Null,190792770,111461,53074
190824210,10.0,10.0,194560,136192,58368,30,194560,Null,Null,190824210,111461,28682
190843679,0.0,0.0,5190000,5090000,100000,2,5190000,Null,Null,190843679,112638,1794
190845657,0.0,0.0,5190000,5090000,100000,2,5190000,Null,Null,190845657,112638,1794
190857198,1175.0,1175.0,2000,1300,700,35,2000,Null,Null,190857198,154455,23416
190860306,652.0,652.0,199000,69000,130000,65,199000,Null,Null,190860306,202607,8227
190863526,66.0,66.0,539000,539000,0,0,539000,Null,Null,190863526,40810,2340
190864821,0.0,0.0,5000,5000,0,0,5000,Null,Null,190864821,111461,28480
190881603,5.0,5.0,6000,6000,0,0,6000,Null,Null,190881603,477953,8305
190887580,118.0,118.0,30000,25000,5000,17,30000,Null,Null,190887580,505265,23078
190936461,57.0,57.0,799000,799000,0,0,799000,Null,Null,190936461,19034,5006
190989470,107.0,107.0,345000,308000,37000,11,345000,Null,Null,190989470,31627,1936
191005978,4.0,4.0,10000,9000,1000,10,10000,Null,Null,191005978,111461,2
191006261,0.0,0.0,6000,6000,0,0,6000,Null,Null,191006261,111461,2
191057553,620.0,620.0,185000,185000,0,0,185000,Null,Null,191057553,5063093,1883
191081573,73.0,73.0,285000,270000,15000,5,285000,Null,Null,191081573,332519,1583
191089378,30.0,30.0,1899000,1739000,160000,8,1899000,Null,Null,191089378,19018,11941
191089547,0.0,0.0,899000,712000,187000,21,899000,Null,Null,191089547,19673,1789
191136026,112.0,112.0,2450000,2390000,60000,2,2450000,Null,Null,191136026,4250493,1883
191136118,576.0,576.0,15000,15000,0,0,15000,Null,Null,191136118,5706641,2488
191138104,5.0,5.0,559000,559000,0,0,559000,Null,Null,191138104,48865,2
191143575,24.0,24.0,119000,107000,12000,10,119000,Null,Null,191143575,17839,1583
191143577,83.0,83.0,149000,134000,15000,10,149000,Null,Null,191143577,17839,11827
191143586,73.0,73.0,119000,99000,20000,17,119000,Null,Null,191143586,17839,1583
191143593,299.0,299.0,149000,134000,15000,10,149000,Null,Null,191143593,17839,11827
191143601,24.0,24.0,249000,224000,25000,10,249000,Null,Null,191143601,17839,17170
191143610,255.0,255.0,149000,119000,30000,20,149000,Null,Null,191143610,17839,11827
191217388,0.0,0.0,650000,617500,32500,5,650000,Null,Null,191217388,161943,11885
191217487,0.0,0.0,1577000,1577000,0,0,1577000,Null,Null,191217487,7391407,53350
191258852,0.0,0.0,4390000,4390000,0,0,4390000,Null,Null,191258852,27449,8165
191267387,10.0,10.0,9990000,6890000,3100000,31,9990000,Null,Null,191267387,25422,1795
191281267,5.0,5.0,799000,589000,210000,26,799000,Null,Null,191281267,46363,5384
191283038,5.0,5.0,1590000,949000,641000,40,1590000,Null,Null,191283038,46363,5385
191292120,5.0,5.0,750000,449000,301000,40,750000,Null,Null,191292120,46363,5384
191297982,0.0,0.0,60000000,42000000,18000000,30,60000000,Null,Null,191297982,5046787,23576
191314537,44.0,44.0,2150000,1800000,350000,16,2150000,Null,Null,191314537,33203,8168
191315762,2.0,2.0,90000,45000,45000,50,90000,Null,Null,191315762,4647777,15318
191319744,69.0,69.0,300000,150000,150000,50,300000,Null,Null,191319744,7400131,15318
191321018,0.0,0.0,19800000,19800000,0,0,19800000,Null,Null,191321018,167287,28860
191322209,75.0,75.0,90000,90000,0,0,90000,Null,Null,191322209,4973949,28674
191326389,45.0,45.0,121000,121000,0,0,121000,Null,Null,191326389,745957,2153
191347858,0.0,0.0,1000,1000,0,0,1000,Null,Null,191347858,111461,2
191348891,0.0,0.0,2500,2500,0,0,2500,Null,Null,191348891,111461,2
191350420,68.0,68.0,2350000,2350000,0,0,2350000,Null,Null,191350420,147856,28856
191356959,129.0,129.0,220000,220000,0,0,220000,Null,Null,191356959,5706641,5995
191365625,577.0,577.0,273000,226000,47000,17,273000,Null,Null,191365625,185075,1583
191365626,142.0,142.0,409200,326000,83200,20,409200,Null,Null,191365626,185075,1583
191365627,398.0,398.0,254600,233000,21600,8,254600,Null,Null,191365627,21274,4413
191365631,453.0,453.0,254600,233000,21600,8,254600,Null,Null,191365631,21274,4413
191365680,109.0,109.0,254600,233000,21600,8,254600,Null,Null,191365680,21274,8217
191365681,145.0,145.0,254600,211000,43600,17,254600,Null,Null,191365681,21274,8217
191365684,81.0,81.0,380000,289000,91000,24,380000,Null,Null,191365684,21274,8217
191365686,207.0,207.0,380000,289000,91000,24,380000,Null,Null,191365686,21274,8217
191375525,2.0,2.0,220000,113000,107000,49,220000,Null,Null,191375525,4647777,15318
191375629,34.0,34.0,99000,99000,0,0,99000,Null,Null,191375629,7304183,4428
191378480,176.0,176.0,120000,115000,5000,4,120000,Null,Null,191378480,5258275,23078
191381262,55.0,55.0,2400000,1800000,600000,25,2400000,Null,Null,191381262,64932,17170
191391429,0.0,0.0,20200000,20200000,0,0,20200000,Null,Null,191391429,50307,7079
191391860,0.0,0.0,23200000,23200000,0,0,23200000,Null,Null,191391860,167287,7079
191406240,0.0,0.0,14300000,14300000,0,0,14300000,Null,Null,191406240,167287,7079
191410834,0.0,0.0,13400000,13400000,0,0,13400000,Null,Null,191410834,167287,28860
191413378,0.0,0.0,2000,2000,0,0,2000,Null,Null,191413378,111461,15318
191420889,0.0,0.0,29500000,29500000,0,0,29500000,Null,Null,191420889,167287,7079
191421884,1.0,1.0,3524000,2642000,882000,25,3524000,Null,Null,191421884,26150,8513
191429193,0.0,0.0,68999000,68999000,0,0,68999000,Null,Null,191429193,18985,8067
191440257,29.0,29.0,437000,325000,112000,26,437000,Null,Null,191440257,217549,11759
191468933,1.0,1.0,15000,15000,0,0,15000,Null,Null,191468933,111461,15250
191469739,0.0,0.0,19000,19000,0,0,19000,Null,Null,191469739,111461,2
191474322,4.0,4.0,850000,819000,31000,4,850000,Null,Null,191474322,19673,1796
191477357,793.0,793.0,199000,139000,60000,30,199000,Null,Null,191477357,625265,28574
191477618,10.0,10.0,2690000,1649000,1041000,39,2690000,Null,Null,191477618,19673,1795
191501918,287.0,287.0,75000,75000,0,0,75000,Null,Null,191501918,4973949,28428
191502436,530.0,530.0,45000,45000,0,0,45000,Null,Null,191502436,4973949,28428
191504379,78.0,78.0,129000,129000,0,0,129000,Null,Null,191504379,5706641,3877
191505175,0.0,0.0,44000000,44000000,0,0,44000000,Null,Null,191505175,4558659,2340
191505971,574.0,574.0,515000,264000,251000,49,515000,Null,Null,191505971,48077,1936
191506484,214.0,214.0,550000,499000,51000,9,550000,Null,Null,191506484,885047,2016
191508469,0.0,0.0,15999000,12143000,3856000,24,15999000,Null,Null,191508469,18776,7273
191513299,4.0,4.0,4500,4000,500,11,4500,Null,Null,191513299,111461,5007
191513391,0.0,0.0,7400,7400,0,0,7400,Null,Null,191513391,111461,1815
191513413,0.0,0.0,7000,7000,0,0,7000,Null,Null,191513413,111461,1815
191513418,0.0,0.0,7400,7400,0,0,7400,Null,Null,191513418,111461,1815
191514845,297.0,297.0,1160000,580000,580000,50,1160000,Null,Null,191514845,7356423,5905
191515410,10.0,10.0,5000,5000,0,0,5000,Null,Null,191515410,111461,28478
191515412,15.0,15.0,275000,275000,0,0,275000,Null,Null,191515412,155308,28738
191516513,13.0,13.0,107900,103000,4900,5,107900,Null,Null,191516513,149308,28576
191529360,119.0,119.0,200000,195000,5000,3,200000,Null,Null,191529360,33203,8168
191552880,0.0,0.0,2500,2500,0,0,2500,Null,Null,191552880,111461,2685
191571013,80.0,80.0,99000,99000,0,0,99000,Null,Null,191571013,4973949,28428
191571091,98.0,98.0,55000,55000,0,0,55000,Null,Null,191571091,4973949,28428
191584663,20.0,20.0,185000,185000,0,0,185000,Null,Null,191584663,7379131,23254
191584847,23.0,23.0,500000,236000,264000,53,500000,Null,Null,191584847,5379677,23304
191585510,0.0,0.0,7700000,7700000,0,0,7700000,Null,Null,191585510,5332317,8165
191587067,0.0,0.0,58500000,58500000,0,0,58500000,Null,Null,191587067,167287,7079
191587220,96.0,96.0,99000,60000,39000,39,99000,Null,Null,191587220,252399,23362
191592116,0.0,0.0,27900000,27900000,0,0,27900000,Null,Null,191592116,167287,11518
191592899,84.0,84.0,99000,95000,4000,4,99000,Null,Null,191592899,7380365,1831
191604412,63.0,63.0,45000,45000,0,0,45000,Null,Null,191604412,4973949,28428
191621019,0.0,0.0,22670000,22670000,0,0,22670000,Null,Null,191621019,183637,28856
191629224,0.0,0.0,2500,2500,0,0,2500,Null,Null,191629224,111461,27180
191629406,0.0,0.0,2500,2500,0,0,2500,Null,Null,191629406,111461,27180
191629692,1.0,1.0,2500,2500,0,0,2500,Null,Null,191629692,111461,27180
191629873,0.0,0.0,2556000,2556000,0,0,2556000,Null,Null,191629873,25422,1795
191636459,20.0,20.0,499000,439000,60000,12,499000,Null,Null,191636459,112638,1796
191654086,26.0,26.0,490000,349000,141000,29,490000,Null,Null,191654086,153086,5006
191682273,0.0,0.0,108000000,108000000,0,0,108000000,Null,Null,191682273,111461,2
191682278,0.0,0.0,38000000,38000000,0,0,38000000,Null,Null,191682278,111461,2
191684818,3024.0,3024.0,94000,94000,0,0,94000,Null,Null,191684818,226401,1811
191689540,0.0,0.0,5180000,4565000,615000,12,5180000,Null,Null,191689540,18802,1795
191689612,0.0,0.0,5180000,4565000,615000,12,5180000,Null,Null,191689612,18802,1795
191689653,0.0,0.0,7000000,6371000,629000,9,7000000,Null,Null,191689653,18802,1795
191689660,0.0,0.0,8390000,8390000,0,0,8390000,Null,Null,191689660,18802,1795
191689713,0.0,0.0,7000000,6371000,629000,9,7000000,Null,Null,191689713,18802,1795
191689727,0.0,0.0,4284000,4284000,0,0,4284000,Null,Null,191689727,25643,1795
191689774,0.0,0.0,3912000,3912000,0,0,3912000,Null,Null,191689774,25643,1795
191689809,0.0,0.0,5180000,4565000,615000,12,5180000,Null,Null,191689809,18802,1795
191689878,0.0,0.0,4632000,4632000,0,0,4632000,Null,Null,191689878,25643,1795
191689899,0.0,0.0,3500000,3500000,0,0,3500000,Null,Null,191689899,18802,1795
191689934,0.0,0.0,4000000,3759000,241000,6,4000000,Null,Null,191689934,18802,1795
191695346,0.0,0.0,9000,9000,0,0,9000,Null,Null,191695346,111461,15318
191717349,0.0,0.0,37000000,37000000,0,0,37000000,Null,Null,191717349,280191,23270
191718244,0.0,0.0,37260000,37260000,0,0,37260000,Null,Null,191718244,280191,23270
191718540,0.0,0.0,40540000,40540000,0,0,40540000,Null,Null,191718540,280191,23270
191719735,54.0,54.0,4290000,4290000,0,0,4290000,Null,Null,191719735,144779,4429
191719740,1.0,1.0,4990000,4790000,200000,4,4990000,Null,Null,191719740,144779,2324
191719745,130.0,130.0,2790000,2790000,0,0,2790000,Null,Null,191719745,144779,2324
191720011,0.0,0.0,68000000,68000000,0,0,68000000,Null,Null,191720011,4899107,23112
191723228,0.0,0.0,55000000,55000000,0,0,55000000,Null,Null,191723228,4899107,23112
191725789,0.0,0.0,58000000,58000000,0,0,58000000,Null,Null,191725789,4899107,27240
191726751,90.0,90.0,150000,150000,0,0,150000,Null,Null,191726751,79682,11835
191732410,0.0,0.0,68000000,68000000,0,0,68000000,Null,Null,191732410,4899107,27240
191738540,0.0,0.0,55000000,55000000,0,0,55000000,Null,Null,191738540,4899107,27240
191740212,0.0,0.0,95000000,95000000,0,0,95000000,Null,Null,191740212,4899107,23112
191740389,0.0,0.0,80000000,80000000,0,0,80000000,Null,Null,191740389,4899107,23112
191752367,343.0,343.0,249000,224000,25000,10,249000,Null,Null,191752367,86206,17170
191752563,104.0,104.0,195000,165000,30000,15,195000,Null,Null,191752563,86206,17170
191752622,353.0,353.0,215000,177000,38000,18,215000,Null,Null,191752622,86206,53350
191755122,0.0,0.0,119000,113050,5950,5,119000,Null,Null,191755122,111461,23010
191757014,92.0,92.0,219000,219000,0,0,219000,Null,Null,191757014,111454,5006
191759223,8.0,8.0,29000,29000,0,0,29000,Null,Null,191759223,111461,15318
191764688,0.0,0.0,2690000,1990000,700000,26,2690000,Null,Null,191764688,25422,1795
191767158,91.0,91.0,208000,145000,63000,30,208000,Null,Null,191767158,79682,1627
191779223,0.0,0.0,5000,5000,0,0,5000,Null,Null,191779223,111461,28622
191787550,14.0,14.0,599000,499000,100000,17,599000,Null,Null,191787550,276181,8167
191798750,0.0,0.0,6680000,6680000,0,0,6680000,Null,Null,191798750,405211,8511
191800574,0.0,0.0,900000,900000,0,0,900000,Null,Null,191800574,111461,28622
191804180,6.0,6.0,1500,1500,0,0,1500,Null,Null,191804180,111461,5450
191804639,0.0,0.0,7950000,7950000,0,0,7950000,Null,Null,191804639,405211,8512
191804681,0.0,0.0,7950000,7950000,0,0,7950000,Null,Null,191804681,405211,7449
191806286,0.0,0.0,7950000,7950000,0,0,7950000,Null,Null,191806286,405211,8511
191808762,0.0,0.0,6000,6000,0,0,6000,Null,Null,191808762,111461,2
191809663,113.0,113.0,990000,790000,200000,20,990000,Null,Null,191809663,111454,28454
191815765,0.0,0.0,12438,12438,0,0,12438,Null,Null,191815765,111461,2
191816378,0.0,0.0,19000,19000,0,0,19000,Null,Null,191816378,111461,2
191816538,0.0,0.0,19000,19000,0,0,19000,Null,Null,191816538,111461,2
191817608,1114.0,1114.0,255000,249900,5100,2,255000,Null,Null,191817608,111461,1815
191818538,0.0,0.0,3850000,3850000,0,0,3850000,Null,Null,191818538,111461,11885
191820153,22.0,22.0,4190000,3167000,1023000,24,4190000,Null,Null,191820153,18802,1795
191823811,0.0,0.0,95000000,95000000,0,0,95000000,Null,Null,191823811,4899107,23112
191828788,0.0,0.0,95000000,95000000,0,0,95000000,Null,Null,191828788,4899107,23112
191890680,0.0,0.0,195000000,195000000,0,0,195000000,Null,Null,191890680,4899107,23112
191893747,59.0,59.0,74500,74500,0,0,74500,Null,Null,191893747,111461,2
191895306,0.0,0.0,99500000,99500000,0,0,99500000,Null,Null,191895306,4899107,23112
191895736,0.0,0.0,50000,50000,0,0,50000,Null,Null,191895736,111461,28480
191899155,0.0,0.0,14200000,14200000,0,0,14200000,Null,Null,191899155,52315,11518
191899217,0.0,0.0,20500000,20500000,0,0,20500000,Null,Null,191899217,52315,11518
191899476,0.0,0.0,2000,2000,0,0,2000,Null,Null,191899476,111461,2
191900082,1.0,1.0,95000,95000,0,0,95000,Null,Null,191900082,111461,2
191911136,22.0,22.0,135000,135000,0,0,135000,Null,Null,191911136,111461,23658
191911148,187.0,187.0,220000,220000,0,0,220000,Null,Null,191911148,111461,23658
191911178,77.0,77.0,129000,75000,54000,42,129000,Null,Null,191911178,111461,1883
191914756,0.0,0.0,5000,4000,1000,20,5000,Null,Null,191914756,111461,5007
191916060,0.0,0.0,2556000,2556000,0,0,2556000,Null,Null,191916060,25422,1795
191918103,277.0,277.0,79000,41000,38000,48,79000,Null,Null,191918103,48077,2514
191918105,176.0,176.0,39000,21000,18000,46,39000,Null,Null,191918105,48077,2514
191918107,48.0,48.0,267000,267000,0,0,267000,Null,Null,191918107,48077,1936
191920712,0.0,0.0,6000,6000,0,0,6000,Null,Null,191920712,111461,2
191921221,0.0,0.0,9000,9000,0,0,9000,Null,Null,191921221,111461,2
191928494,0.0,0.0,195000000,195000000,0,0,195000000,Null,Null,191928494,4899107,23112
191930496,0.0,0.0,2500,2500,0,0,2500,Null,Null,191930496,111461,2
191930873,4.0,4.0,150000,139000,11000,7,150000,Null,Null,191930873,173547,15320
191944689,3.0,3.0,319000,319000,0,0,319000,Null,Null,191944689,111461,23544
191950319,97.0,97.0,2999000,1433000,1566000,52,2999000,Null,Null,191950319,111461,23346
191955983,160.0,160.0,930000,789000,141000,15,930000,Null,Null,191955983,33203,11925
191958796,0.0,0.0,43000000,43000000,0,0,43000000,Null,Null,191958796,4899107,23112
191961174,0.0,0.0,2500,2500,0,0,2500,Null,Null,191961174,111461,2
191977471,0.0,0.0,104130000,104130000,0,0,104130000,Null,Null,191977471,280191,23270
191977833,0.0,0.0,68525000,68525000,0,0,68525000,Null,Null,191977833,280191,23270
191978068,0.0,0.0,98117000,98117000,0,0,98117000,Null,Null,191978068,280191,23270
191978389,0.0,0.0,8000,8000,0,0,8000,Null,Null,191978389,111461,2
191978393,0.0,0.0,8000,8000,0,0,8000,Null,Null,191978393,111461,2
191979061,49.0,49.0,2500000,1950000,550000,22,2500000,Null,Null,191979061,213611,23394
191986009,25.0,25.0,65000,65000,0,0,65000,Null,Null,191986009,111461,28480
192009319,0.0,0.0,1500,1500,0,0,1500,Null,Null,192009319,111461,53058
192009671,40.0,40.0,28900,28900,0,0,28900,Null,Null,192009671,5585229,8193
192032385,0.0,0.0,5000,5000,0,0,5000,Null,Null,192032385,111461,28480
192032600,0.0,0.0,900000,900000,0,0,900000,Null,Null,192032600,111461,28622
192036708,0.0,0.0,4632000,4632000,0,0,4632000,Null,Null,192036708,25643,1795
192052649,0.0,0.0,12980000,12980000,0,0,12980000,Null,Null,192052649,185209,1811
192070209,97.0,97.0,2000,2000,0,0,2000,Null,Null,192070209,111461,53074
192074199,41.0,41.0,1190000,789000,401000,34,1190000,Null,Null,192074199,5375469,23658
192091236,0.0,0.0,44900000,44900000,0,0,44900000,Null,Null,192091236,20091,2340
192100933,13.0,13.0,319000,287100,31900,10,319000,Null,Null,192100933,5073869,28682
192105873,23.0,23.0,70000,68000,2000,3,70000,Null,Null,192105873,505265,23058
192113535,273.0,273.0,790000,383000,407000,52,790000,Null,Null,192113535,204385,1811
192116446,65.0,65.0,2170000,1089000,1081000,50,2170000,Null,Null,192116446,5375469,23658
192120961,331.0,331.0,41000,41000,0,0,41000,Null,Null,192120961,5706641,23134
192121064,223.0,223.0,269000,269000,0,0,269000,Null,Null,192121064,5706641,3877
192135187,45.0,45.0,330347,231243,99104,30,330347,Null,Null,192135187,111461,1838
192139196,0.0,0.0,102000,102000,0,0,102000,Null,Null,192139196,111461,1838
192139900,0.0,0.0,14660000,14660000,0,0,14660000,Null,Null,192139900,185209,26652
192153763,41.0,41.0,54990,54990,0,0,54990,Null,Null,192153763,162313,28574
192155520,26.0,26.0,3900,3900,0,0,3900,Null,Null,192155520,111461,8205
192158205,0.0,0.0,75000,75000,0,0,75000,Null,Null,192158205,111461,8212
192168663,0.0,0.0,105000000,105000000,0,0,105000000,Null,Null,192168663,4554385,27128
192172856,0.0,0.0,3168000,3168000,0,0,3168000,Null,Null,192172856,25643,1795
192177567,0.0,0.0,44900000,44900000,0,0,44900000,Null,Null,192177567,20091,2340
192181439,0.0,0.0,1666,1666,0,0,1666,Null,Null,192181439,63747,23712
192198514,48.0,48.0,475000,475000,0,0,475000,Null,Null,192198514,5126697,28454
192211290,0.0,0.0,11990000,11990000,0,0,11990000,Null,Null,192211290,18802,1795
192257703,125.0,125.0,99000,99000,0,0,99000,Null,Null,192257703,4973949,28428
192257745,0.0,0.0,8000,8000,0,0,8000,Null,Null,192257745,111461,1622
192259854,0.0,0.0,9000,9000,0,0,9000,Null,Null,192259854,111461,2
192275955,8.0,8.0,53000,53000,0,0,53000,Null,Null,192275955,111461,49722
192289487,12.0,12.0,1000,1000,0,0,1000,Null,Null,192289487,111461,27214
192290300,48.0,48.0,320000,306000,14000,4,320000,Null,Null,192290300,25422,1634
192291035,0.0,0.0,2500,2500,0,0,2500,Null,Null,192291035,111461,2
192291424,0.0,0.0,3650000,3650000,0,0,3650000,Null,Null,192291424,111461,8167
192295280,26.0,26.0,450000,450000,0,0,450000,Null,Null,192295280,4522605,28598
192295894,1.0,1.0,1940000,1940000,0,0,1940000,Null,Null,192295894,256727,15320
192303236,3.0,3.0,79000,79000,0,0,79000,Null,Null,192303236,111461,3175
192303944,10.0,10.0,1500,1500,0,0,1500,Null,Null,192303944,111461,23416
192304257,0.0,0.0,1560,1560,0,0,1560,Null,Null,192304257,111461,2
192325645,117.0,117.0,590000,590000,0,0,590000,Null,Null,192325645,722993,11867
192326739,0.0,0.0,45000000,45000000,0,0,45000000,Null,Null,192326739,111461,2
192326767,0.0,0.0,37000000,37000000,0,0,37000000,Null,Null,192326767,111461,2
192330725,0.0,0.0,9000,9000,0,0,9000,Null,Null,192330725,111461,20254
192339768,76.0,76.0,190000,98000,92000,48,190000,Null,Null,192339768,48077,53348
192339772,212.0,212.0,1090000,578000,512000,47,1090000,Null,Null,192339772,48077,53348
192348147,0.0,0.0,4284000,4284000,0,0,4284000,Null,Null,192348147,25643,1795
192354940,37.0,37.0,270000,216038,53962,20,270000,Null,Null,192354940,143353,28574
192364741,189.0,189.0,30000,28000,2000,7,30000,Null,Null,192364741,5763205,1831
192376330,21.0,21.0,95000,95000,0,0,95000,Null,Null,192376330,4973949,20244
192376901,0.0,0.0,8000,8000,0,0,8000,Null,Null,192376901,111461,1622
192393158,0.0,0.0,752000,676800,75200,10,752000,Null,Null,192393158,26150,8511
192393889,8.0,8.0,459000,459000,0,0,459000,Null,Null,192393889,111461,4381
192411583,38.0,38.0,149000,149000,0,0,149000,Null,Null,192411583,5706641,2140
192431673,82.0,82.0,169000,169000,0,0,169000,Null,Null,192431673,4973949,20244
192444013,0.0,0.0,9000,9000,0,0,9000,Null,Null,192444013,111461,8202
192445205,8.0,8.0,450000,300000,150000,33,450000,Null,Null,192445205,111454,12908
192449634,80.0,80.0,1900,1900,0,0,1900,Null,Null,192449634,111461,2
192449661,0.0,0.0,2100,2100,0,0,2100,Null,Null,192449661,111461,2
192449858,0.0,0.0,1000,1000,0,0,1000,Null,Null,192449858,111461,2
192449880,6.0,6.0,2500,2500,0,0,2500,Null,Null,192449880,111461,2
192449901,2.0,2.0,2000,2000,0,0,2000,Null,Null,192449901,111461,2
192450064,0.0,0.0,2100,2100,0,0,2100,Null,Null,192450064,111461,2
192450098,0.0,0.0,2100,2100,0,0,2100,Null,Null,192450098,111461,2
192450306,0.0,0.0,2000,2000,0,0,2000,Null,Null,192450306,111461,2
192450380,0.0,0.0,2100,2100,0,0,2100,Null,Null,192450380,111461,2
192450588,0.0,0.0,2200,2200,0,0,2200,Null,Null,192450588,111461,2
192451067,2281.0,2281.0,645000,491000,154000,24,645000,Null,Null,192451067,238861,8223
192451086,27.0,27.0,99000,99000,0,0,99000,Null,Null,192451086,4973949,28428
192451247,946.0,946.0,645000,449000,196000,30,645000,Null,Null,192451247,238861,8223
192453813,0.0,0.0,14000,14000,0,0,14000,Null,Null,192453813,111461,15320
192454924,68.0,68.0,1000,1000,0,0,1000,Null,Null,192454924,111461,1622
192460452,0.0,0.0,14500000,14500000,0,0,14500000,Null,Null,192460452,228187,11943
192462647,0.0,0.0,14500000,14500000,0,0,14500000,Null,Null,192462647,228187,11943
192471715,149.0,149.0,388000,368000,20000,5,388000,Null,Null,192471715,5465779,23376
192473147,91.0,91.0,199000,196000,3000,2,199000,Null,Null,192473147,111461,27180
192473508,52.0,52.0,45000,43000,2000,4,45000,Null,Null,192473508,111461,20492
192503280,1.0,1.0,9000,9000,0,0,9000,Null,Null,192503280,111461,8202
192523772,499.0,499.0,49000,49000,0,0,49000,Null,Null,192523772,5706641,2514
192546792,0.0,0.0,3897000,3897000,0,0,3897000,Null,Null,192546792,7303705,11881
192548014,13.0,13.0,163200,114240,48960,30,163200,Null,Null,192548014,111461,1838
192560838,0.0,0.0,45250000,45250000,0,0,45250000,Null,Null,192560838,7244473,2340
192582976,74.0,74.0,65000,59000,6000,9,65000,Null,Null,192582976,5406107,2238
192583699,34.0,34.0,29000,29000,0,0,29000,Null,Null,192583699,111461,15318
192583838,4.0,4.0,29000,29000,0,0,29000,Null,Null,192583838,111461,15318
192643623,1.0,1.0,135000,135000,0,0,135000,Null,Null,192643623,111461,15318
192649465,0.0,0.0,19000,19000,0,0,19000,Null,Null,192649465,111461,15320
192649690,1.0,1.0,69000,69000,0,0,69000,Null,Null,192649690,111461,15250
192652893,3.0,3.0,6999998,3499999,3499999,50,6999998,Null,Null,192652893,542569,2340
192654345,2.0,2.0,389000,199000,190000,49,389000,Null,Null,192654345,183257,15236
192655145,0.0,0.0,43000000,43000000,0,0,43000000,Null,Null,192655145,146400,23438
192669917,39.0,39.0,180000,115000,65000,36,180000,Null,Null,192669917,111461,28598
192688324,66.0,66.0,245000,198000,47000,19,245000,Null,Null,192688324,148961,1883
192694043,13.0,13.0,1060000,1060000,0,0,1060000,Null,Null,192694043,18804,1789
192704831,267.0,267.0,420000,196000,224000,53,420000,Null,Null,192704831,262161,2346
192705927,1.0,1.0,100000,90000,10000,10,100000,Null,Null,192705927,111461,15236
192706259,61.0,61.0,375000,375000,0,0,375000,Null,Null,192706259,7428177,28574
192710447,0.0,0.0,54999,54999,0,0,54999,Null,Null,192710447,111461,28574
192710993,12.0,12.0,39000,32900,6100,16,39000,Null,Null,192710993,111461,15320
192711027,13.0,13.0,40000,29500,10500,26,40000,Null,Null,192711027,111461,15250
192711036,8.0,8.0,37000,26000,11000,30,37000,Null,Null,192711036,111461,15250
192712067,58.0,58.0,33000,23000,10000,30,33000,Null,Null,192712067,111461,15320
192712411,4.0,4.0,29000,29000,0,0,29000,Null,Null,192712411,111461,28576
192725094,0.0,0.0,15000,15000,0,0,15000,Null,Null,192725094,111461,15250
192725115,1.0,1.0,15000,15000,0,0,15000,Null,Null,192725115,111461,15250
192725122,0.0,0.0,15000,15000,0,0,15000,Null,Null,192725122,111461,15250
192725134,0.0,0.0,15000,15000,0,0,15000,Null,Null,192725134,111461,15250
192725136,0.0,0.0,15000,15000,0,0,15000,Null,Null,192725136,111461,15250
192729544,41.0,41.0,1990000,1350000,640000,32,1990000,Null,Null,192729544,111454,12908
192729670,3.0,3.0,498000,249000,249000,50,498000,Null,Null,192729670,111461,8511
192731541,290.0,290.0,559000,299000,260000,47,559000,Null,Null,192731541,541293,8167
192731663,3.0,3.0,589000,294500,294500,50,589000,Null,Null,192731663,111461,5385
192731945,260.0,260.0,399000,244000,155000,39,399000,Null,Null,192731945,5659167,8400
192733315,30.0,30.0,1800,1200,600,33,1800,Null,Null,192733315,111461,2363
192790496,97.0,97.0,2200000,1450000,750000,34,2200000,Null,Null,192790496,631569,2340
192795616,82.0,82.0,289000,104000,185000,64,289000,Null,Null,192795616,302375,1838
192804341,64.0,64.0,450000,349000,101000,22,450000,Null,Null,192804341,5147565,2659
192810797,0.0,0.0,99999999,99999999,0,0,99999999,Null,Null,192810797,111461,2
192811071,0.0,0.0,99999999,99999999,0,0,99999999,Null,Null,192811071,111461,2
192811204,0.0,0.0,89000,89000,0,0,89000,Null,Null,192811204,111461,8519
192829542,1.0,1.0,1918660,1918660,0,0,1918660,Null,Null,192829542,46363,5385
192833053,28.0,28.0,35000,20000,15000,43,35000,Null,Null,192833053,111461,8371
192839254,0.0,0.0,8087000,8087000,0,0,8087000,Null,Null,192839254,18802,1795
192850548,27.0,27.0,147000,133000,14000,10,147000,Null,Null,192850548,193677,1936
192851389,35.0,35.0,375000,375000,0,0,375000,Null,Null,192851389,7428177,28574
192857442,52.0,52.0,3900,3900,0,0,3900,Null,Null,192857442,111461,8202
192858996,59.0,59.0,165000,165000,0,0,165000,Null,Null,192858996,111461,23634
192859201,3.0,3.0,9790000,9790000,0,0,9790000,Null,Null,192859201,112735,1795
192863200,0.0,0.0,15000,15000,0,0,15000,Null,Null,192863200,111461,15250
192863709,0.0,0.0,18000,18000,0,0,18000,Null,Null,192863709,111461,15250
192869917,5.0,5.0,18000,18000,0,0,18000,Null,Null,192869917,111461,15250
192870616,42.0,42.0,100000,89000,11000,11,100000,Null,Null,192870616,5763205,1832
192880293,216.0,216.0,58000,29000,29000,50,58000,Null,Null,192880293,7400131,8371
192921746,89.0,89.0,1650000,950000,700000,42,1650000,Null,Null,192921746,631569,2340
192923812,133.0,133.0,12000,12000,0,0,12000,Null,Null,192923812,7457421,23134
192937900,0.0,0.0,12800000,12800000,0,0,12800000,Null,Null,192937900,167287,8067
192947833,2.0,2.0,359000,359000,0,0,359000,Null,Null,192947833,111461,15250
192951644,158.0,158.0,1399000,1199000,200000,14,1399000,Null,Null,192951644,4250493,4381
192974831,14.0,14.0,69750,69750,0,0,69750,Null,Null,192974831,111461,2
192975755,130.0,130.0,95000,95000,0,0,95000,Null,Null,192975755,4720599,23588
192977208,285.0,285.0,392001,392001,0,0,392001,Null,Null,192977208,2630119,2657
192986081,13.0,13.0,24000,24000,0,0,24000,Null,Null,192986081,21437,49728
192986105,1.0,1.0,40000,40000,0,0,40000,Null,Null,192986105,21437,49728
192986127,8.0,8.0,63000,63000,0,0,63000,Null,Null,192986127,21437,49728
192987851,67.0,67.0,790000,638000,152000,19,790000,Null,Null,192987851,28008,1811
192999707,0.0,0.0,52500000,52500000,0,0,52500000,Null,Null,192999707,167287,7079
193003348,0.0,0.0,9550000,7990000,1560000,16,9550000,Null,Null,193003348,27398,2340
193003934,0.0,0.0,23500000,23265000,235000,1,23500000,Null,Null,193003934,167287,7079
193005797,70.0,70.0,790001,790001,0,0,790001,Null,Null,193005797,2630119,2657
193006708,55.0,55.0,1255000,1255000,0,0,1255000,Null,Null,193006708,2630119,28444
193007501,0.0,0.0,6370000,6370000,0,0,6370000,Null,Null,193007501,5332317,8165
193007697,0.0,0.0,5620000,5620000,0,0,5620000,Null,Null,193007697,5332317,11935
193008194,0.0,0.0,8150000,8150000,0,0,8150000,Null,Null,193008194,5332317,11935
193042935,0.0,0.0,6885000,6885000,0,0,6885000,Null,Null,193042935,25502,8511
193044158,0.0,0.0,2798000,2798000,0,0,2798000,Null,Null,193044158,111461,1883
193044172,3.0,3.0,1000,1000,0,0,1000,Null,Null,193044172,111461,8205
193059858,0.0,0.0,8185000,8185000,0,0,8185000,Null,Null,193059858,25502,8511
193060201,0.0,0.0,6085000,6085000,0,0,6085000,Null,Null,193060201,25502,8512
193060585,0.0,0.0,5885000,5885000,0,0,5885000,Null,Null,193060585,25502,5385
193060718,76.0,76.0,368000,368000,0,0,368000,Null,Null,193060718,111461,1883
193061719,145.0,145.0,249000,169000,80000,32,249000,Null,Null,193061719,111461,28482
193061781,13.0,13.0,2000,2000,0,0,2000,Null,Null,193061781,111461,8193
193077776,0.0,0.0,8357143,8357143,0,0,8357143,Null,Null,193077776,405211,5384
193081467,424.0,424.0,1798200,999000,799200,44,1798200,Null,Null,193081467,46703,4381
193095264,30.0,30.0,398000,199000,199000,50,398000,Null,Null,193095264,7400131,15318
193095810,1.0,1.0,9000,9000,0,0,9000,Null,Null,193095810,111461,8202
193098848,59.0,59.0,99000,99000,0,0,99000,Null,Null,193098848,111461,28428
193104129,0.0,0.0,1800,1800,0,0,1800,Null,Null,193104129,111461,23282
193105066,3.0,3.0,150000,150000,0,0,150000,Null,Null,193105066,111461,49722
193114401,0.0,0.0,44902000,44902000,0,0,44902000,Null,Null,193114401,4554385,27128
193124300,4.0,4.0,18000,9000,9000,50,18000,Null,Null,193124300,4647777,15318
193125748,0.0,0.0,65000000,65000000,0,0,65000000,Null,Null,193125748,111461,23112
193126701,0.0,0.0,2000,2000,0,0,2000,Null,Null,193126701,111461,5454
193128433,0.0,0.0,10000,6000,4000,40,10000,Null,Null,193128433,48381,1601
193128451,0.0,0.0,10000,6000,4000,40,10000,Null,Null,193128451,48381,1601
193128511,0.0,0.0,10000,6000,4000,40,10000,Null,Null,193128511,48381,1601
193128528,1.0,1.0,10000,6000,4000,40,10000,Null,Null,193128528,48381,1601
193140847,0.0,0.0,38190000,38190000,0,0,38190000,Null,Null,193140847,4554385,27128
193152585,599.0,599.0,70200,39000,31200,44,70200,Null,Null,193152585,46703,23622
193160084,0.0,0.0,6885000,6885000,0,0,6885000,Null,Null,193160084,25502,5385
193164103,0.0,0.0,7385000,7385000,0,0,7385000,Null,Null,193164103,25502,8511
193176737,1.0,1.0,10485000,10485000,0,0,10485000,Null,Null,193176737,25502,5385
193178278,1.0,1.0,7185000,7185000,0,0,7185000,Null,Null,193178278,25502,5385
193201420,0.0,0.0,9000,9000,0,0,9000,Null,Null,193201420,111461,8202
193202974,0.0,0.0,2500,2500,0,0,2500,Null,Null,193202974,111461,27180
193206340,0.0,0.0,38000000,28681000,9319000,25,38000000,Null,Null,193206340,18802,1795
193206432,0.0,0.0,38000000,28681000,9319000,25,38000000,Null,Null,193206432,18802,1795
193206657,0.0,0.0,38531000,28681000,9850000,26,38531000,Null,Null,193206657,18802,1795
193207281,0.0,0.0,42000000,35150000,6850000,16,42000000,Null,Null,193207281,18802,1795
193207892,0.0,0.0,22551000,15800000,6751000,30,22551000,Null,Null,193207892,18802,1795
193207962,77.0,77.0,475000,319000,156000,33,475000,Null,Null,193207962,110935,1984
193208070,0.0,0.0,22551000,15800000,6751000,30,22551000,Null,Null,193208070,18802,1795
193208134,0.0,0.0,25990000,18490000,7500000,29,25990000,Null,Null,193208134,18802,1795
193208254,0.0,0.0,22200000,17160000,5040000,23,22200000,Null,Null,193208254,18802,1795
193209851,192.0,192.0,1190000,699000,491000,41,1190000,Null,Null,193209851,153086,28454
193209870,0.0,0.0,25990000,18490000,7500000,29,25990000,Null,Null,193209870,18802,1795
193211721,0.0,0.0,57285000,57285000,0,0,57285000,Null,Null,193211721,4554385,27128
193212049,0.0,0.0,50151000,50151000,0,0,50151000,Null,Null,193212049,4554385,27128
193213957,0.0,0.0,35000,35000,0,0,35000,Null,Null,193213957,111461,15318
193213982,0.0,0.0,15000,15000,0,0,15000,Null,Null,193213982,111461,15318
193223028,19.0,19.0,1300000,938000,362000,28,1300000,Null,Null,193223028,111454,28454
193223313,1.0,1.0,12000,12000,0,0,12000,Null,Null,193223313,111461,15318
193223354,0.0,0.0,11000,11000,0,0,11000,Null,Null,193223354,111461,15250
193223379,3.0,3.0,6500,6500,0,0,6500,Null,Null,193223379,111461,15318
193223504,0.0,0.0,17000,17000,0,0,17000,Null,Null,193223504,111461,15318
193223527,0.0,0.0,17000,17000,0,0,17000,Null,Null,193223527,111461,15318
193223608,0.0,0.0,15000,15000,0,0,15000,Null,Null,193223608,111461,15318
193223685,0.0,0.0,67583000,67583000,0,0,67583000,Null,Null,193223685,4554385,27128
193228970,0.0,0.0,63642000,63642000,0,0,63642000,Null,Null,193228970,4554385,27128
193229380,0.0,0.0,48524000,48524000,0,0,48524000,Null,Null,193229380,4554385,27128
193237231,0.0,0.0,47552000,47552000,0,0,47552000,Null,Null,193237231,4554385,27128
193237357,26.0,26.0,1350000,1180000,170000,13,1350000,Null,Null,193237357,722993,11867
193241522,0.0,0.0,39375000,39375000,0,0,39375000,Null,Null,193241522,4554385,27128
193246336,0.0,0.0,38024000,38024000,0,0,38024000,Null,Null,193246336,4554385,27128
193246983,0.0,0.0,2000,2000,0,0,2000,Null,Null,193246983,111461,2
193247512,303.0,303.0,50000,40000,10000,20,50000,Null,Null,193247512,111461,28484
193247967,0.0,0.0,19000,19000,0,0,19000,Null,Null,193247967,111461,2
193248124,46.0,46.0,35000,33250,1750,5,35000,Null,Null,193248124,839837,2685
193263880,9.0,9.0,3490000,2590000,900000,26,3490000,Null,Null,193263880,52232,1795
193279771,52.0,52.0,59900,59900,0,0,59900,Null,Null,193279771,111461,2
193279970,26.0,26.0,53910,53910,0,0,53910,Null,Null,193279970,111461,2
193310183,49.0,49.0,15990000,11990000,4000000,25,15990000,Null,Null,193310183,27468,1795
193341270,0.0,0.0,6485000,6485000,0,0,6485000,Null,Null,193341270,25502,8511
193365988,67.0,67.0,580000,580000,0,0,580000,Null,Null,193365988,885047,2016
193366048,0.0,0.0,15990000,15990000,0,0,15990000,Null,Null,193366048,27468,1795
193366090,2.0,2.0,170000,170000,0,0,170000,Null,Null,193366090,111461,28598
193398365,8.0,8.0,9000,9000,0,0,9000,Null,Null,193398365,111461,8202
193411597,2.0,2.0,58350000,29990000,28360000,49,58350000,Null,Null,193411597,4712171,2340
193433927,199.0,199.0,699000,568000,131000,19,699000,Null,Null,193433927,885047,2016
193434038,0.0,0.0,15770000,15770000,0,0,15770000,Null,Null,193434038,247279,20250
193439273,0.0,0.0,13559000,13559000,0,0,13559000,Null,Null,193439273,165337,20250
193450342,207.0,207.0,189000,119000,70000,37,189000,Null,Null,193450342,709163,23258
193461854,1.0,1.0,15000,15000,0,0,15000,Null,Null,193461854,111461,2
193467386,0.0,0.0,1900,1900,0,0,1900,Null,Null,193467386,111461,23712
193509074,152.0,152.0,3000,2000,1000,33,3000,Null,Null,193509074,111461,2
193509094,26.0,26.0,25000,25000,0,0,25000,Null,Null,193509094,111461,2
193511472,3.0,3.0,119000,119000,0,0,119000,Null,Null,193511472,111461,2
193515134,27.0,27.0,14500,9000,5500,38,14500,Null,Null,193515134,5055635,1815
193530021,55.0,55.0,186250,149000,37250,20,186250,Null,Null,193530021,4408565,23042
193530655,0.0,0.0,6500,6500,0,0,6500,Null,Null,193530655,111461,2
193530656,0.0,0.0,5000,5000,0,0,5000,Null,Null,193530656,111461,2
193530664,0.0,0.0,6000,6000,0,0,6000,Null,Null,193530664,111461,2
193530668,0.0,0.0,7900,7900,0,0,7900,Null,Null,193530668,111461,2
193530673,0.0,0.0,6000,6000,0,0,6000,Null,Null,193530673,111461,2
193530683,0.0,0.0,6300,6300,0,0,6300,Null,Null,193530683,111461,2
193530685,0.0,0.0,6000,6000,0,0,6000,Null,Null,193530685,111461,2
193530689,0.0,0.0,4000,4000,0,0,4000,Null,Null,193530689,111461,2
193530690,2.0,2.0,6500,6500,0,0,6500,Null,Null,193530690,111461,2
193530695,0.0,0.0,5000,5000,0,0,5000,Null,Null,193530695,111461,2
193530697,0.0,0.0,6500,6500,0,0,6500,Null,Null,193530697,111461,2
193530702,0.0,0.0,5300,5300,0,0,5300,Null,Null,193530702,111461,2
193530706,0.0,0.0,6500,6500,0,0,6500,Null,Null,193530706,111461,2
193530718,0.0,0.0,5000,5000,0,0,5000,Null,Null,193530718,111461,2
193530719,0.0,0.0,6500,6500,0,0,6500,Null,Null,193530719,111461,2
193530727,0.0,0.0,6500,6500,0,0,6500,Null,Null,193530727,111461,2
193530739,0.0,0.0,5000,5000,0,0,5000,Null,Null,193530739,111461,2
193530746,2.0,2.0,6000,6000,0,0,6000,Null,Null,193530746,111461,2
193530755,0.0,0.0,6000,6000,0,0,6000,Null,Null,193530755,111461,2
193530762,0.0,0.0,7000,7000,0,0,7000,Null,Null,193530762,111461,2
193530763,0.0,0.0,7900,7900,0,0,7900,Null,Null,193530763,111461,2
193530774,0.0,0.0,6800,6800,0,0,6800,Null,Null,193530774,111461,2
193530779,0.0,0.0,6000,6000,0,0,6000,Null,Null,193530779,111461,2
193530782,0.0,0.0,7300,7300,0,0,7300,Null,Null,193530782,111461,2
193530786,5.0,5.0,6300,6300,0,0,6300,Null,Null,193530786,111461,2
193530788,0.0,0.0,6000,6000,0,0,6000,Null,Null,193530788,111461,2
193530792,0.0,0.0,7900,7900,0,0,7900,Null,Null,193530792,111461,2
193530809,0.0,0.0,5300,5300,0,0,5300,Null,Null,193530809,111461,2
193530810,0.0,0.0,6500,6500,0,0,6500,Null,Null,193530810,111461,8167
193530811,0.0,0.0,7900,7900,0,0,7900,Null,Null,193530811,111461,8167
193530821,0.0,0.0,5000,5000,0,0,5000,Null,Null,193530821,111461,2
193530822,0.0,0.0,5000,5000,0,0,5000,Null,Null,193530822,111461,2
193530824,0.0,0.0,5000,5000,0,0,5000,Null,Null,193530824,111461,2
193530842,0.0,0.0,5000,5000,0,0,5000,Null,Null,193530842,111461,2
193530846,0.0,0.0,4000,4000,0,0,4000,Null,Null,193530846,111461,2
193530854,0.0,0.0,7000,7000,0,0,7000,Null,Null,193530854,111461,2
193530858,0.0,0.0,6300,6300,0,0,6300,Null,Null,193530858,111461,2
193530863,0.0,0.0,6000,6000,0,0,6000,Null,Null,193530863,111461,2
193530876,0.0,0.0,4000,4000,0,0,4000,Null,Null,193530876,111461,2
193530878,0.0,0.0,6000,6000,0,0,6000,Null,Null,193530878,111461,2
193530883,0.0,0.0,6500,6500,0,0,6500,Null,Null,193530883,111461,2
193530891,0.0,0.0,2000,2000,0,0,2000,Null,Null,193530891,111461,2
193530900,10.0,10.0,5000,5000,0,0,5000,Null,Null,193530900,111461,2
193530914,0.0,0.0,6500,6500,0,0,6500,Null,Null,193530914,111461,2
193530922,0.0,0.0,6300,6300,0,0,6300,Null,Null,193530922,111461,2
193530924,0.0,0.0,9500,9500,0,0,9500,Null,Null,193530924,111461,2
193530927,5.0,5.0,6500,6500,0,0,6500,Null,Null,193530927,111461,2
193530935,0.0,0.0,5000,5000,0,0,5000,Null,Null,193530935,111461,2
193530942,0.0,0.0,7900,7900,0,0,7900,Null,Null,193530942,111461,2
193530965,0.0,0.0,5000,5000,0,0,5000,Null,Null,193530965,111461,2
193530982,0.0,0.0,5000,5000,0,0,5000,Null,Null,193530982,111461,2
193530994,0.0,0.0,7900,7900,0,0,7900,Null,Null,193530994,111461,2
193531037,0.0,0.0,6000,6000,0,0,6000,Null,Null,193531037,111461,2
193531040,0.0,0.0,6500000,6500000,0,0,6500000,Null,Null,193531040,111461,2
193531043,0.0,0.0,1000,1000,0,0,1000,Null,Null,193531043,111461,2
193531048,0.0,0.0,6500,6500,0,0,6500,Null,Null,193531048,111461,2
193531055,0.0,0.0,6600,6600,0,0,6600,Null,Null,193531055,111461,2
193531077,0.0,0.0,6500,6500,0,0,6500,Null,Null,193531077,111461,2
193531110,0.0,0.0,7000,7000,0,0,7000,Null,Null,193531110,111461,2
193531111,30.0,30.0,6500,6500,0,0,6500,Null,Null,193531111,111461,2
193531117,0.0,0.0,3500,3500,0,0,3500,Null,Null,193531117,111461,8167
193531119,0.0,0.0,2500,2500,0,0,2500,Null,Null,193531119,111461,2
193531138,20.0,20.0,6000,6000,0,0,6000,Null,Null,193531138,111461,8167
193531148,0.0,0.0,2500,2500,0,0,2500,Null,Null,193531148,111461,2
193531163,0.0,0.0,6500,6500,0,0,6500,Null,Null,193531163,111461,2
193531164,0.0,0.0,5000,5000,0,0,5000,Null,Null,193531164,111461,2
193531171,0.0,0.0,1000,1000,0,0,1000,Null,Null,193531171,111461,2
193531173,0.0,0.0,7000,7000,0,0,7000,Null,Null,193531173,111461,8167
193531176,0.0,0.0,6000,6000,0,0,6000,Null,Null,193531176,111461,2
193531181,7.0,7.0,8500,8500,0,0,8500,Null,Null,193531181,111461,8167
193531183,70.0,70.0,6000,6000,0,0,6000,Null,Null,193531183,111461,2
193531192,0.0,0.0,4500,4500,0,0,4500,Null,Null,193531192,111461,8167
193531193,0.0,0.0,3000,3000,0,0,3000,Null,Null,193531193,111461,8167
193531200,0.0,0.0,6500,6500,0,0,6500,Null,Null,193531200,111461,8167
193531223,0.0,0.0,2000,2000,0,0,2000,Null,Null,193531223,111461,2
193531229,0.0,0.0,1000,1000,0,0,1000,Null,Null,193531229,111461,2
193531244,0.0,0.0,5000,5000,0,0,5000,Null,Null,193531244,111461,2
193531258,0.0,0.0,8000,8000,0,0,8000,Null,Null,193531258,111461,2
193531286,0.0,0.0,5900,5900,0,0,5900,Null,Null,193531286,111461,2
193531308,0.0,0.0,6900,6900,0,0,6900,Null,Null,193531308,111461,2
193531320,0.0,0.0,7000,7000,0,0,7000,Null,Null,193531320,111461,2
193531325,0.0,0.0,5000,5000,0,0,5000,Null,Null,193531325,111461,2
193531326,0.0,0.0,5900,5900,0,0,5900,Null,Null,193531326,111461,2
193531336,0.0,0.0,10000,10000,0,0,10000,Null,Null,193531336,111461,2
193531338,0.0,0.0,4900,4900,0,0,4900,Null,Null,193531338,111461,2
193531352,0.0,0.0,5800,5800,0,0,5800,Null,Null,193531352,111461,2
193531355,0.0,0.0,6500,6500,0,0,6500,Null,Null,193531355,111461,2
193531364,0.0,0.0,7900,7900,0,0,7900,Null,Null,193531364,111461,2
193531374,0.0,0.0,8500,8500,0,0,8500,Null,Null,193531374,111461,2
193531387,0.0,0.0,8000,8000,0,0,8000,Null,Null,193531387,111461,2
193531409,0.0,0.0,6000,6000,0,0,6000,Null,Null,193531409,111461,2
193531413,0.0,0.0,6500,6500,0,0,6500,Null,Null,193531413,111461,8167
193531420,0.0,0.0,1000,1000,0,0,1000,Null,Null,193531420,111461,2
193531421,0.0,0.0,2500,2500,0,0,2500,Null,Null,193531421,111461,8167
193531430,0.0,0.0,6800,6800,0,0,6800,Null,Null,193531430,111461,2
193531433,0.0,0.0,6500,6500,0,0,6500,Null,Null,193531433,111461,2
193531435,0.0,0.0,8100,8100,0,0,8100,Null,Null,193531435,111461,2
193531447,0.0,0.0,7000,7000,0,0,7000,Null,Null,193531447,111461,2
193531464,0.0,0.0,1000,1000,0,0,1000,Null,Null,193531464,111461,2
193531467,0.0,0.0,1000,1000,0,0,1000,Null,Null,193531467,111461,2
193531508,7.0,7.0,7000,7000,0,0,7000,Null,Null,193531508,111461,2
193531527,35.0,35.0,5000,5000,0,0,5000,Null,Null,193531527,111461,8167
193531546,0.0,0.0,4000,4000,0,0,4000,Null,Null,193531546,111461,2
193531572,0.0,0.0,6500,6500,0,0,6500,Null,Null,193531572,111461,2
193531577,0.0,0.0,5000,5000,0,0,5000,Null,Null,193531577,111461,2
193531578,10.0,10.0,5000,5000,0,0,5000,Null,Null,193531578,111461,2
193531581,0.0,0.0,4900,4900,0,0,4900,Null,Null,193531581,111461,2
193531582,0.0,0.0,9000,9000,0,0,9000,Null,Null,193531582,111461,2
193531585,0.0,0.0,5500,5500,0,0,5500,Null,Null,193531585,111461,2
193531603,0.0,0.0,4500,4500,0,0,4500,Null,Null,193531603,111461,8167
193531612,0.0,0.0,6500,6500,0,0,6500,Null,Null,193531612,111461,2
193531620,0.0,0.0,2500,2500,0,0,2500,Null,Null,193531620,111461,2
193531623,0.0,0.0,2500,2500,0,0,2500,Null,Null,193531623,111461,8167
193531627,0.0,0.0,1000,1000,0,0,1000,Null,Null,193531627,111461,2
193531628,0.0,0.0,7900,7900,0,0,7900,Null,Null,193531628,111461,2
193531629,0.0,0.0,8500,8500,0,0,8500,Null,Null,193531629,111461,2
193531630,0.0,0.0,2500,2500,0,0,2500,Null,Null,193531630,111461,2
193531649,0.0,0.0,7000,7000,0,0,7000,Null,Null,193531649,111461,2
193531651,0.0,0.0,5000,5000,0,0,5000,Null,Null,193531651,111461,2
193531657,0.0,0.0,6000,6000,0,0,6000,Null,Null,193531657,111461,8167
193531674,0.0,0.0,1000,1000,0,0,1000,Null,Null,193531674,111461,2
193531678,0.0,0.0,6500,6500,0,0,6500,Null,Null,193531678,111461,2
193531691,0.0,0.0,6800,6800,0,0,6800,Null,Null,193531691,111461,2
193531712,0.0,0.0,1000,1000,0,0,1000,Null,Null,193531712,111461,2
193531716,7.0,7.0,6500,6500,0,0,6500,Null,Null,193531716,111461,2
193531720,0.0,0.0,7900,7900,0,0,7900,Null,Null,193531720,111461,2
193531729,0.0,0.0,6500,6500,0,0,6500,Null,Null,193531729,111461,2
193531741,0.0,0.0,6000,6000,0,0,6000,Null,Null,193531741,111461,8167
193531742,0.0,0.0,5000,5000,0,0,5000,Null,Null,193531742,111461,8167
193531748,0.0,0.0,7000,7000,0,0,7000,Null,Null,193531748,111461,2
193531752,0.0,0.0,6500,6500,0,0,6500,Null,Null,193531752,111461,2
193531762,0.0,0.0,6500,6500,0,0,6500,Null,Null,193531762,111461,2
193531764,0.0,0.0,7000,7000,0,0,7000,Null,Null,193531764,111461,8167
193531770,0.0,0.0,5800,5800,0,0,5800,Null,Null,193531770,111461,2
193531771,0.0,0.0,1000,1000,0,0,1000,Null,Null,193531771,111461,2
193531779,0.0,0.0,5300,5300,0,0,5300,Null,Null,193531779,111461,2
193531783,0.0,0.0,6500,6500,0,0,6500,Null,Null,193531783,111461,2
193531806,0.0,0.0,6800,6800,0,0,6800,Null,Null,193531806,111461,2
193531808,0.0,0.0,9500,9500,0,0,9500,Null,Null,193531808,111461,2
193531827,0.0,0.0,5000,5000,0,0,5000,Null,Null,193531827,111461,2
193531842,0.0,0.0,5000,5000,0,0,5000,Null,Null,193531842,111461,2
193531854,0.0,0.0,7900,7900,0,0,7900,Null,Null,193531854,111461,2
193531857,0.0,0.0,2500,2500,0,0,2500,Null,Null,193531857,111461,2
193531876,0.0,0.0,1700,1700,0,0,1700,Null,Null,193531876,111461,2
193531883,0.0,0.0,1000,1000,0,0,1000,Null,Null,193531883,111461,2
193531885,0.0,0.0,10000,10000,0,0,10000,Null,Null,193531885,111461,2
193531896,10.0,10.0,6300,6300,0,0,6300,Null,Null,193531896,111461,2
193531925,0.0,0.0,7000,7000,0,0,7000,Null,Null,193531925,111461,2
193531929,0.0,0.0,7900,7900,0,0,7900,Null,Null,193531929,111461,2
193531931,0.0,0.0,7000,7000,0,0,7000,Null,Null,193531931,111461,2
193531938,0.0,0.0,5000,5000,0,0,5000,Null,Null,193531938,111461,2
193531939,0.0,0.0,5000,5000,0,0,5000,Null,Null,193531939,111461,2
193531948,0.0,0.0,1000,1000,0,0,1000,Null,Null,193531948,111461,2
193531957,0.0,0.0,4000,4000,0,0,4000,Null,Null,193531957,111461,2
193531965,0.0,0.0,8500,8500,0,0,8500,Null,Null,193531965,111461,2
193531970,0.0,0.0,5000,5000,0,0,5000,Null,Null,193531970,111461,2
193531972,0.0,0.0,7900,7900,0,0,7900,Null,Null,193531972,111461,2
193531977,0.0,0.0,5800,5800,0,0,5800,Null,Null,193531977,111461,2
193531980,0.0,0.0,6500,6500,0,0,6500,Null,Null,193531980,111461,2
193531982,0.0,0.0,1000,1000,0,0,1000,Null,Null,193531982,111461,2
193531986,0.0,0.0,1000,1000,0,0,1000,Null,Null,193531986,111461,2
193531991,0.0,0.0,1000,1000,0,0,1000,Null,Null,193531991,111461,2
193531996,0.0,0.0,1000,1000,0,0,1000,Null,Null,193531996,111461,2
193532026,0.0,0.0,5000,5000,0,0,5000,Null,Null,193532026,111461,2
193532034,0.0,0.0,2000,2000,0,0,2000,Null,Null,193532034,111461,2
193532056,70.0,70.0,6500,6500,0,0,6500,Null,Null,193532056,111461,2
193532057,0.0,0.0,6900,6900,0,0,6900,Null,Null,193532057,111461,2
193532071,0.0,0.0,8500,8500,0,0,8500,Null,Null,193532071,111461,2
193532088,0.0,0.0,1000,1000,0,0,1000,Null,Null,193532088,111461,8167
193532096,0.0,0.0,1000,1000,0,0,1000,Null,Null,193532096,111461,2
193532113,0.0,0.0,8500,8500,0,0,8500,Null,Null,193532113,111461,2
193532121,0.0,0.0,6800,6800,0,0,6800,Null,Null,193532121,111461,8167
193532162,0.0,0.0,8500,8500,0,0,8500,Null,Null,193532162,111461,2
193532165,0.0,0.0,1000,1000,0,0,1000,Null,Null,193532165,111461,2
193532182,0.0,0.0,6300,6300,0,0,6300,Null,Null,193532182,111461,2
193532184,0.0,0.0,6000,6000,0,0,6000,Null,Null,193532184,111461,2
193532202,0.0,0.0,1900,1900,0,0,1900,Null,Null,193532202,111461,2
193532204,0.0,0.0,1000,1000,0,0,1000,Null,Null,193532204,111461,2
193532207,0.0,0.0,7900,7900,0,0,7900,Null,Null,193532207,111461,2
193532213,0.0,0.0,2500,2500,0,0,2500,Null,Null,193532213,111461,2
193532217,20.0,20.0,5000,5000,0,0,5000,Null,Null,193532217,111461,2
193532236,2.0,2.0,6000,6000,0,0,6000,Null,Null,193532236,111461,2
193532239,0.0,0.0,6000,6000,0,0,6000,Null,Null,193532239,111461,8167
193532275,0.0,0.0,5000,5000,0,0,5000,Null,Null,193532275,111461,2
193532338,0.0,0.0,5300,5300,0,0,5300,Null,Null,193532338,111461,2
193532383,0.0,0.0,7000,7000,0,0,7000,Null,Null,193532383,111461,2
193532415,0.0,0.0,7000,7000,0,0,7000,Null,Null,193532415,111461,8167
193532425,0.0,0.0,6000,6000,0,0,6000,Null,Null,193532425,111461,2
193532427,30.0,30.0,6000,6000,0,0,6000,Null,Null,193532427,111461,8167
193532447,0.0,0.0,5000,5000,0,0,5000,Null,Null,193532447,111461,8167
193532450,0.0,0.0,6000,6000,0,0,6000,Null,Null,193532450,111461,2
193532498,0.0,0.0,5000,5000,0,0,5000,Null,Null,193532498,111461,2
193532507,0.0,0.0,7900,7900,0,0,7900,Null,Null,193532507,111461,2
193532517,0.0,0.0,1500,1500,0,0,1500,Null,Null,193532517,111461,8167
193532523,0.0,0.0,7000,7000,0,0,7000,Null,Null,193532523,111461,2
193532529,0.0,0.0,6000,6000,0,0,6000,Null,Null,193532529,111461,2
193532533,1.0,1.0,7000,7000,0,0,7000,Null,Null,193532533,111461,8167
193532544,0.0,0.0,5000,5000,0,0,5000,Null,Null,193532544,111461,2
193532553,0.0,0.0,4500,4500,0,0,4500,Null,Null,193532553,111461,2
193532556,0.0,0.0,8900,8900,0,0,8900,Null,Null,193532556,111461,2
193532558,3.0,3.0,5000,5000,0,0,5000,Null,Null,193532558,111461,8167
193532584,0.0,0.0,6000,6000,0,0,6000,Null,Null,193532584,111461,8167
193532623,0.0,0.0,1000,1000,0,0,1000,Null,Null,193532623,111461,2
193532630,0.0,0.0,6500,6500,0,0,6500,Null,Null,193532630,111461,2
193532660,0.0,0.0,7000,7000,0,0,7000,Null,Null,193532660,111461,8167
193532661,0.0,0.0,1700,1700,0,0,1700,Null,Null,193532661,111461,8193
193532730,0.0,0.0,6000,6000,0,0,6000,Null,Null,193532730,111461,8167
193532744,0.0,0.0,5000,5000,0,0,5000,Null,Null,193532744,111461,2
193532752,0.0,0.0,1000,1000,0,0,1000,Null,Null,193532752,111461,2
193532798,0.0,0.0,7900,7900,0,0,7900,Null,Null,193532798,111461,2
193532808,0.0,0.0,9000,9000,0,0,9000,Null,Null,193532808,111461,2
193532815,26.0,26.0,5000,5000,0,0,5000,Null,Null,193532815,111461,8167
193532820,0.0,0.0,5000,5000,0,0,5000,Null,Null,193532820,111461,2
193533153,1.0,1.0,4500,4500,0,0,4500,Null,Null,193533153,111461,20222
193534727,183.0,183.0,450000,288000,162000,36,450000,Null,Null,193534727,454561,1623
193541405,162.0,162.0,340200,189000,151200,44,340200,Null,Null,193541405,46703,5995
193553588,0.0,0.0,12750000,12750000,0,0,12750000,Null,Null,193553588,18802,8067
193563121,7.0,7.0,129000,129000,0,0,129000,Null,Null,193563121,111461,3990
193563135,2.0,2.0,99000,99000,0,0,99000,Null,Null,193563135,183257,15250
193570155,30.0,30.0,78000,42000,36000,46,78000,Null,Null,193570155,46703,27256
193577444,78.0,78.0,135000,135000,0,0,135000,Null,Null,193577444,111461,3178
193583704,94.0,94.0,142500,121000,21500,15,142500,Null,Null,193583704,21265,13878
193583705,399.0,399.0,198500,173000,25500,13,198500,Null,Null,193583705,21265,8212
193583708,207.0,207.0,198500,171000,27500,14,198500,Null,Null,193583708,21265,8212
193583711,236.0,236.0,142500,121000,21500,15,142500,Null,Null,193583711,21265,8212
193583714,109.0,109.0,138000,121000,17000,12,138000,Null,Null,193583714,21265,13878
193583716,1175.0,1175.0,198500,189000,9500,5,198500,Null,Null,193583716,21265,13878
193583718,186.0,186.0,168000,115000,53000,32,168000,Null,Null,193583718,21265,13878
193584510,2.0,2.0,658000,399000,259000,39,658000,Null,Null,193584510,183257,15318
193590209,0.0,0.0,26900000,26900000,0,0,26900000,Null,Null,193590209,167287,11518
193605808,41.0,41.0,310000,310000,0,0,310000,Null,Null,193605808,111461,23622
193609516,40.0,40.0,30000,15600,14400,48,30000,Null,Null,193609516,111461,53074
193615420,1.0,1.0,198000,99000,99000,50,198000,Null,Null,193615420,7400131,15318
193620736,0.0,0.0,10200000,10200000,0,0,10200000,Null,Null,193620736,111461,2342
193625566,0.0,0.0,12300000,12300000,0,0,12300000,Null,Null,193625566,167287,8070
193642886,0.0,0.0,15400,15400,0,0,15400,Null,Null,193642886,111461,2
193642891,1.0,1.0,16100,16100,0,0,16100,Null,Null,193642891,111461,2
193642918,0.0,0.0,15400,15400,0,0,15400,Null,Null,193642918,111461,2
193642960,0.0,0.0,18900,18900,0,0,18900,Null,Null,193642960,111461,2
193643005,0.0,0.0,15400,15400,0,0,15400,Null,Null,193643005,111461,2
193643007,0.0,0.0,16100,16100,0,0,16100,Null,Null,193643007,111461,2
193645400,0.0,0.0,21938000,21938000,0,0,21938000,Null,Null,193645400,165337,20250
193646232,0.0,0.0,15638000,15638000,0,0,15638000,Null,Null,193646232,165337,20250
193647574,0.0,0.0,8000,8000,0,0,8000,Null,Null,193647574,111461,2
193648147,0.0,0.0,64999,64999,0,0,64999,Null,Null,193648147,111461,2
193692455,115.0,115.0,479000,249000,230000,48,479000,Null,Null,193692455,290031,1597
193702254,0.0,0.0,13063000,13063000,0,0,13063000,Null,Null,193702254,165337,20254
193703461,0.0,0.0,33841000,33841000,0,0,33841000,Null,Null,193703461,165337,20254
193708243,0.0,0.0,12000000,12000000,0,0,12000000,Null,Null,193708243,165337,20254
193708669,317.0,317.0,160200,89000,71200,44,160200,Null,Null,193708669,46703,23282
193709920,373.0,373.0,178200,99000,79200,44,178200,Null,Null,193709920,46703,23282
193715441,0.0,0.0,8500000,6298000,2202000,26,8500000,Null,Null,193715441,26150,8513
193717135,72.0,72.0,299000,152000,147000,49,299000,Null,Null,193717135,290031,1607
193717525,30.0,30.0,269000,135000,134000,50,269000,Null,Null,193717525,290031,1641
193719269,8.0,8.0,1599000,1199000,400000,25,1599000,Null,Null,193719269,46363,977
193720686,152.0,152.0,304000,122000,182000,60,304000,Null,Null,193720686,290031,8192
193724496,87.0,87.0,550000,550000,0,0,550000,Null,Null,193724496,4935523,12984
193733976,0.0,0.0,5263000,4565000,698000,13,5263000,Null,Null,193733976,18802,1795
193736472,163.0,163.0,288000,244000,44000,15,288000,Null,Null,193736472,5172027,1626
193738428,61.0,61.0,30000,15000,15000,50,30000,Null,Null,193738428,111461,18888
193747625,0.0,0.0,2500,2500,0,0,2500,Null,Null,193747625,111461,23112
193758300,0.0,0.0,35500000,35500000,0,0,35500000,Null,Null,193758300,167287,2324
193758408,0.0,0.0,27500000,27500000,0,0,27500000,Null,Null,193758408,879235,2340
193758454,0.0,0.0,70000000,70000000,0,0,70000000,Null,Null,193758454,247279,20254
193760736,0.0,0.0,16500000,16500000,0,0,16500000,Null,Null,193760736,879235,2340
193769065,0.0,0.0,5436000,5436000,0,0,5436000,Null,Null,193769065,25643,1795
193769086,0.0,0.0,6348000,6348000,0,0,6348000,Null,Null,193769086,25643,1795
193769136,0.0,0.0,3012000,2794000,218000,7,3012000,Null,Null,193769136,25643,1795
193769143,0.0,0.0,4632000,4632000,0,0,4632000,Null,Null,193769143,25643,1795
193769168,0.0,0.0,4284000,4284000,0,0,4284000,Null,Null,193769168,25643,1795
193769760,2.0,2.0,7000000,7000000,0,0,7000000,Null,Null,193769760,111461,8172
193770040,0.0,0.0,9357143,9357143,0,0,9357143,Null,Null,193770040,405211,5384
193771459,1.0,1.0,8500000,8500000,0,0,8500000,Null,Null,193771459,111461,2342
193771618,109.0,109.0,169000,139000,30000,18,169000,Null,Null,193771618,111461,3177
193771712,31.0,31.0,20000,11000,9000,45,20000,Null,Null,193771712,111461,20236
193773491,0.0,0.0,10500000,7350000,3150000,30,10500000,Null,Null,193773491,405211,8512
193773814,1.0,1.0,7900000,5598000,2302000,29,7900000,Null,Null,193773814,26150,8513
193773822,0.0,0.0,9500000,7125000,2375000,25,9500000,Null,Null,193773822,26150,8513
193773824,0.0,0.0,11100000,7798000,3302000,30,11100000,Null,Null,193773824,26150,8513
193773828,1.0,1.0,8900000,6666000,2234000,25,8900000,Null,Null,193773828,26150,8513
193773834,3.0,3.0,7900000,5925000,1975000,25,7900000,Null,Null,193773834,26150,8513
193773836,1.0,1.0,7900000,5798000,2102000,27,7900000,Null,Null,193773836,26150,8513
193777430,0.0,0.0,10500000,7350000,3150000,30,10500000,Null,Null,193777430,405211,8512
193857816,108.0,108.0,1900,1900,0,0,1900,Null,Null,193857816,111461,53074
193859499,142.0,142.0,60000,38000,22000,37,60000,Null,Null,193859499,4224691,2225
193874743,34.0,34.0,120000,120000,0,0,120000,Null,Null,193874743,5738319,28430
193879341,4034.0,4034.0,140000,86000,54000,39,140000,Null,Null,193879341,4766405,1520
193881155,2.0,2.0,14890000,14890000,0,0,14890000,Null,Null,193881155,185209,28646
193883161,2.0,2.0,5000,5000,0,0,5000,Null,Null,193883161,111461,8165
193897167,0.0,0.0,15000,15000,0,0,15000,Null,Null,193897167,111461,15236
193897391,0.0,0.0,15000,15000,0,0,15000,Null,Null,193897391,111461,15236
193900108,0.0,0.0,200000,155000,45000,23,200000,Null,Null,193900108,111461,8167
193904297,0.0,0.0,40950000,39722000,1228000,3,40950000,Null,Null,193904297,111461,23622
193922604,0.0,0.0,10500000,7350000,3150000,30,10500000,Null,Null,193922604,405211,8512
193923542,0.0,0.0,12900000,12900000,0,0,12900000,Null,Null,193923542,111461,8066
193924723,0.0,0.0,16800000,16800000,0,0,16800000,Null,Null,193924723,111461,8066
193925270,0.0,0.0,10500000,10500000,0,0,10500000,Null,Null,193925270,405211,8512
193928103,0.0,0.0,10500000,7350000,3150000,30,10500000,Null,Null,193928103,405211,8512
193938371,30.0,30.0,58800,58800,0,0,58800,Null,Null,193938371,111461,2340
193974171,57.0,57.0,120000,120000,0,0,120000,Null,Null,193974171,4973949,28574
193978021,41.0,41.0,488000,488000,0,0,488000,Null,Null,193978021,7481025,1978
193979826,1.0,1.0,10900000,9942000,958000,9,10900000,Null,Null,193979826,4093985,2340
193979830,48.0,48.0,6990000,5490000,1500000,21,6990000,Null,Null,193979830,25643,1795
193980896,0.0,0.0,2500,2500,0,0,2500,Null,Null,193980896,111461,28472
193981143,0.0,0.0,7800000,7800000,0,0,7800000,Null,Null,193981143,145556,15318
193987739,0.0,0.0,7800000,7800000,0,0,7800000,Null,Null,193987739,145556,15318
193987885,0.0,0.0,7800000,7800000,0,0,7800000,Null,Null,193987885,145556,15318
193988101,0.0,0.0,7800000,7800000,0,0,7800000,Null,Null,193988101,145556,15318
193988674,0.0,0.0,7800000,7800000,0,0,7800000,Null,Null,193988674,145556,15318
193993539,0.0,0.0,7280000,7280000,0,0,7280000,Null,Null,193993539,145556,15318
193993631,0.0,0.0,7280000,7280000,0,0,7280000,Null,Null,193993631,145556,15318
193993738,0.0,0.0,7280000,7280000,0,0,7280000,Null,Null,193993738,145556,15318
193994051,0.0,0.0,7800000,7800000,0,0,7800000,Null,Null,193994051,145556,15318
193994094,0.0,0.0,7800000,7800000,0,0,7800000,Null,Null,193994094,145556,15318
193994101,57.0,57.0,152000,149000,3000,2,152000,Null,Null,193994101,111461,23658
193994110,84.0,84.0,350000,249000,101000,29,350000,Null,Null,193994110,454561,1616
193994149,0.0,0.0,7800000,7800000,0,0,7800000,Null,Null,193994149,145556,15318
194003618,0.0,0.0,7800000,7800000,0,0,7800000,Null,Null,194003618,145556,15318
194003693,0.0,0.0,7800000,7800000,0,0,7800000,Null,Null,194003693,145556,15318
194004152,0.0,0.0,7800000,7800000,0,0,7800000,Null,Null,194004152,145556,15318
194004239,0.0,0.0,7800000,7800000,0,0,7800000,Null,Null,194004239,145556,15318
194004303,0.0,0.0,7800000,7800000,0,0,7800000,Null,Null,194004303,145556,15318
194004406,0.0,0.0,7280000,7280000,0,0,7280000,Null,Null,194004406,145556,15318
194004457,0.0,0.0,7280000,7280000,0,0,7280000,Null,Null,194004457,145556,15318
194004495,0.0,0.0,7280000,7280000,0,0,7280000,Null,Null,194004495,145556,15318
194004589,0.0,0.0,7280000,7280000,0,0,7280000,Null,Null,194004589,145556,15318
194004661,0.0,0.0,7800000,7800000,0,0,7800000,Null,Null,194004661,145556,15318
194004721,0.0,0.0,7800000,7800000,0,0,7800000,Null,Null,194004721,145556,15318
194005031,0.0,0.0,7800000,7800000,0,0,7800000,Null,Null,194005031,145556,15318
194005044,0.0,0.0,7800000,7800000,0,0,7800000,Null,Null,194005044,145556,15318
194005215,0.0,0.0,7800000,7800000,0,0,7800000,Null,Null,194005215,145556,15318
194005273,0.0,0.0,7800000,7800000,0,0,7800000,Null,Null,194005273,145556,15318
194005605,59.0,59.0,586000,545000,41000,7,586000,Null,Null,194005605,149699,1583
194016478,121.0,121.0,2000,2000,0,0,2000,Null,Null,194016478,111461,2
194017030,0.0,0.0,10000,10000,0,0,10000,Null,Null,194017030,156901,1601
194020045,0.0,0.0,18900000,18900000,0,0,18900000,Null,Null,194020045,25422,1795
194023606,2.0,2.0,11000,8000,3000,27,11000,Null,Null,194023606,111461,2
194024701,32.0,32.0,686000,466480,219520,32,686000,Null,Null,194024701,111461,2657
194034217,291.0,291.0,23990000,17990000,6000000,25,23990000,Null,Null,194034217,18802,1795
194034389,3.0,3.0,550000,550000,0,0,550000,Null,Null,194034389,111461,8512
194037693,0.0,0.0,9000,9000,0,0,9000,Null,Null,194037693,111461,2
194037967,84.0,84.0,25990000,19990000,6000000,23,25990000,Null,Null,194037967,18802,1795
194039952,1.0,1.0,15000,15000,0,0,15000,Null,Null,194039952,111461,2
194040095,1.0,1.0,12000,12000,0,0,12000,Null,Null,194040095,111461,2
194040127,0.0,0.0,8500,8500,0,0,8500,Null,Null,194040127,111461,2
194040394,0.0,0.0,10000,10000,0,0,10000,Null,Null,194040394,156901,1601
194040396,93.0,93.0,374000,267000,107000,29,374000,Null,Null,194040396,41661,1627
194040985,120.0,120.0,164000,118000,46000,28,164000,Null,Null,194040985,41661,1627
194041787,0.0,0.0,38000000,28681000,9319000,25,38000000,Null,Null,194041787,18802,1795
194041977,0.0,0.0,42000000,35150000,6850000,16,42000000,Null,Null,194041977,18802,1795
194084466,0.0,0.0,5977000,5977000,0,0,5977000,Null,Null,194084466,111461,2
194084470,0.0,0.0,10150000,10150000,0,0,10150000,Null,Null,194084470,111461,2
194084492,0.0,0.0,9694000,9694000,0,0,9694000,Null,Null,194084492,111461,2
194084513,0.0,0.0,6534000,6534000,0,0,6534000,Null,Null,194084513,111461,2
194084522,0.0,0.0,12672000,12672000,0,0,12672000,Null,Null,194084522,111461,2
194084536,0.0,0.0,6488000,6488000,0,0,6488000,Null,Null,194084536,111461,2
194084557,0.0,0.0,7070000,7070000,0,0,7070000,Null,Null,194084557,111461,2
194084565,0.0,0.0,5977000,5977000,0,0,5977000,Null,Null,194084565,111461,2
194084583,0.0,0.0,6325000,6325000,0,0,6325000,Null,Null,194084583,111461,2
194084607,0.0,0.0,6151000,6151000,0,0,6151000,Null,Null,194084607,111461,2
194084621,0.0,0.0,18999000,18999000,0,0,18999000,Null,Null,194084621,111461,2
194084628,0.0,0.0,11007000,11007000,0,0,11007000,Null,Null,194084628,111461,2
194084631,0.0,0.0,11007000,11007000,0,0,11007000,Null,Null,194084631,111461,2
194084636,0.0,0.0,7420000,7420000,0,0,7420000,Null,Null,194084636,111461,2
194084637,0.0,0.0,6656000,6656000,0,0,6656000,Null,Null,194084637,111461,2
194084644,0.0,0.0,5890000,5890000,0,0,5890000,Null,Null,194084644,111461,2
194084646,0.0,0.0,6560000,6560000,0,0,6560000,Null,Null,194084646,111461,2
194086805,1.0,1.0,649000,649000,0,0,649000,Null,Null,194086805,111461,15936
194101531,84.0,84.0,990000,749000,241000,24,990000,Null,Null,194101531,111454,12928
194101714,0.0,0.0,44500000,44500000,0,0,44500000,Null,Null,194101714,111461,23596
194102559,0.0,0.0,68900000,68900000,0,0,68900000,Null,Null,194102559,111461,23596
194103026,0.0,0.0,10000,6000,4000,40,10000,Null,Null,194103026,48381,1601
194103280,56.0,56.0,35000000,19990000,15010000,43,35000000,Null,Null,194103280,4712171,2340
194103369,2.0,2.0,10000,6000,4000,40,10000,Null,Null,194103369,48381,1601
194103984,4.0,4.0,49000,34000,15000,31,49000,Null,Null,194103984,5207367,23040
194104327,31.0,31.0,10000,6000,4000,40,10000,Null,Null,194104327,48381,1601
194105430,0.0,0.0,10000,6000,4000,40,10000,Null,Null,194105430,48381,1601
194113922,30.0,30.0,10000,6000,4000,40,10000,Null,Null,194113922,48381,1601
194114636,99.0,99.0,114000,98000,16000,14,114000,Null,Null,194114636,21265,11817
194116092,0.0,0.0,65000000,65000000,0,0,65000000,Null,Null,194116092,146400,23438
194125008,511.0,511.0,58000,34000,24000,41,58000,Null,Null,194125008,111461,2685
194125023,509.0,509.0,148000,94000,54000,36,148000,Null,Null,194125023,111461,2685
194125082,827.0,827.0,38000,14900,23100,61,38000,Null,Null,194125082,111461,2685
194125350,16.0,16.0,850000,425000,425000,50,850000,Null,Null,194125350,217131,11869
194125862,8.0,8.0,10000,6000,4000,40,10000,Null,Null,194125862,48381,1601
194128053,0.0,0.0,2500,2000,500,20,2500,Null,Null,194128053,111461,20222
194129095,0.0,0.0,8000,6000,2000,25,8000,Null,Null,194129095,48381,1601
194130203,0.0,0.0,9998000,4999000,4999000,50,9998000,Null,Null,194130203,204665,2162
194131300,0.0,0.0,13590000,11890000,1700000,13,13590000,Null,Null,194131300,5740935,8400
194133874,52.0,52.0,115000,115000,0,0,115000,Null,Null,194133874,19107,1815
194134614,12.0,12.0,499000,369000,130000,26,499000,Null,Null,194134614,625853,28454
194139960,1.0,1.0,210000,210000,0,0,210000,Null,Null,194139960,111461,15318
194140985,167.0,167.0,38000,29000,9000,24,38000,Null,Null,194140985,32909,1613
194149881,41.0,41.0,97000,97000,0,0,97000,Null,Null,194149881,111461,12908
194175272,50.0,50.0,2000,2000,0,0,2000,Null,Null,194175272,111461,2
194183796,0.0,0.0,125000,98999,26001,21,125000,Null,Null,194183796,4973949,20244
194193197,0.0,0.0,680000,680000,0,0,680000,Null,Null,194193197,111461,23276
194193205,135.0,135.0,990000,799000,191000,19,990000,Null,Null,194193205,885047,8400
194198355,1.0,1.0,550000,420000,130000,24,550000,Null,Null,194198355,183257,15236
194200217,0.0,0.0,2000,2000,0,0,2000,Null,Null,194200217,111461,53070
194206905,0.0,0.0,1299000,1299000,0,0,1299000,Null,Null,194206905,111461,15318
194306324,0.0,0.0,2500,2500,0,0,2500,Null,Null,194306324,111461,27180
194346847,0.0,0.0,55000000,55000000,0,0,55000000,Null,Null,194346847,4301163,2340
194395860,0.0,0.0,5498000,5498000,0,0,5498000,Null,Null,194395860,19018,1634
194398769,282.0,282.0,649000,575000,74000,11,649000,Null,Null,194398769,4691869,5267
194400887,0.0,0.0,2000,2000,0,0,2000,Null,Null,194400887,111461,23042
194406051,0.0,0.0,10000,6000,4000,40,10000,Null,Null,194406051,48381,1601
194406697,55.0,55.0,2650000,2650000,0,0,2650000,Null,Null,194406697,5130185,23050
194406836,0.0,0.0,45000000,45000000,0,0,45000000,Null,Null,194406836,4301163,2340
194407970,12.0,12.0,12848000,12848000,0,0,12848000,Null,Null,194407970,5740935,5531
194414763,0.0,0.0,85000000,85000000,0,0,85000000,Null,Null,194414763,4301163,2340
194415049,1.0,1.0,49960000,49960000,0,0,49960000,Null,Null,194415049,5740935,2324
194418200,0.0,0.0,7490000,7490000,0,0,7490000,Null,Null,194418200,536905,11857
194420262,0.0,0.0,120000000,120000000,0,0,120000000,Null,Null,194420262,4301163,2340
194420739,0.0,0.0,64240000,64240000,0,0,64240000,Null,Null,194420739,5740935,8067
194432931,17.0,17.0,45000,40000,5000,11,45000,Null,Null,194432931,111461,8513
194448358,38.0,38.0,212000,106000,106000,50,212000,Null,Null,194448358,111461,15318
194449182,114.0,114.0,28000,14000,14000,50,28000,Null,Null,194449182,111461,15318
194449553,39.0,39.0,219000,118900,100100,46,219000,Null,Null,194449553,48077,2513
194455161,2.0,2.0,205000,205000,0,0,205000,Null,Null,194455161,4973949,28486
194457717,1.0,1.0,8000,8000,0,0,8000,Null,Null,194457717,111461,5566
194458001,278.0,278.0,500000,338000,162000,32,500000,Null,Null,194458001,500047,5531
194458229,1.0,1.0,270000,89000,181000,67,270000,Null,Null,194458229,7245301,15320
194462682,0.0,0.0,3490000,3490000,0,0,3490000,Null,Null,194462682,49994,1795
194465122,181.0,181.0,1490000,794000,696000,47,1490000,Null,Null,194465122,48077,53348
194465123,396.0,396.0,1590000,849000,741000,47,1590000,Null,Null,194465123,48077,1626
194465126,141.0,141.0,186000,96000,90000,48,186000,Null,Null,194465126,48077,1626
194465292,345.0,345.0,489000,254000,235000,48,489000,Null,Null,194465292,48077,1936
194470285,5.0,5.0,169000,169000,0,0,169000,Null,Null,194470285,111461,49722
194473476,4.0,4.0,109000,109000,0,0,109000,Null,Null,194473476,111461,49722
194478059,40.0,40.0,139700,139700,0,0,139700,Null,Null,194478059,732689,3178
194486989,0.0,0.0,1249,1249,0,0,1249,Null,Null,194486989,111461,2
194487199,130.0,130.0,360000,269000,91000,25,360000,Null,Null,194487199,202607,1583
194487207,95.0,95.0,65000,65000,0,0,65000,Null,Null,194487207,202607,8167
194487212,430.0,430.0,550000,495000,55000,10,550000,Null,Null,194487212,202607,17170
194489407,0.0,0.0,8644000,8644000,0,0,8644000,Null,Null,194489407,25643,1795
194490039,0.0,0.0,55000000,55000000,0,0,55000000,Null,Null,194490039,4301163,2340
194490386,0.0,0.0,7956000,7956000,0,0,7956000,Null,Null,194490386,25643,1795
194491632,0.0,0.0,40000000,40000000,0,0,40000000,Null,Null,194491632,4301163,2340
194496764,0.0,0.0,90000000,90000000,0,0,90000000,Null,Null,194496764,4301163,2340
194496895,169.0,169.0,129000,85000,44000,34,129000,Null,Null,194496895,230607,23052
194497974,357.0,357.0,180000,158000,22000,12,180000,Null,Null,194497974,79682,11835
194498258,123.0,123.0,210000,152000,58000,28,210000,Null,Null,194498258,230607,2154
194498783,10.0,10.0,32500,32500,0,0,32500,Null,Null,194498783,111461,2685
194498804,4.0,4.0,6990000,6590000,400000,6,6990000,Null,Null,194498804,25643,1794
194498821,4.0,4.0,17000,17000,0,0,17000,Null,Null,194498821,111461,2
194498823,2.0,2.0,17000,17000,0,0,17000,Null,Null,194498823,111461,2
194500873,9.0,9.0,10000,10000,0,0,10000,Null,Null,194500873,111461,2
194500884,7.0,7.0,15000,15000,0,0,15000,Null,Null,194500884,111461,2
194504716,41.0,41.0,1990000,1490000,500000,25,1990000,Null,Null,194504716,25643,8400
194519454,0.0,0.0,20500000,17700000,2800000,14,20500000,Null,Null,194519454,18802,1794
194523288,0.0,0.0,30000000,27500000,2500000,8,30000000,Null,Null,194523288,18802,1794
194563849,0.0,0.0,18000,18000,0,0,18000,Null,Null,194563849,111461,15250
194563966,0.0,0.0,8000,8000,0,0,8000,Null,Null,194563966,111461,15320
194570336,141.0,141.0,49000,49000,0,0,49000,Null,Null,194570336,5706641,23622
194570978,161.0,161.0,398000,199000,199000,50,398000,Null,Null,194570978,7400131,15318
194583058,95.0,95.0,55000,31999,23001,42,55000,Null,Null,194583058,456351,2018
194583418,0.0,0.0,8195000,8195000,0,0,8195000,Null,Null,194583418,5144053,11849
194787568,0.0,0.0,14750000,14750000,0,0,14750000,Null,Null,194787568,53189,8172
194788716,1.0,1.0,899000,699000,200000,22,899000,Null,Null,194788716,25422,1626
194793730,6.0,6.0,8050,8050,0,0,8050,Null,Null,194793730,111461,28468
194793743,20.0,20.0,8050,8050,0,0,8050,Null,Null,194793743,111461,28468
194793752,6.0,6.0,5750,5750,0,0,5750,Null,Null,194793752,111461,28468
194793756,29.0,29.0,8050,8050,0,0,8050,Null,Null,194793756,111461,28468
194804447,0.0,0.0,8050,8050,0,0,8050,Null,Null,194804447,111461,28468
194804481,20.0,20.0,5750,5750,0,0,5750,Null,Null,194804481,111461,28468
194804553,0.0,0.0,9200,9200,0,0,9200,Null,Null,194804553,111461,28468
194804685,0.0,0.0,9200,9200,0,0,9200,Null,Null,194804685,111461,28468
194804743,0.0,0.0,9200,9200,0,0,9200,Null,Null,194804743,111461,28468
194804745,0.0,0.0,9200,9200,0,0,9200,Null,Null,194804745,111461,28468
194805102,0.0,0.0,6900,6900,0,0,6900,Null,Null,194805102,111461,28472
194805564,0.0,0.0,9200,9200,0,0,9200,Null,Null,194805564,111461,28472
194805660,4.0,4.0,6900,6900,0,0,6900,Null,Null,194805660,111461,28472
194805766,0.0,0.0,9200,9200,0,0,9200,Null,Null,194805766,111461,28472
194805805,0.0,0.0,1380,1380,0,0,1380,Null,Null,194805805,111461,28472
194805921,0.0,0.0,9200,9200,0,0,9200,Null,Null,194805921,111461,28472
194806035,2.0,2.0,9200,9200,0,0,9200,Null,Null,194806035,111461,28472
194806046,5.0,5.0,6900,6900,0,0,6900,Null,Null,194806046,111461,28472
194806070,0.0,0.0,6900,6900,0,0,6900,Null,Null,194806070,111461,28472
194819488,337.0,337.0,52000,26000,26000,50,52000,Null,Null,194819488,153168,1936
194827883,36.0,36.0,165000,165000,0,0,165000,Null,Null,194827883,111461,23288
194835755,42.0,42.0,198000,99000,99000,50,198000,Null,Null,194835755,7400131,8371
194835828,217.0,217.0,295000,295000,0,0,295000,Null,Null,194835828,111454,1815
194845821,0.0,0.0,2000,2000,0,0,2000,Null,Null,194845821,111461,53070
194846084,0.0,0.0,14900,14900,0,0,14900,Null,Null,194846084,111461,15318
194857536,98.0,98.0,320000,320000,0,0,320000,Null,Null,194857536,25422,5905
194860325,0.0,0.0,9900,9900,0,0,9900,Null,Null,194860325,111461,2
194860347,0.0,0.0,19000,19000,0,0,19000,Null,Null,194860347,111461,2
194860398,0.0,0.0,9500,9500,0,0,9500,Null,Null,194860398,111461,2
194860458,0.0,0.0,6500,6500,0,0,6500,Null,Null,194860458,111461,2
194860532,53.0,53.0,2000,2000,0,0,2000,Null,Null,194860532,111461,2
194860542,0.0,0.0,2800,2800,0,0,2800,Null,Null,194860542,111461,2
194860649,5.0,5.0,7000,7000,0,0,7000,Null,Null,194860649,111461,2
194860764,428.0,428.0,899000,373000,526000,59,899000,Null,Null,194860764,361359,5531
194861709,0.0,0.0,15000,15000,0,0,15000,Null,Null,194861709,111461,15318
194953544,71.0,71.0,599000,395340,203660,34,599000,Null,Null,194953544,25422,1626
194961039,0.0,0.0,20250000,15800000,4450000,22,20250000,Null,Null,194961039,18802,1795
195000435,94.0,94.0,179000,179000,0,0,179000,Null,Null,195000435,864561,1520
195030675,4.0,4.0,68000,68000,0,0,68000,Null,Null,195030675,174069,1820
195032585,2.0,2.0,54000,54000,0,0,54000,Null,Null,195032585,111461,28674
195032632,69.0,69.0,300000,239000,61000,20,300000,Null,Null,195032632,625265,28574
195090848,0.0,0.0,20000000,13490000,6510000,33,20000000,Null,Null,195090848,47424,2342
195103768,0.0,0.0,54990,54990,0,0,54990,Null,Null,195103768,422017,1820
195105079,131.0,131.0,214000,99000,115000,54,214000,Null,Null,195105079,464405,23370
195105261,0.0,0.0,3950000,3950000,0,0,3950000,Null,Null,195105261,18804,1626
195107143,0.0,0.0,22500000,22500000,0,0,22500000,Null,Null,195107143,165337,20254
195110174,0.0,0.0,15150000,15150000,0,0,15150000,Null,Null,195110174,167287,11518
195111061,54.0,54.0,820000,431000,389000,47,820000,Null,Null,195111061,31627,1984
195111829,0.0,0.0,4000,4000,0,0,4000,Null,Null,195111829,406683,1633
195111850,2.0,2.0,5600,5600,0,0,5600,Null,Null,195111850,406683,1633
195112117,0.0,0.0,21500000,21500000,0,0,21500000,Null,Null,195112117,167287,11518
195112690,53.0,53.0,160000,80000,80000,50,160000,Null,Null,195112690,111625,1820
195122805,0.0,0.0,33750000,33750000,0,0,33750000,Null,Null,195122805,165337,20254
195126327,0.0,0.0,9000,9000,0,0,9000,Null,Null,195126327,111461,2
195126727,0.0,0.0,1000,1000,0,0,1000,Null,Null,195126727,111461,2
195133795,37.0,37.0,1272000,1030000,242000,19,1272000,Null,Null,195133795,146479,8400
195138382,0.0,0.0,22831000,22831000,0,0,22831000,Null,Null,195138382,167287,11518
195150699,0.0,0.0,2000,2000,0,0,2000,Null,Null,195150699,111461,2
195151645,0.0,0.0,2000,2000,0,0,2000,Null,Null,195151645,111461,2
195152428,0.0,0.0,9200,9200,0,0,9200,Null,Null,195152428,111461,28468
195166291,55.0,55.0,85000,85000,0,0,85000,Null,Null,195166291,4973949,20244
195177036,0.0,0.0,4153000,2817000,1336000,32,4153000,Null,Null,195177036,18802,1794
195188826,0.0,0.0,19850000,19850000,0,0,19850000,Null,Null,195188826,247279,20250
195189765,0.0,0.0,13400000,12990000,410000,3,13400000,Null,Null,195189765,5217953,7079
195201056,0.0,0.0,125000000,123100000,1900000,2,125000000,Null,Null,195201056,7426417,23576
195213675,2.0,2.0,10000000,6946000,3054000,31,10000000,Null,Null,195213675,18802,1794
195213684,163.0,163.0,169000,169000,0,0,169000,Null,Null,195213684,25422,2
195231233,0.0,0.0,3468000,3468000,0,0,3468000,Null,Null,195231233,25422,1795
195231834,0.0,0.0,15990000,15990000,0,0,15990000,Null,Null,195231834,25422,1795
195239249,0.0,0.0,11860000,11860000,0,0,11860000,Null,Null,195239249,5096337,28640
195247535,2.0,2.0,13990000,11990000,2000000,14,13990000,Null,Null,195247535,25643,1795
195255507,0.0,0.0,12770000,12390000,380000,3,12770000,Null,Null,195255507,113119,8066
195257875,15.0,15.0,600000,300000,300000,50,600000,Null,Null,195257875,7400131,15318
195271035,36.0,36.0,100000,75000,25000,25,100000,Null,Null,195271035,111461,2
195271156,1.0,1.0,5500,3500,2000,36,5500,Null,Null,195271156,111461,2
195271171,0.0,0.0,3000,1900,1100,37,3000,Null,Null,195271171,111461,1883
195271175,166.0,166.0,2000,2000,0,0,2000,Null,Null,195271175,111461,2363
195271223,6.0,6.0,129000,129000,0,0,129000,Null,Null,195271223,111461,2
195277044,35.0,35.0,565000,268000,297000,53,565000,Null,Null,195277044,505907,4593
195277333,649.0,649.0,250000,149000,101000,40,250000,Null,Null,195277333,625265,28574
195277622,14.0,14.0,42000,42000,0,0,42000,Null,Null,195277622,111461,23238
195280404,0.0,0.0,2000,2000,0,0,2000,Null,Null,195280404,111461,3710
195287178,0.0,0.0,15000,15000,0,0,15000,Null,Null,195287178,111461,15318
195287182,8.0,8.0,2500,2500,0,0,2500,Null,Null,195287182,111461,23082
195287192,0.0,0.0,6000,6000,0,0,6000,Null,Null,195287192,111461,15318
195287195,0.0,0.0,7000,7000,0,0,7000,Null,Null,195287195,111461,15318
195287214,2.0,2.0,10500,10500,0,0,10500,Null,Null,195287214,111461,15250
195288570,21.0,21.0,166000,156000,10000,6,166000,Null,Null,195288570,312329,9013
195288649,82.0,82.0,105000,105000,0,0,105000,Null,Null,195288649,5534927,1630
195292060,24.0,24.0,250000,179000,71000,28,250000,Null,Null,195292060,312329,5566
195300247,4.0,4.0,50000,50000,0,0,50000,Null,Null,195300247,111461,15250
195300525,1.0,1.0,20000,20000,0,0,20000,Null,Null,195300525,111461,15318
195300840,250.0,250.0,800000,590000,210000,26,800000,Null,Null,195300840,218165,8400
195300843,31.0,31.0,1800000,1090000,710000,39,1800000,Null,Null,195300843,218165,8400
195300846,261.0,261.0,300000,250000,50000,17,300000,Null,Null,195300846,50629,12294
195300851,235.0,235.0,1100000,727000,373000,34,1100000,Null,Null,195300851,218165,8400
195300861,444.0,444.0,350000,300000,50000,14,350000,Null,Null,195300861,50629,12294
195300883,132.0,132.0,850000,700000,150000,18,850000,Null,Null,195300883,218165,8400
195300886,276.0,276.0,550000,396000,154000,28,550000,Null,Null,195300886,50629,5006
195305637,59.0,59.0,950000,800000,150000,16,950000,Null,Null,195305637,50629,12908
195305655,546.0,546.0,450000,351000,99000,22,450000,Null,Null,195305655,50629,12908
195305664,41.0,41.0,550000,500000,50000,9,550000,Null,Null,195305664,50629,12928
195305670,13.0,13.0,2000000,1700000,300000,15,2000000,Null,Null,195305670,218165,2324
195305683,213.0,213.0,480000,390000,90000,19,480000,Null,Null,195305683,50629,12908
195305688,212.0,212.0,950000,800000,150000,16,950000,Null,Null,195305688,50629,12908
195305799,8.0,8.0,29000,29000,0,0,29000,Null,Null,195305799,111461,53048
195311658,49.0,49.0,8490000,8490000,0,0,8490000,Null,Null,195311658,25422,1795
195317118,47.0,47.0,6999000,5490000,1509000,22,6999000,Null,Null,195317118,25643,1794
195319105,0.0,0.0,6880000,6880000,0,0,6880000,Null,Null,195319105,7492359,53352
195323206,3.0,3.0,5990000,5290000,700000,12,5990000,Null,Null,195323206,52232,1795
195328962,5.0,5.0,7000,7000,0,0,7000,Null,Null,195328962,111461,15318
195329440,0.0,0.0,15000,15000,0,0,15000,Null,Null,195329440,111461,15318
195330986,1.0,1.0,2890000,2890000,0,0,2890000,Null,Null,195330986,25422,1795
195331908,161.0,161.0,998000,492000,506000,51,998000,Null,Null,195331908,276917,1883
195333531,21.0,21.0,10490000,7990000,2500000,24,10490000,Null,Null,195333531,25643,1795
195341578,0.0,0.0,478800,478800,0,0,478800,Null,Null,195341578,111461,2
195342477,0.0,0.0,4980000,3949000,1031000,21,4980000,Null,Null,195342477,3974293,1626
195352781,3.0,3.0,8990000,7190000,1800000,20,8990000,Null,Null,195352781,25643,1795
195355820,3.0,3.0,10900,7500,3400,31,10900,Null,Null,195355820,477953,8305
195430683,0.0,0.0,2500,2500,0,0,2500,Null,Null,195430683,111461,27180
195436008,62.0,62.0,7900,7000,900,11,7900,Null,Null,195436008,477953,8305
195436019,0.0,0.0,4716000,4716000,0,0,4716000,Null,Null,195436019,25422,1795
195443834,0.0,0.0,4844050,4844050,0,0,4844050,Null,Null,195443834,18804,2334
195444597,159.0,159.0,395000,315000,80000,20,395000,Null,Null,195444597,18845,1820
195445913,159.0,159.0,630000,510000,120000,19,630000,Null,Null,195445913,18845,1820
195454530,378.0,378.0,12000,12000,0,0,12000,Null,Null,195454530,477953,8305
195456412,1.0,1.0,15000,8000,7000,47,15000,Null,Null,195456412,477953,8305
195462024,41.0,41.0,129000,86000,43000,33,129000,Null,Null,195462024,111461,23024
195469953,262.0,262.0,109000,109000,0,0,109000,Null,Null,195469953,5706641,23712
195478995,4.0,4.0,80000,72000,8000,10,80000,Null,Null,195478995,111461,15320
195503760,49.0,49.0,420000,420000,0,0,420000,Null,Null,195503760,257373,1641
195514483,107.0,107.0,15000,7500,7500,50,15000,Null,Null,195514483,477953,8305
195514699,0.0,0.0,1999,1979,20,1,1999,Null,Null,195514699,4284741,8314
195516168,3.0,3.0,8000,8000,0,0,8000,Null,Null,195516168,529455,8309
195516237,1.0,1.0,27950000,27111500,838500,3,27950000,Null,Null,195516237,167287,28860
195527804,42.0,42.0,15000,15000,0,0,15000,Null,Null,195527804,477953,8305
195530831,1.0,1.0,190000,190000,0,0,190000,Null,Null,195530831,111461,23622
195531004,25.0,25.0,398000,299000,99000,25,398000,Null,Null,195531004,48077,53348
195531282,122.0,122.0,250000,179000,71000,28,250000,Null,Null,195531282,625265,28574
195544340,123.0,123.0,398000,186000,212000,53,398000,Null,Null,195544340,5003355,23282
195547067,0.0,0.0,52259904,41807923,10451981,20,52259904,Null,Null,195547067,718983,23276
195547139,0.0,0.0,52700544,42160435,10540109,20,52700544,Null,Null,195547139,718983,23276
195551216,28.0,28.0,1000000,649000,351000,35,1000000,Null,Null,195551216,5415309,3178
195552804,105.0,105.0,3990000,2990000,1000000,25,3990000,Null,Null,195552804,20215,8400
195559389,120.0,120.0,440000,329000,111000,25,440000,Null,Null,195559389,307609,17170
195564932,76.0,76.0,299000,242000,57000,19,299000,Null,Null,195564932,5172027,53348
195568603,1.0,1.0,145000,145000,0,0,145000,Null,Null,195568603,111461,2513
195622820,0.0,0.0,42000000,42000000,0,0,42000000,Null,Null,195622820,111461,12590
195623034,0.0,0.0,47000000,47000000,0,0,47000000,Null,Null,195623034,606305,27222
195623367,4.0,4.0,629000,556000,73000,12,629000,Null,Null,195623367,4691869,1836
195623389,0.0,0.0,56875000,56875000,0,0,56875000,Null,Null,195623389,111461,23112
195635236,18.0,18.0,639000,639000,0,0,639000,Null,Null,195635236,192113,5267
195636655,78.0,78.0,460000,275000,185000,40,460000,Null,Null,195636655,5221825,53348
195638987,0.0,0.0,7990000,7990000,0,0,7990000,Null,Null,195638987,31701,2340
195646217,26.0,26.0,290000,256000,34000,12,290000,Null,Null,195646217,46004,2347
195646874,2.0,2.0,480000,480000,0,0,480000,Null,Null,195646874,111461,15250
195647696,26.0,26.0,1440000,1259000,181000,13,1440000,Null,Null,195647696,218061,1520
195649370,0.0,0.0,10500000,10500000,0,0,10500000,Null,Null,195649370,405211,8511
195649371,78.0,78.0,258000,115000,143000,55,258000,Null,Null,195649371,5003355,23282
195650845,53.0,53.0,12000,8000,4000,33,12000,Null,Null,195650845,477953,8305
195651067,0.0,0.0,10500000,7350000,3150000,30,10500000,Null,Null,195651067,405211,8511
195652308,49.0,49.0,1250000,1213000,37000,3,1250000,Null,Null,195652308,18802,28576
195652690,12.0,12.0,999000,999000,0,0,999000,Null,Null,195652690,720365,2266
195656920,56.0,56.0,2000,2000,0,0,2000,Null,Null,195656920,111461,53074
195661031,0.0,0.0,0,4632000,0,0,4632000,Null,Null,195661031,25643,0
195662897,1.0,1.0,24850000,24850000,0,0,24850000,Null,Null,195662897,198963,11518
195662979,0.0,0.0,5436000,5436000,0,0,5436000,Null,Null,195662979,25643,1795
195666916,128.0,128.0,437000,325000,112000,26,437000,Null,Null,195666916,217549,1609
195677019,0.0,0.0,2000,1800,200,10,2000,Null,Null,195677019,111461,27222
195683588,0.0,0.0,21899000,21899000,0,0,21899000,Null,Null,195683588,162957,20170
195700534,17.0,17.0,520000,507000,13000,3,520000,Null,Null,195700534,111461,1836
195700964,0.0,0.0,47000000,47000000,0,0,47000000,Null,Null,195700964,111461,11858
195701083,3.0,3.0,375000,364000,11000,3,375000,Null,Null,195701083,111461,1836
195722201,19.0,19.0,450000,256000,194000,43,450000,Null,Null,195722201,111454,28454
195732809,0.0,0.0,10785714,7550000,3235714,30,10785714,Null,Null,195732809,405211,8512
195732841,0.0,0.0,10785714,10785714,0,0,10785714,Null,Null,195732841,405211,8511
195732917,0.0,0.0,10785714,7550000,3235714,30,10785714,Null,Null,195732917,405211,8511
195739809,0.0,0.0,4000,4000,0,0,4000,Null,Null,195739809,201253,8167
195741788,0.0,0.0,7500000,7500000,0,0,7500000,Null,Null,195741788,405211,8512
195741816,108.0,108.0,115000,115000,0,0,115000,Null,Null,195741816,5126697,28484
195741835,0.0,0.0,136000000,95200000,40800000,30,136000000,Null,Null,195741835,111461,23646
195757005,6.0,6.0,6000,6000,0,0,6000,Null,Null,195757005,111461,20258
195769378,168.0,168.0,380000,199000,181000,48,380000,Null,Null,195769378,541293,1634
195775228,0.0,0.0,7000,7000,0,0,7000,Null,Null,195775228,111461,20222
195788357,2.0,2.0,79000,79000,0,0,79000,Null,Null,195788357,111461,3175
195791850,166.0,166.0,650000,631000,19000,3,650000,Null,Null,195791850,41048,1984
195791851,189.0,189.0,1000000,951000,49000,5,1000000,Null,Null,195791851,41048,1984
195797725,137.0,137.0,102000,102000,0,0,102000,Null,Null,195797725,41048,2512
195806679,0.0,0.0,29800000,29800000,0,0,29800000,Null,Null,195806679,197095,2340
195808515,19.0,19.0,35200,35200,0,0,35200,Null,Null,195808515,111461,15936
195809200,29.0,29.0,49000,49000,0,0,49000,Null,Null,195809200,111461,23346
195814785,48.0,48.0,124600,93450,31150,25,124600,Null,Null,195814785,922779,11859
195822471,1017.0,1017.0,198000,177000,21000,11,198000,Null,Null,195822471,276721,1520
195825744,0.0,0.0,1000,1000,0,0,1000,Null,Null,195825744,111461,2
195825814,0.0,0.0,2000,2000,0,0,2000,Null,Null,195825814,111461,2
195825908,0.0,0.0,1000,1000,0,0,1000,Null,Null,195825908,111461,2
195844695,311.0,311.0,220000,164000,56000,25,220000,Null,Null,195844695,307609,17170
195852180,294.0,294.0,241000,149000,92000,38,241000,Null,Null,195852180,48077,1936
195852183,799.0,799.0,730000,449000,281000,38,730000,Null,Null,195852183,48077,1936
195860752,3.0,3.0,47400,23700,23700,50,47400,Null,Null,195860752,111461,15318
195869600,579.0,579.0,200000,115000,85000,43,200000,Null,Null,195869600,5534927,1520
195870930,3483.0,3483.0,85000,69000,16000,19,85000,Null,Null,195870930,216511,1520
195872740,0.0,0.0,18200,9100,9100,50,18200,Null,Null,195872740,111461,15318
195874084,0.0,0.0,8100000,8100000,0,0,8100000,Null,Null,195874084,111461,15318
195875548,13.0,13.0,1690000,1090000,600000,36,1690000,Null,Null,195875548,18802,28576
195886815,0.0,0.0,15999,15999,0,0,15999,Null,Null,195886815,111461,2
195888396,0.0,0.0,510000,510000,0,0,510000,Null,Null,195888396,7507147,11857
195891148,4.0,4.0,3550000,3550000,0,0,3550000,Null,Null,195891148,153733,53350
195891839,174.0,174.0,59000,37100,21900,37,59000,Null,Null,195891839,5132069,2018
195894801,7.0,7.0,699000,511000,188000,27,699000,Null,Null,195894801,112638,1796
195896773,0.0,0.0,1000,1000,0,0,1000,Null,Null,195896773,111461,2
195897005,1.0,1.0,2000,2000,0,0,2000,Null,Null,195897005,111461,2
195897006,85.0,85.0,55000,55000,0,0,55000,Null,Null,195897006,111461,2784
195897016,0.0,0.0,2000,2000,0,0,2000,Null,Null,195897016,111461,2
195897040,0.0,0.0,2500,2500,0,0,2500,Null,Null,195897040,111461,2
195901820,263.0,263.0,26250,26250,0,0,26250,Null,Null,195901820,6378473,28484
195902063,43.0,43.0,163350,163350,0,0,163350,Null,Null,195902063,111459,7078
195913891,0.0,0.0,9990000,4285000,5705000,57,9990000,Null,Null,195913891,290031,1609
195915487,198.0,198.0,490000,395000,95000,19,490000,Null,Null,195915487,18845,1820
195915991,100.0,100.0,790000,650000,140000,18,790000,Null,Null,195915991,18845,1820
195916600,130.0,130.0,280000,225000,55000,20,280000,Null,Null,195916600,18845,1820
195916610,9.0,9.0,75000,75000,0,0,75000,Null,Null,195916610,111461,1979
195916617,0.0,0.0,8000,7000,1000,13,8000,Null,Null,195916617,111461,11923
195922829,30.0,30.0,102000,102000,0,0,102000,Null,Null,195922829,19588,2225
195926629,4.0,4.0,450000,450000,0,0,450000,Null,Null,195926629,111461,8512
195928164,0.0,0.0,7956000,7956000,0,0,7956000,Null,Null,195928164,25643,1795
195928309,97.0,97.0,1390000,1100000,290000,21,1390000,Null,Null,195928309,19034,12908
195929285,7.0,7.0,33600,15000,18600,55,33600,Null,Null,195929285,111461,15318
195938043,0.0,0.0,250000,79000,171000,68,250000,Null,Null,195938043,7245301,15320
195938124,2.0,2.0,350000,109000,241000,69,350000,Null,Null,195938124,7245301,15250
195946231,0.0,0.0,3990000,3990000,0,0,3990000,Null,Null,195946231,5382095,8167
195946585,4.0,4.0,8000,8000,0,0,8000,Null,Null,195946585,111461,2
195949375,2372.0,2372.0,300000,172000,128000,43,300000,Null,Null,195949375,4224691,1883
195951151,230.0,230.0,239000,145000,94000,39,239000,Null,Null,195951151,4224691,2513
195951215,1.0,1.0,10000,10000,0,0,10000,Null,Null,195951215,111461,2
195951272,2.0,2.0,32000,32000,0,0,32000,Null,Null,195951272,111461,15236
195960285,33.0,33.0,95000,76000,19000,20,95000,Null,Null,195960285,148529,23362
195962857,0.0,0.0,8644000,8644000,0,0,8644000,Null,Null,195962857,25643,1795
195967172,154.0,154.0,4630000,4630000,0,0,4630000,Null,Null,195967172,7493501,8602
195968028,81.0,81.0,4900000,2450000,2450000,50,4900000,Null,Null,195968028,18802,8400
195968874,289.0,289.0,137000,137000,0,0,137000,Null,Null,195968874,5003355,2018
195972836,239.0,239.0,4380000,2190000,2190000,50,4380000,Null,Null,195972836,7356423,1520
195977274,192.0,192.0,399000,399000,0,0,399000,Null,Null,195977274,5055635,5267
195977553,1.0,1.0,38000000,28681000,9319000,25,38000000,Null,Null,195977553,18802,1795
195979166,21.0,21.0,1150000,1150000,0,0,1150000,Null,Null,195979166,290985,1883
195979313,0.0,0.0,19500000,19500000,0,0,19500000,Null,Null,195979313,167287,11518
195979647,145.0,145.0,996000,516000,480000,48,996000,Null,Null,195979647,48077,1936
195979652,213.0,213.0,1139000,590000,549000,48,1139000,Null,Null,195979652,48077,1936
195980111,435.0,435.0,490000,301000,189000,39,490000,Null,Null,195980111,48077,1936
195980679,0.0,0.0,103200000,103200000,0,0,103200000,Null,Null,195980679,111461,23112
195980862,0.0,0.0,54800000,54800000,0,0,54800000,Null,Null,195980862,111461,23056
195980952,292.0,292.0,44000,44000,0,0,44000,Null,Null,195980952,111461,1883
195981694,40.0,40.0,5230000,5230000,0,0,5230000,Null,Null,195981694,7493501,8602
195981880,122.0,122.0,7000,7000,0,0,7000,Null,Null,195981880,7493501,8602
195981978,0.0,0.0,43000000,43000000,0,0,43000000,Null,Null,195981978,111461,23112
195986314,0.0,0.0,26700000,26700000,0,0,26700000,Null,Null,195986314,167287,11518
195990989,1.0,1.0,70000,70000,0,0,70000,Null,Null,195990989,111461,15318
195998782,0.0,0.0,55000,55000,0,0,55000,Null,Null,195998782,111454,12294
195999085,331.0,331.0,200000,169000,31000,16,200000,Null,Null,195999085,111454,12294
196003099,317.0,317.0,258000,139000,119000,46,258000,Null,Null,196003099,79682,11833
196003161,62.0,62.0,220000,178000,42000,19,220000,Null,Null,196003161,5334715,11799
196013418,6.0,6.0,70000,70000,0,0,70000,Null,Null,196013418,111461,28674
196019445,0.0,0.0,61050000,61050000,0,0,61050000,Null,Null,196019445,167287,11518
196024222,0.0,0.0,38900000,38900000,0,0,38900000,Null,Null,196024222,146400,23438
196044608,0.0,0.0,8644000,8644000,0,0,8644000,Null,Null,196044608,25643,1795
196051243,539.0,539.0,168000,94000,74000,44,168000,Null,Null,196051243,46703,2
196057974,0.0,0.0,14999,14999,0,0,14999,Null,Null,196057974,111461,2
196059894,0.0,0.0,10000,10000,0,0,10000,Null,Null,196059894,111461,2
196059905,0.0,0.0,13000,13000,0,0,13000,Null,Null,196059905,111461,2
196059991,1.0,1.0,52000,52000,0,0,52000,Null,Null,196059991,111461,15236
196069264,0.0,0.0,7990000,5778000,2212000,28,7990000,Null,Null,196069264,111461,2324
196085541,0.0,0.0,14000,14000,0,0,14000,Null,Null,196085541,111461,2
196092518,4.0,4.0,12000,12000,0,0,12000,Null,Null,196092518,4489253,2
196092829,7.0,7.0,12000,12000,0,0,12000,Null,Null,196092829,4489253,2
196094112,0.0,0.0,22551000,15800000,6751000,30,22551000,Null,Null,196094112,18802,1795
196094123,1.0,1.0,7500,7500,0,0,7500,Null,Null,196094123,111461,1819
196145112,3.0,3.0,59000,59000,0,0,59000,Null,Null,196145112,111461,2
196151939,62.0,62.0,12000,12000,0,0,12000,Null,Null,196151939,111461,2
196155721,0.0,0.0,2000,2000,0,0,2000,Null,Null,196155721,111461,2
196157263,2.0,2.0,480000,480000,0,0,480000,Null,Null,196157263,111461,8511
196157299,0.0,0.0,18000,18000,0,0,18000,Null,Null,196157299,111461,28480
196158236,0.0,0.0,4800,4800,0,0,4800,Null,Null,196158236,111461,28480
196176544,0.0,0.0,630000,630000,0,0,630000,Null,Null,196176544,112638,1796
196176603,1.0,1.0,12650000,12650000,0,0,12650000,Null,Null,196176603,167287,7079
196182793,25.0,25.0,199000,199000,0,0,199000,Null,Null,196182793,149308,28430
196188538,6.0,6.0,52000,52000,0,0,52000,Null,Null,196188538,7379131,28682
196193886,24.0,24.0,55000,53900,1100,2,55000,Null,Null,196193886,111461,12908
196193895,2.0,2.0,4490000,4190000,300000,7,4490000,Null,Null,196193895,52232,1795
196196996,66.0,66.0,148000,148000,0,0,148000,Null,Null,196196996,195495,3428
196197701,0.0,0.0,38531000,28681000,9850000,26,38531000,Null,Null,196197701,18802,1795
196197861,0.0,0.0,42000000,35150000,6850000,16,42000000,Null,Null,196197861,18802,1795
196200121,0.0,0.0,20250000,15800000,4450000,22,20250000,Null,Null,196200121,18802,1789
196200197,0.0,0.0,22200000,17160000,5040000,23,22200000,Null,Null,196200197,18802,1795
196200655,0.0,0.0,22200000,17160000,5040000,23,22200000,Null,Null,196200655,18802,1795
196201409,9.0,9.0,220900,220900,0,0,220900,Null,Null,196201409,5266547,2324
196207230,12.0,12.0,400000,400000,0,0,400000,Null,Null,196207230,111461,2
196207249,1.0,1.0,195000,195000,0,0,195000,Null,Null,196207249,111461,2
196207382,16.0,16.0,25000,25000,0,0,25000,Null,Null,196207382,111461,2
196207511,2.0,2.0,18000,18000,0,0,18000,Null,Null,196207511,111461,2
196207522,13.0,13.0,18000,18000,0,0,18000,Null,Null,196207522,111461,2
196207580,2.0,2.0,84000,84000,0,0,84000,Null,Null,196207580,111461,2
196207721,5.0,5.0,66000,66000,0,0,66000,Null,Null,196207721,111461,2
196207747,2.0,2.0,84000,84000,0,0,84000,Null,Null,196207747,111461,2
196207773,24.0,24.0,59000,59000,0,0,59000,Null,Null,196207773,111461,2
196207877,6.0,6.0,68000,68000,0,0,68000,Null,Null,196207877,111461,2
196207981,13.0,13.0,66000,66000,0,0,66000,Null,Null,196207981,111461,2
196250781,0.0,0.0,4000,4000,0,0,4000,Null,Null,196250781,111461,8198
196280241,0.0,0.0,9200,9200,0,0,9200,Null,Null,196280241,111461,2
196282354,2.0,2.0,23990000,14299000,9691000,40,23990000,Null,Null,196282354,18802,1795
196282517,0.0,0.0,25990000,14899000,11091000,43,25990000,Null,Null,196282517,18802,1795
196285297,0.0,0.0,64730000,64730000,0,0,64730000,Null,Null,196285297,111461,27128
196286150,0.0,0.0,5130000,5130000,0,0,5130000,Null,Null,196286150,111461,8198
196297437,133.0,133.0,35000,28000,7000,20,35000,Null,Null,196297437,6378473,28484
196312982,30.0,30.0,189000,189000,0,0,189000,Null,Null,196312982,7245289,20244
196319470,2.0,2.0,579000,579000,0,0,579000,Null,Null,196319470,111461,5384
196319476,14.0,14.0,140000,140000,0,0,140000,Null,Null,196319476,111461,5384
196319495,2.0,2.0,570000,570000,0,0,570000,Null,Null,196319495,111461,5384
196332825,1.0,1.0,745000,745000,0,0,745000,Null,Null,196332825,111461,5384
196332851,53.0,53.0,572000,572000,0,0,572000,Null,Null,196332851,183325,11857
196333071,28.0,28.0,2200000,1380000,820000,37,2200000,Null,Null,196333071,51302,2327
196336659,359.0,359.0,250000,186500,63500,25,250000,Null,Null,196336659,111461,23678
196341171,9.0,9.0,39000,37000,2000,5,39000,Null,Null,196341171,191669,28580
196343012,0.0,0.0,7956000,7956000,0,0,7956000,Null,Null,196343012,25643,1795
196348143,1.0,1.0,4490000,3950000,540000,12,4490000,Null,Null,196348143,25643,1795
196350737,29.0,29.0,35000,35000,0,0,35000,Null,Null,196350737,111461,23704
196362415,106.0,106.0,888000,888000,0,0,888000,Null,Null,196362415,5261211,12988
196372586,1.0,1.0,8000,8000,0,0,8000,Null,Null,196372586,111461,28434
196373081,12.0,12.0,35000,35000,0,0,35000,Null,Null,196373081,111461,28578
196376951,378.0,378.0,250200,139000,111200,44,250200,Null,Null,196376951,46703,3177
196389342,1526.0,1526.0,155000,136000,19000,12,155000,Null,Null,196389342,112885,8223
196389579,20.0,20.0,132000,118000,14000,11,132000,Null,Null,196389579,21867,8300
196423479,20.0,20.0,36650000,23990000,12660000,35,36650000,Null,Null,196423479,5222401,2340
196425386,7.0,7.0,11990000,11990000,0,0,11990000,Null,Null,196425386,18802,2657
196427090,12.0,12.0,330000,330000,0,0,330000,Null,Null,196427090,704815,15318
196427968,1.0,1.0,32500,32500,0,0,32500,Null,Null,196427968,111461,15320
196449051,0.0,0.0,8168000,8168000,0,0,8168000,Null,Null,196449051,26150,8513
196466152,229.0,229.0,48000,38000,10000,21,48000,Null,Null,196466152,111461,28616
196468226,42.0,42.0,315000,315000,0,0,315000,Null,Null,196468226,111461,23588
196468319,1.0,1.0,7900000,5698000,2202000,28,7900000,Null,Null,196468319,26150,8513
196474292,0.0,0.0,45000000,45000000,0,0,45000000,Null,Null,196474292,198963,11518
196478933,97.0,97.0,599000,520000,79000,13,599000,Null,Null,196478933,885047,8400
196480085,0.0,0.0,19000,19000,0,0,19000,Null,Null,196480085,111461,2
196480107,0.0,0.0,15000,15000,0,0,15000,Null,Null,196480107,111461,2
196480126,0.0,0.0,15000,15000,0,0,15000,Null,Null,196480126,111461,2
196480138,12.0,12.0,25000,25000,0,0,25000,Null,Null,196480138,111461,2
196480156,1.0,1.0,55000,55000,0,0,55000,Null,Null,196480156,111461,2
196480168,1.0,1.0,9000,9000,0,0,9000,Null,Null,196480168,111461,2
196480183,0.0,0.0,19000,19000,0,0,19000,Null,Null,196480183,111461,2
196487034,87.0,87.0,250000,169000,81000,32,250000,Null,Null,196487034,625265,28574
196510259,0.0,0.0,1000,1000,0,0,1000,Null,Null,196510259,111461,23082
196515957,11.0,11.0,990000,590000,400000,40,990000,Null,Null,196515957,18802,12928
196518483,65.0,65.0,218000,109000,109000,50,218000,Null,Null,196518483,111461,2
196518627,292.0,292.0,39000,22000,17000,44,39000,Null,Null,196518627,5406107,2363
196529912,0.0,0.0,3829000,3829000,0,0,3829000,Null,Null,196529912,18804,2334
196530625,207.0,207.0,209000,209000,0,0,209000,Null,Null,196530625,746615,23022
196530940,52.0,52.0,100000,89000,11000,11,100000,Null,Null,196530940,111461,5995
196537115,194.0,194.0,189000,189000,0,0,189000,Null,Null,196537115,746615,2238
196545032,0.0,0.0,5390,5390,0,0,5390,Null,Null,196545032,111461,2
196545058,0.0,0.0,7000,7000,0,0,7000,Null,Null,196545058,111461,2
196545208,2.0,2.0,85000,85000,0,0,85000,Null,Null,196545208,111461,2
196545237,0.0,0.0,3000,3000,0,0,3000,Null,Null,196545237,111461,2
196545339,0.0,0.0,9000,9000,0,0,9000,Null,Null,196545339,111461,2
196545373,0.0,0.0,19000,19000,0,0,19000,Null,Null,196545373,111461,2
196545557,0.0,0.0,17000,17000,0,0,17000,Null,Null,196545557,111461,2
196545561,0.0,0.0,15000,15000,0,0,15000,Null,Null,196545561,111461,2
196545623,0.0,0.0,15000,15000,0,0,15000,Null,Null,196545623,111461,2
196545667,0.0,0.0,12000,12000,0,0,12000,Null,Null,196545667,111461,2
196545757,0.0,0.0,15000,15000,0,0,15000,Null,Null,196545757,111461,2
196545784,0.0,0.0,15000,15000,0,0,15000,Null,Null,196545784,111461,2
196545794,0.0,0.0,3000,3000,0,0,3000,Null,Null,196545794,111461,2
196545958,0.0,0.0,11640,11640,0,0,11640,Null,Null,196545958,111461,2
196545996,0.0,0.0,15000,15000,0,0,15000,Null,Null,196545996,111461,2
196546033,0.0,0.0,19000,19000,0,0,19000,Null,Null,196546033,111461,2
196546037,0.0,0.0,15000,15000,0,0,15000,Null,Null,196546037,111461,2
196546145,0.0,0.0,9000,9000,0,0,9000,Null,Null,196546145,111461,2
196546163,0.0,0.0,3000,3000,0,0,3000,Null,Null,196546163,111461,2
196546174,0.0,0.0,19000,19000,0,0,19000,Null,Null,196546174,111461,2
196546267,0.0,0.0,7000,7000,0,0,7000,Null,Null,196546267,111461,2
196546312,0.0,0.0,15000,15000,0,0,15000,Null,Null,196546312,111461,2
196546324,0.0,0.0,19000,19000,0,0,19000,Null,Null,196546324,111461,2
196546378,0.0,0.0,2500,2500,0,0,2500,Null,Null,196546378,111461,2
196546386,0.0,0.0,3000,3000,0,0,3000,Null,Null,196546386,111461,2
196546455,0.0,0.0,15000,15000,0,0,15000,Null,Null,196546455,111461,2
196546581,0.0,0.0,14000,14000,0,0,14000,Null,Null,196546581,111461,2
196546603,0.0,0.0,15000,15000,0,0,15000,Null,Null,196546603,111461,2
196546689,0.0,0.0,14550,14550,0,0,14550,Null,Null,196546689,111461,2
196546713,0.0,0.0,5000,5000,0,0,5000,Null,Null,196546713,111461,2
196546886,0.0,0.0,19000,19000,0,0,19000,Null,Null,196546886,111461,2
196546980,0.0,0.0,4000,4000,0,0,4000,Null,Null,196546980,111461,2
196546988,0.0,0.0,15000,15000,0,0,15000,Null,Null,196546988,111461,2
196547016,0.0,0.0,5000,5000,0,0,5000,Null,Null,196547016,111461,2
196547037,0.0,0.0,15000,15000,0,0,15000,Null,Null,196547037,111461,2
196547078,0.0,0.0,3000,3000,0,0,3000,Null,Null,196547078,111461,2
196547137,0.0,0.0,15200,15200,0,0,15200,Null,Null,196547137,111461,2
196547158,0.0,0.0,2000,2000,0,0,2000,Null,Null,196547158,111461,2
196547205,0.0,0.0,5000,5000,0,0,5000,Null,Null,196547205,111461,2
196548764,0.0,0.0,6500,6500,0,0,6500,Null,Null,196548764,111461,28484
196551149,3.0,3.0,29000,29000,0,0,29000,Null,Null,196551149,111461,15236
196552579,213.0,213.0,100000,89000,11000,11,100000,Null,Null,196552579,111461,5995
196552841,0.0,0.0,18900000,18900000,0,0,18900000,Null,Null,196552841,50307,20170
196554444,0.0,0.0,37500000,37500000,0,0,37500000,Null,Null,196554444,50307,7079
196555228,0.0,0.0,19400000,19400000,0,0,19400000,Null,Null,196555228,50307,7079
196560158,0.0,0.0,38500000,38500000,0,0,38500000,Null,Null,196560158,50307,7079
196562133,0.0,0.0,20250000,15800000,4450000,22,20250000,Null,Null,196562133,18802,1795
196565418,127.0,127.0,97000,48500,48500,50,97000,Null,Null,196565418,7823083,23592
196567002,10.0,10.0,1492,1492,0,0,1492,Null,Null,196567002,7823083,23592
196568810,93.0,93.0,69000,69000,0,0,69000,Null,Null,196568810,7823083,23592
196572909,0.0,0.0,73700000,67804000,5896000,8,73700000,Null,Null,196572909,50307,7079
196574661,72.0,72.0,2500,2500,0,0,2500,Null,Null,196574661,111461,2685
196578909,109.0,109.0,29900,29900,0,0,29900,Null,Null,196578909,111461,28428
196579122,15.0,15.0,375000,357000,18000,5,375000,Null,Null,196579122,705271,28484
196579496,37.0,37.0,148900,148900,0,0,148900,Null,Null,196579496,111461,28428
196580130,1.0,1.0,134000,109948,24052,18,134000,Null,Null,196580130,111461,28576
196597405,100.0,100.0,250000,169000,81000,32,250000,Null,Null,196597405,625265,28574
196600859,2.0,2.0,33500,33500,0,0,33500,Null,Null,196600859,111461,15320
196603289,0.0,0.0,28500000,28500000,0,0,28500000,Null,Null,196603289,50307,11518
196674648,6.0,6.0,29000,29000,0,0,29000,Null,Null,196674648,111461,28480
196675011,248.0,248.0,780000,679000,101000,13,780000,Null,Null,196675011,5763205,12878
196675194,251.0,251.0,108800,108800,0,0,108800,Null,Null,196675194,456351,23362
196675323,0.0,0.0,26500000,26500000,0,0,26500000,Null,Null,196675323,50307,11518
196675405,33.0,33.0,149000,145000,4000,3,149000,Null,Null,196675405,312329,5531
196685420,38.0,38.0,1040000,890000,150000,14,1040000,Null,Null,196685420,25643,8400
196686640,70.0,70.0,449000,290000,159000,35,449000,Null,Null,196686640,20271,1838
196689165,0.0,0.0,19000,19000,0,0,19000,Null,Null,196689165,4489253,49728
196689174,0.0,0.0,299000,209000,90000,30,299000,Null,Null,196689174,25422,53190
196703010,0.0,0.0,13000,13000,0,0,13000,Null,Null,196703010,4489253,49728
196703222,1.0,1.0,13000,13000,0,0,13000,Null,Null,196703222,4489253,49728
196703372,0.0,0.0,17000,17000,0,0,17000,Null,Null,196703372,4489253,49728
196704098,2.0,2.0,68000,68000,0,0,68000,Null,Null,196704098,873101,8224
196718477,47.0,47.0,250000,239000,11000,4,250000,Null,Null,196718477,625265,28574
196724285,7.0,7.0,25000,25000,0,0,25000,Null,Null,196724285,4489253,49728
196724579,1.0,1.0,29000,29000,0,0,29000,Null,Null,196724579,4489253,49728
196725284,0.0,0.0,13885000,13885000,0,0,13885000,Null,Null,196725284,25502,8511
196725654,0.0,0.0,13885000,13885000,0,0,13885000,Null,Null,196725654,25502,8511
196725667,0.0,0.0,19000,19000,0,0,19000,Null,Null,196725667,4489253,49728
196728223,73.0,73.0,130000,130000,0,0,130000,Null,Null,196728223,111461,28482
196752817,20.0,20.0,42000,42000,0,0,42000,Null,Null,196752817,111461,2
196756082,0.0,0.0,2000,2000,0,0,2000,Null,Null,196756082,111461,28470
196756088,0.0,0.0,9000,9000,0,0,9000,Null,Null,196756088,111461,28470
196759911,0.0,0.0,5500000,5500000,0,0,5500000,Null,Null,196759911,111461,1622
196768917,209.0,209.0,499000,399000,100000,20,499000,Null,Null,196768917,5230273,2234
196779339,36.0,36.0,120000,70000,50000,42,120000,Null,Null,196779339,111461,1883
196786213,207.0,207.0,55000,55000,0,0,55000,Null,Null,196786213,111461,1883
196801972,0.0,0.0,4399000,4030000,369000,8,4399000,Null,Null,196801972,18804,11941
196802882,1.0,1.0,4400000,4400000,0,0,4400000,Null,Null,196802882,111461,15318
196808097,0.0,0.0,10640000,10640000,0,0,10640000,Null,Null,196808097,111461,15318
196808253,95.0,95.0,45000,45000,0,0,45000,Null,Null,196808253,111461,2
196812507,0.0,0.0,9685000,9685000,0,0,9685000,Null,Null,196812507,25502,8511
196813291,0.0,0.0,89000,89000,0,0,89000,Null,Null,196813291,111461,2
196815653,2.0,2.0,15000,15000,0,0,15000,Null,Null,196815653,111461,2
196817495,5.0,5.0,19000,19000,0,0,19000,Null,Null,196817495,111461,2
196824681,0.0,0.0,7000,7000,0,0,7000,Null,Null,196824681,111461,8205
196837887,2.0,2.0,15000,15000,0,0,15000,Null,Null,196837887,111461,11375
196840285,184.0,184.0,251000,251000,0,0,251000,Null,Null,196840285,111461,2
196853072,0.0,0.0,9285000,9285000,0,0,9285000,Null,Null,196853072,25502,5385
196853742,0.0,0.0,8885000,8885000,0,0,8885000,Null,Null,196853742,25502,5385
196854550,1.0,1.0,27732000,23110000,4622000,17,27732000,Null,Null,196854550,536241,28640
196855216,0.0,0.0,7085000,7085000,0,0,7085000,Null,Null,196855216,25502,8511
196855553,0.0,0.0,8985000,8985000,0,0,8985000,Null,Null,196855553,25502,8511
196855678,1.0,1.0,937000,937000,0,0,937000,Null,Null,196855678,18984,5264
196856547,2.0,2.0,199000,199000,0,0,199000,Null,Null,196856547,111461,15236
196856615,0.0,0.0,7885000,7885000,0,0,7885000,Null,Null,196856615,25502,5385
196873058,27.0,27.0,12000000,11390000,610000,5,12000000,Null,Null,196873058,183637,28856
196873103,61.0,61.0,3990000,3990000,0,0,3990000,Null,Null,196873103,183637,28856
196887456,0.0,0.0,3500000,3500000,0,0,3500000,Null,Null,196887456,7369997,5893
196889356,0.0,0.0,10000,8000,2000,20,10000,Null,Null,196889356,111461,8194
196889475,6.0,6.0,5000,4950,50,1,5000,Null,Null,196889475,111461,8194
196897054,59.0,59.0,8000,8000,0,0,8000,Null,Null,196897054,197473,17186
196897325,2.0,2.0,35000,35000,0,0,35000,Null,Null,196897325,111461,15250
196897432,0.0,0.0,2500,2500,0,0,2500,Null,Null,196897432,111461,23416
196904297,13.0,13.0,165000,160000,5000,3,165000,Null,Null,196904297,662577,5267
196904748,0.0,0.0,54900000,54900000,0,0,54900000,Null,Null,196904748,111461,23112
196906042,0.0,0.0,60200000,60200000,0,0,60200000,Null,Null,196906042,111461,23112
196906550,0.0,0.0,40850000,40850000,0,0,40850000,Null,Null,196906550,111461,23112
196930267,3.0,3.0,172900,91000,81900,47,172900,Null,Null,196930267,4246951,8602
196949579,78.0,78.0,510000,485000,25000,5,510000,Null,Null,196949579,202607,11605
196953614,0.0,0.0,8644000,8644000,0,0,8644000,Null,Null,196953614,25643,1795
196956316,14.0,14.0,160000,152000,8000,5,160000,Null,Null,196956316,149308,28574
196961502,4.0,4.0,4900000,4900000,0,0,4900000,Null,Null,196961502,227957,11873
196965891,0.0,0.0,9100000,9100000,0,0,9100000,Null,Null,196965891,111461,15318
196973071,29.0,29.0,129000,123000,6000,5,129000,Null,Null,196973071,162313,28426
197005688,0.0,0.0,350000,109000,241000,69,350000,Null,Null,197005688,7245301,15250
197006141,0.0,0.0,250000,79000,171000,68,250000,Null,Null,197006141,7245301,15320
197006262,1.0,1.0,250000,79000,171000,68,250000,Null,Null,197006262,7245301,15320
197042214,27.0,27.0,498000,498000,0,0,498000,Null,Null,197042214,111461,53186
197045354,0.0,0.0,750000,750000,0,0,750000,Null,Null,197045354,112638,1796
197062916,98.0,98.0,389000,221000,168000,43,389000,Null,Null,197062916,5048343,4593
197069556,114.0,114.0,389000,225000,164000,42,389000,Null,Null,197069556,5048343,8519
197070658,220.0,220.0,299000,185000,114000,38,299000,Null,Null,197070658,4224691,2234
197070916,3.0,3.0,6000,6000,0,0,6000,Null,Null,197070916,111461,8165
197095637,0.0,0.0,3408000,3408000,0,0,3408000,Null,Null,197095637,25422,1795
197107235,0.0,0.0,3585600,3585600,0,0,3585600,Null,Null,197107235,111461,2
197107261,0.0,0.0,4968000,4968000,0,0,4968000,Null,Null,197107261,111461,2
197111727,0.0,0.0,3408000,3408000,0,0,3408000,Null,Null,197111727,25422,1795
197114837,0.0,0.0,3420000,3420000,0,0,3420000,Null,Null,197114837,111461,11933
197139915,8.0,8.0,195000,176000,19000,10,195000,Null,Null,197139915,111461,53186
197141318,0.0,0.0,19000,19000,0,0,19000,Null,Null,197141318,111461,15250
197141335,1.0,1.0,30000,30000,0,0,30000,Null,Null,197141335,111461,15250
197141337,0.0,0.0,19000,19000,0,0,19000,Null,Null,197141337,111461,15250
197142952,0.0,0.0,14600000,14600000,0,0,14600000,Null,Null,197142952,144779,2324
197143907,66.0,66.0,4690000,4690000,0,0,4690000,Null,Null,197143907,25422,1795
197144700,1.0,1.0,9800,9800,0,0,9800,Null,Null,197144700,111461,2
197144718,0.0,0.0,1000,1000,0,0,1000,Null,Null,197144718,111461,2
197147134,12.0,12.0,5290000,5290000,0,0,5290000,Null,Null,197147134,25422,1795
197161868,0.0,0.0,44000000,39000000,5000000,11,44000000,Null,Null,197161868,111461,23576
197170696,0.0,0.0,9999,9999,0,0,9999,Null,Null,197170696,111461,2
197170883,0.0,0.0,9000,9000,0,0,9000,Null,Null,197170883,111461,2
197171752,0.0,0.0,9900,9900,0,0,9900,Null,Null,197171752,111461,8194
197171789,50.0,50.0,37000,37000,0,0,37000,Null,Null,197171789,111461,2337
197172184,0.0,0.0,57500000,56350000,1150000,2,57500000,Null,Null,197172184,167287,20170
197183981,0.0,0.0,9000,9000,0,0,9000,Null,Null,197183981,111461,8202
197186998,50.0,50.0,280000,190000,90000,32,280000,Null,Null,197186998,18802,28598
197191820,0.0,0.0,5500000,5500000,0,0,5500000,Null,Null,197191820,7768689,53350
197192476,2.0,2.0,399000,399000,0,0,399000,Null,Null,197192476,183257,15318
197210615,3.0,3.0,149000,149000,0,0,149000,Null,Null,197210615,111461,5384
197210642,2.0,2.0,65000,65000,0,0,65000,Null,Null,197210642,111461,2
197211969,59.0,59.0,4990000,3750000,1240000,25,4990000,Null,Null,197211969,162007,1795
197212719,0.0,0.0,0,19000,0,0,19000,Null,Null,197212719,111461,0
197212761,0.0,0.0,15000,15000,0,0,15000,Null,Null,197212761,111461,2
197213159,0.0,0.0,48000000,47040000,960000,2,48000000,Null,Null,197213159,167287,7079
197214015,302.0,302.0,27990000,21490000,6500000,23,27990000,Null,Null,197214015,17827,1795
197214029,431.0,431.0,24990000,19250000,5740000,23,24990000,Null,Null,197214029,17827,1795
197216279,897.0,897.0,30990000,25250000,5740000,19,30990000,Null,Null,197216279,17827,1795
197216291,2952.0,2952.0,33990000,26990000,7000000,21,33990000,Null,Null,197216291,17827,1795
197218147,0.0,0.0,82662800,82662800,0,0,82662800,Null,Null,197218147,505049,8064
197222623,35.0,35.0,177000,177000,0,0,177000,Null,Null,197222623,21651,28458
197230573,0.0,0.0,38253600,38253600,0,0,38253600,Null,Null,197230573,505049,11518
197238035,0.0,0.0,1500,1500,0,0,1500,Null,Null,197238035,111461,23678
197241372,0.0,0.0,26130000,19597500,6532500,25,26130000,Null,Null,197241372,167287,11518
197243786,55.0,55.0,370000,310400,59600,16,370000,Null,Null,197243786,143353,28574
197253029,0.0,0.0,0,13000,0,0,13000,Null,Null,197253029,111461,0
197299729,0.0,0.0,41122000,38900000,2222000,5,41122000,Null,Null,197299729,7426417,23576
197327460,57.0,57.0,390000,376000,14000,4,390000,Null,Null,197327460,189445,28574
197329612,0.0,0.0,7350000,7350000,0,0,7350000,Null,Null,197329612,405211,8511
197330265,0.0,0.0,7350000,7350000,0,0,7350000,Null,Null,197330265,405211,8512
197332985,0.0,0.0,7650000,7650000,0,0,7650000,Null,Null,197332985,405211,8512
197333177,0.0,0.0,7650000,7650000,0,0,7650000,Null,Null,197333177,405211,8512
197333394,0.0,0.0,0,229000,0,0,229000,Null,Null,197333394,197767,0
197337925,32.0,32.0,490000,466000,24000,5,490000,Null,Null,197337925,189445,28574
197339506,51.0,51.0,250000,250000,0,0,250000,Null,Null,197339506,18804,2153
197339649,0.0,0.0,3390000,3390000,0,0,3390000,Null,Null,197339649,27449,2340
197340123,0.0,0.0,9000,9000,0,0,9000,Null,Null,197340123,111461,2
197340897,72.0,72.0,125000,105000,20000,16,125000,Null,Null,197340897,222917,4451
197344991,19.0,19.0,420000,359000,61000,15,420000,Null,Null,197344991,156929,28484
197345057,0.0,0.0,18500000,18500000,0,0,18500000,Null,Null,197345057,50307,7079
197345914,10.0,10.0,132999,132999,0,0,132999,Null,Null,197345914,111461,2340
197345920,17.0,17.0,420000,400000,20000,5,420000,Null,Null,197345920,156929,28484
197346190,12.0,12.0,330000,249133,80867,25,330000,Null,Null,197346190,143353,28574
197347057,0.0,0.0,41800,19000,22800,55,41800,Null,Null,197347057,111461,15318
197347088,0.0,0.0,49500000,49500000,0,0,49500000,Null,Null,197347088,50307,2324
197354679,0.0,0.0,24500000,24500000,0,0,24500000,Null,Null,197354679,50307,8067
197368242,0.0,0.0,2200,2200,0,0,2200,Null,Null,197368242,111461,23104
197369961,0.0,0.0,31500000,31500000,0,0,31500000,Null,Null,197369961,50307,2324
197372273,0.0,0.0,44130000,44130000,0,0,44130000,Null,Null,197372273,148220,2154
197377320,55.0,55.0,249000,129000,120000,48,249000,Null,Null,197377320,314675,2324
197378660,87.0,87.0,520000,468000,52000,10,520000,Null,Null,197378660,276745,11767
197381889,11.0,11.0,95000,95000,0,0,95000,Null,Null,197381889,111461,23416
197381895,0.0,0.0,67500000,67500000,0,0,67500000,Null,Null,197381895,50307,8067
197386232,34.0,34.0,375000,375000,0,0,375000,Null,Null,197386232,111461,28574
197386353,0.0,0.0,13500,4950,8550,63,13500,Null,Null,197386353,111461,28736
197387272,0.0,0.0,2000,2000,0,0,2000,Null,Null,197387272,111461,1622
197387290,0.0,0.0,7650000,7650000,0,0,7650000,Null,Null,197387290,405211,8512
197387463,0.0,0.0,7650000,7650000,0,0,7650000,Null,Null,197387463,405211,8512
197387476,0.0,0.0,7650000,7650000,0,0,7650000,Null,Null,197387476,405211,8512
197409011,0.0,0.0,27500000,27500000,0,0,27500000,Null,Null,197409011,50331,28862
197409083,161.0,161.0,15000,15000,0,0,15000,Null,Null,197409083,111461,23800
197409467,0.0,0.0,12500,6000,6500,52,12500,Null,Null,197409467,111461,2173
197409813,0.0,0.0,17200000,17200000,0,0,17200000,Null,Null,197409813,50331,2324
197410247,0.0,0.0,18200000,18200000,0,0,18200000,Null,Null,197410247,50331,8064
197412247,353.0,353.0,898000,808000,90000,10,898000,Null,Null,197412247,5465099,1883
197415883,49.0,49.0,35000,19000,16000,46,35000,Null,Null,197415883,5055635,20174
197417743,45.0,45.0,380000,353400,26600,7,380000,Null,Null,197417743,143353,28574
197421138,0.0,0.0,11500000,11500000,0,0,11500000,Null,Null,197421138,50331,2324
197421157,1.0,1.0,108000,108000,0,0,108000,Null,Null,197421157,745957,2153
197426757,0.0,0.0,19990000,19990000,0,0,19990000,Null,Null,197426757,25422,2340
197497153,0.0,0.0,6680000,6680000,0,0,6680000,Null,Null,197497153,405211,8512
197497210,0.0,0.0,6680000,6680000,0,0,6680000,Null,Null,197497210,405211,8512
197497251,0.0,0.0,6680000,6680000,0,0,6680000,Null,Null,197497251,405211,8512
197497442,0.0,0.0,7950000,7950000,0,0,7950000,Null,Null,197497442,405211,8512
197497514,0.0,0.0,7950000,7950000,0,0,7950000,Null,Null,197497514,405211,8512
197497568,0.0,0.0,7950000,7950000,0,0,7950000,Null,Null,197497568,405211,8512
197499095,0.0,0.0,7950000,7950000,0,0,7950000,Null,Null,197499095,405211,8512
197515907,0.0,0.0,7950000,7950000,0,0,7950000,Null,Null,197515907,405211,8512
197516078,0.0,0.0,7950000,7950000,0,0,7950000,Null,Null,197516078,405211,8512
197516100,0.0,0.0,7950000,7950000,0,0,7950000,Null,Null,197516100,405211,8512
197516129,0.0,0.0,7950000,7950000,0,0,7950000,Null,Null,197516129,405211,8512
197516236,0.0,0.0,7950000,7950000,0,0,7950000,Null,Null,197516236,405211,8512
197516499,5.0,5.0,20000,9000,11000,55,20000,Null,Null,197516499,111461,5905
197517683,0.0,0.0,11860000,11860000,0,0,11860000,Null,Null,197517683,885749,8512
197518078,0.0,0.0,11860000,11860000,0,0,11860000,Null,Null,197518078,885749,8512
197518258,0.0,0.0,89000,89000,0,0,89000,Null,Null,197518258,111461,4428
197528980,49.0,49.0,149000,99000,50000,34,149000,Null,Null,197528980,230607,9052
197529134,0.0,0.0,5000,5000,0,0,5000,Null,Null,197529134,111461,20222
197534091,0.0,0.0,1000,1000,0,0,1000,Null,Null,197534091,111461,2
197536466,8.0,8.0,690000,419000,271000,39,690000,Null,Null,197536466,314675,28454
197536670,0.0,0.0,11350000,11350000,0,0,11350000,Null,Null,197536670,50307,2324
197539582,0.0,0.0,16400000,16400000,0,0,16400000,Null,Null,197539582,50307,2324
197543243,0.0,0.0,35950000,26962500,8987500,25,35950000,Null,Null,197543243,19032,11518
197547690,0.0,0.0,38253600,38253600,0,0,38253600,Null,Null,197547690,505049,6653
197548021,80.0,80.0,39000,39000,0,0,39000,Null,Null,197548021,111461,23416
197548049,0.0,0.0,14900000,8565000,6335000,43,14900000,Null,Null,197548049,184543,2340
197552614,2.0,2.0,13900000,10713000,3187000,23,13900000,Null,Null,197552614,184543,2340
197554311,8.0,8.0,30000,30000,0,0,30000,Null,Null,197554311,111461,28576
197559881,0.0,0.0,16350000,16350000,0,0,16350000,Null,Null,197559881,50307,28860
197560348,0.0,0.0,24850000,24850000,0,0,24850000,Null,Null,197560348,50307,2324
197568410,0.0,0.0,12300000,12300000,0,0,12300000,Null,Null,197568410,50307,2324
197568499,0.0,0.0,12950000,12950000,0,0,12950000,Null,Null,197568499,50307,2324
197568664,0.0,0.0,14100000,14100000,0,0,14100000,Null,Null,197568664,50307,2324
197571220,31.0,31.0,190000,190000,0,0,190000,Null,Null,197571220,111461,3990
197574926,0.0,0.0,25850000,25850000,0,0,25850000,Null,Null,197574926,198963,2324
197575307,323.0,323.0,645000,450000,195000,30,645000,Null,Null,197575307,7294963,8170
197576049,1.0,1.0,2100,2100,0,0,2100,Null,Null,197576049,111461,2
197578165,2.0,2.0,12690000,12690000,0,0,12690000,Null,Null,197578165,114527,2657
197578686,0.0,0.0,17490000,17490000,0,0,17490000,Null,Null,197578686,114527,2657
197578692,0.0,0.0,22490000,22490000,0,0,22490000,Null,Null,197578692,114527,2657
197578701,1.0,1.0,13690000,13690000,0,0,13690000,Null,Null,197578701,114527,2657
197581462,483.0,483.0,1063000,413000,650000,61,1063000,Null,Null,197581462,48077,1936
197581502,49.0,49.0,99000,99000,0,0,99000,Null,Null,197581502,166941,1641
197587166,134.0,134.0,1009000,480000,529000,52,1009000,Null,Null,197587166,361359,5531
197599756,249.0,249.0,90000,50000,40000,44,90000,Null,Null,197599756,111461,1520
197603913,12.0,12.0,39000,39000,0,0,39000,Null,Null,197603913,111461,2
197605015,0.0,0.0,20250000,15800000,4450000,22,20250000,Null,Null,197605015,18802,1795
197605473,1293.0,1293.0,590000,419000,171000,29,590000,Null,Null,197605473,238861,11819
197605784,0.0,0.0,38531000,28681000,9850000,26,38531000,Null,Null,197605784,18802,1795
197606058,0.0,0.0,7900000,7900000,0,0,7900000,Null,Null,197606058,536905,11845
197606805,0.0,0.0,95000000,95000000,0,0,95000000,Null,Null,197606805,198963,6653
197606863,0.0,0.0,6900000,6210000,690000,10,6900000,Null,Null,197606863,704815,15250
197607059,0.0,0.0,7900000,7110000,790000,10,7900000,Null,Null,197607059,704815,15250
197607148,0.0,0.0,7900000,7900000,0,0,7900000,Null,Null,197607148,536905,11845
197607561,0.0,0.0,27500000,27500000,0,0,27500000,Null,Null,197607561,198963,2324
197608171,0.0,0.0,13200000,13200000,0,0,13200000,Null,Null,197608171,198963,2324
197608359,0.0,0.0,34190000,34190000,0,0,34190000,Null,Null,197608359,198963,2324
197608665,0.0,0.0,28030000,28030000,0,0,28030000,Null,Null,197608665,198963,2324
197615248,53.0,53.0,119000,119000,0,0,119000,Null,Null,197615248,5706641,3877
197623607,4.0,4.0,80000,80000,0,0,80000,Null,Null,197623607,111461,49722
197626942,0.0,0.0,6350000,6350000,0,0,6350000,Null,Null,197626942,885749,8511
197627136,0.0,0.0,6350000,6350000,0,0,6350000,Null,Null,197627136,885749,8511
197628370,0.0,0.0,19990000,19990000,0,0,19990000,Null,Null,197628370,885749,8511
197628463,35.0,35.0,590000,390000,200000,34,590000,Null,Null,197628463,204385,1811
197628543,0.0,0.0,19990000,19990000,0,0,19990000,Null,Null,197628543,885749,8511
197628658,0.0,0.0,19990000,19990000,0,0,19990000,Null,Null,197628658,885749,8511
197629454,0.0,0.0,50000000,31490000,18510000,37,50000000,Null,Null,197629454,51302,2340
197632125,0.0,0.0,36000000,19990000,16010000,44,36000000,Null,Null,197632125,51302,2340
197633281,0.0,0.0,17990000,17990000,0,0,17990000,Null,Null,197633281,885749,8511
197633333,0.0,0.0,13850000,13850000,0,0,13850000,Null,Null,197633333,885749,8511
197635484,0.0,0.0,148000,148000,0,0,148000,Null,Null,197635484,111461,23136
197636104,30.0,30.0,138999,94999,44000,32,138999,Null,Null,197636104,163707,28574
197636897,3.0,3.0,20600000,19000000,1600000,8,20600000,Null,Null,197636897,4558659,2340
197637947,0.0,0.0,40000,18000,22000,55,40000,Null,Null,197637947,111461,15318
197638372,0.0,0.0,179000000,179000000,0,0,179000000,Null,Null,197638372,4558659,2340
197638675,0.0,0.0,15660000,15660000,0,0,15660000,Null,Null,197638675,885749,8512
197638972,0.0,0.0,15560000,15560000,0,0,15560000,Null,Null,197638972,885749,8512
197639135,0.0,0.0,19800000,19800000,0,0,19800000,Null,Null,197639135,111461,1803
197641640,0.0,0.0,7750000,7750000,0,0,7750000,Null,Null,197641640,885749,8512
197642753,0.0,0.0,7750000,7750000,0,0,7750000,Null,Null,197642753,885749,8512
197644029,0.0,0.0,7750000,7750000,0,0,7750000,Null,Null,197644029,885749,8512
197644139,0.0,0.0,7750000,7750000,0,0,7750000,Null,Null,197644139,885749,8512
197644264,0.0,0.0,7750000,7750000,0,0,7750000,Null,Null,197644264,885749,8512
197644549,0.0,0.0,7850000,7850000,0,0,7850000,Null,Null,197644549,885749,8512
197644781,0.0,0.0,7850000,7850000,0,0,7850000,Null,Null,197644781,885749,8512
197644910,0.0,0.0,11000000,11000000,0,0,11000000,Null,Null,197644910,885749,8511
197644947,0.0,0.0,7850000,7850000,0,0,7850000,Null,Null,197644947,885749,8512
197645360,0.0,0.0,11000000,11000000,0,0,11000000,Null,Null,197645360,885749,8511
197647091,75.0,75.0,23000,23000,0,0,23000,Null,Null,197647091,111461,2337
197648969,0.0,0.0,25500000,25500000,0,0,25500000,Null,Null,197648969,144527,6653
197650383,0.0,0.0,7990000,7990000,0,0,7990000,Null,Null,197650383,885749,8512
197650479,0.0,0.0,7990000,7990000,0,0,7990000,Null,Null,197650479,885749,8512
197650506,29.0,29.0,1150000,1150000,0,0,1150000,Null,Null,197650506,290985,1883
197650514,0.0,0.0,8290000,8290000,0,0,8290000,Null,Null,197650514,885749,8512
197650576,0.0,0.0,8290000,8290000,0,0,8290000,Null,Null,197650576,885749,8512
197650832,0.0,0.0,6350000,6350000,0,0,6350000,Null,Null,197650832,885749,8512
197650856,0.0,0.0,6350000,6350000,0,0,6350000,Null,Null,197650856,885749,8512
197650984,0.0,0.0,6350000,6350000,0,0,6350000,Null,Null,197650984,885749,8512
197651020,0.0,0.0,6350000,6350000,0,0,6350000,Null,Null,197651020,885749,8512
197651936,8.0,8.0,599000,539000,60000,10,599000,Null,Null,197651936,192229,1796
197652030,14.0,14.0,800000,665000,135000,17,800000,Null,Null,197652030,192229,1796
197652784,2.0,2.0,4225000,3380000,845000,20,4225000,Null,Null,197652784,25535,8170
197652945,93.0,93.0,189000,189000,0,0,189000,Null,Null,197652945,7806829,11923
197653182,104.0,104.0,369000,309000,60000,16,369000,Null,Null,197653182,5207801,11923
197653568,6.0,6.0,1890000,1890000,0,0,1890000,Null,Null,197653568,247549,1795
197654695,10.0,10.0,699000,517000,182000,26,699000,Null,Null,197654695,112638,1796
197655377,0.0,0.0,16746000,14736480,2009520,12,16746000,Null,Null,197655377,167287,6653
197658376,76.0,76.0,125000,102000,23000,18,125000,Null,Null,197658376,50653,17184
197659182,0.0,0.0,55660000,55660000,0,0,55660000,Null,Null,197659182,167287,1803
197663826,104.0,104.0,88000,85360,2640,3,88000,Null,Null,197663826,612965,8305
197665467,0.0,0.0,0,5990000,0,0,5990000,Null,Null,197665467,17827,0
197665885,459.0,459.0,5390000,4250000,1140000,21,5390000,Null,Null,197665885,17827,1815
197666071,7.0,7.0,900000,665000,235000,26,900000,Null,Null,197666071,112638,1796
197668735,2.0,2.0,9000,9000,0,0,9000,Null,Null,197668735,111461,20236
197669409,800.0,800.0,76000,62000,14000,18,76000,Null,Null,197669409,112883,17184
197670058,81.0,81.0,11000,11000,0,0,11000,Null,Null,197670058,111461,2685
197670607,36.0,36.0,211000,211000,0,0,211000,Null,Null,197670607,362757,4428
197670818,4.0,4.0,3990000,2801000,1189000,30,3990000,Null,Null,197670818,18802,1795
197674953,21.0,21.0,23990000,18790000,5200000,22,23990000,Null,Null,197674953,17827,2657
197675212,0.0,0.0,24550000,24550000,0,0,24550000,Null,Null,197675212,50307,7079
197676236,36.0,36.0,25000,25000,0,0,25000,Null,Null,197676236,4973949,20244
197676301,339.0,339.0,1300000,1099000,201000,15,1300000,Null,Null,197676301,50655,2
197676953,43.0,43.0,599000,311000,288000,48,599000,Null,Null,197676953,48077,2511
197679365,0.0,0.0,18600000,18600000,0,0,18600000,Null,Null,197679365,167287,1803
197679583,0.0,0.0,13838000,13838000,0,0,13838000,Null,Null,197679583,50307,7079
197684142,0.0,0.0,71810000,71810000,0,0,71810000,Null,Null,197684142,167287,1803
197684511,0.0,0.0,41480000,41480000,0,0,41480000,Null,Null,197684511,167287,1803
197684560,0.0,0.0,18600000,18600000,0,0,18600000,Null,Null,197684560,50307,7079
197684662,0.0,0.0,75210000,75210000,0,0,75210000,Null,Null,197684662,167287,1803
197684719,0.0,0.0,15200000,15200000,0,0,15200000,Null,Null,197684719,167287,1803
197686005,0.0,0.0,5850000,5850000,0,0,5850000,Null,Null,197686005,885749,5384
197686041,0.0,0.0,5850000,5850000,0,0,5850000,Null,Null,197686041,885749,5384
197717084,0.0,0.0,135000,135000,0,0,135000,Null,Null,197717084,111461,15250
197718314,0.0,0.0,18600000,18600000,0,0,18600000,Null,Null,197718314,167287,1803
197719976,2033.0,2033.0,2900,2900,0,0,2900,Null,Null,197719976,111461,1883
197724360,0.0,0.0,17800000,17800000,0,0,17800000,Null,Null,197724360,50307,28872
197725479,35.0,35.0,60000,40100,19900,33,60000,Null,Null,197725479,220049,13878
197725714,85.0,85.0,2600000,1245000,1355000,52,2600000,Null,Null,197725714,111461,4381
197739060,1.0,1.0,99000,99000,0,0,99000,Null,Null,197739060,111461,15250
197744188,193.0,193.0,699000,336000,363000,52,699000,Null,Null,197744188,302375,8400
197746067,20.0,20.0,108000,108000,0,0,108000,Null,Null,197746067,111461,2018
197748782,0.0,0.0,35500000,34435000,1065000,3,35500000,Null,Null,197748782,167287,7079
197750208,9.0,9.0,777000,719000,58000,7,777000,Null,Null,197750208,40626,3422
197751409,0.0,0.0,15100000,15100000,0,0,15100000,Null,Null,197751409,50307,7079
197776679,0.0,0.0,60000000,60000000,0,0,60000000,Null,Null,197776679,111461,23708
197776680,0.0,0.0,47000000,47000000,0,0,47000000,Null,Null,197776680,111461,23708
197776681,0.0,0.0,85000000,85000000,0,0,85000000,Null,Null,197776681,111461,23544
197777608,104.0,104.0,114000,110000,4000,4,114000,Null,Null,197777608,197443,13878
197777610,72.0,72.0,171000,146000,25000,15,171000,Null,Null,197777610,197443,13878
197778485,22.0,22.0,500000,500000,0,0,500000,Null,Null,197778485,464737,8042
197782510,0.0,0.0,6500,6500,0,0,6500,Null,Null,197782510,111461,8167
197782518,0.0,0.0,18350000,18350000,0,0,18350000,Null,Null,197782518,50307,7079
197788454,0.0,0.0,71500000,71500000,0,0,71500000,Null,Null,197788454,162947,7079
197788498,0.0,0.0,31500000,31500000,0,0,31500000,Null,Null,197788498,162947,7079
197788599,0.0,0.0,61500000,61500000,0,0,61500000,Null,Null,197788599,162947,7079
197792282,0.0,0.0,42140000,42140000,0,0,42140000,Null,Null,197792282,111461,2
197792632,1.0,1.0,66000,66000,0,0,66000,Null,Null,197792632,111461,2
197798432,0.0,0.0,8600000,5998000,2602000,30,8600000,Null,Null,197798432,26150,8513
197798537,10.0,10.0,35000,35000,0,0,35000,Null,Null,197798537,425177,15250
197799008,1.0,1.0,60000,48000,12000,20,60000,Null,Null,197799008,111461,15318
197799407,17.0,17.0,50000,34000,16000,32,50000,Null,Null,197799407,111461,15318
197799490,0.0,0.0,1000,1000,0,0,1000,Null,Null,197799490,111461,2
197799500,0.0,0.0,4900,4900,0,0,4900,Null,Null,197799500,111461,2
197799587,0.0,0.0,2910,2910,0,0,2910,Null,Null,197799587,111461,2
197799623,0.0,0.0,1862,1862,0,0,1862,Null,Null,197799623,111461,2
197799658,4.0,4.0,8990,8990,0,0,8990,Null,Null,197799658,111461,2
197799677,30.0,30.0,2910,2910,0,0,2910,Null,Null,197799677,111461,2
197799687,60.0,60.0,5811,5811,0,0,5811,Null,Null,197799687,111461,2
197799692,0.0,0.0,4841,4841,0,0,4841,Null,Null,197799692,111461,2
197799696,3.0,3.0,9290,9290,0,0,9290,Null,Null,197799696,111461,2
197799777,30.0,30.0,1790,1790,0,0,1790,Null,Null,197799777,111461,2
197799889,0.0,0.0,1890,1890,0,0,1890,Null,Null,197799889,111461,2
197799969,6.0,6.0,2940,2940,0,0,2940,Null,Null,197799969,111461,2
197799993,0.0,0.0,1900,1900,0,0,1900,Null,Null,197799993,111461,2
197800040,5.0,5.0,1000,1000,0,0,1000,Null,Null,197800040,111461,2
197800056,1.0,1.0,7760,7760,0,0,7760,Null,Null,197800056,111461,2
197800079,0.0,0.0,2500,2500,0,0,2500,Null,Null,197800079,111461,2
197800174,0.0,0.0,1940,1940,0,0,1940,Null,Null,197800174,111461,2
197800177,3.0,3.0,2940,2940,0,0,2940,Null,Null,197800177,111461,2
197800199,0.0,0.0,5880,5880,0,0,5880,Null,Null,197800199,111461,20254
197800248,0.0,0.0,1000,1000,0,0,1000,Null,Null,197800248,111461,2
197800411,52.0,52.0,1000,1000,0,0,1000,Null,Null,197800411,111461,2
197800463,0.0,0.0,5820,5820,0,0,5820,Null,Null,197800463,111461,2
197800483,0.0,0.0,1000,1000,0,0,1000,Null,Null,197800483,111461,2
197800526,3.0,3.0,4500,4500,0,0,4500,Null,Null,197800526,111461,2
197800548,0.0,0.0,7663,7663,0,0,7663,Null,Null,197800548,111461,2
197800618,0.0,0.0,4900,4900,0,0,4900,Null,Null,197800618,111461,2
197800632,0.0,0.0,2450,2450,0,0,2450,Null,Null,197800632,111461,2
197800805,0.0,0.0,1000,1000,0,0,1000,Null,Null,197800805,111461,2
197800904,0.0,0.0,1000,1000,0,0,1000,Null,Null,197800904,111461,2
197800942,9.0,9.0,6370,6370,0,0,6370,Null,Null,197800942,111461,2
197800958,0.0,0.0,8730,8730,0,0,8730,Null,Null,197800958,111461,2
197801012,0.0,0.0,1890,1890,0,0,1890,Null,Null,197801012,111461,2
197801017,0.0,0.0,1940,1940,0,0,1940,Null,Null,197801017,111461,2
197801018,0.0,0.0,5820,5820,0,0,5820,Null,Null,197801018,111461,2
197801023,0.0,0.0,4850,4850,0,0,4850,Null,Null,197801023,111461,2
197801048,0.0,0.0,7400,7400,0,0,7400,Null,Null,197801048,111461,2
197801123,0.0,0.0,14500,14500,0,0,14500,Null,Null,197801123,111461,2
197801146,0.0,0.0,1000,1000,0,0,1000,Null,Null,197801146,111461,2
197801153,1.0,1.0,6500,6500,0,0,6500,Null,Null,197801153,111461,2
197801238,0.0,0.0,5820,5820,0,0,5820,Null,Null,197801238,111461,2
197801249,0.0,0.0,6370,6370,0,0,6370,Null,Null,197801249,111461,2
197801337,0.0,0.0,6370,6370,0,0,6370,Null,Null,197801337,111461,2
197801359,0.0,0.0,1940,1940,0,0,1940,Null,Null,197801359,111461,2
197801365,0.0,0.0,2690,2690,0,0,2690,Null,Null,197801365,111461,2
197801366,10.0,10.0,3871,3871,0,0,3871,Null,Null,197801366,111461,2
197801402,0.0,0.0,2910,2910,0,0,2910,Null,Null,197801402,111461,2
197801433,0.0,0.0,4900,4900,0,0,4900,Null,Null,197801433,111461,20254
197801453,8.0,8.0,4690,4690,0,0,4690,Null,Null,197801453,111461,2
197801470,0.0,0.0,1960,1960,0,0,1960,Null,Null,197801470,111461,2
197801508,32.0,32.0,3690,3690,0,0,3690,Null,Null,197801508,111461,2
197801524,0.0,0.0,1000,1000,0,0,1000,Null,Null,197801524,111461,2
197801529,0.0,0.0,3430,3430,0,0,3430,Null,Null,197801529,111461,2
197801572,5.0,5.0,2500,2500,0,0,2500,Null,Null,197801572,111461,2
197801598,25.0,25.0,8000,8000,0,0,8000,Null,Null,197801598,111461,2
197801617,10.0,10.0,1000,1000,0,0,1000,Null,Null,197801617,111461,2
197801620,0.0,0.0,2940,2940,0,0,2940,Null,Null,197801620,111461,2
197801629,30.0,30.0,1200,1200,0,0,1200,Null,Null,197801629,111461,2
197801659,0.0,0.0,5880,5880,0,0,5880,Null,Null,197801659,111461,2
197801666,0.0,0.0,3920,3920,0,0,3920,Null,Null,197801666,111461,2
197801678,0.0,0.0,1931,1931,0,0,1931,Null,Null,197801678,111461,2
197801799,30.0,30.0,1900,1900,0,0,1900,Null,Null,197801799,111461,2
197801806,10.0,10.0,2910,2910,0,0,2910,Null,Null,197801806,111461,2
197801917,0.0,0.0,2813,2813,0,0,2813,Null,Null,197801917,111461,2
197801965,0.0,0.0,1000,1000,0,0,1000,Null,Null,197801965,111461,2
197802014,0.0,0.0,9000,9000,0,0,9000,Null,Null,197802014,111461,2
197802036,0.0,0.0,1951,1951,0,0,1951,Null,Null,197802036,111461,2
197802098,0.0,0.0,1000,1000,0,0,1000,Null,Null,197802098,111461,2
197802117,5.0,5.0,2500,2500,0,0,2500,Null,Null,197802117,111461,2
197802160,10.0,10.0,1000,1000,0,0,1000,Null,Null,197802160,111461,2
197802205,10.0,10.0,2910,2910,0,0,2910,Null,Null,197802205,111461,2
197802349,0.0,0.0,8730,8730,0,0,8730,Null,Null,197802349,111461,2
197802395,0.0,0.0,2441,2441,0,0,2441,Null,Null,197802395,111461,2
197802398,4.0,4.0,4900,4900,0,0,4900,Null,Null,197802398,111461,2
197802422,23.0,23.0,3800,3800,0,0,3800,Null,Null,197802422,111461,2
197802438,0.0,0.0,8730,8730,0,0,8730,Null,Null,197802438,111461,2
197802473,0.0,0.0,1000,1000,0,0,1000,Null,Null,197802473,111461,2
197802520,0.0,0.0,8820,8820,0,0,8820,Null,Null,197802520,111461,2
197802560,43.0,43.0,1000,1000,0,0,1000,Null,Null,197802560,111461,2
197802659,0.0,0.0,2425,2425,0,0,2425,Null,Null,197802659,111461,2
197802669,0.0,0.0,1000,1000,0,0,1000,Null,Null,197802669,111461,2
197802674,0.0,0.0,2425,2425,0,0,2425,Null,Null,197802674,111461,2
197802697,0.0,0.0,1000,1000,0,0,1000,Null,Null,197802697,111461,2
197802703,0.0,0.0,2500,2500,0,0,2500,Null,Null,197802703,111461,2
197802714,0.0,0.0,2940,2940,0,0,2940,Null,Null,197802714,111461,2
197802811,8.0,8.0,6990,6990,0,0,6990,Null,Null,197802811,111461,2
197802846,0.0,0.0,1000,1000,0,0,1000,Null,Null,197802846,111461,2
197802917,0.0,0.0,1000,1000,0,0,1000,Null,Null,197802917,111461,2
197802930,0.0,0.0,3990,3990,0,0,3990,Null,Null,197802930,111461,2
197802951,0.0,0.0,3000,3000,0,0,3000,Null,Null,197802951,111461,2
197802996,0.0,0.0,1931,1931,0,0,1931,Null,Null,197802996,111461,8073
197803026,0.0,0.0,1890,1890,0,0,1890,Null,Null,197803026,111461,2
197803028,0.0,0.0,1390,1390,0,0,1390,Null,Null,197803028,111461,2
197803046,12.0,12.0,4350,4350,0,0,4350,Null,Null,197803046,111461,2
197803070,0.0,0.0,5225,5225,0,0,5225,Null,Null,197803070,111461,2
197803087,0.0,0.0,9215,9215,0,0,9215,Null,Null,197803087,111461,2
197803097,0.0,0.0,4900,4900,0,0,4900,Null,Null,197803097,111461,2
197803148,0.0,0.0,1470,1470,0,0,1470,Null,Null,197803148,111461,2
197803159,0.0,0.0,1000,1000,0,0,1000,Null,Null,197803159,111461,2
197803161,0.0,0.0,1951,1951,0,0,1951,Null,Null,197803161,111461,2
197803169,25.0,25.0,6860,6860,0,0,6860,Null,Null,197803169,111461,2
197803178,0.0,0.0,2940,2940,0,0,2940,Null,Null,197803178,111461,2
197803192,0.0,0.0,3900,3900,0,0,3900,Null,Null,197803192,111461,2
197803269,0.0,0.0,1000,1000,0,0,1000,Null,Null,197803269,111461,2
197803416,10.0,10.0,1000,1000,0,0,1000,Null,Null,197803416,111461,2
197803496,114.0,114.0,1000,1000,0,0,1000,Null,Null,197803496,111461,2
197803510,0.0,0.0,1000,1000,0,0,1000,Null,Null,197803510,111461,2
197803525,0.0,0.0,4850,4850,0,0,4850,Null,Null,197803525,111461,2
197803531,0.0,0.0,1000,1000,0,0,1000,Null,Null,197803531,111461,8073
197803595,0.0,0.0,1000,1000,0,0,1000,Null,Null,197803595,111461,2
197803607,0.0,0.0,1940,1940,0,0,1940,Null,Null,197803607,111461,2
197803640,0.0,0.0,3800,3800,0,0,3800,Null,Null,197803640,111461,2
197803717,0.0,0.0,1000,1000,0,0,1000,Null,Null,197803717,111461,2
197803767,0.0,0.0,5335,5335,0,0,5335,Null,Null,197803767,111461,2
197803770,0.0,0.0,3421,3421,0,0,3421,Null,Null,197803770,111461,26658
197803788,0.0,0.0,5871,5871,0,0,5871,Null,Null,197803788,111461,2
197803831,0.0,0.0,1000,1000,0,0,1000,Null,Null,197803831,111461,2
197803840,0.0,0.0,5871,5871,0,0,5871,Null,Null,197803840,111461,2
197803854,0.0,0.0,2910,2910,0,0,2910,Null,Null,197803854,111461,2
197803904,0.0,0.0,1390,1390,0,0,1390,Null,Null,197803904,111461,2
197803943,0.0,0.0,4500,4500,0,0,4500,Null,Null,197803943,111461,2
197803946,0.0,0.0,1000,1000,0,0,1000,Null,Null,197803946,111461,2
197803984,0.0,0.0,1398,1398,0,0,1398,Null,Null,197803984,111461,2
197804006,0.0,0.0,2646,2646,0,0,2646,Null,Null,197804006,111461,2
197804071,0.0,0.0,4900,4900,0,0,4900,Null,Null,197804071,111461,2
197804079,10.0,10.0,7900,7900,0,0,7900,Null,Null,197804079,111461,2
197804103,1.0,1.0,5880,5880,0,0,5880,Null,Null,197804103,111461,2
197804120,0.0,0.0,6900,6900,0,0,6900,Null,Null,197804120,111461,2
197804350,5.0,5.0,5690,5690,0,0,5690,Null,Null,197804350,111461,2
197804507,0.0,0.0,3871,3871,0,0,3871,Null,Null,197804507,111461,20254
197804568,0.0,0.0,3395,3395,0,0,3395,Null,Null,197804568,111461,2
197804597,11.0,11.0,1000,1000,0,0,1000,Null,Null,197804597,111461,2
197804628,0.0,0.0,4750,4750,0,0,4750,Null,Null,197804628,111461,2
197804672,21.0,21.0,28900,28900,0,0,28900,Null,Null,197804672,111461,2
197804726,0.0,0.0,5880,5880,0,0,5880,Null,Null,197804726,111461,2
197804727,0.0,0.0,1843,1843,0,0,1843,Null,Null,197804727,111461,2
197804736,15.0,15.0,3880,3880,0,0,3880,Null,Null,197804736,111461,2
197804761,10.0,10.0,9000,9000,0,0,9000,Null,Null,197804761,111461,2
197804787,10.0,10.0,4410,4410,0,0,4410,Null,Null,197804787,111461,2
197804803,0.0,0.0,3500,3500,0,0,3500,Null,Null,197804803,111461,2
197820987,0.0,0.0,52900000,52900000,0,0,52900000,Null,Null,197820987,111461,23544
197821876,0.0,0.0,58000000,52200000,5800000,10,58000000,Null,Null,197821876,111461,23708
197821885,0.0,0.0,48000000,44160000,3840000,8,48000000,Null,Null,197821885,111461,23708
197821890,0.0,0.0,89000000,72090000,16910000,19,89000000,Null,Null,197821890,111461,23544
197821983,1.0,1.0,180000,180000,0,0,180000,Null,Null,197821983,111461,15250
197822493,2.0,2.0,250000,250000,0,0,250000,Null,Null,197822493,111461,15318
197823661,0.0,0.0,8000,8000,0,0,8000,Null,Null,197823661,111461,1622
197826230,0.0,0.0,23680000,23680000,0,0,23680000,Null,Null,197826230,939519,7079
197828101,0.0,0.0,5000,5000,0,0,5000,Null,Null,197828101,111461,8202
197828758,0.0,0.0,15200000,15200000,0,0,15200000,Null,Null,197828758,50307,7079
197830377,0.0,0.0,22680000,22680000,0,0,22680000,Null,Null,197830377,939519,7079
197849651,0.0,0.0,69999000,64399080,5599920,8,69999000,Null,Null,197849651,111461,23708
197849955,231.0,231.0,459000,430000,29000,6,459000,Null,Null,197849955,3985581,2225
197850024,14.0,14.0,458000,229000,229000,50,458000,Null,Null,197850024,111461,1883
197850095,0.0,0.0,41500000,41500000,0,0,41500000,Null,Null,197850095,50307,7079
197854747,0.0,0.0,59400000,57618000,1782000,3,59400000,Null,Null,197854747,162947,7079
197855704,0.0,0.0,38000000,36100000,1900000,5,38000000,Null,Null,197855704,162947,7079
197858885,0.0,0.0,29990000,26391200,3598800,12,29990000,Null,Null,197858885,50307,11518
197859008,0.0,0.0,60030000,60030000,0,0,60030000,Null,Null,197859008,144527,6653
197860856,0.0,0.0,89300000,89300000,0,0,89300000,Null,Null,197860856,162947,7079
197865867,53.0,53.0,50000,30000,20000,40,50000,Null,Null,197865867,5334123,23276
197878902,178.0,178.0,35000,35000,0,0,35000,Null,Null,197878902,5706641,2363
197878929,110.0,110.0,65000,65000,0,0,65000,Null,Null,197878929,4973949,28428
197885277,2.0,2.0,60000,60000,0,0,60000,Null,Null,197885277,111461,15320
197887886,11.0,11.0,57899,57899,0,0,57899,Null,Null,197887886,111461,23588
197889905,52.0,52.0,3890000,2540000,1350000,35,3890000,Null,Null,197889905,19673,1795
197891720,35.0,35.0,120000,120000,0,0,120000,Null,Null,197891720,445887,28484
197898685,1.0,1.0,124200,124200,0,0,124200,Null,Null,197898685,111461,15250
197899357,40.0,40.0,1200,1200,0,0,1200,Null,Null,197899357,111461,23112
197900186,63.0,63.0,2200000,1490000,710000,32,2200000,Null,Null,197900186,150433,12908
197902379,232.0,232.0,129000,105000,24000,19,129000,Null,Null,197902379,22013,11605
197902452,0.0,0.0,790000,790000,0,0,790000,Null,Null,197902452,112638,1796
197905982,22.0,22.0,349000,349000,0,0,349000,Null,Null,197905982,573293,1796
197907038,72.0,72.0,339000,339000,0,0,339000,Null,Null,197907038,573293,1796
197907683,55.0,55.0,200000,59000,141000,71,200000,Null,Null,197907683,254741,28484
197920567,0.0,0.0,33935000,29862800,4072200,12,33935000,Null,Null,197920567,50307,11518
197922889,7.0,7.0,56400,39000,17400,31,56400,Null,Null,197922889,5132069,3175
197922924,1.0,1.0,2390000,2390000,0,0,2390000,Null,Null,197922924,861723,28856
197927047,0.0,0.0,6499000,6499000,0,0,6499000,Null,Null,197927047,432537,8165
197955257,0.0,0.0,20302000,17865760,2436240,12,20302000,Null,Null,197955257,50307,11518
197960169,14.0,14.0,700000,565000,135000,19,700000,Null,Null,197960169,112638,1796
197964281,0.0,0.0,65300000,65300000,0,0,65300000,Null,Null,197964281,4558659,2340
197966450,120.0,120.0,189000,90000,99000,52,189000,Null,Null,197966450,302375,1838
197966614,0.0,0.0,14050000,14050000,0,0,14050000,Null,Null,197966614,167287,6653
197966909,60.0,60.0,3990000,2849000,1141000,29,3990000,Null,Null,197966909,18802,1795
197970902,2.0,2.0,5400000,4080000,1320000,24,5400000,Null,Null,197970902,227141,11871
197972886,25.0,25.0,210000,210000,0,0,210000,Null,Null,197972886,111461,28452
197972938,655.0,655.0,49000,20000,29000,59,49000,Null,Null,197972938,561415,1883
197989233,0.0,0.0,17450000,17450000,0,0,17450000,Null,Null,197989233,162945,7079
197990359,0.0,0.0,12000,12000,0,0,12000,Null,Null,197990359,111461,15936
197990366,1.0,1.0,16500,16500,0,0,16500,Null,Null,197990366,111461,2
197990407,1.0,1.0,17000,17000,0,0,17000,Null,Null,197990407,111461,2
197990447,1.0,1.0,13000,13000,0,0,13000,Null,Null,197990447,111461,2
197990453,0.0,0.0,8450,8450,0,0,8450,Null,Null,197990453,111461,2
197990454,0.0,0.0,14500,14500,0,0,14500,Null,Null,197990454,111461,15936
197990459,0.0,0.0,12000,12000,0,0,12000,Null,Null,197990459,111461,2
197990470,0.0,0.0,13000,13000,0,0,13000,Null,Null,197990470,111461,2
197990473,0.0,0.0,16000,16000,0,0,16000,Null,Null,197990473,111461,2
197990482,2.0,2.0,7700,7700,0,0,7700,Null,Null,197990482,111461,2
197990509,0.0,0.0,11500,11500,0,0,11500,Null,Null,197990509,111461,2
197990514,0.0,0.0,13000,13000,0,0,13000,Null,Null,197990514,111461,2
197990538,0.0,0.0,7150,7150,0,0,7150,Null,Null,197990538,111461,2
197990543,1.0,1.0,14500,14500,0,0,14500,Null,Null,197990543,111461,2
197990553,4.0,4.0,7500,7500,0,0,7500,Null,Null,197990553,111461,2
197990607,0.0,0.0,13000,13000,0,0,13000,Null,Null,197990607,111461,2
198018866,10.0,10.0,1000,1000,0,0,1000,Null,Null,198018866,111461,2
198019500,0.0,0.0,8400,8400,0,0,8400,Null,Null,198019500,111461,2
198019540,1.0,1.0,9800,9800,0,0,9800,Null,Null,198019540,111461,2
198019609,0.0,0.0,9800,9800,0,0,9800,Null,Null,198019609,111461,2
198019985,0.0,0.0,10800,10800,0,0,10800,Null,Null,198019985,111461,2
198020170,0.0,0.0,55000000,46750000,8250000,15,55000000,Null,Null,198020170,111461,23576
198020481,0.0,0.0,16250000,16250000,0,0,16250000,Null,Null,198020481,50331,6653
198021649,0.0,0.0,81000000,68850000,12150000,15,81000000,Null,Null,198021649,111461,23576
198021686,0.0,0.0,11600000,11600000,0,0,11600000,Null,Null,198021686,50331,6653
198028980,0.0,0.0,360000,360000,0,0,360000,Null,Null,198028980,111461,27170
198029481,0.0,0.0,34699000,34699000,0,0,34699000,Null,Null,198029481,162945,7079
198031212,0.0,0.0,18750000,18750000,0,0,18750000,Null,Null,198031212,162945,7079
198034818,0.0,0.0,13950000,13950000,0,0,13950000,Null,Null,198034818,167287,11516
198034831,0.0,0.0,12250000,12250000,0,0,12250000,Null,Null,198034831,162945,28874
198035723,0.0,0.0,17450000,17450000,0,0,17450000,Null,Null,198035723,162945,28874
198039744,0.0,0.0,14200000,14200000,0,0,14200000,Null,Null,198039744,167287,11516
198040666,0.0,0.0,24750000,24750000,0,0,24750000,Null,Null,198040666,162945,7079
198042943,0.0,0.0,12990000,12990000,0,0,12990000,Null,Null,198042943,162957,1803
198056050,3.0,3.0,122000,122000,0,0,122000,Null,Null,198056050,111461,15318
198057044,55.0,55.0,660000,660000,0,0,660000,Null,Null,198057044,5706641,23236
198058535,260.0,260.0,299000,299000,0,0,299000,Null,Null,198058535,111461,11911
198069246,200.0,200.0,511000,295000,216000,42,511000,Null,Null,198069246,4224691,23832
198069834,30.0,30.0,1500,1500,0,0,1500,Null,Null,198069834,111461,18876
198076584,138.0,138.0,525000,460000,65000,12,525000,Null,Null,198076584,7505233,8223
198081212,111.0,111.0,552000,398000,154000,28,552000,Null,Null,198081212,21261,1630
198081603,29.0,29.0,155000,83000,72000,46,155000,Null,Null,198081603,111461,23392
198082152,138.0,138.0,392000,238000,154000,39,392000,Null,Null,198082152,21261,1630
198084516,260.0,260.0,634000,458000,176000,28,634000,Null,Null,198084516,21261,1630
198084820,2.0,2.0,729000,565000,164000,22,729000,Null,Null,198084820,166193,1796
198085747,0.0,0.0,102880000,102880000,0,0,102880000,Null,Null,198085747,5740935,6653
198088413,246.0,246.0,186000,170000,16000,9,186000,Null,Null,198088413,21261,1631
198091757,0.0,0.0,1900,1900,0,0,1900,Null,Null,198091757,111461,2
198096634,12.0,12.0,699000,517000,182000,26,699000,Null,Null,198096634,150568,1796
198097413,249.0,249.0,329000,164500,164500,50,329000,Null,Null,198097413,5132069,2513
198102288,582.0,582.0,330000,330000,0,0,330000,Null,Null,198102288,276747,1520
198102764,203.0,203.0,250000,149000,101000,40,250000,Null,Null,198102764,938179,3877
198111545,1.0,1.0,8490000,7790000,700000,8,8490000,Null,Null,198111545,52232,1795
198122812,0.0,0.0,16400000,16400000,0,0,16400000,Null,Null,198122812,50307,28874
198126604,234.0,234.0,220000,119000,101000,46,220000,Null,Null,198126604,4224691,1831
198127091,99.0,99.0,260000,96000,164000,63,260000,Null,Null,198127091,5221825,7064
198129669,99.0,99.0,2590000,2590000,0,0,2590000,Null,Null,198129669,196181,2657
198184685,0.0,0.0,14500000,14500000,0,0,14500000,Null,Null,198184685,167287,6653
198187334,0.0,0.0,569000,502000,67000,12,569000,Null,Null,198187334,150568,1796
198188259,7.0,7.0,729000,564000,165000,23,729000,Null,Null,198188259,166193,1796
198188785,3.0,3.0,729000,564000,165000,23,729000,Null,Null,198188785,166193,1796
198192347,103.0,103.0,25000,25000,0,0,25000,Null,Null,198192347,5706641,3177
198198165,0.0,0.0,26500000,26500000,0,0,26500000,Null,Null,198198165,50307,7079
198199219,0.0,0.0,16500000,16500000,0,0,16500000,Null,Null,198199219,50307,7079
198203575,0.0,0.0,1500,1500,0,0,1500,Null,Null,198203575,111461,23156
198203844,0.0,0.0,51700000,51700000,0,0,51700000,Null,Null,198203844,181195,5566
198204684,218.0,218.0,15000,15000,0,0,15000,Null,Null,198204684,864561,11935
198207869,0.0,0.0,51150000,38362500,12787500,25,51150000,Null,Null,198207869,111461,23576
198208154,0.0,0.0,11950000,11950000,0,0,11950000,Null,Null,198208154,7480987,8400
198214329,359.0,359.0,50000,37500,12500,25,50000,Null,Null,198214329,4439523,1883
198219660,1074.0,1074.0,35000,33250,1750,5,35000,Null,Null,198219660,4439523,1883
198224503,0.0,0.0,11950000,11950000,0,0,11950000,Null,Null,198224503,50307,28640
198240361,0.0,0.0,36000000,36000000,0,0,36000000,Null,Null,198240361,181195,28638
198240945,0.0,0.0,20500000,20500000,0,0,20500000,Null,Null,198240945,181195,28638
198245722,2.0,2.0,31000000,29450000,1550000,5,31000000,Null,Null,198245722,50307,7079
198246045,145.0,145.0,350000,163000,187000,53,350000,Null,Null,198246045,5003355,2018
198254452,15.0,15.0,3890000,2690000,1200000,31,3890000,Null,Null,198254452,27932,1795
198256928,0.0,0.0,44000000,41800000,2200000,5,44000000,Null,Null,198256928,50307,7079
198268770,0.0,0.0,17850000,16957500,892500,5,17850000,Null,Null,198268770,50307,7079
198269566,0.0,0.0,19200000,19200000,0,0,19200000,Null,Null,198269566,162945,7079
198269930,121.0,121.0,199000,99000,100000,50,199000,Null,Null,198269930,314675,12908
198278397,0.0,0.0,10500,10500,0,0,10500,Null,Null,198278397,111461,23024
198282334,0.0,0.0,7155555,7155555,0,0,7155555,Null,Null,198282334,885749,8512
198282348,0.0,0.0,11000000,11000000,0,0,11000000,Null,Null,198282348,111461,15318
198282399,0.0,0.0,7150000,7150000,0,0,7150000,Null,Null,198282399,885749,8512
198282460,0.0,0.0,7150000,7150000,0,0,7150000,Null,Null,198282460,885749,8512
198282805,0.0,0.0,11000000,11000000,0,0,11000000,Null,Null,198282805,111461,15318
198282884,0.0,0.0,9100000,9100000,0,0,9100000,Null,Null,198282884,111461,15318
198283502,0.0,0.0,15500,15500,0,0,15500,Null,Null,198283502,111461,15320
198292236,65.0,65.0,265000,265000,0,0,265000,Null,Null,198292236,4202899,2363
198295120,0.0,0.0,9000,9000,0,0,9000,Null,Null,198295120,111461,28470
198295129,0.0,0.0,9000,9000,0,0,9000,Null,Null,198295129,111461,1819
198295325,209.0,209.0,231000,138000,93000,40,231000,Null,Null,198295325,48077,23126
198296244,0.0,0.0,36900000,36900000,0,0,36900000,Null,Null,198296244,111461,23576
198296247,10.0,10.0,18900,18900,0,0,18900,Null,Null,198296247,111461,2514
198296331,0.0,0.0,63300000,60135000,3165000,5,63300000,Null,Null,198296331,50307,7079
198297084,0.0,0.0,43900000,43900000,0,0,43900000,Null,Null,198297084,111461,23072
198301392,0.0,0.0,32500000,32500000,0,0,32500000,Null,Null,198301392,153313,11516
198302946,15.0,15.0,8000,8000,0,0,8000,Null,Null,198302946,111461,8305
198311810,0.0,0.0,120000,120000,0,0,120000,Null,Null,198311810,111461,15318
198312370,0.0,0.0,20000,11000,9000,45,20000,Null,Null,198312370,4647777,15318
198320645,13.0,13.0,1485,1485,0,0,1485,Null,Null,198320645,111461,2363
198320648,67.0,67.0,1485,1485,0,0,1485,Null,Null,198320648,111461,2363
198328273,1.0,1.0,4650000,3559000,1091000,23,4650000,Null,Null,198328273,218061,1626
198334840,0.0,0.0,10000,7000,3000,30,10000,Null,Null,198334840,779129,1520
198341167,154.0,154.0,81000,66000,15000,19,81000,Null,Null,198341167,112886,1583
198349981,36.0,36.0,63000,63000,0,0,63000,Null,Null,198349981,4973949,20244
198363821,9.0,9.0,2190000,2190000,0,0,2190000,Null,Null,198363821,25422,1795
198364602,0.0,0.0,5250000,5250000,0,0,5250000,Null,Null,198364602,111461,2
198364603,0.0,0.0,10600000,10600000,0,0,10600000,Null,Null,198364603,111461,2
198364611,0.0,0.0,3500000,3500000,0,0,3500000,Null,Null,198364611,111461,2
198364612,0.0,0.0,8560000,8560000,0,0,8560000,Null,Null,198364612,111461,2
198364616,0.0,0.0,3800000,3800000,0,0,3800000,Null,Null,198364616,111461,2
198364625,0.0,0.0,19000000,19000000,0,0,19000000,Null,Null,198364625,111461,2
198364629,2.0,2.0,4800000,4800000,0,0,4800000,Null,Null,198364629,111461,2
198364630,0.0,0.0,5250000,5250000,0,0,5250000,Null,Null,198364630,111461,2
198364637,4.0,4.0,7400000,7400000,0,0,7400000,Null,Null,198364637,111461,2
198364645,0.0,0.0,3500000,3500000,0,0,3500000,Null,Null,198364645,111461,2
198364651,0.0,0.0,12600000,12600000,0,0,12600000,Null,Null,198364651,111461,2
198364655,0.0,0.0,7200000,7200000,0,0,7200000,Null,Null,198364655,111461,2
198364767,51.0,51.0,196000,196000,0,0,196000,Null,Null,198364767,7814835,1623
198373493,38.0,38.0,550000,550000,0,0,550000,Null,Null,198373493,189445,28574
198378706,23.0,23.0,490000,490000,0,0,490000,Null,Null,198378706,189445,28574
198380859,0.0,0.0,4250000,4250000,0,0,4250000,Null,Null,198380859,885749,8512
198382045,0.0,0.0,8100000,6885000,1215000,15,8100000,Null,Null,198382045,111461,15318
198384729,15.0,15.0,280000,280000,0,0,280000,Null,Null,198384729,606305,7078
198384811,18.0,18.0,16000,16000,0,0,16000,Null,Null,198384811,111461,15250
198384812,12.0,12.0,13000,13000,0,0,13000,Null,Null,198384812,111461,15236
198384832,34.0,34.0,16000,16000,0,0,16000,Null,Null,198384832,111461,15318
198384860,25.0,25.0,12000,12000,0,0,12000,Null,Null,198384860,111461,15236
198396594,7.0,7.0,60000,60000,0,0,60000,Null,Null,198396594,111461,8371
198412803,0.0,0.0,20500,20500,0,0,20500,Null,Null,198412803,111461,15320
198417113,11.0,11.0,1500,1500,0,0,1500,Null,Null,198417113,111461,23042
198417119,33.0,33.0,1500,1500,0,0,1500,Null,Null,198417119,111461,23042
198417137,0.0,0.0,44700000,44700000,0,0,44700000,Null,Null,198417137,5648015,23576
198417140,0.0,0.0,72600000,72600000,0,0,72600000,Null,Null,198417140,5648015,23576
198417159,0.0,0.0,55100000,38570000,16530000,30,55100000,Null,Null,198417159,5648015,23576
198417200,0.0,0.0,56400000,56400000,0,0,56400000,Null,Null,198417200,5648015,23576
198419182,0.0,0.0,8900000,8900000,0,0,8900000,Null,Null,198419182,111461,15318
198419578,0.0,0.0,61000000,61000000,0,0,61000000,Null,Null,198419578,162945,11516
198425388,0.0,0.0,32600000,32600000,0,0,32600000,Null,Null,198425388,167287,11516
198432761,58.0,58.0,2400000,2215000,185000,8,2400000,Null,Null,198432761,112614,2657
198436377,0.0,0.0,19100000,19100000,0,0,19100000,Null,Null,198436377,50307,7079
198436526,93.0,93.0,390000,199000,191000,49,390000,Null,Null,198436526,111461,53054
198436702,0.0,0.0,49300000,49300000,0,0,49300000,Null,Null,198436702,162945,11516
198447877,3.0,3.0,6290000,6290000,0,0,6290000,Null,Null,198447877,25422,1794
198451286,0.0,0.0,18000,18000,0,0,18000,Null,Null,198451286,111461,15320
198453583,0.0,0.0,37000,37000,0,0,37000,Null,Null,198453583,111461,2
198457556,0.0,0.0,3192000,3192000,0,0,3192000,Null,Null,198457556,25643,1795
198458249,0.0,0.0,9100000,7735000,1365000,15,9100000,Null,Null,198458249,111461,15318
198462340,0.0,0.0,11000000,9900000,1100000,10,11000000,Null,Null,198462340,111461,15318
198468394,0.0,0.0,15490000,15490000,0,0,15490000,Null,Null,198468394,18641,1815
198494823,8.0,8.0,11000,6000,5000,45,11000,Null,Null,198494823,111461,28426
198495912,4.0,4.0,179100,179100,0,0,179100,Null,Null,198495912,162313,28484
198497724,17.0,17.0,250000,158000,92000,37,250000,Null,Null,198497724,4224691,49722
198500332,69.0,69.0,286200,159000,127200,44,286200,Null,Null,198500332,46703,3177
198509623,0.0,0.0,37500000,37500000,0,0,37500000,Null,Null,198509623,111461,2
198509661,0.0,0.0,40000000,40000000,0,0,40000000,Null,Null,198509661,111461,2
198509909,0.0,0.0,50000000,50000000,0,0,50000000,Null,Null,198509909,111461,2
198509951,0.0,0.0,37500000,37500000,0,0,37500000,Null,Null,198509951,111461,2
198510237,81.0,81.0,240000,124000,116000,48,240000,Null,Null,198510237,154455,18876
198517292,10.0,10.0,80000,80000,0,0,80000,Null,Null,198517292,111461,15250
198518795,0.0,0.0,16800000,15959000,841000,5,16800000,Null,Null,198518795,20239,2324
198531441,92.0,92.0,210000,210000,0,0,210000,Null,Null,198531441,5383335,7078
198531476,1.0,1.0,24519,24519,0,0,24519,Null,Null,198531476,111461,15320
198539715,327.0,327.0,15000,15000,0,0,15000,Null,Null,198539715,111461,23416
198558908,0.0,0.0,1200,1200,0,0,1200,Null,Null,198558908,111461,53054
198558953,5.0,5.0,2000,2000,0,0,2000,Null,Null,198558953,111461,53054
198560707,1242.0,1242.0,135000,89000,46000,34,135000,Null,Null,198560707,5534927,1520
198564551,403.0,403.0,121000,73000,48000,40,121000,Null,Null,198564551,7270983,23042
198564659,0.0,0.0,20500000,20500000,0,0,20500000,Null,Null,198564659,162945,28860
198565432,0.0,0.0,21900000,21900000,0,0,21900000,Null,Null,198565432,162945,11516
198569132,141.0,141.0,140000,140000,0,0,140000,Null,Null,198569132,111461,28452
198569215,57.0,57.0,20000,12000,8000,40,20000,Null,Null,198569215,111461,914
198569334,57.0,57.0,20000,12000,8000,40,20000,Null,Null,198569334,111461,914
198569588,9.0,9.0,1990000,1990000,0,0,1990000,Null,Null,198569588,25422,1811
198572236,49.0,49.0,990000,599000,391000,39,990000,Null,Null,198572236,246045,12908
198573069,0.0,0.0,42900000,42900000,0,0,42900000,Null,Null,198573069,162945,28860
198573571,6.0,6.0,8000,4000,4000,50,8000,Null,Null,198573571,111461,2
198573850,95.0,95.0,2100000,1250000,850000,40,2100000,Null,Null,198573850,631569,2340
198578821,0.0,0.0,8840000,8840000,0,0,8840000,Null,Null,198578821,369895,8227
198584202,0.0,0.0,19170000,14377500,4792500,25,19170000,Null,Null,198584202,155565,11518
198584686,0.0,0.0,36770000,36770000,0,0,36770000,Null,Null,198584686,155565,28868
198585479,0.0,0.0,8300000,8300000,0,0,8300000,Null,Null,198585479,4235555,2340
198585533,0.0,0.0,26130000,19597500,6532500,25,26130000,Null,Null,198585533,155565,11518
198589289,0.0,0.0,32860000,24645000,8215000,25,32860000,Null,Null,198589289,155565,11518
198589445,0.0,0.0,16200000,16200000,0,0,16200000,Null,Null,198589445,167287,6653
198590276,0.0,0.0,51170000,38377500,12792500,25,51170000,Null,Null,198590276,155565,28868
198590778,0.0,0.0,16500000,16500000,0,0,16500000,Null,Null,198590778,167287,6653
198591111,0.0,0.0,14100000,14100000,0,0,14100000,Null,Null,198591111,167287,6653
198591312,3.0,3.0,46650000,27990000,18660000,40,46650000,Null,Null,198591312,4712171,2340
198592687,20.0,20.0,689000,292000,397000,58,689000,Null,Null,198592687,402501,2659
198615565,53.0,53.0,220000,141000,79000,36,220000,Null,Null,198615565,245945,23392
198617631,41.0,41.0,12500,6000,6500,52,12500,Null,Null,198617631,111461,11923
198617923,18.0,18.0,20000,8000,12000,60,20000,Null,Null,198617923,111461,11923
198618406,1.0,1.0,1000,1000,0,0,1000,Null,Null,198618406,111461,2685
198629016,2.0,2.0,195000,194999,1,0,195000,Null,Null,198629016,5126697,5006
198641564,0.0,0.0,6650000,6650000,0,0,6650000,Null,Null,198641564,885749,8511
198642684,0.0,0.0,4580000,4580000,0,0,4580000,Null,Null,198642684,508835,11873
198648645,99.0,99.0,2490000,1850000,640000,26,2490000,Null,Null,198648645,25422,1795
198650498,0.0,0.0,21500000,21500000,0,0,21500000,Null,Null,198650498,167287,6653
198650660,0.0,0.0,659000,529000,130000,20,659000,Null,Null,198650660,19018,8165
198651067,0.0,0.0,12200000,12200000,0,0,12200000,Null,Null,198651067,228187,2334
198671551,49.0,49.0,30000,16000,14000,47,30000,Null,Null,198671551,461173,3179
198671555,65.0,65.0,20000,10000,10000,50,20000,Null,Null,198671555,461173,3179
198671563,60.0,60.0,30000,16000,14000,47,30000,Null,Null,198671563,461173,3179
198671718,45.0,45.0,3990000,2810000,1180000,30,3990000,Null,Null,198671718,18802,1795
198692954,55.0,55.0,555000,377000,178000,32,555000,Null,Null,198692954,111461,23388
198696936,12.0,12.0,245000,128000,117000,48,245000,Null,Null,198696936,461173,2234
198699098,0.0,0.0,1090000,1048000,42000,4,1090000,Null,Null,198699098,111461,2324
198724934,0.0,0.0,16800000,16800000,0,0,16800000,Null,Null,198724934,167287,6653
198732256,0.0,0.0,3651000,3139000,512000,14,3651000,Null,Null,198732256,18802,1795
198732321,0.0,0.0,3651000,3139000,512000,14,3651000,Null,Null,198732321,18802,1795
198732327,0.0,0.0,3390000,3139000,251000,7,3390000,Null,Null,198732327,18802,1795
198732767,65.0,65.0,500000,475000,25000,5,500000,Null,Null,198732767,202607,11605
198733333,42.0,42.0,7000,7000,0,0,7000,Null,Null,198733333,7493501,8602
198733696,0.0,0.0,145000000,145000000,0,0,145000000,Null,Null,198733696,167287,6653
198734319,0.0,0.0,6348000,6348000,0,0,6348000,Null,Null,198734319,25643,1795
198734778,0.0,0.0,49999000,44639000,5360000,11,49999000,Null,Null,198734778,18985,2977
198735130,4.0,4.0,42898,42898,0,0,42898,Null,Null,198735130,4973949,28428
198735743,0.0,0.0,7000000,7000000,0,0,7000000,Null,Null,198735743,885749,8511
198735917,0.0,0.0,7000000,7000000,0,0,7000000,Null,Null,198735917,885749,8511
198738034,0.0,0.0,7000000,7000000,0,0,7000000,Null,Null,198738034,885749,8511
198738417,0.0,0.0,7000000,7000000,0,0,7000000,Null,Null,198738417,885749,8511
198738733,0.0,0.0,7000000,7000000,0,0,7000000,Null,Null,198738733,885749,8511
198738855,0.0,0.0,170000,170000,0,0,170000,Null,Null,198738855,111461,23276
198738977,0.0,0.0,4300000,4300000,0,0,4300000,Null,Null,198738977,111461,2
198768552,4.0,4.0,9000,9000,0,0,9000,Null,Null,198768552,111461,1815
198769197,0.0,0.0,5850000,5850000,0,0,5850000,Null,Null,198769197,885749,8511
198769267,0.0,0.0,5850000,5850000,0,0,5850000,Null,Null,198769267,885749,8512
198769281,0.0,0.0,5850000,5850000,0,0,5850000,Null,Null,198769281,885749,8511
198769303,0.0,0.0,5850000,5850000,0,0,5850000,Null,Null,198769303,885749,8511
198769926,49.0,49.0,15000,9900,5100,34,15000,Null,Null,198769926,886923,1520
198778618,313.0,313.0,18000,18000,0,0,18000,Null,Null,198778618,111461,23416
198780093,0.0,0.0,12950000,12950000,0,0,12950000,Null,Null,198780093,167287,6653
198780203,0.0,0.0,29440000,22080000,7360000,25,29440000,Null,Null,198780203,155565,11518
198788199,0.0,0.0,45000000,45000000,0,0,45000000,Null,Null,198788199,7480987,2324
198791415,0.0,0.0,42050000,42050000,0,0,42050000,Null,Null,198791415,167287,5566
198791492,35.0,35.0,649000,649000,0,0,649000,Null,Null,198791492,5073869,5264
198791649,0.0,0.0,37000000,37000000,0,0,37000000,Null,Null,198791649,7480987,12882
198792474,0.0,0.0,56000000,56000000,0,0,56000000,Null,Null,198792474,167287,5566
198794090,10.0,10.0,1000,1000,0,0,1000,Null,Null,198794090,111461,23432
198800861,265.0,265.0,529000,325000,204000,39,529000,Null,Null,198800861,48077,23304
198801102,99.0,99.0,150000,75000,75000,50,150000,Null,Null,198801102,5003355,2018
198815372,34.0,34.0,406000,203000,203000,50,406000,Null,Null,198815372,7818523,13878
198817033,0.0,0.0,2100,2100,0,0,2100,Null,Null,198817033,111461,2
198817052,0.0,0.0,2100,2100,0,0,2100,Null,Null,198817052,111461,2
198817056,0.0,0.0,2100,2100,0,0,2100,Null,Null,198817056,111461,2
198817078,0.0,0.0,2100,2100,0,0,2100,Null,Null,198817078,111461,2
198823492,72.0,72.0,1590000,1050000,540000,34,1590000,Null,Null,198823492,17827,28574
198858152,0.0,0.0,7650000,7650000,0,0,7650000,Null,Null,198858152,885749,8512
198858451,11.0,11.0,3990000,2869000,1121000,28,3990000,Null,Null,198858451,18802,1795
198858501,0.0,0.0,7650000,7650000,0,0,7650000,Null,Null,198858501,885749,8512
198858690,0.0,0.0,7650000,7650000,0,0,7650000,Null,Null,198858690,885749,8512
198859052,0.0,0.0,89000000,72980000,16020000,18,89000000,Null,Null,198859052,198963,11518
198859141,0.0,0.0,13700000,13700000,0,0,13700000,Null,Null,198859141,167287,6653
198859153,0.0,0.0,7650000,7650000,0,0,7650000,Null,Null,198859153,885749,8512
198864785,0.0,0.0,6500000,6500000,0,0,6500000,Null,Null,198864785,885749,8512
198864949,0.0,0.0,6500000,6500000,0,0,6500000,Null,Null,198864949,885749,8512
198865483,0.0,0.0,6500000,6500000,0,0,6500000,Null,Null,198865483,885749,8512
198865660,0.0,0.0,6500000,6500000,0,0,6500000,Null,Null,198865660,885749,8512
198865688,0.0,0.0,99500000,99500000,0,0,99500000,Null,Null,198865688,198963,11518
198866054,40.0,40.0,50000,50000,0,0,50000,Null,Null,198866054,50662,8227
198867742,316.0,316.0,25000,25000,0,0,25000,Null,Null,198867742,111461,27214
198868573,2.0,2.0,1050000,1050000,0,0,1050000,Null,Null,198868573,257401,8061
198868735,2.0,2.0,880000,880000,0,0,880000,Null,Null,198868735,257401,8061
198880889,6.0,6.0,350000,267000,83000,24,350000,Null,Null,198880889,4820811,23588
198883430,0.0,0.0,11000000,11000000,0,0,11000000,Null,Null,198883430,111461,15318
198884380,0.0,0.0,15900000,15900000,0,0,15900000,Null,Null,198884380,52315,6653
198887093,0.0,0.0,9100000,8190000,910000,10,9100000,Null,Null,198887093,111461,15318
198887705,0.0,0.0,17000000,14450000,2550000,15,17000000,Null,Null,198887705,111461,15318
198888214,0.0,0.0,1498,1498,0,0,1498,Null,Null,198888214,111461,3177
198888227,0.0,0.0,11000000,11000000,0,0,11000000,Null,Null,198888227,111461,15318
198888325,0.0,0.0,9100000,8190000,910000,10,9100000,Null,Null,198888325,111461,15318
198888770,0.0,0.0,11000000,9900000,1100000,10,11000000,Null,Null,198888770,111461,15318
198889063,0.0,0.0,2487,2487,0,0,2487,Null,Null,198889063,111461,3177
198889616,0.0,0.0,11000000,9350000,1650000,15,11000000,Null,Null,198889616,111461,15318
198889728,0.0,0.0,9100000,8190000,910000,10,9100000,Null,Null,198889728,111461,15318
198895212,34.0,34.0,259000,259000,0,0,259000,Null,Null,198895212,4182359,11753
198900119,0.0,0.0,92500000,92500000,0,0,92500000,Null,Null,198900119,7480987,12882
198902560,2.0,2.0,17200,8000,9200,53,17200,Null,Null,198902560,111461,15318
198916597,2.0,2.0,105868,105868,0,0,105868,Null,Null,198916597,111461,3216
198924595,0.0,0.0,14900,4000,10900,73,14900,Null,Null,198924595,111461,1819
198930257,0.0,0.0,20600000,20600000,0,0,20600000,Null,Null,198930257,50307,7079
198935986,0.0,0.0,11400000,11400000,0,0,11400000,Null,Null,198935986,50307,7079
198956592,108.0,108.0,170000,161500,8500,5,170000,Null,Null,198956592,111461,53048
198957493,86.0,86.0,50000,27000,23000,46,50000,Null,Null,198957493,111461,8224
198961119,370.0,370.0,550000,312000,238000,43,550000,Null,Null,198961119,4234729,1634
198968094,7.0,7.0,2190000,1839000,351000,16,2190000,Null,Null,198968094,25422,1795
198971133,0.0,0.0,11900,11900,0,0,11900,Null,Null,198971133,111461,2
198971147,0.0,0.0,10000,10000,0,0,10000,Null,Null,198971147,111461,2
198971148,0.0,0.0,6900,6900,0,0,6900,Null,Null,198971148,111461,2
198971149,0.0,0.0,12000,12000,0,0,12000,Null,Null,198971149,111461,2
198971162,0.0,0.0,10000,10000,0,0,10000,Null,Null,198971162,111461,2
198971199,0.0,0.0,15000,15000,0,0,15000,Null,Null,198971199,111461,2
198971217,0.0,0.0,13000,13000,0,0,13000,Null,Null,198971217,111461,2
198971218,0.0,0.0,10000,10000,0,0,10000,Null,Null,198971218,111461,2
198971228,0.0,0.0,3000,3000,0,0,3000,Null,Null,198971228,111461,2
198971272,3.0,3.0,10000,10000,0,0,10000,Null,Null,198971272,111461,2
198971297,0.0,0.0,18000,18000,0,0,18000,Null,Null,198971297,111461,2
198971305,0.0,0.0,6900,6900,0,0,6900,Null,Null,198971305,111461,2
198971320,0.0,0.0,5000,5000,0,0,5000,Null,Null,198971320,111461,2
198971363,0.0,0.0,15500,15500,0,0,15500,Null,Null,198971363,111461,2
198971368,0.0,0.0,8000,8000,0,0,8000,Null,Null,198971368,111461,2
198971412,0.0,0.0,15000,15000,0,0,15000,Null,Null,198971412,111461,2
198971430,0.0,0.0,10000,10000,0,0,10000,Null,Null,198971430,111461,2
198971440,0.0,0.0,8000,8000,0,0,8000,Null,Null,198971440,111461,2
198971458,0.0,0.0,6900,6900,0,0,6900,Null,Null,198971458,111461,2
198971461,0.0,0.0,10000,10000,0,0,10000,Null,Null,198971461,111461,2
198971471,0.0,0.0,10000,10000,0,0,10000,Null,Null,198971471,111461,2
198971473,0.0,0.0,10000,10000,0,0,10000,Null,Null,198971473,111461,2
198971474,0.0,0.0,10000,10000,0,0,10000,Null,Null,198971474,111461,2
198971538,0.0,0.0,10000,10000,0,0,10000,Null,Null,198971538,111461,2
198971558,0.0,0.0,10000,10000,0,0,10000,Null,Null,198971558,111461,2
198971565,0.0,0.0,10000,10000,0,0,10000,Null,Null,198971565,111461,2
198971573,10.0,10.0,10000,10000,0,0,10000,Null,Null,198971573,111461,2
198971592,0.0,0.0,16000,16000,0,0,16000,Null,Null,198971592,111461,2
198971638,0.0,0.0,15000,15000,0,0,15000,Null,Null,198971638,111461,2
198971717,0.0,0.0,2500,2500,0,0,2500,Null,Null,198971717,111461,2
198971763,0.0,0.0,6900,6900,0,0,6900,Null,Null,198971763,111461,2
198971773,0.0,0.0,5000,5000,0,0,5000,Null,Null,198971773,111461,2
198971782,0.0,0.0,15000,15000,0,0,15000,Null,Null,198971782,111461,2
198971787,0.0,0.0,3000,3000,0,0,3000,Null,Null,198971787,111461,2
198971796,0.0,0.0,10000,10000,0,0,10000,Null,Null,198971796,111461,2
198971800,0.0,0.0,10000,10000,0,0,10000,Null,Null,198971800,111461,2
198971831,0.0,0.0,10000,10000,0,0,10000,Null,Null,198971831,111461,2
198971835,0.0,0.0,6900,6900,0,0,6900,Null,Null,198971835,111461,2
198971839,0.0,0.0,10000,10000,0,0,10000,Null,Null,198971839,111461,2
198971843,0.0,0.0,10000,10000,0,0,10000,Null,Null,198971843,111461,2
198971848,0.0,0.0,4999,4999,0,0,4999,Null,Null,198971848,111461,2
198971878,0.0,0.0,16000,16000,0,0,16000,Null,Null,198971878,111461,2
198971904,0.0,0.0,10000,10000,0,0,10000,Null,Null,198971904,111461,2
198971920,0.0,0.0,15000,15000,0,0,15000,Null,Null,198971920,111461,2
198971933,0.0,0.0,1000,1000,0,0,1000,Null,Null,198971933,111461,2
198972075,0.0,0.0,10000,10000,0,0,10000,Null,Null,198972075,111461,2
198972086,0.0,0.0,6800,6800,0,0,6800,Null,Null,198972086,111461,2
198972087,0.0,0.0,15000,15000,0,0,15000,Null,Null,198972087,111461,2
198972117,0.0,0.0,10000,10000,0,0,10000,Null,Null,198972117,111461,2
198972130,0.0,0.0,15000,15000,0,0,15000,Null,Null,198972130,111461,2
198972132,0.0,0.0,10000,10000,0,0,10000,Null,Null,198972132,111461,2
198972179,0.0,0.0,15000,15000,0,0,15000,Null,Null,198972179,111461,2
198972181,0.0,0.0,10000,10000,0,0,10000,Null,Null,198972181,111461,2
198972184,0.0,0.0,10000,10000,0,0,10000,Null,Null,198972184,111461,2
198972190,0.0,0.0,15000,15000,0,0,15000,Null,Null,198972190,111461,2
198972195,0.0,0.0,10000,10000,0,0,10000,Null,Null,198972195,111461,2
198972216,0.0,0.0,15000,15000,0,0,15000,Null,Null,198972216,111461,2
198972261,0.0,0.0,7000,7000,0,0,7000,Null,Null,198972261,111461,2
198972266,0.0,0.0,10000,10000,0,0,10000,Null,Null,198972266,111461,2
198972267,0.0,0.0,18000,18000,0,0,18000,Null,Null,198972267,111461,2
198972308,0.0,0.0,3000,3000,0,0,3000,Null,Null,198972308,111461,2
198972399,0.0,0.0,16000,16000,0,0,16000,Null,Null,198972399,111461,2
198972431,0.0,0.0,18000,18000,0,0,18000,Null,Null,198972431,111461,2
198972437,0.0,0.0,11000,11000,0,0,11000,Null,Null,198972437,111461,2
198972445,0.0,0.0,14000,14000,0,0,14000,Null,Null,198972445,111461,2
198972555,0.0,0.0,6000,6000,0,0,6000,Null,Null,198972555,111461,2
198972584,0.0,0.0,15000,15000,0,0,15000,Null,Null,198972584,111461,2
198972597,0.0,0.0,10000,10000,0,0,10000,Null,Null,198972597,111461,2
198972617,0.0,0.0,15000,15000,0,0,15000,Null,Null,198972617,111461,2
198972656,1.0,1.0,10000,10000,0,0,10000,Null,Null,198972656,111461,2
198972756,0.0,0.0,10000,10000,0,0,10000,Null,Null,198972756,111461,2
198972816,0.0,0.0,10000,10000,0,0,10000,Null,Null,198972816,111461,2
198972985,0.0,0.0,6000,6000,0,0,6000,Null,Null,198972985,111461,2
198973044,0.0,0.0,15000,15000,0,0,15000,Null,Null,198973044,111461,2
198973145,0.0,0.0,1999,1999,0,0,1999,Null,Null,198973145,111461,2
198973173,0.0,0.0,10000,10000,0,0,10000,Null,Null,198973173,111461,2
198973237,0.0,0.0,10000,10000,0,0,10000,Null,Null,198973237,111461,2
198973268,0.0,0.0,9000,9000,0,0,9000,Null,Null,198973268,111461,2
198977386,80.0,80.0,229000,159000,70000,31,229000,Null,Null,198977386,111461,8225
198995587,0.0,0.0,107400,48000,59400,55,107400,Null,Null,198995587,111461,15318
198995620,25.0,25.0,49900,49900,0,0,49900,Null,Null,198995620,111461,23588
199006511,1.0,1.0,5190000,5190000,0,0,5190000,Null,Null,199006511,48649,1634
199009117,272.0,272.0,370000,352000,18000,5,370000,Null,Null,199009117,202607,11605
199010696,256.0,256.0,570000,542000,28000,5,570000,Null,Null,199010696,202607,17170
199020711,45.0,45.0,190000,190000,0,0,190000,Null,Null,199020711,149308,28574
199030861,0.0,0.0,5000,5000,0,0,5000,Null,Null,199030861,5209537,28486
199032361,14.0,14.0,1440000,1440000,0,0,1440000,Null,Null,199032361,19673,1795
199034756,2.0,2.0,799000,505000,294000,37,799000,Null,Null,199034756,111461,5385
199036681,0.0,0.0,49600000,49600000,0,0,49600000,Null,Null,199036681,162945,2324
199036961,389.0,389.0,479000,239000,240000,50,479000,Null,Null,199036961,19813,1984
199037373,0.0,0.0,13600000,13600000,0,0,13600000,Null,Null,199037373,50307,8067
199040451,0.0,0.0,96900000,96900000,0,0,96900000,Null,Null,199040451,50307,7079
199043449,0.0,0.0,3590000,3590000,0,0,3590000,Null,Null,199043449,208841,2340
199043570,0.0,0.0,96500000,96500000,0,0,96500000,Null,Null,199043570,50307,7079
199045576,129.0,129.0,400000,262000,138000,35,400000,Null,Null,199045576,63894,1634
199051099,0.0,0.0,54500000,54500000,0,0,54500000,Null,Null,199051099,50307,7079
199051332,7.0,7.0,475000,475000,0,0,475000,Null,Null,199051332,111461,23362
199052423,0.0,0.0,39900000,39900000,0,0,39900000,Null,Null,199052423,111461,27232
199054159,104.0,104.0,187000,141000,46000,25,187000,Null,Null,199054159,47664,8212
199078187,0.0,0.0,35800000,35800000,0,0,35800000,Null,Null,199078187,50307,7079
199099836,19.0,19.0,250000,119000,131000,52,250000,Null,Null,199099836,111461,28460
199104668,0.0,0.0,42300000,42300000,0,0,42300000,Null,Null,199104668,167287,5566
199105101,0.0,0.0,21350000,21350000,0,0,21350000,Null,Null,199105101,167287,5566
199105317,0.0,0.0,4500,4500,0,0,4500,Null,Null,199105317,111461,8205
199108256,1.0,1.0,214000,214000,0,0,214000,Null,Null,199108256,111454,28460
199110358,1.0,1.0,11290000,11290000,0,0,11290000,Null,Null,199110358,167287,5566
199111787,0.0,0.0,23700000,23700000,0,0,23700000,Null,Null,199111787,50307,7079
199112415,0.0,0.0,16900000,16900000,0,0,16900000,Null,Null,199112415,50307,7079
199113166,0.0,0.0,19800000,19800000,0,0,19800000,Null,Null,199113166,50307,7079
199113613,28.0,28.0,25000,23750,1250,5,25000,Null,Null,199113613,4269901,23022
199120958,146.0,146.0,139000,139000,0,0,139000,Null,Null,199120958,4973949,20244
199121199,147.0,147.0,139000,139000,0,0,139000,Null,Null,199121199,4973949,20244
199125679,1.0,1.0,132990,132990,0,0,132990,Null,Null,199125679,111461,23126
199129989,0.0,0.0,7000,7000,0,0,7000,Null,Null,199129989,111461,2
199137543,196.0,196.0,24000,18000,6000,25,24000,Null,Null,199137543,111461,20222
199137985,0.0,0.0,8200000,8200000,0,0,8200000,Null,Null,199137985,48649,1634
199141894,28.0,28.0,120998,109999,10999,9,120998,Null,Null,199141894,111461,2514
199142404,12.0,12.0,19000,19000,0,0,19000,Null,Null,199142404,111461,23416
199142753,114.0,114.0,295000,295000,0,0,295000,Null,Null,199142753,171459,8513
199144529,0.0,0.0,6000,6000,0,0,6000,Null,Null,199144529,111461,8167
199144601,6.0,6.0,5000,5000,0,0,5000,Null,Null,199144601,111461,8167
199144679,0.0,0.0,4500,4500,0,0,4500,Null,Null,199144679,111461,8167
199146029,4.0,4.0,199000,199000,0,0,199000,Null,Null,199146029,111461,15250
199147889,2.0,2.0,94999,94999,0,0,94999,Null,Null,199147889,4522605,28596
199152655,0.0,0.0,17000,17000,0,0,17000,Null,Null,199152655,111461,15250
199152661,0.0,0.0,19000,19000,0,0,19000,Null,Null,199152661,111461,2
199152676,1.0,1.0,35000,35000,0,0,35000,Null,Null,199152676,111461,15936
199165708,231.0,231.0,119000,119000,0,0,119000,Null,Null,199165708,111461,1815
199168161,48.0,48.0,149000,149000,0,0,149000,Null,Null,199168161,111461,2136
199168456,30.0,30.0,500000,250000,250000,50,500000,Null,Null,199168456,7400131,15318
199169935,0.0,0.0,6490000,6490000,0,0,6490000,Null,Null,199169935,732431,8512
199170067,0.0,0.0,6490000,6490000,0,0,6490000,Null,Null,199170067,732431,8512
199170101,0.0,0.0,6490000,6490000,0,0,6490000,Null,Null,199170101,732431,8512
199170120,0.0,0.0,6490000,6490000,0,0,6490000,Null,Null,199170120,732431,8512
199170135,0.0,0.0,6490000,6490000,0,0,6490000,Null,Null,199170135,732431,8512
199170182,0.0,0.0,6490000,6490000,0,0,6490000,Null,Null,199170182,732431,8512
199170231,0.0,0.0,8660000,8660000,0,0,8660000,Null,Null,199170231,732431,8512
199170330,0.0,0.0,8660000,8660000,0,0,8660000,Null,Null,199170330,732431,8512
199170353,0.0,0.0,8860000,8860000,0,0,8860000,Null,Null,199170353,732431,8512
199170395,0.0,0.0,8860000,8860000,0,0,8860000,Null,Null,199170395,732431,8512
199170453,0.0,0.0,8860000,8860000,0,0,8860000,Null,Null,199170453,732431,8512
199170524,0.0,0.0,8860000,8860000,0,0,8860000,Null,Null,199170524,732431,8512
199170594,0.0,0.0,8860000,8860000,0,0,8860000,Null,Null,199170594,732431,8512
199170668,0.0,0.0,8860000,8860000,0,0,8860000,Null,Null,199170668,732431,8512
199170695,0.0,0.0,7860000,7860000,0,0,7860000,Null,Null,199170695,732431,8512
199170805,0.0,0.0,7860000,7860000,0,0,7860000,Null,Null,199170805,732431,8512
199170822,0.0,0.0,7860000,7860000,0,0,7860000,Null,Null,199170822,732431,8512
199171281,43.0,43.0,139000,139000,0,0,139000,Null,Null,199171281,26675,28452
199173257,183.0,183.0,469000,232000,237000,51,469000,Null,Null,199173257,5048343,4593
199173264,9.0,9.0,188000,188000,0,0,188000,Null,Null,199173264,373635,28574
199173596,0.0,0.0,9000,9000,0,0,9000,Null,Null,199173596,111461,8202
199173664,0.0,0.0,9000,9000,0,0,9000,Null,Null,199173664,111461,8202
199175612,0.0,0.0,14500000,14500000,0,0,14500000,Null,Null,199175612,228187,11943
199196755,1.0,1.0,2190000,1819000,371000,17,2190000,Null,Null,199196755,25422,1795
199200453,2.0,2.0,507000,375000,132000,26,507000,Null,Null,199200453,173547,15250
199200558,0.0,0.0,25860000,25860000,0,0,25860000,Null,Null,199200558,50307,7079
199216113,0.0,0.0,36500000,36500000,0,0,36500000,Null,Null,199216113,50307,7079
199216155,379.0,379.0,1500000,799000,701000,47,1500000,Null,Null,199216155,631569,2340
199216922,4.0,4.0,850000,850000,0,0,850000,Null,Null,199216922,4584257,2347
199244716,137.0,137.0,38000,34000,4000,11,38000,Null,Null,199244716,4245195,8192
199249541,411.0,411.0,500000,339000,161000,32,500000,Null,Null,199249541,50629,12908
199251408,0.0,0.0,54300000,54300000,0,0,54300000,Null,Null,199251408,50307,7079
199254089,0.0,0.0,63500000,63500000,0,0,63500000,Null,Null,199254089,50307,7079
199254482,109.0,109.0,149000,141000,8000,5,149000,Null,Null,199254482,111461,2018
199263040,0.0,0.0,65500000,65500000,0,0,65500000,Null,Null,199263040,50307,7079
199263272,0.0,0.0,37500000,37500000,0,0,37500000,Null,Null,199263272,50307,7079
199263969,271.0,271.0,436000,436000,0,0,436000,Null,Null,199263969,523789,1883
199270605,0.0,0.0,5850000,5850000,0,0,5850000,Null,Null,199270605,732431,8512
199270701,0.0,0.0,5850000,5850000,0,0,5850000,Null,Null,199270701,732431,8512
199270739,0.0,0.0,5850000,5850000,0,0,5850000,Null,Null,199270739,732431,8512
199270793,0.0,0.0,9000,9000,0,0,9000,Null,Null,199270793,111461,8202
199270805,0.0,0.0,5850000,5850000,0,0,5850000,Null,Null,199270805,732431,8512
199495383,0.0,0.0,13200000,13200000,0,0,13200000,Null,Null,199495383,111461,15318
199515583,4.0,4.0,480000,480000,0,0,480000,Null,Null,199515583,4584257,1601
199516208,0.0,0.0,24900000,24900000,0,0,24900000,Null,Null,199516208,50307,7079
199519686,0.0,0.0,72500000,72500000,0,0,72500000,Null,Null,199519686,50307,7079
199522906,0.0,0.0,32400,16200,16200,50,32400,Null,Null,199522906,111461,15318
199525542,358.0,358.0,500000,317000,183000,37,500000,Null,Null,199525542,50629,12908
199526308,0.0,0.0,50200000,50200000,0,0,50200000,Null,Null,199526308,50307,7079
199527729,0.0,0.0,35900000,35900000,0,0,35900000,Null,Null,199527729,50307,7079
199531789,1.0,1.0,25000,16000,9000,36,25000,Null,Null,199531789,111461,15250
199532440,0.0,0.0,11050000,11050000,0,0,11050000,Null,Null,199532440,7834805,5385
199536123,0.0,0.0,23960000,23960000,0,0,23960000,Null,Null,199536123,50307,7079
199538702,0.0,0.0,3990000,3990000,0,0,3990000,Null,Null,199538702,208841,2340
199539210,202.0,202.0,10000,10000,0,0,10000,Null,Null,199539210,111461,2514
199540391,0.0,0.0,18990000,16990000,2000000,11,18990000,Null,Null,199540391,25643,1795
199542339,1.0,1.0,3385000,3385000,0,0,3385000,Null,Null,199542339,218061,8165
199543859,1.0,1.0,99000,45000,54000,55,99000,Null,Null,199543859,111461,15236
199552458,0.0,0.0,32900000,32900000,0,0,32900000,Null,Null,199552458,50307,7079
199553581,3.0,3.0,1900000,1079000,821000,43,1900000,Null,Null,199553581,144018,28574
199569880,86.0,86.0,3500,3500,0,0,3500,Null,Null,199569880,111461,1634
199570871,0.0,0.0,9000,9000,0,0,9000,Null,Null,199570871,111461,8202
199571632,114.0,114.0,9900,5000,4900,49,9900,Null,Null,199571632,111461,11923
199572914,134.0,134.0,569000,347000,222000,39,569000,Null,Null,199572914,5048343,4593
199578815,37.0,37.0,45899,45899,0,0,45899,Null,Null,199578815,111461,23588
199593358,0.0,0.0,31900000,31900000,0,0,31900000,Null,Null,199593358,162945,7079
199593599,2239.0,2239.0,297000,274000,23000,8,297000,Null,Null,199593599,523789,1883
199596970,118.0,118.0,33000,33000,0,0,33000,Null,Null,199596970,2630119,28426
199600827,0.0,0.0,16050000,16050000,0,0,16050000,Null,Null,199600827,488701,2340
199601519,24.0,24.0,50000,50000,0,0,50000,Null,Null,199601519,50662,11741
199601523,53.0,53.0,50000,50000,0,0,50000,Null,Null,199601523,50662,11741
199606251,20.0,20.0,180000,180000,0,0,180000,Null,Null,199606251,372895,1583
199608128,0.0,0.0,92900000,92900000,0,0,92900000,Null,Null,199608128,167287,2324
199617694,0.0,0.0,66500000,66500000,0,0,66500000,Null,Null,199617694,167287,2324
199618363,0.0,0.0,49500000,49500000,0,0,49500000,Null,Null,199618363,162945,7079
199621924,0.0,0.0,71350000,71350000,0,0,71350000,Null,Null,199621924,162945,7079
199621944,0.0,0.0,75900000,75900000,0,0,75900000,Null,Null,199621944,167287,6653
199621975,0.0,0.0,9900000,9900000,0,0,9900000,Null,Null,199621975,228187,2334
199623722,0.0,0.0,9900000,9900000,0,0,9900000,Null,Null,199623722,228187,2334
199629140,1.0,1.0,9900000,9900000,0,0,9900000,Null,Null,199629140,228187,2334
199629460,0.0,0.0,64500000,64500000,0,0,64500000,Null,Null,199629460,167287,6653
199631510,0.0,0.0,67500000,67500000,0,0,67500000,Null,Null,199631510,167287,6653
199631597,0.0,0.0,14800000,14800000,0,0,14800000,Null,Null,199631597,50368,7079
199631845,6.0,6.0,345000,328000,17000,5,345000,Null,Null,199631845,448601,20170
199632244,0.0,0.0,29500000,29500000,0,0,29500000,Null,Null,199632244,50368,7079
199632314,0.0,0.0,53500000,53500000,0,0,53500000,Null,Null,199632314,167287,6653
199632508,0.0,0.0,42500000,42500000,0,0,42500000,Null,Null,199632508,167287,6653
199637810,0.0,0.0,32400000,32400000,0,0,32400000,Null,Null,199637810,167287,6653
199638326,474.0,474.0,492000,415000,77000,16,492000,Null,Null,199638326,111461,23660
199638892,0.0,0.0,31900000,31900000,0,0,31900000,Null,Null,199638892,167287,6653
199639328,0.0,0.0,88550000,88550000,0,0,88550000,Null,Null,199639328,50368,7079
199639390,0.0,0.0,29500000,29500000,0,0,29500000,Null,Null,199639390,167287,6653
199640033,0.0,0.0,26599000,26067020,531980,2,26599000,Null,Null,199640033,167287,6653
199641835,24.0,24.0,34000,27989,6011,18,34000,Null,Null,199641835,111461,28574
199645433,24.0,24.0,8000,8000,0,0,8000,Null,Null,199645433,111461,28630
199648814,46.0,46.0,49000,49000,0,0,49000,Null,Null,199648814,111461,2
199650623,43.0,43.0,12500,6000,6500,52,12500,Null,Null,199650623,111461,11923
199668840,0.0,0.0,3606000,3606000,0,0,3606000,Null,Null,199668840,5195985,8227
199669158,77.0,77.0,138000,110000,28000,20,138000,Null,Null,199669158,7840203,1613
199680994,0.0,0.0,705000,705000,0,0,705000,Null,Null,199680994,111461,2
199680997,0.0,0.0,286000,286000,0,0,286000,Null,Null,199680997,111461,2
199681125,0.0,0.0,298000,298000,0,0,298000,Null,Null,199681125,111461,28480
199683360,0.0,0.0,11448000,11448000,0,0,11448000,Null,Null,199683360,111461,2
199692585,0.0,0.0,38999000,29999999,8999001,23,38999000,Null,Null,199692585,542569,1520
199693002,50.0,50.0,790000,348000,442000,56,790000,Null,Null,199693002,31627,1936
199693007,85.0,85.0,615000,273000,342000,56,615000,Null,Null,199693007,31627,1936
199701547,2.0,2.0,18899,18899,0,0,18899,Null,Null,199701547,111461,2514
199708120,158.0,158.0,90000,89000,1000,1,90000,Null,Null,199708120,922811,23588
199727377,0.0,0.0,4350000,4154000,196000,5,4350000,Null,Null,199727377,199801,11885
199727437,208.0,208.0,459000,279000,180000,39,459000,Null,Null,199727437,7841849,2234
199727623,42.0,42.0,729000,448000,281000,39,729000,Null,Null,199727623,7841849,2234
199727627,83.0,83.0,359000,221000,138000,38,359000,Null,Null,199727627,7841849,2234
199728521,307.0,307.0,450000,301000,149000,33,450000,Null,Null,199728521,41048,23832
199728963,0.0,0.0,31500000,31500000,0,0,31500000,Null,Null,199728963,165405,2324
199733419,1.0,1.0,250000,79000,171000,68,250000,Null,Null,199733419,7245301,15320
199733449,1.0,1.0,250000,79000,171000,68,250000,Null,Null,199733449,7245301,15320
199733792,1.0,1.0,250000,79000,171000,68,250000,Null,Null,199733792,7245301,15320
199738611,0.0,0.0,1750,1750,0,0,1750,Null,Null,199738611,111461,6305
199738964,1.0,1.0,23000,23000,0,0,23000,Null,Null,199738964,111461,2
199739124,0.0,0.0,33000,33000,0,0,33000,Null,Null,199739124,111461,2
199747218,0.0,0.0,6000,6000,0,0,6000,Null,Null,199747218,111461,2
199753481,0.0,0.0,54500000,54500000,0,0,54500000,Null,Null,199753481,50307,7079
199802304,0.0,0.0,118999,78999,40000,34,118999,Null,Null,199802304,111461,28576
199839538,0.0,0.0,72900000,72900000,0,0,72900000,Null,Null,199839538,50307,7079
199840018,0.0,0.0,16400000,16400000,0,0,16400000,Null,Null,199840018,50307,7079
199857074,0.0,0.0,9000,9000,0,0,9000,Null,Null,199857074,111461,8202
199895543,49.0,49.0,529000,273000,256000,48,529000,Null,Null,199895543,5048343,4593
199898588,1.0,1.0,490000,490000,0,0,490000,Null,Null,199898588,111461,8516
199898984,0.0,0.0,32600000,32600000,0,0,32600000,Null,Null,199898984,167287,6653
199900850,1.0,1.0,3500000,3500000,0,0,3500000,Null,Null,199900850,18804,2334
199900924,2.0,2.0,274998,249999,24999,9,274998,Null,Null,199900924,4973949,28428
199901837,0.0,0.0,2088000,2088000,0,0,2088000,Null,Null,199901837,25422,1795
199902129,1.0,1.0,2190000,1850000,340000,16,2190000,Null,Null,199902129,25422,1795
199902188,0.0,0.0,2000,2000,0,0,2000,Null,Null,199902188,111461,2
199909888,0.0,0.0,89000000,89000000,0,0,89000000,Null,Null,199909888,198963,11518
199909914,0.0,0.0,18500000,18500000,0,0,18500000,Null,Null,199909914,167287,6653
199910125,0.0,0.0,98000000,98000000,0,0,98000000,Null,Null,199910125,198963,11518
199911056,0.0,0.0,20500000,20500000,0,0,20500000,Null,Null,199911056,167287,6653
199916048,0.0,0.0,53150000,53150000,0,0,53150000,Null,Null,199916048,64930,11518
199916506,0.0,0.0,39500000,39500000,0,0,39500000,Null,Null,199916506,5710451,20170
199916549,0.0,0.0,11950000,11950000,0,0,11950000,Null,Null,199916549,167287,6653
199916697,0.0,0.0,45900000,45900000,0,0,45900000,Null,Null,199916697,21717,7079
199916805,28.0,28.0,690000,499000,191000,28,690000,Null,Null,199916805,204385,4429
199916860,130.0,130.0,6000,5940,60,1,6000,Null,Null,199916860,111461,2153
199930878,0.0,0.0,73900000,73900000,0,0,73900000,Null,Null,199930878,21717,7079
199931076,0.0,0.0,27690000,27690000,0,0,27690000,Null,Null,199931076,21717,7079
199942105,0.0,0.0,37500000,37500000,0,0,37500000,Null,Null,199942105,180963,11518
199942556,0.0,0.0,11500000,11270000,230000,2,11500000,Null,Null,199942556,167287,6653
199945017,35.0,35.0,250000,150000,100000,40,250000,Null,Null,199945017,111461,23388
199951879,0.0,0.0,27300000,27300000,0,0,27300000,Null,Null,199951879,180963,11518
199952490,0.0,0.0,24100000,24100000,0,0,24100000,Null,Null,199952490,180963,11518
199952492,0.0,0.0,37400000,36652000,748000,2,37400000,Null,Null,199952492,167287,6653
199953134,0.0,0.0,13600000,13600000,0,0,13600000,Null,Null,199953134,180963,11518
199955526,2.0,2.0,485000,483999,1001,0,485000,Null,Null,199955526,5211387,28484
199957340,0.0,0.0,11700000,11466000,234000,2,11700000,Null,Null,199957340,167287,6653
199959667,2730.0,2730.0,87000,58000,29000,33,87000,Null,Null,199959667,47664,17162
199962986,0.0,0.0,6150000,6150000,0,0,6150000,Null,Null,199962986,732431,8512
199963264,0.0,0.0,6150000,6150000,0,0,6150000,Null,Null,199963264,732431,8512
199963342,0.0,0.0,6150000,6150000,0,0,6150000,Null,Null,199963342,732431,8512
199963903,0.0,0.0,8350000,8350000,0,0,8350000,Null,Null,199963903,732431,8512
199964025,0.0,0.0,8350000,8350000,0,0,8350000,Null,Null,199964025,732431,8512
199964247,0.0,0.0,8350000,8350000,0,0,8350000,Null,Null,199964247,732431,8512
199973185,66.0,66.0,629000,629000,0,0,629000,Null,Null,199973185,150002,9013
199974062,0.0,0.0,60000000,60000000,0,0,60000000,Null,Null,199974062,111461,23544
199974064,0.0,0.0,88000000,88000000,0,0,88000000,Null,Null,199974064,111461,23544
199974067,0.0,0.0,43990000,43990000,0,0,43990000,Null,Null,199974067,111461,23544
199974072,0.0,0.0,72000000,72000000,0,0,72000000,Null,Null,199974072,111461,23708
199974074,0.0,0.0,47000000,47000000,0,0,47000000,Null,Null,199974074,111461,23708
199975162,5.0,5.0,79000,79000,0,0,79000,Null,Null,199975162,111461,2
199976786,4.0,4.0,79000,79000,0,0,79000,Null,Null,199976786,111461,2
199976947,16.0,16.0,2000,2000,0,0,2000,Null,Null,199976947,111461,2
199976979,0.0,0.0,14999,14999,0,0,14999,Null,Null,199976979,111461,2
199977081,4.0,4.0,9000,9000,0,0,9000,Null,Null,199977081,111461,2
199977661,0.0,0.0,19400000,19400000,0,0,19400000,Null,Null,199977661,180963,28860
199977802,0.0,0.0,4500000,4500000,0,0,4500000,Null,Null,199977802,111461,2342
199978769,0.0,0.0,11000000,11000000,0,0,11000000,Null,Null,199978769,111461,2340
199992048,3639.0,3639.0,125000,85000,40000,32,125000,Null,Null,199992048,143130,1520
199992189,0.0,0.0,17502000,15401760,2100240,12,17502000,Null,Null,199992189,162945,28860
199992352,0.0,0.0,43821000,38562480,5258520,12,43821000,Null,Null,199992352,162945,11518
199993091,0.0,0.0,48999,48999,0,0,48999,Null,Null,199993091,111461,2
199997650,0.0,0.0,34697000,30533360,4163640,12,34697000,Null,Null,199997650,162945,11518
199997776,44.0,44.0,142571,142571,0,0,142571,Null,Null,199997776,5745605,20244
199997800,7.0,7.0,749000,589000,160000,21,749000,Null,Null,199997800,46363,5384
199998948,0.0,0.0,56271000,49518480,6752520,12,56271000,Null,Null,199998948,162945,11518
199999176,0.0,0.0,19000000,19000000,0,0,19000000,Null,Null,199999176,111461,2340
199999329,0.0,0.0,40940000,40940000,0,0,40940000,Null,Null,199999329,201253,23576
199999929,0.0,0.0,79800000,79800000,0,0,79800000,Null,Null,199999929,201253,23576
200000491,0.0,0.0,99800000,99800000,0,0,99800000,Null,Null,200000491,201253,23576
200001374,0.0,0.0,86276000,75922880,10353120,12,86276000,Null,Null,200001374,162945,11518
200003942,0.0,0.0,8636000,6477000,2159000,25,8636000,Null,Null,200003942,26150,8513
200003945,0.0,0.0,8636000,6477000,2159000,25,8636000,Null,Null,200003945,26150,8513
200005143,1.0,1.0,2750000,2750000,0,0,2750000,Null,Null,200005143,5172107,8512
200006032,0.0,0.0,8800000,8800000,0,0,8800000,Null,Null,200006032,156409,5385
200006321,0.0,0.0,8900000,8900000,0,0,8900000,Null,Null,200006321,156409,5385
200006612,8.0,8.0,8400,8400,0,0,8400,Null,Null,200006612,111461,8068
200038419,0.0,0.0,19000,19000,0,0,19000,Null,Null,200038419,111461,2
200038960,10.0,10.0,129000,129000,0,0,129000,Null,Null,200038960,111461,3175
200253671,0.0,0.0,4199000,3810000,389000,9,4199000,Null,Null,200253671,18804,1634
200521206,0.0,0.0,3350000,3350000,0,0,3350000,Null,Null,200521206,5172107,8512
200521526,1.0,1.0,3500,3500,0,0,3500,Null,Null,200521526,111461,2
200617537,6.0,6.0,790000,790000,0,0,790000,Null,Null,200617537,7400143,53350
200619308,17.0,17.0,75000,75000,0,0,75000,Null,Null,200619308,5745605,28458
200622657,0.0,0.0,2500,2500,0,0,2500,Null,Null,200622657,739195,23112
200622683,0.0,0.0,2500,2500,0,0,2500,Null,Null,200622683,739195,23112
200622720,0.0,0.0,2500,2500,0,0,2500,Null,Null,200622720,739195,23112
200622732,0.0,0.0,2500,2500,0,0,2500,Null,Null,200622732,739195,23112
200622776,0.0,0.0,2500,2500,0,0,2500,Null,Null,200622776,739195,23112
200622778,0.0,0.0,2500,2500,0,0,2500,Null,Null,200622778,739195,23112
200622782,0.0,0.0,2500,2500,0,0,2500,Null,Null,200622782,739195,23112
200623233,0.0,0.0,2500,2500,0,0,2500,Null,Null,200623233,739195,23112
200623249,0.0,0.0,18000,18000,0,0,18000,Null,Null,200623249,739195,15250
200623329,0.0,0.0,2500,2500,0,0,2500,Null,Null,200623329,739195,23112
200623394,0.0,0.0,2500,2500,0,0,2500,Null,Null,200623394,739195,23112
200623432,0.0,0.0,2500,2500,0,0,2500,Null,Null,200623432,739195,23112
200623470,0.0,0.0,2500,2500,0,0,2500,Null,Null,200623470,739195,23112
200623476,0.0,0.0,2500,2500,0,0,2500,Null,Null,200623476,739195,23112
200623496,0.0,0.0,2500,2500,0,0,2500,Null,Null,200623496,739195,23112
200630573,1.0,1.0,23990000,19099000,4891000,20,23990000,Null,Null,200630573,20215,1805
200634178,81.0,81.0,165000,165000,0,0,165000,Null,Null,200634178,7843689,23362
200652020,8.0,8.0,177900,177900,0,0,177900,Null,Null,200652020,464737,8042
200653060,0.0,0.0,235000000,235000000,0,0,235000000,Null,Null,200653060,879595,2340
200653713,0.0,0.0,0,1000,0,0,1000,Null,Null,200653713,111461,0
200657733,37.0,37.0,54900,54900,0,0,54900,Null,Null,200657733,111461,8167
200671467,1.0,1.0,220000,220000,0,0,220000,Null,Null,200671467,111461,15250
200678912,181.0,181.0,159000,127200,31800,20,159000,Null,Null,200678912,26675,1815
200679196,9.0,9.0,650000,650000,0,0,650000,Null,Null,200679196,5727591,11847
200679217,14.0,14.0,27375,24887,2488,9,27375,Null,Null,200679217,4973949,28484
200679270,0.0,0.0,2000,2000,0,0,2000,Null,Null,200679270,111461,23082
200679893,0.0,0.0,56260000,49508800,6751200,12,56260000,Null,Null,200679893,162945,11518
200689657,0.0,0.0,99500000,87560000,11940000,12,99500000,Null,Null,200689657,162945,8067
200689817,306.0,306.0,95000,95000,0,0,95000,Null,Null,200689817,5706641,23236
200694619,60.0,60.0,5000,4950,50,1,5000,Null,Null,200694619,4672141,15320
200694823,3.0,3.0,160000,96000,64000,40,160000,Null,Null,200694823,4672141,15320
200695302,23.0,23.0,10000,9500,500,5,10000,Null,Null,200695302,4672141,15320
200695816,9.0,9.0,198000,118800,79200,40,198000,Null,Null,200695816,4672141,15320
200696450,66.0,66.0,5000,4950,50,1,5000,Null,Null,200696450,4672141,15320
200696569,8.0,8.0,180000,108000,72000,40,180000,Null,Null,200696569,4672141,15320
200697357,19.0,19.0,10000,9500,500,5,10000,Null,Null,200697357,4672141,15320
200698408,3.0,3.0,148000,88800,59200,40,148000,Null,Null,200698408,4672141,15320
200698657,57.0,57.0,5000,4950,50,1,5000,Null,Null,200698657,4672141,15320
200706541,0.0,0.0,18200,18200,0,0,18200,Null,Null,200706541,111461,2
200707022,0.0,0.0,80000,80000,0,0,80000,Null,Null,200707022,111461,2
200707954,0.0,0.0,13350,13350,0,0,13350,Null,Null,200707954,111461,2
200708044,0.0,0.0,15000,15000,0,0,15000,Null,Null,200708044,111461,2
200708950,0.0,0.0,15000,15000,0,0,15000,Null,Null,200708950,111461,15320
200710424,7.0,7.0,126000,75600,50400,40,126000,Null,Null,200710424,4672141,15320
200711312,1.0,1.0,29000,29000,0,0,29000,Null,Null,200711312,111461,15250
200721854,90.0,90.0,250000,129000,121000,48,250000,Null,Null,200721854,314675,5263
200724173,0.0,0.0,23151000,23151000,0,0,23151000,Null,Null,200724173,162945,11518
200727844,0.0,0.0,57879000,50933520,6945480,12,57879000,Null,Null,200727844,162945,11518
200728038,2.0,2.0,180000,108000,72000,40,180000,Null,Null,200728038,4672141,15320
200728493,22.0,22.0,5000,4750,250,5,5000,Null,Null,200728493,4672141,15320
200728709,6.0,6.0,230000,138000,92000,40,230000,Null,Null,200728709,4672141,15320
200728829,29.0,29.0,185000,85000,100000,54,185000,Null,Null,200728829,314675,2324
200729458,0.0,0.0,82500000,82500000,0,0,82500000,Null,Null,200729458,162945,11518
200729649,22.0,22.0,5530000,5530000,0,0,5530000,Null,Null,200729649,7493501,8602
200729734,3.0,3.0,596000,357600,238400,40,596000,Null,Null,200729734,4672141,15318
200729910,5.0,5.0,5800,3480,2320,40,5800,Null,Null,200729910,4672141,15320
200730194,5.0,5.0,658000,394800,263200,40,658000,Null,Null,200730194,4672141,15318
200731209,17.0,17.0,330000,198000,132000,40,330000,Null,Null,200731209,4672141,15318
200731781,40.0,40.0,235000,176000,59000,25,235000,Null,Null,200731781,7493501,8602
200731933,62.0,62.0,105000,86000,19000,18,105000,Null,Null,200731933,31580,3426
200731941,71.0,71.0,105000,98800,6200,6,105000,Null,Null,200731941,48727,17186
200732056,0.0,0.0,16400000,16400000,0,0,16400000,Null,Null,200732056,50307,2324
200732479,263.0,263.0,6290000,5930000,360000,6,6290000,Null,Null,200732479,25643,1795
200732886,5.0,5.0,565000,339000,226000,40,565000,Null,Null,200732886,4672141,15318
200736829,553.0,553.0,150000,89000,61000,41,150000,Null,Null,200736829,227665,1520
200738495,0.0,0.0,12000,12000,0,0,12000,Null,Null,200738495,111461,3877
200738507,0.0,0.0,12000,12000,0,0,12000,Null,Null,200738507,111461,23276
200738510,0.0,0.0,19000,19000,0,0,19000,Null,Null,200738510,111461,2337
200738518,0.0,0.0,23000,23000,0,0,23000,Null,Null,200738518,111461,23282
200738525,0.0,0.0,23000,23000,0,0,23000,Null,Null,200738525,111461,23126
200738555,0.0,0.0,8000,8000,0,0,8000,Null,Null,200738555,111461,2238
200738567,0.0,0.0,29900,29900,0,0,29900,Null,Null,200738567,111461,27256
200738583,0.0,0.0,59000,59000,0,0,59000,Null,Null,200738583,111461,27180
200738585,0.0,0.0,88000,88000,0,0,88000,Null,Null,200738585,111461,23394
200738592,0.0,0.0,48000,48000,0,0,48000,Null,Null,200738592,111461,27256
200738607,0.0,0.0,8000,8000,0,0,8000,Null,Null,200738607,111461,3216
200738625,0.0,0.0,6000,6000,0,0,6000,Null,Null,200738625,111461,2514
200738628,0.0,0.0,16000,16000,0,0,16000,Null,Null,200738628,111461,6948
200738657,0.0,0.0,25000,25000,0,0,25000,Null,Null,200738657,111461,2513
200738708,0.0,0.0,24000,24000,0,0,24000,Null,Null,200738708,111461,2337
200738709,0.0,0.0,68000,68000,0,0,68000,Null,Null,200738709,111461,2849
200738712,0.0,0.0,6000,6000,0,0,6000,Null,Null,200738712,111461,23304
200739018,3.0,3.0,243000,145800,97200,40,243000,Null,Null,200739018,4672141,15318
200739148,16.0,16.0,246000,147600,98400,40,246000,Null,Null,200739148,4672141,15318
200743341,132.0,132.0,15000,14850,150,1,15000,Null,Null,200743341,4672141,15250
200759243,0.0,0.0,99999999,98999999,1000000,1,99999999,Null,Null,200759243,111461,2392
200759342,0.0,0.0,99999999,98999999,1000000,1,99999999,Null,Null,200759342,111461,2392
200762341,38.0,38.0,358000,179000,179000,50,358000,Null,Null,200762341,111461,1883
200765019,0.0,0.0,24780000,21806400,2973600,12,24780000,Null,Null,200765019,162945,11518
200765127,0.0,0.0,6360000,6360000,0,0,6360000,Null,Null,200765127,111643,5385
200765137,1.0,1.0,6360000,6360000,0,0,6360000,Null,Null,200765137,111643,5385
200765171,0.0,0.0,6360000,6360000,0,0,6360000,Null,Null,200765171,111643,5385
200765181,1.0,1.0,6360000,6360000,0,0,6360000,Null,Null,200765181,111643,5385
200765195,0.0,0.0,6360000,6360000,0,0,6360000,Null,Null,200765195,111643,5385
200765570,34.0,34.0,15000,14250,750,5,15000,Null,Null,200765570,4672141,15250
200765579,0.0,0.0,26150000,26150000,0,0,26150000,Null,Null,200765579,167287,5566
200766419,0.0,0.0,22990000,20231200,2758800,12,22990000,Null,Null,200766419,162945,8067
200767243,0.0,0.0,34678000,30516640,4161360,12,34678000,Null,Null,200767243,162945,11518
200771528,12.0,12.0,650000,650000,0,0,650000,Null,Null,200771528,111461,6305
200771763,0.0,0.0,27500000,27500000,0,0,27500000,Null,Null,200771763,144527,6653
200779142,11.0,11.0,3990000,3190000,800000,20,3990000,Null,Null,200779142,208841,2340
200779840,2.0,2.0,7500,7500,0,0,7500,Null,Null,200779840,111461,1813
200779847,2.0,2.0,390000,234000,156000,40,390000,Null,Null,200779847,4672141,15250
200780756,0.0,0.0,36000000,36000000,0,0,36000000,Null,Null,200780756,111461,2
200782721,414.0,414.0,52000,52000,0,0,52000,Null,Null,200782721,111461,1883
200785327,20.0,20.0,1000,1000,0,0,1000,Null,Null,200785327,111461,2
200787381,0.0,0.0,5225000,4990000,235000,4,5225000,Null,Null,200787381,199801,11885
200788883,0.0,0.0,19590000,18610500,979500,5,19590000,Null,Null,200788883,144538,2324
200790524,0.0,0.0,11840000,11248000,592000,5,11840000,Null,Null,200790524,153444,11518
200791426,60.0,60.0,150000,105000,45000,30,150000,Null,Null,200791426,277519,3179
200792939,439.0,439.0,414000,199000,215000,52,414000,Null,Null,200792939,238861,8223
200793382,0.0,0.0,17500000,16625000,875000,5,17500000,Null,Null,200793382,50331,8064
200794672,37.0,37.0,39000,39000,0,0,39000,Null,Null,200794672,111461,2
200795446,0.0,0.0,29850000,28357500,1492500,5,29850000,Null,Null,200795446,198963,11518
200795589,3.0,3.0,275000,275000,0,0,275000,Null,Null,200795589,464737,8042
200795694,0.0,0.0,38500000,38500000,0,0,38500000,Null,Null,200795694,167287,6653
200801955,0.0,0.0,33000000,31350000,1650000,5,33000000,Null,Null,200801955,7259141,11518
200803561,0.0,0.0,64850000,61607500,3242500,5,64850000,Null,Null,200803561,198963,8064
200804408,7.0,7.0,700000,450000,250000,36,700000,Null,Null,200804408,535885,28574
200804529,0.0,0.0,97409,88554,8855,9,97409,Null,Null,200804529,4973949,20244
200810945,0.0,0.0,22000000,20900000,1100000,5,22000000,Null,Null,200810945,153444,7079
200815499,0.0,0.0,28100000,26695000,1405000,5,28100000,Null,Null,200815499,50307,7079
200816271,0.0,0.0,10431000,10431000,0,0,10431000,Null,Null,200816271,111461,2
200816283,0.0,0.0,31293000,31293000,0,0,31293000,Null,Null,200816283,111461,2
200816286,0.0,0.0,18905000,18905000,0,0,18905000,Null,Null,200816286,111461,2
200816374,0.0,0.0,589000,519000,70000,12,589000,Null,Null,200816374,150568,1796
200816787,0.0,0.0,37514000,33012320,4501680,12,37514000,Null,Null,200816787,162945,28866
200817447,0.0,0.0,599000,539000,60000,10,599000,Null,Null,200817447,150568,1796
200817770,0.0,0.0,12650000,12650000,0,0,12650000,Null,Null,200817770,50368,28872
200819471,17.0,17.0,799000,655000,144000,18,799000,Null,Null,200819471,22017,1796
200825145,4.0,4.0,1950000,1589000,361000,19,1950000,Null,Null,200825145,111461,49724
200825908,0.0,0.0,35900000,34105000,1795000,5,35900000,Null,Null,200825908,153444,7079
200829966,14.0,14.0,500000,410000,90000,18,500000,Null,Null,200829966,22017,1796
200830057,0.0,0.0,38880000,36936000,1944000,5,38880000,Null,Null,200830057,181409,7079
200840800,9.0,9.0,65999,65999,0,0,65999,Null,Null,200840800,111461,53074
200841071,0.0,0.0,17820000,17285400,534600,3,17820000,Null,Null,200841071,167287,6653
200841131,0.0,0.0,45600000,44232000,1368000,3,45600000,Null,Null,200841131,167287,6653
200841431,99.0,99.0,1000000,535000,465000,47,1000000,Null,Null,200841431,4224691,2340
200842317,0.0,0.0,2850000,2850000,0,0,2850000,Null,Null,200842317,5172107,8512
200851294,0.0,0.0,4525000,4525000,0,0,4525000,Null,Null,200851294,7844215,17170
200851687,0.0,0.0,3392000,3392000,0,0,3392000,Null,Null,200851687,7844215,17174
200852408,1.0,1.0,290000,217500,72500,25,290000,Null,Null,200852408,4058421,49722
200852728,24.0,24.0,137000,117000,20000,15,137000,Null,Null,200852728,21265,1616
200853983,30.0,30.0,699000,389000,310000,44,699000,Null,Null,200853983,625853,28454
200854213,22.0,22.0,849000,849000,0,0,849000,Null,Null,200854213,53335,2971
200854354,0.0,0.0,39999999,39999999,0,0,39999999,Null,Null,200854354,111461,2
200854406,0.0,0.0,37777777,37777777,0,0,37777777,Null,Null,200854406,111461,2
200854630,0.0,0.0,67777777,67777777,0,0,67777777,Null,Null,200854630,111461,2
200855073,0.0,0.0,42345678,42345678,0,0,42345678,Null,Null,200855073,111461,2
200855348,0.0,0.0,39999999,39999999,0,0,39999999,Null,Null,200855348,111461,2
200855424,0.0,0.0,39999999,39999999,0,0,39999999,Null,Null,200855424,111461,23642
200855526,0.0,0.0,100000000,100000000,0,0,100000000,Null,Null,200855526,111461,2
200868118,63.0,63.0,699000,429000,270000,39,699000,Null,Null,200868118,625853,28454
200875556,0.0,0.0,5099000,4490000,609000,12,5099000,Null,Null,200875556,18804,2334
200876203,146.0,146.0,286200,159000,127200,44,286200,Null,Null,200876203,46703,23282
200925316,0.0,0.0,2100,2100,0,0,2100,Null,Null,200925316,111461,3179
200930795,0.0,0.0,19500000,19500000,0,0,19500000,Null,Null,200930795,167287,5566
200933189,0.0,0.0,21591000,16193250,5397750,25,21591000,Null,Null,200933189,26150,8513
200933925,0.0,0.0,9000,9000,0,0,9000,Null,Null,200933925,111461,2
200934396,0.0,0.0,5000,5000,0,0,5000,Null,Null,200934396,111461,2
200937466,0.0,0.0,2500,2500,0,0,2500,Null,Null,200937466,111461,2153
200938553,460.0,460.0,115000,103000,12000,10,115000,Null,Null,200938553,86206,1583
200939648,0.0,0.0,27500000,27500000,0,0,27500000,Null,Null,200939648,167287,6653
200940376,23.0,23.0,2205,2205,0,0,2205,Null,Null,200940376,111461,2
200946144,58.0,58.0,59000,42000,17000,29,59000,Null,Null,200946144,5073869,28674
200948387,351.0,351.0,150000,99000,51000,34,150000,Null,Null,200948387,7288833,28674
200950950,0.0,0.0,24000,11000,13000,54,24000,Null,Null,200950950,111461,15318
200954314,33.0,33.0,192512,192512,0,0,192512,Null,Null,200954314,5745605,28674
200960749,0.0,0.0,20200,9000,11200,55,20200,Null,Null,200960749,111461,15318
200960766,0.0,0.0,14500000,14065000,435000,3,14500000,Null,Null,200960766,167287,6653
200962888,13.0,13.0,625000,619000,6000,1,625000,Null,Null,200962888,18804,2334
200962904,15.0,15.0,697200,589000,108200,16,697200,Null,Null,200962904,18804,2334
200963043,1.0,1.0,109600,54800,54800,50,109600,Null,Null,200963043,111461,15318
200979742,0.0,0.0,18300000,16836000,1464000,8,18300000,Null,Null,200979742,181409,20170
200981602,0.0,0.0,8000,8000,0,0,8000,Null,Null,200981602,111461,8198
200985228,2.0,2.0,3990000,3990000,0,0,3990000,Null,Null,200985228,208841,2340
200994687,0.0,0.0,23780000,17835000,5945000,25,23780000,Null,Null,200994687,26065,7079
200995800,3.0,3.0,2490000,1750000,740000,30,2490000,Null,Null,200995800,247549,1795
200996327,0.0,0.0,36800000,27600000,9200000,25,36800000,Null,Null,200996327,26065,7079
200998110,0.0,0.0,39580000,29685000,9895000,25,39580000,Null,Null,200998110,26065,7079
200998225,0.0,0.0,96500000,86850000,9650000,10,96500000,Null,Null,200998225,167287,6653
200998845,20.0,20.0,2490000,2490000,0,0,2490000,Null,Null,200998845,247549,1795
200999827,0.0,0.0,32710000,24532500,8177500,25,32710000,Null,Null,200999827,26065,7079
201000274,0.0,0.0,28500000,28215000,285000,1,28500000,Null,Null,201000274,167287,6653
201001781,0.0,0.0,699000,550000,149000,21,699000,Null,Null,201001781,112638,1796
201001972,0.0,0.0,11500000,11500000,0,0,11500000,Null,Null,201001972,167287,6653
201003623,0.0,0.0,630000,630000,0,0,630000,Null,Null,201003623,112638,1796
201007184,0.0,0.0,1490000,1469000,21000,1,1490000,Null,Null,201007184,19673,1796
201010055,71.0,71.0,590000,299000,291000,49,590000,Null,Null,201010055,314675,2324
201014941,6.0,6.0,239000,239000,0,0,239000,Null,Null,201014941,111461,2
201015086,0.0,0.0,3590000,3590000,0,0,3590000,Null,Null,201015086,208841,2340
201034177,0.0,0.0,39580000,29685000,9895000,25,39580000,Null,Null,201034177,26065,28874
201034207,2152.0,2152.0,205000,182000,23000,11,205000,Null,Null,201034207,21266,13878
201036658,0.0,0.0,19630000,14722500,4907500,25,19630000,Null,Null,201036658,26065,7079
201038467,0.0,0.0,27770000,20827500,6942500,25,27770000,Null,Null,201038467,26065,7079
201039635,14.0,14.0,450000,229500,220500,49,450000,Null,Null,201039635,111454,28458
201039728,2.0,2.0,820000,750000,70000,9,820000,Null,Null,201039728,19673,1796
201040328,1513.0,1513.0,715000,371000,344000,48,715000,Null,Null,201040328,48077,1936
201046442,13.0,13.0,2415,2415,0,0,2415,Null,Null,201046442,111461,2
201046461,8.0,8.0,2500,2500,0,0,2500,Null,Null,201046461,111461,2
201046766,5.0,5.0,2500,2500,0,0,2500,Null,Null,201046766,111461,2363
201046877,15.0,15.0,2500,2500,0,0,2500,Null,Null,201046877,111461,2266
201047013,1.0,1.0,865000,790000,75000,9,865000,Null,Null,201047013,19673,1796
201048253,0.0,0.0,44650000,33487500,11162500,25,44650000,Null,Null,201048253,26065,7079
201050349,108.0,108.0,649000,559000,90000,14,649000,Null,Null,201050349,79682,10228
201050674,0.0,0.0,11500000,11500000,0,0,11500000,Null,Null,201050674,167287,6653
201055295,0.0,0.0,30090000,22567500,7522500,25,30090000,Null,Null,201055295,26065,7079
201055364,9.0,9.0,599000,599000,0,0,599000,Null,Null,201055364,314675,28454
201057368,288.0,288.0,1800000,1100000,700000,39,1800000,Null,Null,201057368,7303721,11923
201057857,0.0,0.0,19297000,16981360,2315640,12,19297000,Null,Null,201057857,167287,6653
201058285,0.0,0.0,18200000,16016000,2184000,12,18200000,Null,Null,201058285,167287,6653
201062337,0.0,0.0,33829000,29769520,4059480,12,33829000,Null,Null,201062337,167287,6653
201062346,0.0,0.0,46550000,34912500,11637500,25,46550000,Null,Null,201062346,26065,28874
201062355,0.0,0.0,25909000,19431750,6477250,25,25909000,Null,Null,201062355,26150,8513
201067570,0.0,0.0,84500000,74360000,10140000,12,84500000,Null,Null,201067570,167287,6653
201067649,378.0,378.0,3990000,3590000,400000,10,3990000,Null,Null,201067649,147856,1789
201072500,0.0,0.0,9673000,7254750,2418250,25,9673000,Null,Null,201072500,26150,8513
201072732,41.0,41.0,1865000,1399000,466000,25,1865000,Null,Null,201072732,218061,11943
201087061,0.0,0.0,2500,2500,0,0,2500,Null,Null,201087061,111461,23446
201087132,0.0,0.0,1500,1500,0,0,1500,Null,Null,201087132,111461,53070
201089451,0.0,0.0,120000,86000,34000,28,120000,Null,Null,201089451,111461,23588
201106495,25.0,25.0,1450000,1348500,101500,7,1450000,Null,Null,201106495,277519,2016
201110578,1.0,1.0,10000,10000,0,0,10000,Null,Null,201110578,111461,49726
201110669,5.0,5.0,5900,5900,0,0,5900,Null,Null,201110669,111461,23134
201112268,245.0,245.0,129000,129000,0,0,129000,Null,Null,201112268,5706641,3877
201112719,20.0,20.0,69000,69000,0,0,69000,Null,Null,201112719,550967,1601
201113157,16.0,16.0,299000,299000,0,0,299000,Null,Null,201113157,18802,28430
201113589,2.0,2.0,1575,1575,0,0,1575,Null,Null,201113589,111461,2
201113624,0.0,0.0,1890,1890,0,0,1890,Null,Null,201113624,111461,2
201118909,3.0,3.0,1000,1000,0,0,1000,Null,Null,201118909,111461,2
201123023,16.0,16.0,900000,599000,301000,33,900000,Null,Null,201123023,19312,28454
201123027,47.0,47.0,2000000,1499000,501000,25,2000000,Null,Null,201123027,19312,28454
201123316,4.0,4.0,19500000,19500000,0,0,19500000,Null,Null,201123316,18802,8067
201125305,329.0,329.0,70000,49000,21000,30,70000,Null,Null,201125305,4244853,28480
201127169,0.0,0.0,15000,15000,0,0,15000,Null,Null,201127169,111461,2
201127170,0.0,0.0,19000,19000,0,0,19000,Null,Null,201127170,111461,2
201127171,0.0,0.0,15000,15000,0,0,15000,Null,Null,201127171,111461,2
201127189,0.0,0.0,13000,13000,0,0,13000,Null,Null,201127189,111461,2
201152873,0.0,0.0,9750,9750,0,0,9750,Null,Null,201152873,111461,2
201157651,0.0,0.0,88000,83999,4001,5,88000,Null,Null,201157651,111461,28486
201158571,15.0,15.0,5000,5000,0,0,5000,Null,Null,201158571,111461,20258
201158773,9.0,9.0,13860000,13860000,0,0,13860000,Null,Null,201158773,144779,2324
201161524,126.0,126.0,1560000,1149000,411000,26,1560000,Null,Null,201161524,4250493,2849
201161718,0.0,0.0,17000,17000,0,0,17000,Null,Null,201161718,111461,2
201163403,0.0,0.0,11000,11000,0,0,11000,Null,Null,201163403,111461,15320
201163408,0.0,0.0,19000,19000,0,0,19000,Null,Null,201163408,111461,2
201163411,0.0,0.0,19000,19000,0,0,19000,Null,Null,201163411,111461,2
201163414,1.0,1.0,19000,19000,0,0,19000,Null,Null,201163414,111461,2
201163432,0.0,0.0,19000,19000,0,0,19000,Null,Null,201163432,111461,2
201163442,0.0,0.0,13000,13000,0,0,13000,Null,Null,201163442,111461,2
201163458,0.0,0.0,11000,11000,0,0,11000,Null,Null,201163458,111461,2
201163465,0.0,0.0,13000,13000,0,0,13000,Null,Null,201163465,111461,2
201164084,0.0,0.0,7250,7250,0,0,7250,Null,Null,201164084,111461,2
201164086,0.0,0.0,9950,9950,0,0,9950,Null,Null,201164086,111461,2
201164135,0.0,0.0,9950,9950,0,0,9950,Null,Null,201164135,111461,2
201164148,1.0,1.0,7250,7250,0,0,7250,Null,Null,201164148,111461,2
201164197,0.0,0.0,9950,9950,0,0,9950,Null,Null,201164197,111461,2
201164211,1.0,1.0,5000,5000,0,0,5000,Null,Null,201164211,111461,2
201164236,0.0,0.0,9950,9950,0,0,9950,Null,Null,201164236,111461,2
201164285,0.0,0.0,7450,7450,0,0,7450,Null,Null,201164285,111461,2
201164286,0.0,0.0,7450,7450,0,0,7450,Null,Null,201164286,111461,2
201164302,0.0,0.0,5000,5000,0,0,5000,Null,Null,201164302,111461,2
201164303,0.0,0.0,9950,9950,0,0,9950,Null,Null,201164303,111461,2
201170639,0.0,0.0,2400,2400,0,0,2400,Null,Null,201170639,111461,2
201175991,0.0,0.0,1000,1000,0,0,1000,Null,Null,201175991,111461,2
201176037,1.0,1.0,1000,1000,0,0,1000,Null,Null,201176037,111461,2
201176094,1.0,1.0,1000,1000,0,0,1000,Null,Null,201176094,111461,2
201176097,0.0,0.0,1000,1000,0,0,1000,Null,Null,201176097,111461,2
201176144,0.0,0.0,1000,1000,0,0,1000,Null,Null,201176144,111461,2
201176220,1.0,1.0,1000,1000,0,0,1000,Null,Null,201176220,111461,2
201176438,0.0,0.0,1000,1000,0,0,1000,Null,Null,201176438,111461,2
201176801,2.0,2.0,1000,1000,0,0,1000,Null,Null,201176801,111461,2
201176939,1.0,1.0,395000,395000,0,0,395000,Null,Null,201176939,111461,2
201226032,0.0,0.0,12708000,9531000,3177000,25,12708000,Null,Null,201226032,26150,8513
201226164,0.0,0.0,15000,15000,0,0,15000,Null,Null,201226164,21437,49728
201226191,0.0,0.0,15000,15000,0,0,15000,Null,Null,201226191,21437,49728
201226212,0.0,0.0,15000,15000,0,0,15000,Null,Null,201226212,21437,49728
201243220,26.0,26.0,160000,160000,0,0,160000,Null,Null,201243220,111461,28598
201295932,0.0,0.0,6650000,6650000,0,0,6650000,Null,Null,201295932,111461,8167
201296252,2.0,2.0,148999,129978,19021,13,148999,Null,Null,201296252,166419,28576
201296598,0.0,0.0,5800000,5800000,0,0,5800000,Null,Null,201296598,111461,8167
201299010,0.0,0.0,2300,2300,0,0,2300,Null,Null,201299010,111461,2
201299621,0.0,0.0,1000,1000,0,0,1000,Null,Null,201299621,111461,2
201308561,471.0,471.0,410000,405900,4100,1,410000,Null,Null,201308561,18984,3428
201354626,1.0,1.0,81000,81000,0,0,81000,Null,Null,201354626,111461,15318
201358891,0.0,0.0,59000000,57230000,1770000,3,59000000,Null,Null,201358891,162945,7079
201359203,1.0,1.0,645000,645000,0,0,645000,Null,Null,201359203,18984,3428
201359226,0.0,0.0,48500000,47045000,1455000,3,48500000,Null,Null,201359226,162945,7079
201359310,84.0,84.0,1110000,879000,231000,21,1110000,Null,Null,201359310,25697,28452
201359436,0.0,0.0,83500000,80995000,2505000,3,83500000,Null,Null,201359436,162945,7079
201363325,0.0,0.0,58000000,56260000,1740000,3,58000000,Null,Null,201363325,162945,7079
201367831,8.0,8.0,1999000,1590000,409000,20,1999000,Null,Null,201367831,18984,3428
201373093,38.0,38.0,1690000,1690000,0,0,1690000,Null,Null,201373093,18984,3428
201375653,14.0,14.0,550000,280500,269500,49,550000,Null,Null,201375653,111454,28458
201383174,6.0,6.0,1490000,1490000,0,0,1490000,Null,Null,201383174,7400143,53350
201384895,0.0,0.0,3550,3550,0,0,3550,Null,Null,201384895,111461,8194
201385184,333.0,333.0,249000,159000,90000,36,249000,Null,Null,201385184,5527787,2334
201427784,8.0,8.0,165000,165000,0,0,165000,Null,Null,201427784,149308,28594
201429095,3.0,3.0,47000,47000,0,0,47000,Null,Null,201429095,111461,15320
201430268,4.0,4.0,229000,229000,0,0,229000,Null,Null,201430268,111461,15318
201437397,1354.0,1354.0,250000,219000,31000,12,250000,Null,Null,201437397,4244853,1815
201437484,3344.0,3344.0,489900,459000,30900,6,489900,Null,Null,201437484,4244853,1815
201437945,0.0,0.0,5993548,5993548,0,0,5993548,Null,Null,201437945,7873343,15250
201475516,0.0,0.0,5993548,5993548,0,0,5993548,Null,Null,201475516,7873343,15250
201476190,0.0,0.0,59000000,59000000,0,0,59000000,Null,Null,201476190,784117,23276
201490941,1.0,1.0,4490000,3650000,840000,19,4490000,Null,Null,201490941,52232,1795
201505295,0.0,0.0,34400,17200,17200,50,34400,Null,Null,201505295,111461,15318
201505358,106.0,106.0,190000,190000,0,0,190000,Null,Null,201505358,4973949,28428
201508866,1.0,1.0,26400,12000,14400,55,26400,Null,Null,201508866,111461,15318
201523961,38.0,38.0,99000,99000,0,0,99000,Null,Null,201523961,3216013,20492
201538051,13.0,13.0,250000,250000,0,0,250000,Null,Null,201538051,149308,28574
201538072,25.0,25.0,270000,270000,0,0,270000,Null,Null,201538072,149308,28484
201538312,1.0,1.0,229000,229000,0,0,229000,Null,Null,201538312,111461,15318
201548628,112.0,112.0,3190000,2050000,1140000,36,3190000,Null,Null,201548628,19673,1795
201549588,5.0,5.0,700000,630000,70000,10,700000,Null,Null,201549588,171149,28684
201549594,150.0,150.0,68000,68000,0,0,68000,Null,Null,201549594,111461,23592
201565959,0.0,0.0,15700000,15543000,157000,1,15700000,Null,Null,201565959,162945,28858
201566005,862.0,862.0,217000,104000,113000,52,217000,Null,Null,201566005,48077,1936
201567874,22.0,22.0,2480000,1843000,637000,26,2480000,Null,Null,201567874,18984,3428
201568951,0.0,0.0,819000,819000,0,0,819000,Null,Null,201568951,18984,9013
201569179,0.0,0.0,78500000,77715000,785000,1,78500000,Null,Null,201569179,162945,7079
201569238,146.0,146.0,990000,850000,140000,14,990000,Null,Null,201569238,18984,5267
201569290,125.0,125.0,3200000,2400000,800000,25,3200000,Null,Null,201569290,631569,2340
201569462,3.0,3.0,409000,409000,0,0,409000,Null,Null,201569462,18984,9013
201571558,0.0,0.0,28175000,24794000,3381000,12,28175000,Null,Null,201571558,167287,6653
201571567,0.0,0.0,24500000,24255000,245000,1,24500000,Null,Null,201571567,162945,7079
201572012,13.0,13.0,1890000,1755000,135000,7,1890000,Null,Null,201572012,18984,5267
201575654,1.0,1.0,15000,15000,0,0,15000,Null,Null,201575654,111461,2
201576200,1.0,1.0,27000,27000,0,0,27000,Null,Null,201576200,111461,2
201576990,0.0,0.0,17500,17500,0,0,17500,Null,Null,201576990,111461,2
201577317,1.0,1.0,38000,38000,0,0,38000,Null,Null,201577317,111461,2
201579915,1.0,1.0,99000,99000,0,0,99000,Null,Null,201579915,111461,2
201580274,2447.0,2447.0,50000,25000,25000,50,50000,Null,Null,201580274,143130,1520
201580690,0.0,0.0,69900000,66405000,3495000,5,69900000,Null,Null,201580690,5232357,8067
201580891,181.0,181.0,33000,33000,0,0,33000,Null,Null,201580891,2630119,28426
201580912,41.0,41.0,33000,33000,0,0,33000,Null,Null,201580912,2630119,28426
201592234,126.0,126.0,140000,119000,21000,15,140000,Null,Null,201592234,519741,1601
201593083,47.0,47.0,140000,119000,21000,15,140000,Null,Null,201593083,519741,1601
201594563,0.0,0.0,74950000,71202500,3747500,5,74950000,Null,Null,201594563,144538,8067
201599813,0.0,0.0,72590000,69686400,2903600,4,72590000,Null,Null,201599813,167287,6653
201602752,0.0,0.0,72500000,71775000,725000,1,72500000,Null,Null,201602752,162945,28874
201602823,5.0,5.0,1000,1000,0,0,1000,Null,Null,201602823,7436599,23112
201604083,1.0,1.0,95000,95000,0,0,95000,Null,Null,201604083,111461,2
201604559,2.0,2.0,90000,90000,0,0,90000,Null,Null,201604559,111461,2
201605112,0.0,0.0,10000,10000,0,0,10000,Null,Null,201605112,111461,15318
201606579,0.0,0.0,15000,15000,0,0,15000,Null,Null,201606579,111461,2
201606730,8.0,8.0,175000,175000,0,0,175000,Null,Null,201606730,111461,2
201606753,1.0,1.0,75000,75000,0,0,75000,Null,Null,201606753,111461,2
201611240,10.0,10.0,2490000,2190000,300000,12,2490000,Null,Null,201611240,18984,5267
201621880,0.0,0.0,30500000,30195000,305000,1,30500000,Null,Null,201621880,162945,7079
201621901,0.0,0.0,13400000,12730000,670000,5,13400000,Null,Null,201621901,5217953,7079
201622217,0.0,0.0,150000,60000,90000,60,150000,Null,Null,201622217,111461,15250
201622467,12.0,12.0,165000,135000,30000,18,165000,Null,Null,201622467,7865367,11512
201623472,0.0,0.0,37300000,36927000,373000,1,37300000,Null,Null,201623472,162945,28874
201630199,0.0,0.0,81600000,81600000,0,0,81600000,Null,Null,201630199,162945,7079
201630337,22.0,22.0,68000,68000,0,0,68000,Null,Null,201630337,111461,23592
201630983,0.0,0.0,70800000,67968000,2832000,4,70800000,Null,Null,201630983,167287,6653
201631491,0.0,0.0,43680000,43680000,0,0,43680000,Null,Null,201631491,162945,7079
201631493,136.0,136.0,149000,79000,70000,47,149000,Null,Null,201631493,5055635,3428
201631518,3.0,3.0,2800000,2139000,661000,24,2800000,Null,Null,201631518,18802,1795
201631701,0.0,0.0,43500000,41325000,2175000,5,43500000,Null,Null,201631701,20215,28870
201632311,0.0,0.0,53500000,52965000,535000,1,53500000,Null,Null,201632311,162945,7079
201632579,0.0,0.0,75500000,71725000,3775000,5,75500000,Null,Null,201632579,20215,28870
201643513,2.0,2.0,35000000,33250000,1750000,5,35000000,Null,Null,201643513,50331,28870
201643783,0.0,0.0,55100000,52345000,2755000,5,55100000,Null,Null,201643783,153444,28868
201643795,0.0,0.0,52100000,49495000,2605000,5,52100000,Null,Null,201643795,50307,28868
201648680,0.0,0.0,15585000,12000000,3585000,23,15585000,Null,Null,201648680,5347313,11516
201671967,112.0,112.0,569000,309000,260000,46,569000,Null,Null,201671967,5048343,4593
201672497,277.0,277.0,800000,387000,413000,52,800000,Null,Null,201672497,111461,11923
201677252,0.0,0.0,11000,5500,5500,50,11000,Null,Null,201677252,111461,8194
201677294,4.0,4.0,5000,2500,2500,50,5000,Null,Null,201677294,111461,2685
201677394,0.0,0.0,3000,1500,1500,50,3000,Null,Null,201677394,111461,18888
201677483,0.0,0.0,5000,5000,0,0,5000,Null,Null,201677483,111461,15318
201687096,179.0,179.0,808000,808000,0,0,808000,Null,Null,201687096,5465099,1883
201691932,72.0,72.0,989000,907000,82000,8,989000,Null,Null,201691932,18984,3428
201691985,0.0,0.0,78500000,77715000,785000,1,78500000,Null,Null,201691985,162945,7079
201693309,26.0,26.0,2499000,1690000,809000,32,2499000,Null,Null,201693309,18984,5267
201693460,111.0,111.0,20000,19000,1000,5,20000,Null,Null,201693460,839837,53190
201693788,10.0,10.0,2450000,2389000,61000,2,2450000,Null,Null,201693788,18984,5267
201694029,105.0,105.0,15000,15000,0,0,15000,Null,Null,201694029,4439523,53190
201695519,7.0,7.0,1499000,835000,664000,44,1499000,Null,Null,201695519,18984,2971
201695557,0.0,0.0,78500000,77715000,785000,1,78500000,Null,Null,201695557,162945,7079
201696793,18.0,18.0,2748000,2590000,158000,6,2748000,Null,Null,201696793,18984,2971
201699231,80.0,80.0,1390000,1376000,14000,1,1390000,Null,Null,201699231,18984,4429
201703358,0.0,0.0,6500000,6500000,0,0,6500000,Null,Null,201703358,18802,1795
201711550,0.0,0.0,97880000,92986000,4894000,5,97880000,Null,Null,201711550,181409,28868
201767351,0.0,0.0,26500000,25175000,1325000,5,26500000,Null,Null,201767351,50331,28868
201770590,0.0,0.0,36000000,34200000,1800000,5,36000000,Null,Null,201770590,50331,28868
201771702,0.0,0.0,5000,5000,0,0,5000,Null,Null,201771702,111461,1819
201777833,0.0,0.0,72500000,71775000,725000,1,72500000,Null,Null,201777833,162945,28874
201796443,938.0,938.0,7000,7000,0,0,7000,Null,Null,201796443,7493501,8602
201802380,0.0,0.0,82000000,82000000,0,0,82000000,Null,Null,201802380,7874265,2340
201802391,0.0,0.0,42200,19000,23200,55,42200,Null,Null,201802391,111461,15318
201804129,895.0,895.0,150000,98000,52000,35,150000,Null,Null,201804129,7493501,8602
201816436,103.0,103.0,1550000,1099000,451000,29,1550000,Null,Null,201816436,218061,53348
201831056,222.0,222.0,1690000,1190000,500000,30,1690000,Null,Null,201831056,4250493,23634
201832678,91.0,91.0,559000,329000,230000,41,559000,Null,Null,201832678,5048343,4593
201845794,0.0,0.0,14150000,14150000,0,0,14150000,Null,Null,201845794,50368,7079
201848064,0.0,0.0,7000,7000,0,0,7000,Null,Null,201848064,111461,2
201849743,20.0,20.0,259000,259000,0,0,259000,Null,Null,201849743,7882139,23588
201849987,0.0,0.0,94860000,94860000,0,0,94860000,Null,Null,201849987,154011,11518
201849988,20.0,20.0,589000,589000,0,0,589000,Null,Null,201849988,192113,5267
201850862,32.0,32.0,10000,9500,500,5,10000,Null,Null,201850862,4672141,15250
201852399,0.0,0.0,41700000,41700000,0,0,41700000,Null,Null,201852399,154011,11518
201853840,137.0,137.0,15000,14850,150,1,15000,Null,Null,201853840,4672141,15250
201854006,139.0,139.0,10000,9900,100,1,10000,Null,Null,201854006,4672141,15250
201855332,35.0,35.0,10000,9500,500,5,10000,Null,Null,201855332,4672141,15250
201859002,42.0,42.0,1000,1000,0,0,1000,Null,Null,201859002,111461,2
201872990,0.0,0.0,5500000,3990000,1510000,27,5500000,Null,Null,201872990,208841,2340
201873111,20.0,20.0,149000,149000,0,0,149000,Null,Null,201873111,111461,23228
201873141,0.0,0.0,5050000,3590000,1460000,29,5050000,Null,Null,201873141,208841,2340
201873353,8.0,8.0,265000,220000,45000,17,265000,Null,Null,201873353,7878585,3426
201873360,8.0,8.0,246000,147600,98400,40,246000,Null,Null,201873360,4672141,15250
201873426,0.0,0.0,68000000,47600000,20400000,30,68000000,Null,Null,201873426,111461,23658
201874272,0.0,0.0,1850,1850,0,0,1850,Null,Null,201874272,111461,23016
201877310,0.0,0.0,19500000,9999000,9501000,49,19500000,Null,Null,201877310,31701,2340
201877336,0.0,0.0,33160000,33160000,0,0,33160000,Null,Null,201877336,154011,11518
201892556,0.0,0.0,18900000,18900000,0,0,18900000,Null,Null,201892556,154011,11518
201914300,0.0,0.0,34960000,34960000,0,0,34960000,Null,Null,201914300,154011,11518
201918488,11.0,11.0,190000,114000,76000,40,190000,Null,Null,201918488,4672141,15250
201919624,0.0,0.0,66880000,64204800,2675200,4,66880000,Null,Null,201919624,26065,28860
201929463,0.0,0.0,16400000,16400000,0,0,16400000,Null,Null,201929463,167287,6653
201930281,0.0,0.0,33500000,32160000,1340000,4,33500000,Null,Null,201930281,52315,8067
201933481,6.0,6.0,799000,682000,117000,15,799000,Null,Null,201933481,150568,1796
201933786,0.0,0.0,86500000,83040000,3460000,4,86500000,Null,Null,201933786,52315,11518
201935051,59.0,59.0,450000,233000,217000,48,450000,Null,Null,201935051,835097,2514
201937313,24.0,24.0,186000,171000,15000,8,186000,Null,Null,201937313,21276,1616
201937679,28.0,28.0,700000,600000,100000,14,700000,Null,Null,201937679,26150,2784
201951576,0.0,0.0,21900000,21900000,0,0,21900000,Null,Null,201951576,50331,28638
201970060,6.0,6.0,148000,96000,52000,35,148000,Null,Null,201970060,111461,27546
201976005,0.0,0.0,2465,2465,0,0,2465,Null,Null,201976005,111461,5450
201976096,0.0,0.0,2465,2465,0,0,2465,Null,Null,201976096,111461,5450
201976230,0.0,0.0,2202,2202,0,0,2202,Null,Null,201976230,111461,2
201976233,0.0,0.0,2465,2465,0,0,2465,Null,Null,201976233,111461,2
201976320,0.0,0.0,2465,2465,0,0,2465,Null,Null,201976320,111461,2
202013764,0.0,0.0,22900000,16900000,6000000,26,22900000,Null,Null,202013764,20091,2340
202013963,0.0,0.0,95000000,95000000,0,0,95000000,Null,Null,202013963,52315,11518
202016196,0.0,0.0,32260000,32260000,0,0,32260000,Null,Null,202016196,52315,8067
202016688,0.0,0.0,66880000,66880000,0,0,66880000,Null,Null,202016688,52315,28860
202020082,21.0,21.0,100000,47000,53000,53,100000,Null,Null,202020082,7367463,28480
202024780,0.0,0.0,34960000,34960000,0,0,34960000,Null,Null,202024780,52315,11518
202031937,10.0,10.0,7000,7000,0,0,7000,Null,Null,202031937,496891,20258
202032384,0.0,0.0,18980000,18980000,0,0,18980000,Null,Null,202032384,154011,11518
202037962,0.0,0.0,13000,13000,0,0,13000,Null,Null,202037962,111461,15236
202040544,10.0,10.0,217000,119000,98000,45,217000,Null,Null,202040544,48077,3177
202042685,0.0,0.0,33160000,33160000,0,0,33160000,Null,Null,202042685,154011,11518
202046077,0.0,0.0,6348000,6348000,0,0,6348000,Null,Null,202046077,25643,1795
202047695,0.0,0.0,15375000,15375000,0,0,15375000,Null,Null,202047695,7834805,8511
202047697,0.0,0.0,13638000,13638000,0,0,13638000,Null,Null,202047697,7834805,8511
202047699,0.0,0.0,9313000,9313000,0,0,9313000,Null,Null,202047699,7834805,8511
202047701,0.0,0.0,11050000,11050000,0,0,11050000,Null,Null,202047701,7834805,8511
202047703,0.0,0.0,8875000,8875000,0,0,8875000,Null,Null,202047703,7834805,8511
202047705,0.0,0.0,8238000,8238000,0,0,8238000,Null,Null,202047705,7834805,5384
202047706,0.0,0.0,10400000,10400000,0,0,10400000,Null,Null,202047706,7834805,8511
202047708,0.0,0.0,11050000,11050000,0,0,11050000,Null,Null,202047708,7834805,8511
202047710,0.0,0.0,9963000,9963000,0,0,9963000,Null,Null,202047710,7834805,8511
202047713,0.0,0.0,7150000,7150000,0,0,7150000,Null,Null,202047713,7834805,8511
202047714,0.0,0.0,9313000,9313000,0,0,9313000,Null,Null,202047714,7834805,8511
202047717,0.0,0.0,11050000,11050000,0,0,11050000,Null,Null,202047717,7834805,8511
202047719,0.0,0.0,11050000,11050000,0,0,11050000,Null,Null,202047719,7834805,8511
202047721,0.0,0.0,8238000,8238000,0,0,8238000,Null,Null,202047721,7834805,8511
202047723,0.0,0.0,11050000,11050000,0,0,11050000,Null,Null,202047723,7834805,8511
202047725,0.0,0.0,13638000,13638000,0,0,13638000,Null,Null,202047725,7834805,8511
202047726,0.0,0.0,11050000,11050000,0,0,11050000,Null,Null,202047726,7834805,8511
202047729,0.0,0.0,10400000,10400000,0,0,10400000,Null,Null,202047729,7834805,8511
202047730,0.0,0.0,11050000,11050000,0,0,11050000,Null,Null,202047730,7834805,8511
202047733,0.0,0.0,13213000,13213000,0,0,13213000,Null,Null,202047733,7834805,8511
202047735,0.0,0.0,9750000,9750000,0,0,9750000,Null,Null,202047735,7834805,8511
202047737,0.0,0.0,11050000,11050000,0,0,11050000,Null,Null,202047737,7834805,8511
202047741,0.0,0.0,11050000,11050000,0,0,11050000,Null,Null,202047741,7834805,8511
202047743,0.0,0.0,13213000,13213000,0,0,13213000,Null,Null,202047743,7834805,8511
202047745,0.0,0.0,13638000,13638000,0,0,13638000,Null,Null,202047745,7834805,8511
202047747,0.0,0.0,7150000,7150000,0,0,7150000,Null,Null,202047747,7834805,8511
202047749,0.0,0.0,12563000,12563000,0,0,12563000,Null,Null,202047749,7834805,8511
202047751,0.0,0.0,10400000,10400000,0,0,10400000,Null,Null,202047751,7834805,8511
202047753,0.0,0.0,15813000,15813000,0,0,15813000,Null,Null,202047753,7834805,8511
202047754,0.0,0.0,7150000,7150000,0,0,7150000,Null,Null,202047754,7834805,8511
202047757,0.0,0.0,11050000,11050000,0,0,11050000,Null,Null,202047757,7834805,8511
202047759,0.0,0.0,10400000,10400000,0,0,10400000,Null,Null,202047759,7834805,8511
202047761,0.0,0.0,7800000,7800000,0,0,7800000,Null,Null,202047761,7834805,8511
202047763,0.0,0.0,15813000,15813000,0,0,15813000,Null,Null,202047763,7834805,8511
202047765,0.0,0.0,7150000,7150000,0,0,7150000,Null,Null,202047765,7834805,8511
202047767,0.0,0.0,6713000,6713000,0,0,6713000,Null,Null,202047767,7834805,8511
202047769,0.0,0.0,9313000,9313000,0,0,9313000,Null,Null,202047769,7834805,8511
202047771,0.0,0.0,11050000,11050000,0,0,11050000,Null,Null,202047771,7834805,8511
202047773,0.0,0.0,11050000,11050000,0,0,11050000,Null,Null,202047773,7834805,8511
202047775,0.0,0.0,9750000,9750000,0,0,9750000,Null,Null,202047775,7834805,5384
202047777,0.0,0.0,13638000,13638000,0,0,13638000,Null,Null,202047777,7834805,8511
202047778,0.0,0.0,7800000,7800000,0,0,7800000,Null,Null,202047778,7834805,8511
202047781,0.0,0.0,12563000,12563000,0,0,12563000,Null,Null,202047781,7834805,8511
202047783,0.0,0.0,11050000,11050000,0,0,11050000,Null,Null,202047783,7834805,8511
202047785,0.0,0.0,9750000,9750000,0,0,9750000,Null,Null,202047785,7834805,8511
202047787,0.0,0.0,16463000,16463000,0,0,16463000,Null,Null,202047787,7834805,8511
202047789,0.0,0.0,7150000,7150000,0,0,7150000,Null,Null,202047789,7834805,5384
202047791,0.0,0.0,11050000,11050000,0,0,11050000,Null,Null,202047791,7834805,5384
202047793,0.0,0.0,11050000,11050000,0,0,11050000,Null,Null,202047793,7834805,8511
202047795,0.0,0.0,7800000,7800000,0,0,7800000,Null,Null,202047795,7834805,8511
202047797,0.0,0.0,11050000,11050000,0,0,11050000,Null,Null,202047797,7834805,8511
202047799,0.0,0.0,11050000,11050000,0,0,11050000,Null,Null,202047799,7834805,8511
202047801,0.0,0.0,13213000,13213000,0,0,13213000,Null,Null,202047801,7834805,8511
202047802,0.0,0.0,18625000,18625000,0,0,18625000,Null,Null,202047802,7834805,8511
202047805,0.0,0.0,9750000,9750000,0,0,9750000,Null,Null,202047805,7834805,8511
202047811,0.0,0.0,10400000,10400000,0,0,10400000,Null,Null,202047811,7834805,8511
202047813,0.0,0.0,11050000,11050000,0,0,11050000,Null,Null,202047813,7834805,8511
202047815,0.0,0.0,10400000,10400000,0,0,10400000,Null,Null,202047815,7834805,8511
202047817,0.0,0.0,13213000,13213000,0,0,13213000,Null,Null,202047817,7834805,8511
202047819,0.0,0.0,13638000,13638000,0,0,13638000,Null,Null,202047819,7834805,8511
202047821,0.0,0.0,13213000,13213000,0,0,13213000,Null,Null,202047821,7834805,8511
202047823,0.0,0.0,11050000,11050000,0,0,11050000,Null,Null,202047823,7834805,8511
202047824,0.0,0.0,7150000,7150000,0,0,7150000,Null,Null,202047824,7834805,8511
202047827,0.0,0.0,10400000,10400000,0,0,10400000,Null,Null,202047827,7834805,8511
202047829,0.0,0.0,10400000,10400000,0,0,10400000,Null,Null,202047829,7834805,8511
202047831,0.0,0.0,10400000,10400000,0,0,10400000,Null,Null,202047831,7834805,8511
202047833,0.0,0.0,13213000,13213000,0,0,13213000,Null,Null,202047833,7834805,8511
202047834,0.0,0.0,13638000,13638000,0,0,13638000,Null,Null,202047834,7834805,5384
202047837,0.0,0.0,24463000,24463000,0,0,24463000,Null,Null,202047837,7834805,8511
202047839,0.0,0.0,13638000,13638000,0,0,13638000,Null,Null,202047839,7834805,8511
202047841,0.0,0.0,15375000,15375000,0,0,15375000,Null,Null,202047841,7834805,8511
202047843,0.0,0.0,15813000,15813000,0,0,15813000,Null,Null,202047843,7834805,8511
202047845,0.0,0.0,10400000,10400000,0,0,10400000,Null,Null,202047845,7834805,8511
202047847,0.0,0.0,10400000,10400000,0,0,10400000,Null,Null,202047847,7834805,8511
202047849,0.0,0.0,10400000,10400000,0,0,10400000,Null,Null,202047849,7834805,8511
202047851,0.0,0.0,9750000,9750000,0,0,9750000,Null,Null,202047851,7834805,8511
202047853,0.0,0.0,11050000,11050000,0,0,11050000,Null,Null,202047853,7834805,8511
202047854,0.0,0.0,11050000,11050000,0,0,11050000,Null,Null,202047854,7834805,8511
202047859,0.0,0.0,11050000,11050000,0,0,11050000,Null,Null,202047859,7834805,8511
202047860,0.0,0.0,13638000,13638000,0,0,13638000,Null,Null,202047860,7834805,5384
202047863,0.0,0.0,13213000,13213000,0,0,13213000,Null,Null,202047863,7834805,8511
202047865,0.0,0.0,10400000,10400000,0,0,10400000,Null,Null,202047865,7834805,5384
202047867,0.0,0.0,13638000,13638000,0,0,13638000,Null,Null,202047867,7834805,8511
202047869,0.0,0.0,9750000,9750000,0,0,9750000,Null,Null,202047869,7834805,8511
202047871,0.0,0.0,9313000,9313000,0,0,9313000,Null,Null,202047871,7834805,5384
202047873,0.0,0.0,10400000,10400000,0,0,10400000,Null,Null,202047873,7834805,8511
202047875,0.0,0.0,11050000,11050000,0,0,11050000,Null,Null,202047875,7834805,8511
202047877,0.0,0.0,9750000,9750000,0,0,9750000,Null,Null,202047877,7834805,8511
202047878,0.0,0.0,10400000,10400000,0,0,10400000,Null,Null,202047878,7834805,5384
202047881,0.0,0.0,8875000,8875000,0,0,8875000,Null,Null,202047881,7834805,8511
202047883,0.0,0.0,8238000,8238000,0,0,8238000,Null,Null,202047883,7834805,8511
202047884,0.0,0.0,7800000,7800000,0,0,7800000,Null,Null,202047884,7834805,8511
202047887,0.0,0.0,11050000,11050000,0,0,11050000,Null,Null,202047887,7834805,8511
202047889,0.0,0.0,8238000,8238000,0,0,8238000,Null,Null,202047889,7834805,8511
202047891,0.0,0.0,12563000,12563000,0,0,12563000,Null,Null,202047891,7834805,8511
202047893,0.0,0.0,19050000,19050000,0,0,19050000,Null,Null,202047893,7834805,8511
202047895,0.0,0.0,13213000,13213000,0,0,13213000,Null,Null,202047895,7834805,8511
202047897,0.0,0.0,11050000,11050000,0,0,11050000,Null,Null,202047897,7834805,8511
202047899,0.0,0.0,9750000,9750000,0,0,9750000,Null,Null,202047899,7834805,8511
202047910,0.0,0.0,11050000,11050000,0,0,11050000,Null,Null,202047910,7834805,8511
202047966,0.0,0.0,9313000,9313000,0,0,9313000,Null,Null,202047966,7834805,8511
202048004,0.0,0.0,13638000,13638000,0,0,13638000,Null,Null,202048004,7834805,8511
202048009,0.0,0.0,16463000,16463000,0,0,16463000,Null,Null,202048009,7834805,8511
202048016,0.0,0.0,9313000,9313000,0,0,9313000,Null,Null,202048016,7834805,8511
202048049,0.0,0.0,10400000,10400000,0,0,10400000,Null,Null,202048049,7834805,5384
202048200,0.0,0.0,11050000,11050000,0,0,11050000,Null,Null,202048200,7834805,8511
202048208,0.0,0.0,11050000,11050000,0,0,11050000,Null,Null,202048208,7834805,8511
202048237,0.0,0.0,13213000,13213000,0,0,13213000,Null,Null,202048237,7834805,8511
202048407,0.0,0.0,8238000,8238000,0,0,8238000,Null,Null,202048407,7834805,8511
202048491,0.0,0.0,11050000,11050000,0,0,11050000,Null,Null,202048491,7834805,8511
202048749,0.0,0.0,7150000,7150000,0,0,7150000,Null,Null,202048749,7834805,8511
202048958,0.0,0.0,7150000,7150000,0,0,7150000,Null,Null,202048958,7834805,8511
202060096,0.0,0.0,18000,18000,0,0,18000,Null,Null,202060096,7506947,15250
202060114,0.0,0.0,18000,18000,0,0,18000,Null,Null,202060114,7506947,23112
202060186,0.0,0.0,2500,2500,0,0,2500,Null,Null,202060186,7506947,23112
202060210,0.0,0.0,2500,2500,0,0,2500,Null,Null,202060210,7506947,23112
202060344,0.0,0.0,2500,2500,0,0,2500,Null,Null,202060344,7506947,23112
202060346,0.0,0.0,18000,18000,0,0,18000,Null,Null,202060346,7506947,15250
202060356,0.0,0.0,2500,2500,0,0,2500,Null,Null,202060356,7506947,23112
202060420,0.0,0.0,2500,2500,0,0,2500,Null,Null,202060420,7506947,23112
202060492,2.0,2.0,2500,2500,0,0,2500,Null,Null,202060492,7506947,23112
202061880,0.0,0.0,18000,18000,0,0,18000,Null,Null,202061880,7506947,15250
202061891,0.0,0.0,18000,18000,0,0,18000,Null,Null,202061891,7506947,15250
202062385,0.0,0.0,41680000,41680000,0,0,41680000,Null,Null,202062385,154011,11518
202062554,12671.0,12671.0,197000,170000,27000,14,197000,Null,Null,202062554,21266,13878
202062715,0.0,0.0,94860000,94860000,0,0,94860000,Null,Null,202062715,154011,11518
202069921,200.0,200.0,50000,25000,25000,50,50000,Null,Null,202069921,32909,11821
202152243,12.0,12.0,250000,250000,0,0,250000,Null,Null,202152243,192495,1838
202215321,183.0,183.0,209000,195000,14000,7,209000,Null,Null,202215321,7879249,11817
202217564,0.0,0.0,14500000,14500000,0,0,14500000,Null,Null,202217564,7480987,28640
202222551,43.0,43.0,209000,209000,0,0,209000,Null,Null,202222551,5272071,1936
202232734,3.0,3.0,120000,120000,0,0,120000,Null,Null,202232734,111461,49722
202233794,0.0,0.0,6980000,6980000,0,0,6980000,Null,Null,202233794,405211,8512
202233859,0.0,0.0,6980000,6980000,0,0,6980000,Null,Null,202233859,405211,8512
202233868,0.0,0.0,6980000,6980000,0,0,6980000,Null,Null,202233868,405211,8512
202233898,0.0,0.0,6980000,6980000,0,0,6980000,Null,Null,202233898,405211,8512
202233920,0.0,0.0,7180000,7180000,0,0,7180000,Null,Null,202233920,405211,8512
202233937,0.0,0.0,7180000,7180000,0,0,7180000,Null,Null,202233937,405211,8512
202233966,0.0,0.0,7180000,7180000,0,0,7180000,Null,Null,202233966,405211,8512
202233984,0.0,0.0,7180000,7180000,0,0,7180000,Null,Null,202233984,405211,8512
202234024,0.0,0.0,7180000,7180000,0,0,7180000,Null,Null,202234024,405211,8512
202236493,557.0,557.0,65000,45900,19100,29,65000,Null,Null,202236493,52724,1815
202263809,49.0,49.0,14900,14900,0,0,14900,Null,Null,202263809,111461,2
202269832,0.0,0.0,13990000,11990000,2000000,14,13990000,Null,Null,202269832,52232,1795
202270275,0.0,0.0,18000,18000,0,0,18000,Null,Null,202270275,739195,15250
202270395,0.0,0.0,18000,18000,0,0,18000,Null,Null,202270395,739195,15250
202270654,0.0,0.0,18000,18000,0,0,18000,Null,Null,202270654,739195,15250
202329125,3.0,3.0,7500,7500,0,0,7500,Null,Null,202329125,111461,8073
202329146,2.0,2.0,2500,2500,0,0,2500,Null,Null,202329146,111461,8073
202329155,1.0,1.0,3800,3800,0,0,3800,Null,Null,202329155,111461,8073
202329164,31.0,31.0,2500,2500,0,0,2500,Null,Null,202329164,111461,8073
202329225,10.0,10.0,7500,7500,0,0,7500,Null,Null,202329225,111461,8073
202329238,0.0,0.0,43800,43800,0,0,43800,Null,Null,202329238,111461,26658
202329259,0.0,0.0,7500,7500,0,0,7500,Null,Null,202329259,111461,26658
202329287,5.0,5.0,23800,23800,0,0,23800,Null,Null,202329287,111461,8073
202329551,40.0,40.0,2500,2500,0,0,2500,Null,Null,202329551,111461,2
202330086,0.0,0.0,19000,9500,9500,50,19000,Null,Null,202330086,111461,1815
202330181,0.0,0.0,5870000,5870000,0,0,5870000,Null,Null,202330181,26150,8513
202331893,0.0,0.0,30800000,30800000,0,0,30800000,Null,Null,202331893,7878607,8073
202332221,5.0,5.0,400000,326851,73149,18,400000,Null,Null,202332221,143353,28574
202333769,1.0,1.0,450000,182000,268000,60,450000,Null,Null,202333769,111461,15936
202338143,0.0,0.0,15000,15000,0,0,15000,Null,Null,202338143,111461,49726
202338475,60.0,60.0,1000,1000,0,0,1000,Null,Null,202338475,111461,53074
202339625,127.0,127.0,75000,75000,0,0,75000,Null,Null,202339625,111461,8189
202383193,4.0,4.0,210000,210000,0,0,210000,Null,Null,202383193,111461,5384
202383465,0.0,0.0,6000,6000,0,0,6000,Null,Null,202383465,111461,28480
202412577,2.0,2.0,49000,49000,0,0,49000,Null,Null,202412577,111461,15318
202413130,0.0,0.0,5000,5000,0,0,5000,Null,Null,202413130,111461,15318
202438233,0.0,0.0,12500000,12500000,0,0,12500000,Null,Null,202438233,7480987,8400
202439550,36.0,36.0,1190000,920000,270000,23,1190000,Null,Null,202439550,18984,2971
202448038,0.0,0.0,2500,2500,0,0,2500,Null,Null,202448038,5211083,23112
202448041,0.0,0.0,1999,1999,0,0,1999,Null,Null,202448041,5211083,28680
202448217,0.0,0.0,2500,2500,0,0,2500,Null,Null,202448217,5211083,1819
202448578,0.0,0.0,2500,2500,0,0,2500,Null,Null,202448578,5211083,23112
202448733,0.0,0.0,2500,2500,0,0,2500,Null,Null,202448733,5211083,15936
202450384,3.0,3.0,56999,56999,0,0,56999,Null,Null,202450384,111461,28574
202451070,0.0,0.0,1999,1999,0,0,1999,Null,Null,202451070,5211083,28478
202451188,0.0,0.0,2500,2500,0,0,2500,Null,Null,202451188,5211083,23112
202451296,0.0,0.0,2500,2500,0,0,2500,Null,Null,202451296,5211083,1819
202451346,0.0,0.0,18000,18000,0,0,18000,Null,Null,202451346,5211083,15318
202451376,0.0,0.0,2500,2500,0,0,2500,Null,Null,202451376,5211083,23112
202452099,0.0,0.0,1000,1000,0,0,1000,Null,Null,202452099,5211083,23102
202452437,0.0,0.0,2500,2500,0,0,2500,Null,Null,202452437,5211083,23112
202455795,0.0,0.0,60000000,60000000,0,0,60000000,Null,Null,202455795,111461,3990
202461453,0.0,0.0,27500000,27500000,0,0,27500000,Null,Null,202461453,7480987,28640
202465273,59.0,59.0,769000,769000,0,0,769000,Null,Null,202465273,20271,1815
202466681,0.0,0.0,13799000,13799000,0,0,13799000,Null,Null,202466681,7480987,28640
202477035,0.0,0.0,13799000,13799000,0,0,13799000,Null,Null,202477035,7480987,28640
202477272,4.0,4.0,79000,79000,0,0,79000,Null,Null,202477272,193489,28430
202478525,34.0,34.0,379000,189500,189500,50,379000,Null,Null,202478525,63894,1634
202483946,108.0,108.0,1650000,1099000,551000,33,1650000,Null,Null,202483946,218061,1520
202491911,6.0,6.0,45000,45000,0,0,45000,Null,Null,202491911,111461,27128
202509632,107.0,107.0,19500,19500,0,0,19500,Null,Null,202509632,111461,28484
202509815,606.0,606.0,19000,19000,0,0,19000,Null,Null,202509815,111461,28484
202511226,1.0,1.0,5750000,5750000,0,0,5750000,Null,Null,202511226,111461,11933
202558281,0.0,0.0,24000000,24000000,0,0,24000000,Null,Null,202558281,1940065,2340
202558406,0.0,0.0,9900000,9900000,0,0,9900000,Null,Null,202558406,1940065,2340
202558604,0.0,0.0,9900000,9900000,0,0,9900000,Null,Null,202558604,1940065,2340
202596813,13.0,13.0,25000,25000,0,0,25000,Null,Null,202596813,111461,15318
202596923,24.0,24.0,7000,7000,0,0,7000,Null,Null,202596923,111461,2
202596925,40.0,40.0,28000,28000,0,0,28000,Null,Null,202596925,111461,2
202599032,33.0,33.0,2500,2500,0,0,2500,Null,Null,202599032,111461,2
202603203,44.0,44.0,299000,299000,0,0,299000,Null,Null,202603203,149308,28574
202611775,4.0,4.0,210000,210000,0,0,210000,Null,Null,202611775,111461,5384
202612292,74.0,74.0,230000,230000,0,0,230000,Null,Null,202612292,189445,20244
202614725,804.0,804.0,230000,179000,51000,22,230000,Null,Null,202614725,86206,1583
202623370,0.0,0.0,37000000,37000000,0,0,37000000,Null,Null,202623370,111461,11858
202623849,0.0,0.0,39300000,39300000,0,0,39300000,Null,Null,202623849,111461,11858
202625204,0.0,0.0,40999000,40999000,0,0,40999000,Null,Null,202625204,111461,11858
202640583,19.0,19.0,13990000,13990000,0,0,13990000,Null,Null,202640583,183637,28856
202645513,0.0,0.0,6000,6000,0,0,6000,Null,Null,202645513,111461,2
202652223,3.0,3.0,280000,280000,0,0,280000,Null,Null,202652223,111461,8512
202702736,16.0,16.0,150000,122000,28000,19,150000,Null,Null,202702736,218061,10228
202709287,0.0,0.0,12800000,12800000,0,0,12800000,Null,Null,202709287,26065,7079
202712913,0.0,0.0,12950000,12950000,0,0,12950000,Null,Null,202712913,26065,7079
202728141,0.0,0.0,169000,168999,1,0,169000,Null,Null,202728141,111454,5006
202734406,1.0,1.0,34000,17000,17000,50,34000,Null,Null,202734406,111461,15318
202736783,0.0,0.0,57330000,57330000,0,0,57330000,Null,Null,202736783,7480987,6653
202760782,0.0,0.0,4180000,4180000,0,0,4180000,Null,Null,202760782,4973087,11875
202764149,0.0,0.0,99950000,99950000,0,0,99950000,Null,Null,202764149,7480987,6653
202768963,104.0,104.0,95000,65000,30000,32,95000,Null,Null,202768963,111461,2
202769860,9.0,9.0,950000,950000,0,0,950000,Null,Null,202769860,111461,5566
202770124,25.0,25.0,79500,73140,6360,8,79500,Null,Null,202770124,4898665,8602
202780277,85.0,85.0,279000,229000,50000,18,279000,Null,Null,202780277,4958627,1883
202793234,0.0,0.0,22500000,22500000,0,0,22500000,Null,Null,202793234,167287,8067
202797356,9.0,9.0,3000,3000,0,0,3000,Null,Null,202797356,111461,28716
202804725,0.0,0.0,219998,199999,19999,9,219998,Null,Null,202804725,111454,12908
202804727,53.0,53.0,900000,900000,0,0,900000,Null,Null,202804727,111454,2659
202805334,0.0,0.0,20200000,20200000,0,0,20200000,Null,Null,202805334,167287,11518
202805930,429.0,429.0,1490000,899000,591000,40,1490000,Null,Null,202805930,48077,2225
202816310,7.0,7.0,80000,80000,0,0,80000,Null,Null,202816310,111461,28578
202837367,6.0,6.0,280000,280000,0,0,280000,Null,Null,202837367,111461,8512
202837396,29.0,29.0,199000,135000,64000,32,199000,Null,Null,202837396,20271,1838
202840456,418.0,418.0,154000,142000,12000,8,154000,Null,Null,202840456,523789,1883
202854195,1613.0,1613.0,380000,195000,185000,49,380000,Null,Null,202854195,248385,1520
202862628,18.0,18.0,299000,245000,54000,18,299000,Null,Null,202862628,689147,1609
202875459,196.0,196.0,50000,50000,0,0,50000,Null,Null,202875459,7884447,23392
202876808,0.0,0.0,12600000,12348000,252000,2,12600000,Null,Null,202876808,144527,28860
202876938,0.0,0.0,0,599000,0,0,599000,Null,Null,202876938,3985581,0
202876946,0.0,0.0,7500000,7500000,0,0,7500000,Null,Null,202876946,873871,11873
202879745,55.0,55.0,500000,500000,0,0,500000,Null,Null,202879745,111454,4428
202895733,5.0,5.0,90000,90000,0,0,90000,Null,Null,202895733,111461,49722
202905204,8.0,8.0,140000,140000,0,0,140000,Null,Null,202905204,111461,49722
202945143,0.0,0.0,129000,129000,0,0,129000,Null,Null,202945143,21653,28458
202957206,0.0,0.0,1850,1850,0,0,1850,Null,Null,202957206,111461,2
202957268,0.0,0.0,2000,2000,0,0,2000,Null,Null,202957268,111461,2
202958253,43.0,43.0,35000,35000,0,0,35000,Null,Null,202958253,5706641,7064
202961247,12.0,12.0,620000,590000,30000,5,620000,Null,Null,202961247,152306,28574
203003289,0.0,0.0,34980000,34980000,0,0,34980000,Null,Null,203003289,550159,28868
203008493,6.0,6.0,428000,428000,0,0,428000,Null,Null,203008493,4504403,23082
203012934,10.0,10.0,450000,450000,0,0,450000,Null,Null,203012934,4827915,1631
203013096,402.0,402.0,498000,479000,19000,4,498000,Null,Null,203013096,111461,1520
203016313,0.0,0.0,39100000,39100000,0,0,39100000,Null,Null,203016313,167287,11518
203016648,10.0,10.0,12000,8000,4000,33,12000,Null,Null,203016648,734429,1627
203023954,78.0,78.0,1398000,699000,699000,50,1398000,Null,Null,203023954,260983,8511
203025782,0.0,0.0,16280000,16280000,0,0,16280000,Null,Null,203025782,749425,28870
203039882,5.0,5.0,799000,739000,60000,8,799000,Null,Null,203039882,25422,2018
203049257,77.0,77.0,1398000,699000,699000,50,1398000,Null,Null,203049257,260983,8512
203049297,0.0,0.0,43500000,43500000,0,0,43500000,Null,Null,203049297,167287,11518
203054618,75.0,75.0,1398000,699000,699000,50,1398000,Null,Null,203054618,260983,8511
203064813,0.0,0.0,99999999,99999999,0,0,99999999,Null,Null,203064813,111461,23544
203065243,19.0,19.0,235000,235000,0,0,235000,Null,Null,203065243,4298221,5531
203065251,0.0,0.0,99999999,99999999,0,0,99999999,Null,Null,203065251,111461,23544
203065557,0.0,0.0,99999999,98999999,1000000,1,99999999,Null,Null,203065557,111461,23544
203065559,0.0,0.0,58520000,52082800,6437200,11,58520000,Null,Null,203065559,111461,23708
203065561,0.0,0.0,99999999,98999999,1000000,1,99999999,Null,Null,203065561,111461,23544
203110091,0.0,0.0,34500000,34500000,0,0,34500000,Null,Null,203110091,50307,7079
203122596,0.0,0.0,65500000,65500000,0,0,65500000,Null,Null,203122596,167287,28860
203144029,6.0,6.0,9000,9000,0,0,9000,Null,Null,203144029,111461,11831
203145400,0.0,0.0,14599000,14599000,0,0,14599000,Null,Null,203145400,412133,1813
203146930,82.0,82.0,349000,285000,64000,18,349000,Null,Null,203146930,929841,11943
203147472,0.0,0.0,16750000,16750000,0,0,16750000,Null,Null,203147472,412133,1813
203149991,0.0,0.0,18480000,18480000,0,0,18480000,Null,Null,203149991,550159,28870
203150091,0.0,0.0,33900000,33900000,0,0,33900000,Null,Null,203150091,167287,28860
203157227,68.0,68.0,159000,149000,10000,6,159000,Null,Null,203157227,929841,8165
203157765,3.0,3.0,5800000,5800000,0,0,5800000,Null,Null,203157765,18804,1626
203176045,212.0,212.0,370000,285000,85000,23,370000,Null,Null,203176045,307609,17170
203176326,0.0,0.0,12100000,11036000,1064000,9,12100000,Null,Null,203176326,199801,11873
203176585,15.0,15.0,19000,19000,0,0,19000,Null,Null,203176585,111461,11923
203176623,129.0,129.0,740000,540000,200000,27,740000,Null,Null,203176623,307609,17170
203176714,0.0,0.0,6800000,6494000,306000,5,6800000,Null,Null,203176714,199801,11873
203177133,167.0,167.0,79000,79000,0,0,79000,Null,Null,203177133,929841,8165
203177580,0.0,0.0,12247000,12247000,0,0,12247000,Null,Null,203177580,1773095,11937
203177601,0.0,0.0,3957000,3957000,0,0,3957000,Null,Null,203177601,1773095,11937
203177714,1.0,1.0,4377000,4377000,0,0,4377000,Null,Null,203177714,1773095,11937
203183659,0.0,0.0,44500000,44500000,0,0,44500000,Null,Null,203183659,167287,28860
203195468,1.0,1.0,120000,120000,0,0,120000,Null,Null,203195468,111461,49722
203195701,0.0,0.0,15500000,15500000,0,0,15500000,Null,Null,203195701,167287,28860
203198834,0.0,0.0,55000,55000,0,0,55000,Null,Null,203198834,21653,12908
203198868,0.0,0.0,59000,59000,0,0,59000,Null,Null,203198868,21653,12908
203198886,0.0,0.0,75000,75000,0,0,75000,Null,Null,203198886,21653,12918
203198964,0.0,0.0,59000,59000,0,0,59000,Null,Null,203198964,21653,28458
203199018,0.0,0.0,55000,55000,0,0,55000,Null,Null,203199018,21653,3805
203202218,13.0,13.0,60000,60000,0,0,60000,Null,Null,203202218,162313,28484
203205435,53.0,53.0,285000,267000,18000,6,285000,Null,Null,203205435,402501,2659
203210561,1.0,1.0,44999,44894,105,0,44999,Null,Null,203210561,4973949,28484
203212872,0.0,0.0,12189000,9141750,3047250,25,12189000,Null,Null,203212872,26150,8513
203213063,57.0,57.0,699000,339000,360000,52,699000,Null,Null,203213063,5221825,5905
203213292,0.0,0.0,45600000,43320000,2280000,5,45600000,Null,Null,203213292,50307,28868
203214526,22.0,22.0,10000,10000,0,0,10000,Null,Null,203214526,111461,15318
203214625,120.0,120.0,250000,205000,45000,18,250000,Null,Null,203214625,21271,11833
203220069,19.0,19.0,1580000,1439000,141000,9,1580000,Null,Null,203220069,41048,2136
203220337,399.0,399.0,188000,107000,81000,43,188000,Null,Null,203220337,7888803,2685
203220338,164.0,164.0,188000,96000,92000,49,188000,Null,Null,203220338,7888803,2685
203222741,23.0,23.0,20000,20000,0,0,20000,Null,Null,203222741,111461,49722
203222792,0.0,0.0,30000,16500,13500,45,30000,Null,Null,203222792,111461,15250
203233016,0.0,0.0,2000,2000,0,0,2000,Null,Null,203233016,111461,8205
203233097,42.0,42.0,4990000,4290000,700000,14,4990000,Null,Null,203233097,196181,2657
203241196,0.0,0.0,1022,1022,0,0,1022,Null,Null,203241196,5514897,2
203260551,0.0,0.0,3727000,3727000,0,0,3727000,Null,Null,203260551,1773095,11937
203260687,0.0,0.0,12247000,12247000,0,0,12247000,Null,Null,203260687,1773095,11937
203278278,35.0,35.0,2990000,2039000,951000,32,2990000,Null,Null,203278278,18802,1795
203285534,5.0,5.0,3000,1800,1200,40,3000,Null,Null,203285534,111461,23660
203285555,67.0,67.0,169000,119000,50000,30,169000,Null,Null,203285555,111461,23658
203285692,18.0,18.0,420000,420000,0,0,420000,Null,Null,203285692,111461,4380
203288929,88.0,88.0,458000,229000,229000,50,458000,Null,Null,203288929,7798515,1520
203290119,70.0,70.0,325000,325000,0,0,325000,Null,Null,203290119,7882195,23048
203291218,0.0,0.0,13200000,13200000,0,0,13200000,Null,Null,203291218,167287,8067
203291556,9.0,9.0,196480,137536,58944,30,196480,Null,Null,203291556,111461,4428
203393264,91.0,91.0,150000,109000,41000,27,150000,Null,Null,203393264,7288833,1813
203397439,0.0,0.0,18000,18000,0,0,18000,Null,Null,203397439,111461,2
203401676,0.0,0.0,45000,45000,0,0,45000,Null,Null,203401676,21653,28458
203401708,0.0,0.0,279000,279000,0,0,279000,Null,Null,203401708,21653,12294
203401827,0.0,0.0,29999000,25499150,4499850,15,29999000,Null,Null,203401827,111461,11933
203427120,0.0,0.0,1500,1500,0,0,1500,Null,Null,203427120,111461,2
203434611,0.0,0.0,32200000,32200000,0,0,32200000,Null,Null,203434611,167287,11518
203448753,47.0,47.0,250000,250000,0,0,250000,Null,Null,203448753,7882195,28458
203448782,0.0,0.0,40700000,40700000,0,0,40700000,Null,Null,203448782,167287,11518
203449477,0.0,0.0,11000000,8200000,2800000,25,11000000,Null,Null,203449477,53189,2342
203462947,1.0,1.0,16000,16000,0,0,16000,Null,Null,203462947,111461,2
203463039,0.0,0.0,18000,18000,0,0,18000,Null,Null,203463039,111461,2
203466887,0.0,0.0,5000,5000,0,0,5000,Null,Null,203466887,111461,8167
203467177,0.0,0.0,34100000,34100000,0,0,34100000,Null,Null,203467177,167287,11516
203467781,0.0,0.0,7000,7000,0,0,7000,Null,Null,203467781,111461,2
203467844,42.0,42.0,790000,589000,201000,25,790000,Null,Null,203467844,18805,1836
203468186,0.0,0.0,14420000,14420000,0,0,14420000,Null,Null,203468186,167287,28860
203468222,0.0,0.0,5000,5000,0,0,5000,Null,Null,203468222,111461,26658
203468578,0.0,0.0,19000,19000,0,0,19000,Null,Null,203468578,111461,2
203469132,0.0,0.0,25535000,25535000,0,0,25535000,Null,Null,203469132,298581,8073
203469281,0.0,0.0,39860000,39860000,0,0,39860000,Null,Null,203469281,167287,28860
203476395,1.0,1.0,12450000,12450000,0,0,12450000,Null,Null,203476395,144779,2324
203476609,0.0,0.0,650000,649999,1,0,650000,Null,Null,203476609,5126697,28454
203477294,0.0,0.0,599000,599000,0,0,599000,Null,Null,203477294,183257,15250
203477853,0.0,0.0,13200000,13200000,0,0,13200000,Null,Null,203477853,7480987,2324
203478064,0.0,0.0,9000,9000,0,0,9000,Null,Null,203478064,111461,8167
203483318,3.0,3.0,181000,181000,0,0,181000,Null,Null,203483318,111461,49722
203483359,0.0,0.0,38500000,38500000,0,0,38500000,Null,Null,203483359,7480987,2324
203494171,0.0,0.0,11000000,8800000,2200000,20,11000000,Null,Null,203494171,111461,15318
203494212,0.0,0.0,9100000,7735000,1365000,15,9100000,Null,Null,203494212,111461,15318
203504978,120.0,120.0,750000,398000,352000,47,750000,Null,Null,203504978,4655707,3426
203506323,1.0,1.0,1000,1000,0,0,1000,Null,Null,203506323,111461,2
203506621,0.0,0.0,890000,792000,98000,11,890000,Null,Null,203506621,111461,49724
203569872,110.0,110.0,38000,33440,4560,12,38000,Null,Null,203569872,839837,2685
203583617,74.0,74.0,29000,19000,10000,34,29000,Null,Null,203583617,929841,8193
203592327,3.0,3.0,145000,145000,0,0,145000,Null,Null,203592327,111461,27544
203602108,105.0,105.0,65000,65000,0,0,65000,Null,Null,203602108,461155,1831
203602192,5.0,5.0,165000,165000,0,0,165000,Null,Null,203602192,111461,27544
203702168,20.0,20.0,2000,2000,0,0,2000,Null,Null,203702168,111461,23642
203721908,71.0,71.0,355000,355000,0,0,355000,Null,Null,203721908,183013,1520
203723888,0.0,0.0,48930000,48930000,0,0,48930000,Null,Null,203723888,7362435,2340
203724012,74.0,74.0,95000,95000,0,0,95000,Null,Null,203724012,4671129,8602
203725030,5.0,5.0,2000000,1520000,480000,24,2000000,Null,Null,203725030,49024,28644
203736657,1.0,1.0,275000,235000,40000,15,275000,Null,Null,203736657,111461,2340
203740983,54.0,54.0,336000,170000,166000,49,336000,Null,Null,203740983,4514729,2225
203746529,0.0,0.0,24500000,24500000,0,0,24500000,Null,Null,203746529,7362435,2340
203756629,41.0,41.0,7900000,3761000,4139000,52,7900000,Null,Null,203756629,111461,4381
203757099,181.0,181.0,500000,489000,11000,2,500000,Null,Null,203757099,4244853,53190
203757412,7.0,7.0,20000,20000,0,0,20000,Null,Null,203757412,111461,2
203759814,0.0,0.0,215000,215000,0,0,215000,Null,Null,203759814,111461,49724
203763209,90.0,90.0,5990000,4890000,1100000,18,5990000,Null,Null,203763209,162007,1795
203764665,216.0,216.0,4990000,4390000,600000,12,4990000,Null,Null,203764665,162007,1795
203798277,0.0,0.0,22800,11400,11400,50,22800,Null,Null,203798277,111461,15318
203804139,5.0,5.0,570000,570000,0,0,570000,Null,Null,203804139,111461,23236
203813235,48.0,48.0,573850,573850,0,0,573850,Null,Null,203813235,111461,23236
203815267,0.0,0.0,2000,2000,0,0,2000,Null,Null,203815267,111461,1622
203815525,42.0,42.0,180000,171000,9000,5,180000,Null,Null,203815525,839837,3177
203825264,3.0,3.0,120000,120000,0,0,120000,Null,Null,203825264,111461,49722
203831398,2.0,2.0,90000,90000,0,0,90000,Null,Null,203831398,111461,49722
203834339,0.0,0.0,350000,109000,241000,69,350000,Null,Null,203834339,7245301,15250
203834475,1.0,1.0,350000,179000,171000,49,350000,Null,Null,203834475,7245301,15320
203834549,1.0,1.0,250000,79000,171000,68,250000,Null,Null,203834549,7245301,15320
203834761,2.0,2.0,250000,79000,171000,68,250000,Null,Null,203834761,7245301,15320
203834765,0.0,0.0,320000,159000,161000,50,320000,Null,Null,203834765,7245301,15250
203834946,1.0,1.0,250000,79000,171000,68,250000,Null,Null,203834946,7245301,15320
203842493,0.0,0.0,41600,19000,22600,54,41600,Null,Null,203842493,111461,15318
203850350,0.0,0.0,9900,9900,0,0,9900,Null,Null,203850350,111461,8167
203853390,92.0,92.0,3290000,2750000,540000,16,3290000,Null,Null,203853390,25643,1795
203862447,0.0,0.0,12950000,12950000,0,0,12950000,Null,Null,203862447,144779,2324
203864283,552.0,552.0,3990000,3290000,700000,18,3990000,Null,Null,203864283,25643,1795
203868051,27.0,27.0,518000,388500,129500,25,518000,Null,Null,203868051,287541,17170
203868227,184.0,184.0,109000,109000,0,0,109000,Null,Null,203868227,5272071,23362
203871091,0.0,0.0,38500000,38500000,0,0,38500000,Null,Null,203871091,7480987,2324
203875499,4.0,4.0,39990000,25990000,14000000,35,39990000,Null,Null,203875499,5222401,2340
203875501,12.0,12.0,28400000,17990000,10410000,37,28400000,Null,Null,203875501,5222401,2340
203883187,285.0,285.0,9500,9500,0,0,9500,Null,Null,203883187,111461,53074
203889587,25.0,25.0,99000,78900,20100,20,99000,Null,Null,203889587,111461,23036
203890028,0.0,0.0,9000,9000,0,0,9000,Null,Null,203890028,111461,8205
203898486,85.0,85.0,200000,139000,61000,31,200000,Null,Null,203898486,4244853,20244
203901760,0.0,0.0,19000,19000,0,0,19000,Null,Null,203901760,111461,15320
203904791,0.0,0.0,9000,9000,0,0,9000,Null,Null,203904791,111461,8205
203911395,1097.0,1097.0,169000,105000,64000,38,169000,Null,Null,203911395,5534927,1631
203923011,329.0,329.0,125000,90000,35000,28,125000,Null,Null,203923011,5534927,1627
203923275,1.0,1.0,14000,7000,7000,50,14000,Null,Null,203923275,111461,7064
203927261,175.0,175.0,124000,115000,9000,7,124000,Null,Null,203927261,5534927,11735
203927345,0.0,0.0,2800,2800,0,0,2800,Null,Null,203927345,111461,28428
203931616,0.0,0.0,6000,5000,1000,17,6000,Null,Null,203931616,227935,1612
203931929,18.0,18.0,2099000,1099000,1000000,48,2099000,Null,Null,203931929,111454,8400
203945371,15.0,15.0,29000,29000,0,0,29000,Null,Null,203945371,111461,53188
203949012,207.0,207.0,170000,88000,82000,48,170000,Null,Null,203949012,7896671,11837
203949388,94.0,94.0,450000,166000,284000,63,450000,Null,Null,203949388,7896671,53350
203949614,38.0,38.0,9990000,6290000,3700000,37,9990000,Null,Null,203949614,18802,1794
203950335,0.0,0.0,2000,2000,0,0,2000,Null,Null,203950335,111461,2
203957192,466.0,466.0,55000,27000,28000,51,55000,Null,Null,203957192,47633,1831
203959896,113.0,113.0,300000,140000,160000,53,300000,Null,Null,203959896,7896671,8217
203960678,0.0,0.0,9000,9000,0,0,9000,Null,Null,203960678,111461,8193
203960841,19.0,19.0,2900,2900,0,0,2900,Null,Null,203960841,111461,1601
203960886,0.0,0.0,5500,5500,0,0,5500,Null,Null,203960886,111461,8194
203960914,2.0,2.0,3900,3900,0,0,3900,Null,Null,203960914,111461,8198
203960975,0.0,0.0,5000,5000,0,0,5000,Null,Null,203960975,111461,1520
203961167,1.0,1.0,1900,1900,0,0,1900,Null,Null,203961167,111461,8196
203961170,0.0,0.0,9000,9000,0,0,9000,Null,Null,203961170,111461,11803
203966092,84.0,84.0,300000,140000,160000,53,300000,Null,Null,203966092,7896671,8217
203968586,0.0,0.0,45000,45000,0,0,45000,Null,Null,203968586,111461,12908
203969829,19.0,19.0,95000,95000,0,0,95000,Null,Null,203969829,111461,5450
203972090,0.0,0.0,20100000,20100000,0,0,20100000,Null,Null,203972090,7480987,2324
203981611,356.0,356.0,150000,82000,68000,45,150000,Null,Null,203981611,5534927,1630
203986151,0.0,0.0,59000000,56640000,2360000,4,59000000,Null,Null,203986151,167287,6653
203986693,0.0,0.0,4650000,4650000,0,0,4650000,Null,Null,203986693,253481,8172
203992107,0.0,0.0,7900,7900,0,0,7900,Null,Null,203992107,111461,8196
203992160,0.0,0.0,9000,9000,0,0,9000,Null,Null,203992160,111461,8197
203992191,0.0,0.0,4500,4500,0,0,4500,Null,Null,203992191,111461,8197
203992231,0.0,0.0,4900,4900,0,0,4900,Null,Null,203992231,111461,8193
203992261,0.0,0.0,7500,7500,0,0,7500,Null,Null,203992261,111461,8194
203992322,6.0,6.0,4500,4500,0,0,4500,Null,Null,203992322,111461,8194
203992342,10.0,10.0,9000,9000,0,0,9000,Null,Null,203992342,111461,8197
203996337,32.0,32.0,52000,52000,0,0,52000,Null,Null,203996337,111461,23022
203996405,0.0,0.0,56000000,56000000,0,0,56000000,Null,Null,203996405,7480987,2324
203998897,0.0,0.0,4500,4500,0,0,4500,Null,Null,203998897,111461,8167
203998993,0.0,0.0,9000,9000,0,0,9000,Null,Null,203998993,111461,8193
203999028,0.0,0.0,5500,5500,0,0,5500,Null,Null,203999028,111461,1601
203999039,0.0,0.0,5500,5500,0,0,5500,Null,Null,203999039,111461,8196
204001744,0.0,0.0,46580000,46580000,0,0,46580000,Null,Null,204001744,154221,23622
204002803,0.0,0.0,19600,9000,10600,54,19600,Null,Null,204002803,111461,15318
204009169,476.0,476.0,100000,65000,35000,35,100000,Null,Null,204009169,4732457,2
204027089,0.0,0.0,9011000,6644000,2367000,26,9011000,Null,Null,204027089,241109,2340
204027871,0.0,0.0,18000,9000,9000,50,18000,Null,Null,204027871,111461,15318
204030554,1.0,1.0,6214000,4200000,2014000,32,6214000,Null,Null,204030554,241109,11935
204032489,1.0,1.0,8700000,6541000,2159000,25,8700000,Null,Null,204032489,241109,11935
204038070,48.0,48.0,398000,199000,199000,50,398000,Null,Null,204038070,7400131,8371
204038971,15.0,15.0,398000,199000,199000,50,398000,Null,Null,204038971,7400131,8371
204039014,16.0,16.0,300000,150000,150000,50,300000,Null,Null,204039014,7400131,8371
204039338,43.0,43.0,300000,150000,150000,50,300000,Null,Null,204039338,7400131,8371
204044091,0.0,0.0,2500,2500,0,0,2500,Null,Null,204044091,111461,3179
204052270,105.0,105.0,340000,340000,0,0,340000,Null,Null,204052270,111461,26652
204052384,0.0,0.0,55400000,55400000,0,0,55400000,Null,Null,204052384,7480987,2324
204057041,0.0,0.0,89100000,85536000,3564000,4,89100000,Null,Null,204057041,167287,6653
204057050,72.0,72.0,2490000,1480000,1010000,41,2490000,Null,Null,204057050,111461,4381
204057171,0.0,0.0,44500000,44500000,0,0,44500000,Null,Null,204057171,7480987,2324
204064343,0.0,0.0,4500,4500,0,0,4500,Null,Null,204064343,111461,8197
204064363,0.0,0.0,9000,9000,0,0,9000,Null,Null,204064363,111461,8193
204064502,41.0,41.0,45000,45000,0,0,45000,Null,Null,204064502,111461,8193
204064544,0.0,0.0,5000,5000,0,0,5000,Null,Null,204064544,111461,8194
204064645,0.0,0.0,3500,3500,0,0,3500,Null,Null,204064645,111461,8190
204064718,0.0,0.0,4900,4900,0,0,4900,Null,Null,204064718,111461,8194
204064868,0.0,0.0,8000,8000,0,0,8000,Null,Null,204064868,111461,1601
204064908,0.0,0.0,3900,3900,0,0,3900,Null,Null,204064908,111461,1601
204064912,0.0,0.0,3500,3500,0,0,3500,Null,Null,204064912,111461,8194
204064941,0.0,0.0,9000,9000,0,0,9000,Null,Null,204064941,111461,8193
204065010,0.0,0.0,2900,2900,0,0,2900,Null,Null,204065010,111461,8194
204065030,5.0,5.0,8000,8000,0,0,8000,Null,Null,204065030,111461,8193
204065435,0.0,0.0,5900,5900,0,0,5900,Null,Null,204065435,111461,8194
204066551,9.0,9.0,2990000,2049000,941000,31,2990000,Null,Null,204066551,18802,1795
204066765,1.0,1.0,59000,59000,0,0,59000,Null,Null,204066765,111461,2
204066850,0.0,0.0,92000,92000,0,0,92000,Null,Null,204066850,111461,2
204067022,0.0,0.0,99000,99000,0,0,99000,Null,Null,204067022,475439,5384
204067073,1.0,1.0,55000,55000,0,0,55000,Null,Null,204067073,111461,2
204067100,1.0,1.0,69000,69000,0,0,69000,Null,Null,204067100,111461,2
204067114,2.0,2.0,59000,59000,0,0,59000,Null,Null,204067114,111461,2
204067140,1.0,1.0,79000,79000,0,0,79000,Null,Null,204067140,111461,2
204083681,232.0,232.0,19000,19000,0,0,19000,Null,Null,204083681,5706641,2514
204204887,24.0,24.0,349000,244000,105000,30,349000,Null,Null,204204887,18984,1831
204206152,83.0,83.0,20000,20000,0,0,20000,Null,Null,204206152,111461,53074
204207230,351.0,351.0,198000,93060,104940,53,198000,Null,Null,204207230,7400131,1883
204208058,10.0,10.0,235000,199000,36000,15,235000,Null,Null,204208058,111461,4593
204212145,92.0,92.0,198000,99000,99000,50,198000,Null,Null,204212145,7400131,8371
204213348,5.0,5.0,9000,9000,0,0,9000,Null,Null,204213348,111461,2
204216292,1.0,1.0,1500,1500,0,0,1500,Null,Null,204216292,111461,2
204218144,520.0,520.0,50000,50000,0,0,50000,Null,Null,204218144,4584215,8305
204228934,158.0,158.0,39000,36000,3000,8,39000,Null,Null,204228934,192111,1883
204231178,162.0,162.0,398000,199000,199000,50,398000,Null,Null,204231178,7400131,8371
204234679,6.0,6.0,48600,46656,1944,4,48600,Null,Null,204234679,111461,2
204237148,94.0,94.0,319000,319000,0,0,319000,Null,Null,204237148,746615,2238
204249188,33.0,33.0,320000,320000,0,0,320000,Null,Null,204249188,111461,12590
204249324,94.0,94.0,210000,210000,0,0,210000,Null,Null,204249324,4671129,8602
204249337,56.0,56.0,398000,199000,199000,50,398000,Null,Null,204249337,7400131,8371
204249433,34.0,34.0,354000,171000,183000,52,354000,Null,Null,204249433,148961,3216
204267259,94.0,94.0,4000,4000,0,0,4000,Null,Null,204267259,886923,1520
204280498,19.0,19.0,700000,350000,350000,50,700000,Null,Null,204280498,7400131,8371
204282679,0.0,0.0,8900000,6698000,2202000,25,8900000,Null,Null,204282679,26150,8513
204282682,0.0,0.0,8900000,6698000,2202000,25,8900000,Null,Null,204282682,26150,8513
204310471,14.0,14.0,600000,339000,261000,44,600000,Null,Null,204310471,4655707,8227
204314321,0.0,0.0,45000000,45000000,0,0,45000000,Null,Null,204314321,7480987,2324
204318337,0.0,0.0,7000,7000,0,0,7000,Null,Null,204318337,111461,8194
204318343,6.0,6.0,4900,4900,0,0,4900,Null,Null,204318343,111461,8194
204325897,148.0,148.0,15398,13999,1399,9,15398,Null,Null,204325897,111461,53074
204340232,0.0,0.0,12869,12869,0,0,12869,Null,Null,204340232,111461,2
204365586,2.0,2.0,8800000,8800000,0,0,8800000,Null,Null,204365586,111461,11935
204374657,0.0,0.0,56000000,56000000,0,0,56000000,Null,Null,204374657,7480987,2324
204376858,0.0,0.0,15600000,14976000,624000,4,15600000,Null,Null,204376858,167287,6653
204378216,1.0,1.0,53600,24000,29600,55,53600,Null,Null,204378216,111461,15318
204380973,0.0,0.0,91500000,91500000,0,0,91500000,Null,Null,204380973,7480987,2324
204387059,0.0,0.0,56000000,56000000,0,0,56000000,Null,Null,204387059,7480987,2324
204394080,0.0,0.0,4760000,4760000,0,0,4760000,Null,Null,204394080,7834983,17174
204394238,1.0,1.0,10000,10000,0,0,10000,Null,Null,204394238,111461,8197
204398887,4.0,4.0,28000,14000,14000,50,28000,Null,Null,204398887,111461,15318
204399255,0.0,0.0,5000,3000,2000,40,5000,Null,Null,204399255,111461,2
204405138,28.0,28.0,279000,271000,8000,3,279000,Null,Null,204405138,21651,5531
204405626,29.0,29.0,889000,889000,0,0,889000,Null,Null,204405626,21651,4429
204408112,0.0,0.0,249000,249000,0,0,249000,Null,Null,204408112,21651,8400
204411075,0.0,0.0,68500000,68500000,0,0,68500000,Null,Null,204411075,7480987,2324
204414482,2.0,2.0,90000,77000,13000,14,90000,Null,Null,204414482,111461,2
204415554,0.0,0.0,2025,2025,0,0,2025,Null,Null,204415554,111461,2
204423507,0.0,0.0,9600000,9600000,0,0,9600000,Null,Null,204423507,111461,15318
204424703,2.0,2.0,3500000,3440000,60000,2,3500000,Null,Null,204424703,111461,2340
204425271,21.0,21.0,5890000,3550000,2340000,40,5890000,Null,Null,204425271,74999,11516
204428864,0.0,0.0,23395000,23395000,0,0,23395000,Null,Null,204428864,162945,7081
204428992,12.0,12.0,180000,114000,66000,37,180000,Null,Null,204428992,111461,28482
204429057,0.0,0.0,23350000,23350000,0,0,23350000,Null,Null,204429057,162945,7081
204429319,0.0,0.0,13800000,13800000,0,0,13800000,Null,Null,204429319,162945,7081
204431176,497.0,497.0,22000,22000,0,0,22000,Null,Null,204431176,746615,2337
204432056,34.0,34.0,550000,550000,0,0,550000,Null,Null,204432056,7882195,2324
204437221,0.0,0.0,9000,9000,0,0,9000,Null,Null,204437221,111461,8194
204437861,0.0,0.0,13680000,13680000,0,0,13680000,Null,Null,204437861,162945,7081
204443768,0.0,0.0,20900000,20900000,0,0,20900000,Null,Null,204443768,162945,7081
204450025,0.0,0.0,5000,5000,0,0,5000,Null,Null,204450025,111461,15318
204450309,0.0,0.0,18800000,18800000,0,0,18800000,Null,Null,204450309,162945,7081
204538261,86.0,86.0,169000,169000,0,0,169000,Null,Null,204538261,5706641,3177
204609782,33.0,33.0,17500,17500,0,0,17500,Null,Null,204609782,111461,23216
204611078,28.0,28.0,175000,175000,0,0,175000,Null,Null,204611078,111461,53186
204611737,0.0,0.0,24800,12400,12400,50,24800,Null,Null,204611737,111461,15318
204615449,75.0,75.0,1000,950,50,5,1000,Null,Null,204615449,111461,27214
204616376,1.0,1.0,9900,9900,0,0,9900,Null,Null,204616376,111461,7064
204621272,0.0,0.0,2800,2800,0,0,2800,Null,Null,204621272,111461,1819
204626118,0.0,0.0,150000,135000,15000,10,150000,Null,Null,204626118,111461,15250
204631078,0.0,0.0,13230000,13230000,0,0,13230000,Null,Null,204631078,162945,4428
204631357,113.0,113.0,95000,95000,0,0,95000,Null,Null,204631357,4671129,8602
204633678,0.0,0.0,7000,7000,0,0,7000,Null,Null,204633678,4671129,8602
204634606,485.0,485.0,21000,15750,5250,25,21000,Null,Null,204634606,541755,8305
204639536,0.0,0.0,11600000,11600000,0,0,11600000,Null,Null,204639536,162945,4428
204639630,28.0,28.0,199000,192000,7000,4,199000,Null,Null,204639630,4973949,28428
204643115,0.0,0.0,42042000,42042000,0,0,42042000,Null,Null,204643115,111461,6511
204644656,0.0,0.0,89424000,45606240,43817760,49,89424000,Null,Null,204644656,201253,2340
204644861,0.0,0.0,71760000,36597600,35162400,49,71760000,Null,Null,204644861,201253,2340
204645597,0.0,0.0,71760000,36597600,35162400,49,71760000,Null,Null,204645597,201253,2340
204650038,0.0,0.0,3390000,3390000,0,0,3390000,Null,Null,204650038,157347,2340
204650191,0.0,0.0,40020000,20410200,19609800,49,40020000,Null,Null,204650191,201253,2340
204658727,0.0,0.0,9000,9000,0,0,9000,Null,Null,204658727,111461,1601
204658816,34.0,34.0,27000,27000,0,0,27000,Null,Null,204658816,111461,53048
204659761,0.0,0.0,6500000,4317000,2183000,34,6500000,Null,Null,204659761,157347,2340
204662061,0.0,0.0,9900,9900,0,0,9900,Null,Null,204662061,5225483,8172
204662721,0.0,0.0,40020000,20410200,19609800,49,40020000,Null,Null,204662721,201253,2340
204663946,0.0,0.0,40020000,20410200,19609800,49,40020000,Null,Null,204663946,201253,2340
204666625,38.0,38.0,159000,157000,2000,1,159000,Null,Null,204666625,111461,1984
204666756,4.0,4.0,175000,175000,0,0,175000,Null,Null,204666756,111461,27546
204668345,0.0,0.0,3434000,3434000,0,0,3434000,Null,Null,204668345,7339853,8227
204669101,0.0,0.0,12500000,12500000,0,0,12500000,Null,Null,204669101,111461,8068
204671569,1.0,1.0,3290000,2681000,609000,19,3290000,Null,Null,204671569,25643,1795
204680477,43.0,43.0,9000,8550,450,5,9000,Null,Null,204680477,5132069,7064
204704369,75.0,75.0,890000,569000,321000,36,890000,Null,Null,204704369,865157,1626
204761663,0.0,0.0,0,369000,0,0,369000,Null,Null,204761663,5048343,0
204762023,0.0,0.0,3570,3570,0,0,3570,Null,Null,204762023,111461,2
204765594,71.0,71.0,300000,150000,150000,50,300000,Null,Null,204765594,181165,28574
204765815,0.0,0.0,4000,4000,0,0,4000,Null,Null,204765815,111461,1622
204767550,35.0,35.0,150000,146000,4000,3,150000,Null,Null,204767550,111839,1815
204767582,19.0,19.0,140000,140000,0,0,140000,Null,Null,204767582,111839,1815
204769743,58.0,58.0,210000,210000,0,0,210000,Null,Null,204769743,111461,23184
204788371,4.0,4.0,199000,109000,90000,45,199000,Null,Null,204788371,302375,1838
204802771,0.0,0.0,4632000,4632000,0,0,4632000,Null,Null,204802771,25643,1795
204806140,0.0,0.0,57200,28600,28600,50,57200,Null,Null,204806140,111461,15318
204806226,1.0,1.0,255000,169000,86000,34,255000,Null,Null,204806226,183257,15236
204810590,1.0,1.0,6216000,6216000,0,0,6216000,Null,Null,204810590,25643,1795
204816237,0.0,0.0,69500000,69500000,0,0,69500000,Null,Null,204816237,111461,23576
204817125,39.0,39.0,19000,19000,0,0,19000,Null,Null,204817125,111461,2
204821309,0.0,0.0,37500000,37500000,0,0,37500000,Null,Null,204821309,111461,23576
204822180,0.0,0.0,39500000,39500000,0,0,39500000,Null,Null,204822180,111461,23596
204825000,0.0,0.0,40040000,40040000,0,0,40040000,Null,Null,204825000,111461,3178
204828586,0.0,0.0,42500000,42500000,0,0,42500000,Null,Null,204828586,111461,23576
204828807,0.0,0.0,39500000,39500000,0,0,39500000,Null,Null,204828807,111461,23576
204849415,24.0,24.0,88400,73000,15400,17,88400,Null,Null,204849415,111461,2
204872160,1.0,1.0,3290000,2759000,531000,16,3290000,Null,Null,204872160,25643,1795
204872307,0.0,0.0,42328000,42328000,0,0,42328000,Null,Null,204872307,111461,6511
204877499,62.0,62.0,105000,105000,0,0,105000,Null,Null,204877499,4671129,8602
204877913,379.0,379.0,320000,168000,152000,48,320000,Null,Null,204877913,5221825,8170
204878122,0.0,0.0,7283000,7283000,0,0,7283000,Null,Null,204878122,111643,5385
204879152,4.0,4.0,1150000,1150000,0,0,1150000,Null,Null,204879152,638831,17170
204881215,0.0,0.0,2150,2150,0,0,2150,Null,Null,204881215,111461,2
204881513,1.0,1.0,140000,126000,14000,10,140000,Null,Null,204881513,111461,15250
204885170,0.0,0.0,42900000,42900000,0,0,42900000,Null,Null,204885170,111461,6511
204888071,111.0,111.0,109000,109000,0,0,109000,Null,Null,204888071,111461,5263
204895704,0.0,0.0,45188000,45188000,0,0,45188000,Null,Null,204895704,111461,3178
204897090,2.0,2.0,999000,619000,380000,38,999000,Null,Null,204897090,21282,53348
204897953,4.0,4.0,1749000,1299000,450000,26,1749000,Null,Null,204897953,21282,53348
204915457,0.0,0.0,8100000,6885000,1215000,15,8100000,Null,Null,204915457,111461,15318
204923445,1.0,1.0,9000,9000,0,0,9000,Null,Null,204923445,111461,2
204923623,7.0,7.0,2500,2500,0,0,2500,Null,Null,204923623,111461,2
204926241,0.0,0.0,1000,1000,0,0,1000,Null,Null,204926241,111461,2
204927002,0.0,0.0,6500,6500,0,0,6500,Null,Null,204927002,111461,2
204927925,0.0,0.0,16500,16500,0,0,16500,Null,Null,204927925,111461,2
204940720,0.0,0.0,45000000,45000000,0,0,45000000,Null,Null,204940720,111461,2
204954075,27.0,27.0,110000,110000,0,0,110000,Null,Null,204954075,111461,5450
204954156,32.0,32.0,440000,220000,220000,50,440000,Null,Null,204954156,7798515,1634
204957395,2.0,2.0,1140000,855000,285000,25,1140000,Null,Null,204957395,26150,8516
204961592,6.0,6.0,2000,2000,0,0,2000,Null,Null,204961592,7843315,53070
204985068,0.0,0.0,36608000,36608000,0,0,36608000,Null,Null,204985068,111461,6511
204987177,0.0,0.0,37950000,37950000,0,0,37950000,Null,Null,204987177,111461,3178
204989478,0.0,0.0,41454000,18447000,23007000,56,41454000,Null,Null,204989478,26150,8513
205001868,1.0,1.0,400000,219000,181000,45,400000,Null,Null,205001868,111461,49724
205002001,0.0,0.0,51590000,51590000,0,0,51590000,Null,Null,205002001,111461,3178
205002802,0.0,0.0,40150000,40150000,0,0,40150000,Null,Null,205002802,111461,3178
205003189,0.0,0.0,42790000,42790000,0,0,42790000,Null,Null,205003189,111461,6511
205007476,0.0,0.0,20300000,20300000,0,0,20300000,Null,Null,205007476,313739,20170
205009037,0.0,0.0,355000,355000,0,0,355000,Null,Null,205009037,111461,2
205012005,324.0,324.0,25000,14900,10100,40,25000,Null,Null,205012005,111461,8165
205012803,905.0,905.0,75000,67500,7500,10,75000,Null,Null,205012803,369051,1630
205014161,995.0,995.0,60000,54000,6000,10,60000,Null,Null,205014161,223181,1630
205014818,0.0,0.0,71295,71295,0,0,71295,Null,Null,205014818,111461,6948
205019768,46.0,46.0,160000,131000,29000,18,160000,Null,Null,205019768,111461,23184
205019897,36.0,36.0,190000,100000,90000,47,190000,Null,Null,205019897,152763,1831
205031256,0.0,0.0,45320000,45320000,0,0,45320000,Null,Null,205031256,111461,6511
205046613,0.0,0.0,52910000,52910000,0,0,52910000,Null,Null,205046613,111461,3178
205049401,0.0,0.0,41800000,41800000,0,0,41800000,Null,Null,205049401,111461,3178
205049748,0.0,0.0,8000,8000,0,0,8000,Null,Null,205049748,111461,2
205049749,0.0,0.0,8000,8000,0,0,8000,Null,Null,205049749,111461,2
205050660,0.0,0.0,9000,9000,0,0,9000,Null,Null,205050660,111461,2
205051177,26.0,26.0,152730,121000,31730,21,152730,Null,Null,205051177,111461,23184
205051212,12.0,12.0,490000,490000,0,0,490000,Null,Null,205051212,111461,1752
205052346,1378.0,1378.0,70000,70000,0,0,70000,Null,Null,205052346,50043,1631
205059588,0.0,0.0,52250000,52250000,0,0,52250000,Null,Null,205059588,111461,3178
205059817,228.0,228.0,999000,619000,380000,38,999000,Null,Null,205059817,21282,53348
205068764,0.0,0.0,2000,2000,0,0,2000,Null,Null,205068764,111461,23446
205071101,0.0,0.0,55770000,55770000,0,0,55770000,Null,Null,205071101,111461,6511
205071456,0.0,0.0,39182000,39182000,0,0,39182000,Null,Null,205071456,111461,6511
205071964,0.0,0.0,40150000,40150000,0,0,40150000,Null,Null,205071964,111461,6511
205072724,0.0,0.0,36850000,36850000,0,0,36850000,Null,Null,205072724,111461,6511
205072770,21.0,21.0,165000,165000,0,0,165000,Null,Null,205072770,111461,3990
205073212,0.0,0.0,41250000,41250000,0,0,41250000,Null,Null,205073212,111461,6511
205076690,27.0,27.0,580000,469000,111000,19,580000,Null,Null,205076690,4732457,1637
205080744,193.0,193.0,550000,495000,55000,10,550000,Null,Null,205080744,4827915,11879
205081411,0.0,0.0,26730000,26730000,0,0,26730000,Null,Null,205081411,7480987,6653
205081497,0.0,0.0,16600,8300,8300,50,16600,Null,Null,205081497,111461,15318
205101962,0.0,0.0,9000,9000,0,0,9000,Null,Null,205101962,111461,2
205113403,0.0,0.0,3490000,2850000,640000,18,3490000,Null,Null,205113403,52232,1795
205113529,0.0,0.0,2990000,2199000,791000,26,2990000,Null,Null,205113529,52232,1795
205123427,6.0,6.0,580000,580000,0,0,580000,Null,Null,205123427,4228599,53350
205124782,147.0,147.0,49000,49000,0,0,49000,Null,Null,205124782,21653,20174
205128563,5.0,5.0,650000,650000,0,0,650000,Null,Null,205128563,714023,53350
205148370,0.0,0.0,16290000,16290000,0,0,16290000,Null,Null,205148370,632211,20170
205150017,0.0,0.0,2400,2400,0,0,2400,Null,Null,205150017,111461,2
205153468,0.0,0.0,2000,2000,0,0,2000,Null,Null,205153468,111461,2
205161232,3.0,3.0,3490000,2390000,1100000,32,3490000,Null,Null,205161232,247549,1795
205162131,44.0,44.0,285000,185000,100000,35,285000,Null,Null,205162131,205035,17162
205162610,23.0,23.0,280000,235000,45000,16,280000,Null,Null,205162610,200189,11867
205173044,0.0,0.0,57772000,57772000,0,0,57772000,Null,Null,205173044,111461,3178
205177693,0.0,0.0,58058000,58058000,0,0,58058000,Null,Null,205177693,111461,3178
205194870,22.0,22.0,110000,110000,0,0,110000,Null,Null,205194870,111461,1634
205195382,0.0,0.0,1300,1300,0,0,1300,Null,Null,205195382,111461,2
205197486,4.0,4.0,99000,99000,0,0,99000,Null,Null,205197486,111461,28576
205204415,0.0,0.0,6000,6000,0,0,6000,Null,Null,205204415,111461,2
205204895,0.0,0.0,9500,9500,0,0,9500,Null,Null,205204895,111461,2
205223132,4.0,4.0,529000,529000,0,0,529000,Null,Null,205223132,21651,28688
205225273,0.0,0.0,49478000,49478000,0,0,49478000,Null,Null,205225273,111461,6511
205226074,0.0,0.0,38038000,38038000,0,0,38038000,Null,Null,205226074,111461,6511
205226737,5.0,5.0,59000,59000,0,0,59000,Null,Null,205226737,21651,5006
205229152,0.0,0.0,49478000,49478000,0,0,49478000,Null,Null,205229152,111461,3178
205229652,0.0,0.0,39754000,39754000,0,0,39754000,Null,Null,205229652,111461,3178
205234282,0.0,0.0,48334000,48334000,0,0,48334000,Null,Null,205234282,111461,6511
205234366,13.0,13.0,129000,129000,0,0,129000,Null,Null,205234366,21651,12908
205236408,0.0,0.0,39050000,39050000,0,0,39050000,Null,Null,205236408,111461,6511
205239306,0.0,0.0,50336000,50336000,0,0,50336000,Null,Null,205239306,111461,3178
205243713,0.0,0.0,48334000,48334000,0,0,48334000,Null,Null,205243713,111461,6511
205257043,0.0,0.0,5999,5999,0,0,5999,Null,Null,205257043,111461,28676
205257050,0.0,0.0,37950000,37950000,0,0,37950000,Null,Null,205257050,111461,6511
205257296,0.0,0.0,46750000,46750000,0,0,46750000,Null,Null,205257296,111461,6511
205257848,2.0,2.0,320000,169000,151000,47,320000,Null,Null,205257848,111461,49724
205259355,0.0,0.0,52910000,52910000,0,0,52910000,Null,Null,205259355,111461,3178
205262767,0.0,0.0,46332000,46332000,0,0,46332000,Null,Null,205262767,111461,3178
205272376,0.0,0.0,2000,2000,0,0,2000,Null,Null,205272376,111461,2
205285857,0.0,0.0,1000,1000,0,0,1000,Null,Null,205285857,111461,2
205286070,0.0,0.0,36000,18000,18000,50,36000,Null,Null,205286070,111461,15318
205290105,68.0,68.0,175000,175000,0,0,175000,Null,Null,205290105,111459,7078
205291529,19.0,19.0,200000,200000,0,0,200000,Null,Null,205291529,7882195,1838
205299729,28.0,28.0,780000,390000,390000,50,780000,Null,Null,205299729,7917161,10228
205300177,0.0,0.0,1000,1000,0,0,1000,Null,Null,205300177,111461,28472
205300195,0.0,0.0,1000,1000,0,0,1000,Null,Null,205300195,111461,23244
205305888,0.0,0.0,55484000,55484000,0,0,55484000,Null,Null,205305888,111461,6511
205306315,0.0,0.0,51480000,51480000,0,0,51480000,Null,Null,205306315,111461,6511
205306520,0.0,0.0,68068000,68068000,0,0,68068000,Null,Null,205306520,111461,3178
205311927,0.0,0.0,46090000,46090000,0,0,46090000,Null,Null,205311927,111461,3178
205313522,0.0,0.0,12400000,12400000,0,0,12400000,Null,Null,205313522,313739,20170
205319039,0.0,0.0,9000,9000,0,0,9000,Null,Null,205319039,111461,28472
205323355,8.0,8.0,44000,40000,4000,9,44000,Null,Null,205323355,7401397,3805
205335963,0.0,0.0,49000000,49000000,0,0,49000000,Null,Null,205335963,850093,53074
205342365,0.0,0.0,64922000,64922000,0,0,64922000,Null,Null,205342365,111461,6511
205354871,0.0,0.0,47762000,47762000,0,0,47762000,Null,Null,205354871,111461,6511
205355239,34.0,34.0,999000,649000,350000,35,999000,Null,Null,205355239,20271,9013
205374128,0.0,0.0,71500000,71500000,0,0,71500000,Null,Null,205374128,111461,6511
205375585,0.0,0.0,48290000,48290000,0,0,48290000,Null,Null,205375585,111461,6511
205379544,0.0,0.0,56342000,56342000,0,0,56342000,Null,Null,205379544,111461,3178
205387516,0.0,0.0,36400000,36400000,0,0,36400000,Null,Null,205387516,111461,3178
205391437,0.0,0.0,8000,8000,0,0,8000,Null,Null,205391437,111461,8073
205412234,0.0,0.0,3200000,3200000,0,0,3200000,Null,Null,205412234,50937,15250
205412328,8.0,8.0,55000,55000,0,0,55000,Null,Null,205412328,111461,28472
205413852,69.0,69.0,7000,7000,0,0,7000,Null,Null,205413852,246767,11858
205417561,0.0,0.0,10359000,10359000,0,0,10359000,Null,Null,205417561,111461,2340
205420751,0.0,0.0,9000,9000,0,0,9000,Null,Null,205420751,111461,2
205420783,0.0,0.0,8000,8000,0,0,8000,Null,Null,205420783,111461,2
205420869,0.0,0.0,5000,5000,0,0,5000,Null,Null,205420869,111461,2
205420907,0.0,0.0,9000,9000,0,0,9000,Null,Null,205420907,111461,2
205420938,0.0,0.0,8000,8000,0,0,8000,Null,Null,205420938,111461,2
205420962,0.0,0.0,6000,6000,0,0,6000,Null,Null,205420962,111461,2
205420982,0.0,0.0,5000,5000,0,0,5000,Null,Null,205420982,111461,2
205421011,0.0,0.0,8500,8500,0,0,8500,Null,Null,205421011,111461,2
205421036,0.0,0.0,5000,5000,0,0,5000,Null,Null,205421036,111461,2
205421058,1.0,1.0,5000,5000,0,0,5000,Null,Null,205421058,111461,2
205421062,0.0,0.0,8000,8000,0,0,8000,Null,Null,205421062,111461,2
205421079,0.0,0.0,8000,8000,0,0,8000,Null,Null,205421079,111461,2
205421102,0.0,0.0,6000,6000,0,0,6000,Null,Null,205421102,111461,2
205421138,0.0,0.0,6000,6000,0,0,6000,Null,Null,205421138,111461,2
205421160,0.0,0.0,8000,8000,0,0,8000,Null,Null,205421160,111461,2
205421169,0.0,0.0,8000,8000,0,0,8000,Null,Null,205421169,111461,2
205421226,0.0,0.0,8000,8000,0,0,8000,Null,Null,205421226,111461,2
205421250,0.0,0.0,5000,5000,0,0,5000,Null,Null,205421250,111461,2
205421258,0.0,0.0,4000,4000,0,0,4000,Null,Null,205421258,111461,2
205421260,0.0,0.0,6000,6000,0,0,6000,Null,Null,205421260,111461,2
205421340,1.0,1.0,5000,5000,0,0,5000,Null,Null,205421340,111461,2
205421347,5.0,5.0,6000,6000,0,0,6000,Null,Null,205421347,111461,2
205421354,0.0,0.0,5000,5000,0,0,5000,Null,Null,205421354,111461,2
205421367,0.0,0.0,4000,4000,0,0,4000,Null,Null,205421367,111461,2
205421378,0.0,0.0,8000,8000,0,0,8000,Null,Null,205421378,111461,2
205421383,3.0,3.0,4000,4000,0,0,4000,Null,Null,205421383,111461,2
205421428,0.0,0.0,6000,6000,0,0,6000,Null,Null,205421428,111461,2
205421494,0.0,0.0,3000,3000,0,0,3000,Null,Null,205421494,111461,2
205421501,0.0,0.0,6000,6000,0,0,6000,Null,Null,205421501,111461,2
205421523,0.0,0.0,6000,6000,0,0,6000,Null,Null,205421523,111461,2
205421525,0.0,0.0,7000,7000,0,0,7000,Null,Null,205421525,111461,2
205421552,0.0,0.0,8000,8000,0,0,8000,Null,Null,205421552,111461,2
205421556,20.0,20.0,4000,4000,0,0,4000,Null,Null,205421556,111461,2
205421634,0.0,0.0,8000,8000,0,0,8000,Null,Null,205421634,111461,2
205421641,0.0,0.0,5000,5000,0,0,5000,Null,Null,205421641,111461,2
205421673,0.0,0.0,8000,8000,0,0,8000,Null,Null,205421673,111461,2
205421852,0.0,0.0,6000,6000,0,0,6000,Null,Null,205421852,111461,2
205421902,0.0,0.0,6000,6000,0,0,6000,Null,Null,205421902,111461,2
205421914,0.0,0.0,6000,6000,0,0,6000,Null,Null,205421914,111461,2
205421970,0.0,0.0,3000,3000,0,0,3000,Null,Null,205421970,111461,2
205421984,0.0,0.0,8000,8000,0,0,8000,Null,Null,205421984,111461,2
205422049,0.0,0.0,6000,6000,0,0,6000,Null,Null,205422049,111461,2
205422061,15.0,15.0,3000,3000,0,0,3000,Null,Null,205422061,111461,2
205422065,0.0,0.0,6000,6000,0,0,6000,Null,Null,205422065,111461,2
205422093,0.0,0.0,8500,8500,0,0,8500,Null,Null,205422093,111461,2
205422109,0.0,0.0,6000,6000,0,0,6000,Null,Null,205422109,111461,2
205422117,0.0,0.0,5000,5000,0,0,5000,Null,Null,205422117,111461,2
205422138,0.0,0.0,8000,8000,0,0,8000,Null,Null,205422138,111461,2
205422202,0.0,0.0,6000,6000,0,0,6000,Null,Null,205422202,111461,2
205422255,0.0,0.0,5000,5000,0,0,5000,Null,Null,205422255,111461,2
205422261,10.0,10.0,8000,8000,0,0,8000,Null,Null,205422261,111461,2
205422299,0.0,0.0,8000,8000,0,0,8000,Null,Null,205422299,111461,2
205422302,0.0,0.0,2000,2000,0,0,2000,Null,Null,205422302,111461,2
205422327,0.0,0.0,6000,6000,0,0,6000,Null,Null,205422327,111461,2
205422362,0.0,0.0,8000,8000,0,0,8000,Null,Null,205422362,111461,2
205422386,0.0,0.0,8000,8000,0,0,8000,Null,Null,205422386,111461,2
205422399,0.0,0.0,8000,8000,0,0,8000,Null,Null,205422399,111461,2
205422430,0.0,0.0,5000,5000,0,0,5000,Null,Null,205422430,111461,2
205422490,0.0,0.0,8000,8000,0,0,8000,Null,Null,205422490,111461,2
205422521,0.0,0.0,6000,6000,0,0,6000,Null,Null,205422521,111461,2
205422547,0.0,0.0,6000,6000,0,0,6000,Null,Null,205422547,111461,2
205422552,0.0,0.0,8000,8000,0,0,8000,Null,Null,205422552,111461,2
205422555,0.0,0.0,3000,3000,0,0,3000,Null,Null,205422555,111461,2
205422578,0.0,0.0,8000,8000,0,0,8000,Null,Null,205422578,111461,2
205422606,0.0,0.0,5000,5000,0,0,5000,Null,Null,205422606,111461,2
205422707,0.0,0.0,5000,5000,0,0,5000,Null,Null,205422707,111461,2
205474841,11.0,11.0,9000,9000,0,0,9000,Null,Null,205474841,111461,2
205492640,93.0,93.0,260000,175000,85000,33,260000,Null,Null,205492640,111461,2
205500678,27.0,27.0,149000,79000,70000,47,149000,Null,Null,205500678,111461,1634
205505987,10.0,10.0,460000,460000,0,0,460000,Null,Null,205505987,469547,15236
205506042,8.0,8.0,590000,590000,0,0,590000,Null,Null,205506042,469547,15236
205506088,1.0,1.0,780000,780000,0,0,780000,Null,Null,205506088,469547,15236
205506815,16.0,16.0,480000,480000,0,0,480000,Null,Null,205506815,469547,15250
205508194,1.0,1.0,350000,189000,161000,46,350000,Null,Null,205508194,111461,49724
205508242,0.0,0.0,115000,115000,0,0,115000,Null,Null,205508242,111461,49724
205509902,0.0,0.0,8900,8900,0,0,8900,Null,Null,205509902,7980887,8305
205510528,0.0,0.0,1500,1500,0,0,1500,Null,Null,205510528,111461,2
205514181,0.0,0.0,9000,9000,0,0,9000,Null,Null,205514181,111461,2
205514541,4.0,4.0,9000,9000,0,0,9000,Null,Null,205514541,111461,2
205518952,0.0,0.0,6690000,4879000,1811000,27,6690000,Null,Null,205518952,18802,1795
205541965,2.0,2.0,5800000,4350000,1450000,25,5800000,Null,Null,205541965,416127,8227
205544066,30.0,30.0,4790000,2999000,1791000,37,4790000,Null,Null,205544066,25422,1795
205550381,3.0,3.0,80000,80000,0,0,80000,Null,Null,205550381,4647777,15250
205551198,3.0,3.0,10000,5000,5000,50,10000,Null,Null,205551198,154009,11937
205574168,523.0,523.0,127350,120000,7350,6,127350,Null,Null,205574168,21274,4413
205574170,577.0,577.0,127350,120000,7350,6,127350,Null,Null,205574170,21274,4413
205576508,9.0,9.0,27900,27900,0,0,27900,Null,Null,205576508,111461,2
205582269,95.0,95.0,1500,1500,0,0,1500,Null,Null,205582269,111461,27214
205583402,0.0,0.0,9000,9000,0,0,9000,Null,Null,205583402,111461,2
205584164,0.0,0.0,13400000,10050000,3350000,25,13400000,Null,Null,205584164,26150,8513
205587578,12.0,12.0,400000,400000,0,0,400000,Null,Null,205587578,143353,20244
205599946,25.0,25.0,549000,549000,0,0,549000,Null,Null,205599946,18984,1831
205602058,2.0,2.0,622000,485160,136840,22,622000,Null,Null,205602058,26150,8516
205608871,3.0,3.0,1607000,1607000,0,0,1607000,Null,Null,205608871,26150,8511
205609015,0.0,0.0,5000,5000,0,0,5000,Null,Null,205609015,111461,2
205609054,0.0,0.0,6000,6000,0,0,6000,Null,Null,205609054,111461,2
205609091,0.0,0.0,17000,17000,0,0,17000,Null,Null,205609091,111461,2
205609113,0.0,0.0,3000,3000,0,0,3000,Null,Null,205609113,111461,2
205609131,0.0,0.0,1500,1500,0,0,1500,Null,Null,205609131,111461,2
205609233,0.0,0.0,7000,7000,0,0,7000,Null,Null,205609233,111461,2
205609249,0.0,0.0,1200,1200,0,0,1200,Null,Null,205609249,111461,2
205609305,0.0,0.0,3000,3000,0,0,3000,Null,Null,205609305,111461,2
205609329,0.0,0.0,5000,5000,0,0,5000,Null,Null,205609329,111461,2
205609374,0.0,0.0,1000,1000,0,0,1000,Null,Null,205609374,111461,2
205609468,0.0,0.0,6000,6000,0,0,6000,Null,Null,205609468,111461,2
205609485,0.0,0.0,8000,8000,0,0,8000,Null,Null,205609485,111461,2
205609495,0.0,0.0,8000,8000,0,0,8000,Null,Null,205609495,111461,2
205609516,0.0,0.0,2500,2500,0,0,2500,Null,Null,205609516,111461,2
205610774,0.0,0.0,11900000,11900000,0,0,11900000,Null,Null,205610774,847679,12890
205614564,0.0,0.0,2000,2000,0,0,2000,Null,Null,205614564,111461,27214
205620995,81.0,81.0,369000,248000,121000,33,369000,Null,Null,205620995,5048343,4593
205622318,17.0,17.0,65000,65000,0,0,65000,Null,Null,205622318,111461,28428
205644502,0.0,0.0,5000,5000,0,0,5000,Null,Null,205644502,3989637,8172
205644505,0.0,0.0,4000,4000,0,0,4000,Null,Null,205644505,3989637,8172
205644536,0.0,0.0,3500,3500,0,0,3500,Null,Null,205644536,3989637,8172
205644646,0.0,0.0,5000,5000,0,0,5000,Null,Null,205644646,3989637,8172
205644691,0.0,0.0,39540000,39540000,0,0,39540000,Null,Null,205644691,600319,27196
205644773,0.0,0.0,4500,4500,0,0,4500,Null,Null,205644773,3989637,8172
205644933,0.0,0.0,40018000,40018000,0,0,40018000,Null,Null,205644933,600319,27196
205673214,0.0,0.0,7800000,7800000,0,0,7800000,Null,Null,205673214,111461,1634
205673393,0.0,0.0,6800000,6800000,0,0,6800000,Null,Null,205673393,111461,1634
205673512,3.0,3.0,3680000,3680000,0,0,3680000,Null,Null,205673512,111461,1634
205674589,0.0,0.0,7400000,7400000,0,0,7400000,Null,Null,205674589,111461,1634
205674818,0.0,0.0,8900000,8900000,0,0,8900000,Null,Null,205674818,111461,1634
205684105,0.0,0.0,8590000,8590000,0,0,8590000,Null,Null,205684105,111461,1634
205684265,0.0,0.0,9900000,9900000,0,0,9900000,Null,Null,205684265,111461,1634
205684499,50.0,50.0,2250000,1500000,750000,33,2250000,Null,Null,205684499,7881679,23576
205684536,0.0,0.0,10485000,10485000,0,0,10485000,Null,Null,205684536,25502,5385
205684867,41.0,41.0,95000,89000,6000,6,95000,Null,Null,205684867,111461,5454
205684919,0.0,0.0,8485000,8485000,0,0,8485000,Null,Null,205684919,25502,5385
205685188,0.0,0.0,11539000,11539000,0,0,11539000,Null,Null,205685188,24876,28454
205685290,0.0,0.0,8690000,8690000,0,0,8690000,Null,Null,205685290,111461,1634
205685296,53.0,53.0,279000,273000,6000,2,279000,Null,Null,205685296,4973949,20244
205685397,0.0,0.0,8300000,8300000,0,0,8300000,Null,Null,205685397,111461,1634
205685411,0.0,0.0,6800000,6800000,0,0,6800000,Null,Null,205685411,111461,1634
205689029,0.0,0.0,48001000,48001000,0,0,48001000,Null,Null,205689029,111461,2
205689082,0.0,0.0,2000,2000,0,0,2000,Null,Null,205689082,111461,2
205689146,0.0,0.0,1000,1000,0,0,1000,Null,Null,205689146,111461,2
205689197,0.0,0.0,42751000,42751000,0,0,42751000,Null,Null,205689197,111461,2
205689309,0.0,0.0,2500,2500,0,0,2500,Null,Null,205689309,111461,2
205689610,0.0,0.0,40001000,40001000,0,0,40001000,Null,Null,205689610,111461,2
205689810,0.0,0.0,2000,2000,0,0,2000,Null,Null,205689810,111461,2
205690642,0.0,0.0,9289000,9289000,0,0,9289000,Null,Null,205690642,111461,8165
205690661,0.0,0.0,5999000,5999000,0,0,5999000,Null,Null,205690661,111461,8165
205691354,2.0,2.0,3690000,3690000,0,0,3690000,Null,Null,205691354,111461,1634
205691803,3.0,3.0,250000,179000,71000,28,250000,Null,Null,205691803,183257,15236
205691882,0.0,0.0,28990000,23500000,5490000,19,28990000,Null,Null,205691882,144538,2324
205692248,0.0,0.0,2500,2500,0,0,2500,Null,Null,205692248,111461,3179
205695128,71.0,71.0,99000,99000,0,0,99000,Null,Null,205695128,7401397,3805
205696307,37.0,37.0,249000,249000,0,0,249000,Null,Null,205696307,5738319,20244
205702135,7.0,7.0,150000,150000,0,0,150000,Null,Null,205702135,111461,49722
205704686,71.0,71.0,3750,3750,0,0,3750,Null,Null,205704686,549763,5267
205717910,47.0,47.0,68001,68001,0,0,68001,Null,Null,205717910,2630119,28430
205726536,60.0,60.0,1790000,1650000,140000,8,1790000,Null,Null,205726536,19673,1795
205728226,0.0,0.0,7394600,7394600,0,0,7394600,Null,Null,205728226,7873343,15236
205728714,0.0,0.0,6533333,6533333,0,0,6533333,Null,Null,205728714,7873343,15236
205729569,0.0,0.0,8669677,8669677,0,0,8669677,Null,Null,205729569,7873343,15320
205729628,2.0,2.0,78000,78000,0,0,78000,Null,Null,205729628,111461,15320
205729718,6.0,6.0,13990000,13990000,0,0,13990000,Null,Null,205729718,233903,1795
205738647,0.0,0.0,46000,46000,0,0,46000,Null,Null,205738647,111461,8167
205750556,0.0,0.0,4632000,4632000,0,0,4632000,Null,Null,205750556,25643,1795
205752358,127.0,127.0,200000,95000,105000,53,200000,Null,Null,205752358,500047,4428
205757027,180.0,180.0,49000,49000,0,0,49000,Null,Null,205757027,111461,28484
205757174,0.0,0.0,26990000,23990000,3000000,11,26990000,Null,Null,205757174,5232357,2324
205759048,2.0,2.0,1600,1600,0,0,1600,Null,Null,205759048,111461,23592
205759089,0.0,0.0,13600000,6800000,6800000,50,13600000,Null,Null,205759089,111461,15318
205767964,0.0,0.0,6215914,6215914,0,0,6215914,Null,Null,205767964,7873343,15320
205773094,25.0,25.0,19900000,18490000,1410000,7,19900000,Null,Null,205773094,18641,28392
205792611,2.0,2.0,336400,150000,186400,55,336400,Null,Null,205792611,111461,15318
205800826,0.0,0.0,14285000,14285000,0,0,14285000,Null,Null,205800826,25502,8511
205808132,114.0,114.0,195000,187000,8000,4,195000,Null,Null,205808132,111461,3177
205811873,331.0,331.0,180000,180000,0,0,180000,Null,Null,205811873,184299,1630
205814940,0.0,0.0,43000000,43000000,0,0,43000000,Null,Null,205814940,931671,27128
205815576,141.0,141.0,12990000,11010000,1980000,15,12990000,Null,Null,205815576,17827,1794
205815593,227.0,227.0,23990000,20530000,3460000,14,23990000,Null,Null,205815593,17827,1794
205815614,0.0,0.0,0,14990000,0,0,14990000,Null,Null,205815614,17827,0
205817099,0.0,0.0,12960000,6480000,6480000,50,12960000,Null,Null,205817099,111461,15318
205821019,5.0,5.0,209000,209000,0,0,209000,Null,Null,205821019,111461,2324
205822992,29.0,29.0,55000,55000,0,0,55000,Null,Null,205822992,248385,11735
205823151,49.0,49.0,129000,119000,10000,8,129000,Null,Null,205823151,3985581,23022
205828446,40.0,40.0,129000,129000,0,0,129000,Null,Null,205828446,21653,12908
205829858,8.0,8.0,10000,10000,0,0,10000,Null,Null,205829858,111461,20174
205846229,0.0,0.0,4632000,4632000,0,0,4632000,Null,Null,205846229,25643,1795
205851107,0.0,0.0,1000,1000,0,0,1000,Null,Null,205851107,111461,23592
205854537,0.0,0.0,2500,2500,0,0,2500,Null,Null,205854537,111461,2
205855820,1.0,1.0,54150,54150,0,0,54150,Null,Null,205855820,111461,15320
205856283,99.0,99.0,650000,650000,0,0,650000,Null,Null,205856283,932151,23346
205863672,0.0,0.0,4680000,4680000,0,0,4680000,Null,Null,205863672,7835789,8165
205883591,0.0,0.0,4190000,4190000,0,0,4190000,Null,Null,205883591,7846077,2
205884414,0.0,0.0,1530000,1530000,0,0,1530000,Null,Null,205884414,26150,8512
205885163,207.0,207.0,125000,110000,15000,12,125000,Null,Null,205885163,837721,1883
205894291,94.0,94.0,29000,27550,1450,5,29000,Null,Null,205894291,839837,23052
205895170,87.0,87.0,30000,28500,1500,5,30000,Null,Null,205895170,839837,2363
205897182,0.0,0.0,6290000,5339000,951000,15,6290000,Null,Null,205897182,25422,1794
205899050,0.0,0.0,6564000,5907600,656400,10,6564000,Null,Null,205899050,26150,5385
205905589,102.0,102.0,55000,49500,5500,10,55000,Null,Null,205905589,839837,23220
205915161,0.0,0.0,6564000,5907600,656400,10,6564000,Null,Null,205915161,26150,5385
205920877,501.0,501.0,23000,23000,0,0,23000,Null,Null,205920877,5706641,53074
205926324,72.0,72.0,59000,59000,0,0,59000,Null,Null,205926324,21653,28484
205941664,85.0,85.0,25000,23750,1250,5,25000,Null,Null,205941664,839837,2363
205943372,14.0,14.0,110000,110000,0,0,110000,Null,Null,205943372,111461,5531
205949473,0.0,0.0,5900000,5600000,300000,5,5900000,Null,Null,205949473,46007,17170
205955343,1.0,1.0,250000,250000,0,0,250000,Null,Null,205955343,111461,2018
205957842,0.0,0.0,16000,16000,0,0,16000,Null,Null,205957842,111461,2
205960637,0.0,0.0,2300,2300,0,0,2300,Null,Null,205960637,111461,2
205960718,0.0,0.0,2400,2400,0,0,2400,Null,Null,205960718,111461,2
205963271,0.0,0.0,1000,1000,0,0,1000,Null,Null,205963271,111461,18888
205985267,198.0,198.0,420000,320000,100000,24,420000,Null,Null,205985267,4275489,1520
205985398,130.0,130.0,5100000,3800000,1300000,25,5100000,Null,Null,205985398,7322743,4381
205985407,29.0,29.0,1500000,1300000,200000,13,1500000,Null,Null,205985407,50629,28454
205985416,84.0,84.0,1600000,1180000,420000,26,1600000,Null,Null,205985416,50629,28454
205985422,36.0,36.0,1000000,800000,200000,20,1000000,Null,Null,205985422,50629,28454
205985873,2.0,2.0,502000,502000,0,0,502000,Null,Null,205985873,111461,5267
205989564,0.0,0.0,4300000,4085000,215000,5,4300000,Null,Null,205989564,46007,17170
205989846,107.0,107.0,190000,177000,13000,7,190000,Null,Null,205989846,22013,2347
205989847,115.0,115.0,190000,177000,13000,7,190000,Null,Null,205989847,22013,17170
205989850,1062.0,1062.0,75000,68000,7000,9,75000,Null,Null,205989850,22013,1583
205996231,11.0,11.0,226000,226000,0,0,226000,Null,Null,205996231,7917221,11747
206069076,648.0,648.0,250000,89000,161000,64,250000,Null,Null,206069076,7896671,1609
206082356,0.0,0.0,6170000,6170000,0,0,6170000,Null,Null,206082356,111461,1634
206082604,0.0,0.0,5600000,5600000,0,0,5600000,Null,Null,206082604,111461,1634
206086496,0.0,0.0,10000,10000,0,0,10000,Null,Null,206086496,111461,8193
206103259,0.0,0.0,13500000,13500000,0,0,13500000,Null,Null,206103259,749425,28870
206112554,43.0,43.0,600000,302000,298000,50,600000,Null,Null,206112554,111461,8165
206117893,1.0,1.0,2500,2500,0,0,2500,Null,Null,206117893,111461,2
206117988,0.0,0.0,7000,7000,0,0,7000,Null,Null,206117988,111461,2
206123256,72.0,72.0,1398000,699000,699000,50,1398000,Null,Null,206123256,260983,8512
206123811,88.0,88.0,2780000,1390000,1390000,50,2780000,Null,Null,206123811,260983,8512
206134133,9.0,9.0,492000,393600,98400,20,492000,Null,Null,206134133,26150,8513
206135073,0.0,0.0,6700000,6700000,0,0,6700000,Null,Null,206135073,258977,8227
206141225,0.0,0.0,9000,9000,0,0,9000,Null,Null,206141225,111461,2
206141230,2.0,2.0,19000,19000,0,0,19000,Null,Null,206141230,111461,2
206141267,0.0,0.0,15000,15000,0,0,15000,Null,Null,206141267,111461,2
206147612,0.0,0.0,3900000,3900000,0,0,3900000,Null,Null,206147612,111461,8167
206157458,15.0,15.0,45000,45000,0,0,45000,Null,Null,206157458,111461,28428
206164593,29.0,29.0,705000,688000,17000,2,705000,Null,Null,206164593,111461,5267
206202845,355.0,355.0,25000,24750,250,1,25000,Null,Null,206202845,5382095,2
206205776,0.0,0.0,21300000,21300000,0,0,21300000,Null,Null,206205776,153444,5566
206205778,0.0,0.0,13194500,12000000,1194500,9,13194500,Null,Null,206205778,5347313,11516
206205826,0.0,0.0,20500000,20500000,0,0,20500000,Null,Null,206205826,153444,4428
206229073,1.0,1.0,7500,7500,0,0,7500,Null,Null,206229073,111461,2
206229418,0.0,0.0,15000,15000,0,0,15000,Null,Null,206229418,111461,15318
206229642,0.0,0.0,15000,15000,0,0,15000,Null,Null,206229642,111461,15318
206231163,293.0,293.0,500000,332000,168000,34,500000,Null,Null,206231163,500047,5531
206234195,2.0,2.0,28000,19600,8400,30,28000,Null,Null,206234195,111461,28574
206235415,0.0,0.0,3500000,3500000,0,0,3500000,Null,Null,206235415,27398,2
206237925,0.0,0.0,4008000,4008000,0,0,4008000,Null,Null,206237925,25643,1795
206241606,37.0,37.0,27900,27900,0,0,27900,Null,Null,206241606,5326489,5007
206248133,0.0,0.0,1639,1639,0,0,1639,Null,Null,206248133,111461,2
206249641,9.0,9.0,360000,360000,0,0,360000,Null,Null,206249641,469547,15318
206250982,0.0,0.0,200000,200000,0,0,200000,Null,Null,206250982,111461,15250
206252119,0.0,0.0,1000,1000,0,0,1000,Null,Null,206252119,111461,18888
206254285,41.0,41.0,600000,350000,250000,42,600000,Null,Null,206254285,500047,5531
206255526,1.0,1.0,590000,299000,291000,49,590000,Null,Null,206255526,4647777,15318
206265193,13.0,13.0,600000,350000,250000,42,600000,Null,Null,206265193,500047,5531
206265377,2.0,2.0,39000,24000,15000,38,39000,Null,Null,206265377,111461,15250
206266326,5.0,5.0,48000,38300,9700,20,48000,Null,Null,206266326,111461,15320
206269799,3.0,3.0,36000,31100,4900,14,36000,Null,Null,206269799,111461,15318
206270584,0.0,0.0,2000,2000,0,0,2000,Null,Null,206270584,111461,11939
206270639,0.0,0.0,1800,1800,0,0,1800,Null,Null,206270639,111461,23588
206270728,0.0,0.0,8800,8800,0,0,8800,Null,Null,206270728,470537,1623
206284529,0.0,0.0,1400,1400,0,0,1400,Null,Null,206284529,111461,27212
206289419,0.0,0.0,31880000,31880000,0,0,31880000,Null,Null,206289419,7982659,7449
206290837,0.0,0.0,1999,1999,0,0,1999,Null,Null,206290837,111461,2
206291077,3.0,3.0,3900,3900,0,0,3900,Null,Null,206291077,111461,2
206291134,6.0,6.0,5900,5900,0,0,5900,Null,Null,206291134,111461,2
206291319,0.0,0.0,3900,3900,0,0,3900,Null,Null,206291319,111461,2
206291418,3.0,3.0,5900,5900,0,0,5900,Null,Null,206291418,111461,2
206294378,0.0,0.0,6980000,6980000,0,0,6980000,Null,Null,206294378,405211,8512
206296456,33.0,33.0,1610000,1139000,471000,29,1610000,Null,Null,206296456,25697,28452
206305041,0.0,0.0,1899,1899,0,0,1899,Null,Null,206305041,111461,2
206305150,0.0,0.0,1100,1100,0,0,1100,Null,Null,206305150,111461,2
206306378,0.0,0.0,4600,4600,0,0,4600,Null,Null,206306378,111461,2
206306814,0.0,0.0,1199,1199,0,0,1199,Null,Null,206306814,111461,2
206307062,2.0,2.0,1290,1290,0,0,1290,Null,Null,206307062,111461,2
206310889,10.0,10.0,1417000,999000,418000,29,1417000,Null,Null,206310889,243693,4593
206316845,0.0,0.0,8014194,8014194,0,0,8014194,Null,Null,206316845,7873343,15320
206319625,0.0,0.0,13050000,13050000,0,0,13050000,Null,Null,206319625,26065,28876
206319832,0.0,0.0,8500000,7225000,1275000,15,8500000,Null,Null,206319832,5382095,2
206319839,0.0,0.0,6650000,6317500,332500,5,6650000,Null,Null,206319839,5382095,2
206319854,0.0,0.0,3800000,3610000,190000,5,3800000,Null,Null,206319854,5382095,2
206319885,0.0,0.0,5900000,4690000,1210000,21,5900000,Null,Null,206319885,5382095,2
206319908,0.0,0.0,8200000,7790000,410000,5,8200000,Null,Null,206319908,5382095,2
206319989,0.0,0.0,11500000,10925000,575000,5,11500000,Null,Null,206319989,5382095,2
206320108,0.0,0.0,9200000,7190000,2010000,22,9200000,Null,Null,206320108,5382095,2
206320203,0.0,0.0,5680000,4749000,931000,16,5680000,Null,Null,206320203,5382095,2
206320217,0.0,0.0,9500000,7190000,2310000,24,9500000,Null,Null,206320217,5382095,2
206320493,0.0,0.0,13100000,13100000,0,0,13100000,Null,Null,206320493,26065,28876
206320512,0.0,0.0,12490000,12490000,0,0,12490000,Null,Null,206320512,114527,2657
206320514,0.0,0.0,22490000,22490000,0,0,22490000,Null,Null,206320514,114527,2657
206320516,0.0,0.0,12490000,12490000,0,0,12490000,Null,Null,206320516,114527,2657
206320849,0.0,0.0,3940000,3940000,0,0,3940000,Null,Null,206320849,5382095,2
206321149,18.0,18.0,2499,2499,0,0,2499,Null,Null,206321149,111461,53074
206321476,0.0,0.0,13200000,13200000,0,0,13200000,Null,Null,206321476,26065,1803
206325700,0.0,0.0,1200,1200,0,0,1200,Null,Null,206325700,111461,2
206330391,0.0,0.0,1000,1000,0,0,1000,Null,Null,206330391,111461,2
206330414,0.0,0.0,2000,2000,0,0,2000,Null,Null,206330414,111461,2
206340567,46.0,46.0,500000,276000,224000,45,500000,Null,Null,206340567,500047,5531
206377156,198.0,198.0,270000,215000,55000,20,270000,Null,Null,206377156,198555,1613
206378109,402.0,402.0,235000,187000,48000,20,235000,Null,Null,206378109,198555,1613
206451886,0.0,0.0,3850,3850,0,0,3850,Null,Null,206451886,111461,2
206454066,2.0,2.0,9000,9000,0,0,9000,Null,Null,206454066,111461,2
206455758,0.0,0.0,10000,10000,0,0,10000,Null,Null,206455758,111461,2
206457173,0.0,0.0,6000,6000,0,0,6000,Null,Null,206457173,111461,2
206458069,0.0,0.0,9000,9000,0,0,9000,Null,Null,206458069,111461,2
206459166,0.0,0.0,10000,10000,0,0,10000,Null,Null,206459166,111461,2
206459256,0.0,0.0,4800,4800,0,0,4800,Null,Null,206459256,111461,2
206459625,0.0,0.0,7200,7200,0,0,7200,Null,Null,206459625,111461,2
206459649,0.0,0.0,7000,7000,0,0,7000,Null,Null,206459649,111461,2
206460258,0.0,0.0,7500,7500,0,0,7500,Null,Null,206460258,111461,2
206461393,0.0,0.0,5600,5600,0,0,5600,Null,Null,206461393,111461,2
206463501,0.0,0.0,5250,5250,0,0,5250,Null,Null,206463501,111461,2
206463701,0.0,0.0,10000,10000,0,0,10000,Null,Null,206463701,111461,2
206469511,0.0,0.0,7000,7000,0,0,7000,Null,Null,206469511,111461,2
206473614,319.0,319.0,135000,75000,60000,44,135000,Null,Null,206473614,46703,23622
206473652,0.0,0.0,6000,6000,0,0,6000,Null,Null,206473652,111461,2
206481184,0.0,0.0,19416000,17700000,1716000,9,19416000,Null,Null,206481184,18802,1794
206485076,1288.0,1288.0,55000,37000,18000,33,55000,Null,Null,206485076,7486975,1883
206485207,211.0,211.0,100000,99000,1000,1,100000,Null,Null,206485207,4524605,10228
206485250,225.0,225.0,360000,360000,0,0,360000,Null,Null,206485250,5173455,11935
206485286,366.0,366.0,63000,35000,28000,44,63000,Null,Null,206485286,46703,23622
206488487,1.0,1.0,1845000,1725000,120000,7,1845000,Null,Null,206488487,19018,1634
206488637,41.0,41.0,480000,432000,48000,10,480000,Null,Null,206488637,276745,3422
206488835,759.0,759.0,498000,388000,110000,22,498000,Null,Null,206488835,238861,8223
206490290,76.0,76.0,249000,211000,38000,15,249000,Null,Null,206490290,238861,1613
206490305,29.0,29.0,249000,236000,13000,5,249000,Null,Null,206490305,238861,1616
206500889,0.0,0.0,0,3800,0,0,3800,Null,Null,206500889,111461,0
206501670,0.0,0.0,3000,3000,0,0,3000,Null,Null,206501670,111461,1819
206501876,6.0,6.0,89000,89000,0,0,89000,Null,Null,206501876,111461,2324
206501934,46.0,46.0,145000,145000,0,0,145000,Null,Null,206501934,111461,28454
206502048,1.0,1.0,9000,9000,0,0,9000,Null,Null,206502048,111461,28732
206502153,25.0,25.0,85000,85000,0,0,85000,Null,Null,206502153,111461,4429
206502240,1.0,1.0,6000,6000,0,0,6000,Null,Null,206502240,111461,2
206502393,390.0,390.0,412200,229000,183200,44,412200,Null,Null,206502393,46703,23622
206532765,35.0,35.0,130000,130000,0,0,130000,Null,Null,206532765,7882195,20182
206536586,34.0,34.0,45000,45000,0,0,45000,Null,Null,206536586,111461,3710
206537919,4.0,4.0,10000,10000,0,0,10000,Null,Null,206537919,111461,2
206548283,186.0,186.0,174000,134000,40000,23,174000,Null,Null,206548283,4825271,23282
206548589,0.0,0.0,168000000,168000000,0,0,168000000,Null,Null,206548589,4558659,2340
206553300,0.0,0.0,7400000,7400000,0,0,7400000,Null,Null,206553300,111461,1634
206553302,0.0,0.0,6240000,6240000,0,0,6240000,Null,Null,206553302,111461,1634
206553308,1.0,1.0,6690000,6690000,0,0,6690000,Null,Null,206553308,111461,1634
206553394,0.0,0.0,8400000,8400000,0,0,8400000,Null,Null,206553394,111461,1634
206553412,0.0,0.0,8190000,8190000,0,0,8190000,Null,Null,206553412,111461,1634
206553432,0.0,0.0,10900000,10900000,0,0,10900000,Null,Null,206553432,111461,1634
206553444,0.0,0.0,8290000,8290000,0,0,8290000,Null,Null,206553444,111461,1634
206553450,0.0,0.0,7190000,7190000,0,0,7190000,Null,Null,206553450,111461,1634
206553452,0.0,0.0,6140000,6140000,0,0,6140000,Null,Null,206553452,111461,1634
206554013,8.0,8.0,125684,125684,0,0,125684,Null,Null,206554013,4816109,28574
206560759,74.0,74.0,1770001,1770001,0,0,1770001,Null,Null,206560759,2630119,2657
206566695,57.0,57.0,550000,550000,0,0,550000,Null,Null,206566695,629081,23288
206621326,92.0,92.0,50000,39000,11000,22,50000,Null,Null,206621326,5534927,1520
206629474,0.0,0.0,7000000,7000000,0,0,7000000,Null,Null,206629474,506629,2347
206634388,1.0,1.0,5650000,5650000,0,0,5650000,Null,Null,206634388,111461,8165
206640892,3.0,3.0,950000,950000,0,0,950000,Null,Null,206640892,925095,17170
206643700,5.0,5.0,550000,550000,0,0,550000,Null,Null,206643700,925095,3422
206644465,5.0,5.0,980000,980000,0,0,980000,Null,Null,206644465,925095,53350
206649392,6.0,6.0,2290000,2038000,252000,11,2290000,Null,Null,206649392,207367,8371
206649454,0.0,0.0,11500000,9016000,2484000,22,11500000,Null,Null,206649454,18802,1795
206651357,0.0,0.0,7721000,6022380,1698620,22,7721000,Null,Null,206651357,26150,8513
206651599,0.0,0.0,8162000,6366360,1795640,22,8162000,Null,Null,206651599,26150,8513
206663022,0.0,0.0,12500000,12500000,0,0,12500000,Null,Null,206663022,313739,20170
206663143,0.0,0.0,10100000,5699000,4401000,44,10100000,Null,Null,206663143,46007,8227
206664322,1.0,1.0,300000,300000,0,0,300000,Null,Null,206664322,4298221,12928
206665000,0.0,0.0,1300,1300,0,0,1300,Null,Null,206665000,111461,2
206665048,0.0,0.0,7500,7500,0,0,7500,Null,Null,206665048,111461,2
206665141,0.0,0.0,2990,2990,0,0,2990,Null,Null,206665141,111461,2
206665237,0.0,0.0,7200,7200,0,0,7200,Null,Null,206665237,111461,2
206665253,0.0,0.0,2500,2500,0,0,2500,Null,Null,206665253,111461,2
206665287,0.0,0.0,9900,9900,0,0,9900,Null,Null,206665287,111461,2
206665318,0.0,0.0,6000,6000,0,0,6000,Null,Null,206665318,111461,2
206665433,0.0,0.0,4990,4990,0,0,4990,Null,Null,206665433,111461,2
206665478,2.0,2.0,9000,9000,0,0,9000,Null,Null,206665478,111461,2
206665494,0.0,0.0,4490,4490,0,0,4490,Null,Null,206665494,111461,2
206665505,0.0,0.0,9500,9500,0,0,9500,Null,Null,206665505,111461,2
206665974,0.0,0.0,12400000,6800000,5600000,45,12400000,Null,Null,206665974,46007,8227
206669261,17.0,17.0,890000,890000,0,0,890000,Null,Null,206669261,411559,28598
206690242,19.0,19.0,49999,33000,16999,34,49999,Null,Null,206690242,111461,53074
206693132,17.0,17.0,585000,585000,0,0,585000,Null,Null,206693132,111461,28616
206714709,0.0,0.0,1000,1000,0,0,1000,Null,Null,206714709,111461,18888
206716473,0.0,0.0,1000,1000,0,0,1000,Null,Null,206716473,111461,2
206716838,0.0,0.0,49500900,49500900,0,0,49500900,Null,Null,206716838,111461,2
206718254,0.0,0.0,1000,1000,0,0,1000,Null,Null,206718254,111461,2
206718801,0.0,0.0,41625000,41625000,0,0,41625000,Null,Null,206718801,111461,2
206719056,0.0,0.0,42375000,42375000,0,0,42375000,Null,Null,206719056,111461,2
206719522,0.0,0.0,40875000,40875000,0,0,40875000,Null,Null,206719522,111461,2
206719850,0.0,0.0,1000,1000,0,0,1000,Null,Null,206719850,111461,2
206719982,0.0,0.0,40125000,40125000,0,0,40125000,Null,Null,206719982,111461,2
206720039,0.0,0.0,1500,1500,0,0,1500,Null,Null,206720039,111461,2
206720640,0.0,0.0,42375000,42375000,0,0,42375000,Null,Null,206720640,111461,2
206720670,0.0,0.0,43125000,43125000,0,0,43125000,Null,Null,206720670,111461,2
206769440,6.0,6.0,100000,100000,0,0,100000,Null,Null,206769440,111461,28594
206770351,1.0,1.0,6999000,4390000,2609000,37,6999000,Null,Null,206770351,4885445,8172
206771206,0.0,0.0,4390000,4390000,0,0,4390000,Null,Null,206771206,4885445,8172
206782059,0.0,0.0,5000000,3399000,1601000,32,5000000,Null,Null,206782059,46007,8227
206794670,81.0,81.0,510000,365000,145000,28,510000,Null,Null,206794670,111461,2340
206794812,153.0,153.0,379050,360097,18953,5,379050,Null,Null,206794812,183251,1520
206795172,4.0,4.0,2390000,2151000,239000,10,2390000,Null,Null,206795172,207367,8371
206795260,0.0,0.0,15000,15000,0,0,15000,Null,Null,206795260,111461,2
206824433,3.0,3.0,273898,248999,24899,9,273898,Null,Null,206824433,4973949,20244
206832478,0.0,0.0,4500,4500,0,0,4500,Null,Null,206832478,111461,8189
206832788,2.0,2.0,4500,4500,0,0,4500,Null,Null,206832788,111461,2
206833013,7.0,7.0,63000,63000,0,0,63000,Null,Null,206833013,111461,2
206833528,0.0,0.0,1800,1800,0,0,1800,Null,Null,206833528,111461,8167
206834390,0.0,0.0,4500,4500,0,0,4500,Null,Null,206834390,111461,1622
206834524,30.0,30.0,40000,40000,0,0,40000,Null,Null,206834524,111461,8193
206834688,0.0,0.0,9000,9000,0,0,9000,Null,Null,206834688,111461,8205
206834935,0.0,0.0,7000,7000,0,0,7000,Null,Null,206834935,111461,8205
206835448,0.0,0.0,3600,3600,0,0,3600,Null,Null,206835448,111461,8202
206835714,0.0,0.0,9000,9000,0,0,9000,Null,Null,206835714,111461,8189
206835717,0.0,0.0,9900,9900,0,0,9900,Null,Null,206835717,111461,1622
206835797,0.0,0.0,7200,7200,0,0,7200,Null,Null,206835797,111461,2
206835938,32.0,32.0,6000,6000,0,0,6000,Null,Null,206835938,111461,8205
206835950,2.0,2.0,9000,9000,0,0,9000,Null,Null,206835950,111461,8205
206835967,0.0,0.0,4500,4500,0,0,4500,Null,Null,206835967,111461,2
206836171,0.0,0.0,4500,4500,0,0,4500,Null,Null,206836171,111461,8205
206836246,0.0,0.0,4500,4500,0,0,4500,Null,Null,206836246,111461,8190
206836327,2.0,2.0,9000,9000,0,0,9000,Null,Null,206836327,111461,2
206837294,0.0,0.0,8100,8100,0,0,8100,Null,Null,206837294,111461,8202
206837298,0.0,0.0,3600,3600,0,0,3600,Null,Null,206837298,111461,1622
206837305,0.0,0.0,5310,5310,0,0,5310,Null,Null,206837305,111461,8190
206837406,0.0,0.0,3150,3150,0,0,3150,Null,Null,206837406,111461,8167
206837418,0.0,0.0,9000,9000,0,0,9000,Null,Null,206837418,111461,8202
206854630,0.0,0.0,0,2000,0,0,2000,Null,Null,206854630,111461,0
206873631,53.0,53.0,122000,109000,13000,11,122000,Null,Null,206873631,7398711,2019
206906133,310.0,310.0,150000,85000,65000,43,150000,Null,Null,206906133,5534927,1520
206907050,581.0,581.0,793000,614000,179000,23,793000,Null,Null,206907050,238861,7061
206907629,2.0,2.0,990000,990000,0,0,990000,Null,Null,206907629,5130835,20170
206945905,0.0,0.0,4500,4500,0,0,4500,Null,Null,206945905,5066745,28698
206952374,13.0,13.0,79000,45000,34000,43,79000,Null,Null,206952374,25048,1641
206993589,0.0,0.0,8500,8500,0,0,8500,Null,Null,206993589,111461,2
206993771,0.0,0.0,1000,1000,0,0,1000,Null,Null,206993771,111461,2
206993858,0.0,0.0,15000,15000,0,0,15000,Null,Null,206993858,111461,2
206994005,1.0,1.0,25000,25000,0,0,25000,Null,Null,206994005,111461,2
206994014,0.0,0.0,12000,12000,0,0,12000,Null,Null,206994014,111461,2
206994037,0.0,0.0,12000,12000,0,0,12000,Null,Null,206994037,111461,2
206994170,3.0,3.0,15000,15000,0,0,15000,Null,Null,206994170,111461,2
206994456,1.0,1.0,12000,12000,0,0,12000,Null,Null,206994456,111461,2
206994547,0.0,0.0,12000,12000,0,0,12000,Null,Null,206994547,111461,2
206994656,0.0,0.0,12000,12000,0,0,12000,Null,Null,206994656,111461,2
206994808,1.0,1.0,25000,25000,0,0,25000,Null,Null,206994808,111461,2
206995383,31.0,31.0,15000,15000,0,0,15000,Null,Null,206995383,111461,23052
206996344,22.0,22.0,358000,260000,98000,27,358000,Null,Null,206996344,204385,28640
207002034,0.0,0.0,6900000,3650000,3250000,47,6900000,Null,Null,207002034,46007,8227
207010156,0.0,0.0,9000,9000,0,0,9000,Null,Null,207010156,111461,2
207010401,0.0,0.0,2500,2500,0,0,2500,Null,Null,207010401,111461,2
207013473,0.0,0.0,6000,6000,0,0,6000,Null,Null,207013473,111461,1622
207013880,64.0,64.0,519000,269000,250000,48,519000,Null,Null,207013880,5048343,4593
207025612,0.0,0.0,13000000,13000000,0,0,13000000,Null,Null,207025612,111461,2
207034148,0.0,0.0,2500,2500,0,0,2500,Null,Null,207034148,111461,23688
207041968,0.0,0.0,69500000,66720000,2780000,4,69500000,Null,Null,207041968,167287,11518
207161537,0.0,0.0,50800000,48768000,2032000,4,50800000,Null,Null,207161537,167287,11518
207166978,0.0,0.0,96988000,96988000,0,0,96988000,Null,Null,207166978,7362435,2340
207192149,0.0,0.0,12000000,12000000,0,0,12000000,Null,Null,207192149,506629,2
207192206,0.0,0.0,26990000,25910400,1079600,4,26990000,Null,Null,207192206,167287,11518
207194138,0.0,0.0,34500000,34500000,0,0,34500000,Null,Null,207194138,7362435,2340
207195875,0.0,0.0,96686000,96686000,0,0,96686000,Null,Null,207195875,7362435,2340
207196788,274.0,274.0,63000,63000,0,0,63000,Null,Null,207196788,185677,1883
207196837,0.0,0.0,66990000,66990000,0,0,66990000,Null,Null,207196837,7362435,2340
207201155,0.0,0.0,14000000,12800000,1200000,9,14000000,Null,Null,207201155,111461,8066
207205745,0.0,0.0,85000000,85000000,0,0,85000000,Null,Null,207205745,111461,23576
207205803,0.0,0.0,3500000,3500000,0,0,3500000,Null,Null,207205803,258977,8227
207206016,1.0,1.0,15000,15000,0,0,15000,Null,Null,207206016,111461,2
207207132,1.0,1.0,99500,99500,0,0,99500,Null,Null,207207132,173519,15318
207207434,0.0,0.0,7500000,7500000,0,0,7500000,Null,Null,207207434,258977,17170
207207699,58.0,58.0,106200,59000,47200,44,106200,Null,Null,207207699,46703,1831
207207880,8.0,8.0,450000,427500,22500,5,450000,Null,Null,207207880,183325,11875
207208831,0.0,0.0,25000,15000,10000,40,25000,Null,Null,207208831,111461,2
207208888,0.0,0.0,27000,19000,8000,30,27000,Null,Null,207208888,111461,2
207209149,0.0,0.0,30000,18000,12000,40,30000,Null,Null,207209149,111461,2
207209298,0.0,0.0,32000,19000,13000,41,32000,Null,Null,207209298,111461,2
207209829,3.0,3.0,215000,215000,0,0,215000,Null,Null,207209829,111461,11923
207220581,0.0,0.0,4500000,4500000,0,0,4500000,Null,Null,207220581,258977,8227
207222990,11.0,11.0,451000,428450,22550,5,451000,Null,Null,207222990,183325,11861
207227296,8.0,8.0,546000,518700,27300,5,546000,Null,Null,207227296,183325,11871
207227386,0.0,0.0,80000000,80000000,0,0,80000000,Null,Null,207227386,111461,23576
207227582,24.0,24.0,561000,532950,28050,5,561000,Null,Null,207227582,183325,11857
207236114,0.0,0.0,36200000,34752000,1448000,4,36200000,Null,Null,207236114,167287,11518
207238906,1.0,1.0,25500000,25500000,0,0,25500000,Null,Null,207238906,144527,11518
207241120,108.0,108.0,566000,295000,271000,48,566000,Null,Null,207241120,166495,28574
207245125,19.0,19.0,389000,193000,196000,50,389000,Null,Null,207245125,166495,28484
207254976,0.0,0.0,40000000,40000000,0,0,40000000,Null,Null,207254976,111461,23576
207255695,0.0,0.0,89500000,89500000,0,0,89500000,Null,Null,207255695,7362435,2340
207255767,0.0,0.0,57800000,55488000,2312000,4,57800000,Null,Null,207255767,167287,11518
207255839,0.0,0.0,14700000,14700000,0,0,14700000,Null,Null,207255839,749425,28870
207255927,33.0,33.0,108000,58000,50000,46,108000,Null,Null,207255927,853295,11879
207256162,0.0,0.0,76200000,73152000,3048000,4,76200000,Null,Null,207256162,167287,11518
207256180,0.0,0.0,92000000,92000000,0,0,92000000,Null,Null,207256180,7362435,2340
207256565,0.0,0.0,168800000,168800000,0,0,168800000,Null,Null,207256565,7362435,2340
207256893,0.0,0.0,112800000,112800000,0,0,112800000,Null,Null,207256893,7362435,2340
207267499,2.0,2.0,6290000,6227100,62900,1,6290000,Null,Null,207267499,111461,11933
207268082,0.0,0.0,3468000,3468000,0,0,3468000,Null,Null,207268082,25422,1795
207268125,0.0,0.0,3468000,3468000,0,0,3468000,Null,Null,207268125,25422,1795
207268144,0.0,0.0,2990000,2139000,851000,28,2990000,Null,Null,207268144,18802,1795
207268146,0.0,0.0,5263000,5263000,0,0,5263000,Null,Null,207268146,18802,1795
207268158,0.0,0.0,2990000,2139000,851000,28,2990000,Null,Null,207268158,18802,1795
207268160,0.0,0.0,2990000,2139000,851000,28,2990000,Null,Null,207268160,18802,1795
207268527,0.0,0.0,45000000,43200000,1800000,4,45000000,Null,Null,207268527,167287,11518
207268672,0.0,0.0,56500000,54240000,2260000,4,56500000,Null,Null,207268672,167287,11518
207270188,60.0,60.0,1750001,1750001,0,0,1750001,Null,Null,207270188,2630119,2657
207272246,0.0,0.0,64000000,61440000,2560000,4,64000000,Null,Null,207272246,167287,11518
207272451,37.0,37.0,75000,75000,0,0,75000,Null,Null,207272451,5706641,23052
207280090,0.0,0.0,75780000,72748800,3031200,4,75780000,Null,Null,207280090,167287,11518
207281819,0.0,0.0,32760000,32760000,0,0,32760000,Null,Null,207281819,7362435,1520
207285063,0.0,0.0,77280000,77280000,0,0,77280000,Null,Null,207285063,7362435,2340
207289203,17.0,17.0,350000,230000,120000,34,350000,Null,Null,207289203,213611,23394
207292525,5.0,5.0,520000,520000,0,0,520000,Null,Null,207292525,508513,17170
207294576,263.0,263.0,35000,26000,9000,26,35000,Null,Null,207294576,111461,15318
207301502,0.0,0.0,21900000,21900000,0,0,21900000,Null,Null,207301502,162957,20170
207311530,0.0,0.0,3500,3500,0,0,3500,Null,Null,207311530,3989637,2
207311665,82.0,82.0,30000,30000,0,0,30000,Null,Null,207311665,4973949,20244
207316699,47.0,47.0,299000,299000,0,0,299000,Null,Null,207316699,4958627,1520
207316778,0.0,0.0,22490000,22490000,0,0,22490000,Null,Null,207316778,114527,2657
207316784,0.0,0.0,22490000,22490000,0,0,22490000,Null,Null,207316784,114527,2657
207316791,0.0,0.0,22490000,22490000,0,0,22490000,Null,Null,207316791,114527,2657
207316816,0.0,0.0,24990000,24990000,0,0,24990000,Null,Null,207316816,114527,2657
207316822,0.0,0.0,22490000,22490000,0,0,22490000,Null,Null,207316822,114527,2657
207320059,53.0,53.0,178000,89000,89000,50,178000,Null,Null,207320059,477953,8305
207324160,32.0,32.0,19800,9900,9900,50,19800,Null,Null,207324160,477953,8305
207333361,0.0,0.0,76900000,73824000,3076000,4,76900000,Null,Null,207333361,167287,28860
207335387,8.0,8.0,910000,790000,120000,13,910000,Null,Null,207335387,111461,11516
207335706,0.0,0.0,25200000,24192000,1008000,4,25200000,Null,Null,207335706,167287,8067
207336383,37.0,37.0,325000,231000,94000,29,325000,Null,Null,207336383,7426365,8309
207337154,0.0,0.0,2000,2000,0,0,2000,Null,Null,207337154,111461,1883
207341032,10.0,10.0,79000,79000,0,0,79000,Null,Null,207341032,111461,2
207346146,1.0,1.0,54000,27000,27000,50,54000,Null,Null,207346146,111461,27546
207354752,0.0,0.0,41490000,39830400,1659600,4,41490000,Null,Null,207354752,167287,8067
207359176,16.0,16.0,650000,650000,0,0,650000,Null,Null,207359176,7426365,17186
207359277,0.0,0.0,20990000,20990000,0,0,20990000,Null,Null,207359277,163367,20170
207360677,0.0,0.0,26000000,26000000,0,0,26000000,Null,Null,207360677,163367,20170
207364353,0.0,0.0,1000,1000,0,0,1000,Null,Null,207364353,111461,18888
207373461,3.0,3.0,4599000,4599000,0,0,4599000,Null,Null,207373461,450333,8066
207382104,0.0,0.0,37000,18500,18500,50,37000,Null,Null,207382104,111461,15318
207382556,0.0,0.0,36855000,36855000,0,0,36855000,Null,Null,207382556,201253,23576
207387119,0.0,0.0,13000000,13000000,0,0,13000000,Null,Null,207387119,163367,20170
207387754,0.0,0.0,34990000,34990000,0,0,34990000,Null,Null,207387754,163367,20170
207390073,98.0,98.0,800001,800001,0,0,800001,Null,Null,207390073,2630119,2657
207397965,0.0,0.0,2500,2500,0,0,2500,Null,Null,207397965,111461,2
207398370,2.0,2.0,14999,14999,0,0,14999,Null,Null,207398370,111461,23800
207400187,92.0,92.0,15000,15000,0,0,15000,Null,Null,207400187,111461,23800
207400500,59.0,59.0,1500001,1500001,0,0,1500001,Null,Null,207400500,2630119,2657
207400523,154.0,154.0,105000,105000,0,0,105000,Null,Null,207400523,245945,23362
207403037,43.0,43.0,69000,69000,0,0,69000,Null,Null,207403037,111461,4428
207422420,58.0,58.0,650000,430000,220000,34,650000,Null,Null,207422420,623599,11925
207438580,0.0,0.0,4650000,4650000,0,0,4650000,Null,Null,207438580,111461,11943
207449969,0.0,0.0,11380000,11380000,0,0,11380000,Null,Null,207449969,20215,6653
207473375,18.0,18.0,225000,202500,22500,10,225000,Null,Null,207473375,111461,1815
207475461,41.0,41.0,5990000,4890000,1100000,18,5990000,Null,Null,207475461,162007,1795
207490821,0.0,0.0,70600000,70600000,0,0,70600000,Null,Null,207490821,50307,7079
207491124,0.0,0.0,37990000,37990000,0,0,37990000,Null,Null,207491124,251079,23634
207492788,5.0,5.0,89000,89000,0,0,89000,Null,Null,207492788,166419,28580
207493207,0.0,0.0,100000000,100000000,0,0,100000000,Null,Null,207493207,50307,7079
207498593,1.0,1.0,18500000,18500000,0,0,18500000,Null,Null,207498593,167287,11518
207502044,15.0,15.0,89000,85000,4000,4,89000,Null,Null,207502044,166419,28578
207502352,0.0,0.0,42800000,42800000,0,0,42800000,Null,Null,207502352,167287,11518
207503267,0.0,0.0,33900000,24590000,9310000,27,33900000,Null,Null,207503267,853517,2340
207503270,38.0,38.0,529000,529000,0,0,529000,Null,Null,207503270,853517,2340
207503272,0.0,0.0,24990000,15590000,9400000,38,24990000,Null,Null,207503272,853517,2340
207517970,0.0,0.0,35800000,35800000,0,0,35800000,Null,Null,207517970,167287,11518
207520850,0.0,0.0,138999,138999,0,0,138999,Null,Null,207520850,111454,12294
207529806,0.0,0.0,52000000,52000000,0,0,52000000,Null,Null,207529806,167287,11518
207537156,2.0,2.0,120000,120000,0,0,120000,Null,Null,207537156,111461,15318
207552873,34.0,34.0,472000,396000,76000,16,472000,Null,Null,207552873,204385,8400
207555174,0.0,0.0,95000000,95000000,0,0,95000000,Null,Null,207555174,111461,23112
207557113,1.0,1.0,1000,1000,0,0,1000,Null,Null,207557113,111461,18888
207557574,150.0,150.0,79000,78000,1000,1,79000,Null,Null,207557574,111461,1883
207558976,22.0,22.0,229000,121000,108000,47,229000,Null,Null,207558976,5048343,28738
207559368,12.0,12.0,189000,92000,97000,51,189000,Null,Null,207559368,5048343,28738
207559483,0.0,0.0,25500000,25500000,0,0,25500000,Null,Null,207559483,144527,11518
207572115,12.0,12.0,299000,299000,0,0,299000,Null,Null,207572115,111461,1936
207626743,31.0,31.0,1250000,1129000,121000,10,1250000,Null,Null,207626743,26689,53350
207640319,0.0,0.0,39000000,39000000,0,0,39000000,Null,Null,207640319,167287,11518
207641038,1.0,1.0,45000,45000,0,0,45000,Null,Null,207641038,111461,15320
207644682,0.0,0.0,48500000,48500000,0,0,48500000,Null,Null,207644682,167287,11518
207646663,108.0,108.0,169000,168000,1000,1,169000,Null,Null,207646663,7288833,3990
207658045,0.0,0.0,22500000,22500000,0,0,22500000,Null,Null,207658045,167287,11518
207693711,0.0,0.0,10000,5000,5000,50,10000,Null,Null,207693711,5104653,8305
207698460,0.0,0.0,138999,138999,0,0,138999,Null,Null,207698460,111454,28458
207699541,0.0,0.0,17680000,17680000,0,0,17680000,Null,Null,207699541,167287,11518
207709093,2.0,2.0,22899,16000,6899,30,22899,Null,Null,207709093,111461,2514
207709123,0.0,0.0,7868338,7868338,0,0,7868338,Null,Null,207709123,7873343,15320
207709679,63.0,63.0,350000,205000,145000,41,350000,Null,Null,207709679,4627197,5531
207710183,0.0,0.0,62100000,59616000,2484000,4,62100000,Null,Null,207710183,50331,8064
207717788,0.0,0.0,38640000,37094400,1545600,4,38640000,Null,Null,207717788,50331,11518
207722056,1.0,1.0,168000,168000,0,0,168000,Null,Null,207722056,111461,15236
207722063,92.0,92.0,3500,3500,0,0,3500,Null,Null,207722063,2630119,49722
207722605,0.0,0.0,51600000,49536000,2064000,4,51600000,Null,Null,207722605,50331,11518
207722769,42.0,42.0,60000,60000,0,0,60000,Null,Null,207722769,111461,18876
207723265,0.0,0.0,2000,2000,0,0,2000,Null,Null,207723265,111461,28698
207724932,1.0,1.0,22490000,18355000,4135000,18,22490000,Null,Null,207724932,114527,2657
207725845,0.0,0.0,72680000,69772800,2907200,4,72680000,Null,Null,207725845,50331,11518
207730001,0.0,0.0,57960000,55641600,2318400,4,57960000,Null,Null,207730001,50331,11518
207730275,146.0,146.0,100000,69000,31000,31,100000,Null,Null,207730275,4244853,4593
207733159,4.0,4.0,50000,50000,0,0,50000,Null,Null,207733159,111461,15320
207733398,0.0,0.0,79200000,76032000,3168000,4,79200000,Null,Null,207733398,50331,11518
207734554,0.0,0.0,79200000,76032000,3168000,4,79200000,Null,Null,207734554,50331,11518
207735188,2.0,2.0,80000,72000,8000,10,80000,Null,Null,207735188,111461,15320
207735560,0.0,0.0,70000,63000,7000,10,70000,Null,Null,207735560,111461,15320
207746663,0.0,0.0,8100000,7290000,810000,10,8100000,Null,Null,207746663,111461,15318
207747137,0.0,0.0,11000000,8800000,2200000,20,11000000,Null,Null,207747137,111461,15318
207747781,1.0,1.0,4500,2250,2250,50,4500,Null,Null,207747781,111461,23024
207751010,12.0,12.0,149000,149000,0,0,149000,Null,Null,207751010,111461,28428
207752558,0.0,0.0,11990000,10860000,1130000,9,11990000,Null,Null,207752558,111461,2324
207753012,18.0,18.0,5000,5000,0,0,5000,Null,Null,207753012,111461,1819
207753056,46.0,46.0,108000,93000,15000,14,108000,Null,Null,207753056,112887,3426
207753066,106.0,106.0,98000,84500,13500,14,98000,Null,Null,207753066,112887,11605
207753581,0.0,0.0,17680000,17680000,0,0,17680000,Null,Null,207753581,167287,11518
207754726,0.0,0.0,22500000,22500000,0,0,22500000,Null,Null,207754726,167287,11518
207755204,0.0,0.0,48500000,48500000,0,0,48500000,Null,Null,207755204,167287,11518
207755366,95.0,95.0,300000,229000,71000,24,300000,Null,Null,207755366,839837,28644
207757282,0.0,0.0,37050000,37050000,0,0,37050000,Null,Null,207757282,167287,11518
207759273,0.0,0.0,51500000,51500000,0,0,51500000,Null,Null,207759273,167287,11518
207759800,0.0,0.0,14102000,12409760,1692240,12,14102000,Null,Null,207759800,167287,2324
207760362,0.0,0.0,34720000,34720000,0,0,34720000,Null,Null,207760362,167287,11518
207761759,49.0,49.0,3990000,3190000,800000,20,3990000,Null,Null,207761759,18802,1795
207762443,0.0,0.0,41510000,39434500,2075500,5,41510000,Null,Null,207762443,167287,11518
207763050,0.0,0.0,23186000,20403680,2782320,12,23186000,Null,Null,207763050,167287,6653
207767042,0.0,0.0,17790000,9990000,7800000,44,17790000,Null,Null,207767042,853517,2340
207767844,0.0,0.0,10000,5000,5000,50,10000,Null,Null,207767844,111461,7064
207774697,0.0,0.0,19170000,14377500,4792500,25,19170000,Null,Null,207774697,162945,28866
207775316,165.0,165.0,72000,72000,0,0,72000,Null,Null,207775316,111461,8167
207777018,30.0,30.0,219000,195000,24000,11,219000,Null,Null,207777018,354595,8212
207777611,73.0,73.0,999000,664000,335000,34,999000,Null,Null,207777611,21282,11833
207777865,37.0,37.0,499000,371000,128000,26,499000,Null,Null,207777865,21282,11833
207777911,0.0,0.0,35640000,24689000,10951000,31,35640000,Null,Null,207777911,241109,11935
207777989,0.0,0.0,21590000,16192500,5397500,25,21590000,Null,Null,207777989,162945,11518
207778317,0.0,0.0,15970000,11977500,3992500,25,15970000,Null,Null,207778317,162945,8067
207779005,94.0,94.0,1450000,1050000,400000,28,1450000,Null,Null,207779005,18802,28454
207779010,11.0,11.0,88000,88000,0,0,88000,Null,Null,207779010,111461,49722
207780715,0.0,0.0,24600,11000,13600,55,24600,Null,Null,207780715,111461,15318
207781207,0.0,0.0,4390000,4390000,0,0,4390000,Null,Null,207781207,366783,8172
207781289,0.0,0.0,9200000,9200000,0,0,9200000,Null,Null,207781289,27449,2340
207781364,0.0,0.0,9999000,9999000,0,0,9999000,Null,Null,207781364,366783,8172
207782014,0.0,0.0,19170000,14377500,4792500,25,19170000,Null,Null,207782014,162945,8067
207782739,0.0,0.0,47520000,31415000,16105000,34,47520000,Null,Null,207782739,241109,11935
207789733,42.0,42.0,1200000,790000,410000,34,1200000,Null,Null,207789733,111454,28454
207795326,1.0,1.0,3950000,3950000,0,0,3950000,Null,Null,207795326,111461,8167
207802057,36.0,36.0,72000,65000,7000,10,72000,Null,Null,207802057,199927,11829
207808201,22.0,22.0,5000,5000,0,0,5000,Null,Null,207808201,111461,8167
207809534,11.0,11.0,739000,739000,0,0,739000,Null,Null,207809534,111461,23254
207809852,0.0,0.0,0,9000,0,0,9000,Null,Null,207809852,111461,0
207810498,81.0,81.0,120000,65000,55000,46,120000,Null,Null,207810498,4224691,3515
207815008,404.0,404.0,550000,298000,252000,46,550000,Null,Null,207815008,4224691,1520
207815025,28.0,28.0,99000,99000,0,0,99000,Null,Null,207815025,21651,28574
207815178,0.0,0.0,9000,9000,0,0,9000,Null,Null,207815178,111461,8202
207815232,0.0,0.0,9000,9000,0,0,9000,Null,Null,207815232,111461,8202
207815234,0.0,0.0,9000,9000,0,0,9000,Null,Null,207815234,111461,8202
207819024,57.0,57.0,30000,21000,9000,30,30000,Null,Null,207819024,111461,3177
207819085,0.0,0.0,5500,5500,0,0,5500,Null,Null,207819085,3989637,2342
207819090,0.0,0.0,6000,6000,0,0,6000,Null,Null,207819090,3989637,2342
207819110,0.0,0.0,4500,4500,0,0,4500,Null,Null,207819110,3989637,8309
207825538,0.0,0.0,17570000,13177500,4392500,25,17570000,Null,Null,207825538,162945,28860
207829092,0.0,0.0,17059000,15011920,2047080,12,17059000,Null,Null,207829092,167287,6653
207830718,8.0,8.0,809000,659000,150000,19,809000,Null,Null,207830718,7398711,23246
207854208,1.0,1.0,225000,225000,0,0,225000,Null,Null,207854208,111461,49722
207854260,0.0,0.0,18890000,14167500,4722500,25,18890000,Null,Null,207854260,162945,11518
207865298,0.0,0.0,99600000,81672000,17928000,18,99600000,Null,Null,207865298,162945,11518
207871753,6.0,6.0,2500,2500,0,0,2500,Null,Null,207871753,111461,28478
207874559,0.0,0.0,11600000,11600000,0,0,11600000,Null,Null,207874559,749425,28870
207883258,0.0,0.0,9490000,9490000,0,0,9490000,Null,Null,207883258,112735,1795
207888516,0.0,0.0,37500000,37500000,0,0,37500000,Null,Null,207888516,180963,11518
207888518,0.0,0.0,58888000,51821440,7066560,12,58888000,Null,Null,207888518,167287,6653
207892026,0.0,0.0,43053000,37886640,5166360,12,43053000,Null,Null,207892026,167287,6653
207892650,5.0,5.0,416000,215000,201000,48,416000,Null,Null,207892650,19034,28484
207898574,0.0,0.0,51566000,45378080,6187920,12,51566000,Null,Null,207898574,167287,6653
207900008,0.0,0.0,18900000,18900000,0,0,18900000,Null,Null,207900008,180963,28860
207903868,0.0,0.0,82067000,72218960,9848040,12,82067000,Null,Null,207903868,167287,6653
207903983,13.0,13.0,9500,6500,3000,32,9500,Null,Null,207903983,111461,28480
207911389,0.0,0.0,8000,8000,0,0,8000,Null,Null,207911389,111461,8205
207911424,0.0,0.0,5000,5000,0,0,5000,Null,Null,207911424,111461,8205
207911503,0.0,0.0,5500,5500,0,0,5500,Null,Null,207911503,111461,8205
207911547,0.0,0.0,3500,3500,0,0,3500,Null,Null,207911547,111461,8205
207911684,0.0,0.0,8500,8500,0,0,8500,Null,Null,207911684,111461,8205
207911737,0.0,0.0,8500,8500,0,0,8500,Null,Null,207911737,111461,8205
207911950,0.0,0.0,8500,8500,0,0,8500,Null,Null,207911950,111461,8205
207912004,0.0,0.0,7500,7500,0,0,7500,Null,Null,207912004,111461,8205
207912192,0.0,0.0,3900,3900,0,0,3900,Null,Null,207912192,111461,2
207912210,0.0,0.0,6800,6800,0,0,6800,Null,Null,207912210,111461,8205
207912453,0.0,0.0,4800,4800,0,0,4800,Null,Null,207912453,111461,8205
207913046,0.0,0.0,8500,8500,0,0,8500,Null,Null,207913046,111461,8205
207913243,0.0,0.0,8500,8500,0,0,8500,Null,Null,207913243,111461,8205
207913248,0.0,0.0,6900,6900,0,0,6900,Null,Null,207913248,111461,8205
207913676,1.0,1.0,7500,7500,0,0,7500,Null,Null,207913676,111461,8205
207913821,0.0,0.0,5000,5000,0,0,5000,Null,Null,207913821,111461,8205
207914534,3.0,3.0,1790000,1739000,51000,3,1790000,Null,Null,207914534,19673,1796
207917223,0.0,0.0,158000,158000,0,0,158000,Null,Null,207917223,111461,15318
207919527,0.0,0.0,435000,435000,0,0,435000,Null,Null,207919527,111461,15318
207919632,1.0,1.0,150000,150000,0,0,150000,Null,Null,207919632,111461,15250
207919966,0.0,0.0,83000,83000,0,0,83000,Null,Null,207919966,111461,2
207921172,0.0,0.0,18200,9100,9100,50,18200,Null,Null,207921172,111461,15318
207928564,0.0,0.0,11500000,11500000,0,0,11500000,Null,Null,207928564,308577,15318
207933093,71.0,71.0,1100,1100,0,0,1100,Null,Null,207933093,111461,53074
207933405,0.0,0.0,18377000,18377000,0,0,18377000,Null,Null,207933405,308577,15318
207935794,141.0,141.0,250200,139000,111200,44,250200,Null,Null,207935794,46703,28682
207941719,329.0,329.0,934000,481000,453000,49,934000,Null,Null,207941719,48077,23832
207941869,0.0,0.0,17600000,17600000,0,0,17600000,Null,Null,207941869,180963,11518
207946136,0.0,0.0,13200000,13200000,0,0,13200000,Null,Null,207946136,180963,11518
207946138,0.0,0.0,70928000,62416640,8511360,12,70928000,Null,Null,207946138,167287,6653
207947343,53.0,53.0,550000,299000,251000,46,550000,Null,Null,207947343,246045,3804
207947387,4.0,4.0,154000,154000,0,0,154000,Null,Null,207947387,111461,11933
207947426,12.0,12.0,1190000,699000,491000,41,1190000,Null,Null,207947426,246045,4593
207947529,0.0,0.0,2220000,2220000,0,0,2220000,Null,Null,207947529,52232,1795
207948404,29.0,29.0,918000,456000,462000,50,918000,Null,Null,207948404,202607,8227
207952152,0.0,0.0,23633000,20797040,2835960,12,23633000,Null,Null,207952152,167287,6653
207955003,0.0,0.0,38150000,38150000,0,0,38150000,Null,Null,207955003,111461,2
207955621,0.0,0.0,38850000,38850000,0,0,38850000,Null,Null,207955621,111461,2
207958296,216.0,216.0,1514,1514,0,0,1514,Null,Null,207958296,111461,3710
207971156,0.0,0.0,13200000,13200000,0,0,13200000,Null,Null,207971156,180963,11518
207974027,0.0,0.0,17600000,17600000,0,0,17600000,Null,Null,207974027,180963,11518
207974084,28.0,28.0,129000,129000,0,0,129000,Null,Null,207974084,218061,1520
207980573,28.0,28.0,150000,85000,65000,43,150000,Null,Null,207980573,839837,23246
207983440,16.0,16.0,2390000,1890000,500000,21,2390000,Null,Null,207983440,18984,3428
207983477,0.0,0.0,53864000,47400320,6463680,12,53864000,Null,Null,207983477,167287,6653
207990106,3.0,3.0,1000,1000,0,0,1000,Null,Null,207990106,111461,1883
207996003,0.0,0.0,32155000,32155000,0,0,32155000,Null,Null,207996003,167287,6653
208012324,0.0,0.0,1000,1000,0,0,1000,Null,Null,208012324,111461,18888
208015261,0.0,0.0,20404000,17955520,2448480,12,20404000,Null,Null,208015261,167287,6653
208016580,35.0,35.0,790000,696000,94000,12,790000,Null,Null,208016580,20215,2324
208028176,0.0,0.0,17502000,15401760,2100240,12,17502000,Null,Null,208028176,167287,6653
208030616,0.0,0.0,17059000,15011920,2047080,12,17059000,Null,Null,208030616,167287,6653
208037456,0.0,0.0,43821000,38562480,5258520,12,43821000,Null,Null,208037456,167287,6653
208051568,0.0,0.0,49000,49000,0,0,49000,Null,Null,208051568,111461,15320
208051721,2.0,2.0,99000,99000,0,0,99000,Null,Null,208051721,111461,2
208051744,3.0,3.0,85000,85000,0,0,85000,Null,Null,208051744,111461,2
208051825,2.0,2.0,59000,59000,0,0,59000,Null,Null,208051825,111461,2
208056741,54.0,54.0,29000,29000,0,0,29000,Null,Null,208056741,111461,1883
208064355,0.0,0.0,58888000,51821440,7066560,12,58888000,Null,Null,208064355,167287,6653
208065426,0.0,0.0,43053000,37886640,5166360,12,43053000,Null,Null,208065426,167287,6653
208067103,22.0,22.0,339000,339000,0,0,339000,Null,Null,208067103,111461,28454
208068493,22.0,22.0,1099000,1099000,0,0,1099000,Null,Null,208068493,111461,2
208069825,16.0,16.0,120000,78000,42000,35,120000,Null,Null,208069825,111461,1831
208070114,0.0,0.0,33935000,29862800,4072200,12,33935000,Null,Null,208070114,167287,6653
208071124,0.0,0.0,9500,6500,3000,32,9500,Null,Null,208071124,111461,28682
208073416,2.0,2.0,29000,29000,0,0,29000,Null,Null,208073416,111461,2
208073467,0.0,0.0,26999,26999,0,0,26999,Null,Null,208073467,111461,28484
208073722,0.0,0.0,4900,4900,0,0,4900,Null,Null,208073722,111461,1815
208073771,5.0,5.0,4900,4900,0,0,4900,Null,Null,208073771,111461,1815
208074766,0.0,0.0,9500,6500,3000,32,9500,Null,Null,208074766,111461,28480
208080078,0.0,0.0,8100,8100,0,0,8100,Null,Null,208080078,111461,2
208085164,0.0,0.0,9000,9000,0,0,9000,Null,Null,208085164,111461,2
208098794,11.0,11.0,119000,119000,0,0,119000,Null,Null,208098794,111461,3177
208099383,635.0,635.0,67900,67900,0,0,67900,Null,Null,208099383,111461,23622
208113472,0.0,0.0,14000,14000,0,0,14000,Null,Null,208113472,111461,2
208113535,0.0,0.0,10500,10500,0,0,10500,Null,Null,208113535,111461,2
208115782,0.0,0.0,14950000,13455000,1495000,10,14950000,Null,Null,208115782,704815,15250
208118465,0.0,0.0,3750000,3750000,0,0,3750000,Null,Null,208118465,520283,53350
208121667,0.0,0.0,3810000,3810000,0,0,3810000,Null,Null,208121667,262661,53350
208122168,9.0,9.0,749000,749000,0,0,749000,Null,Null,208122168,111461,23276
208126172,0.0,0.0,3050000,3050000,0,0,3050000,Null,Null,208126172,18802,1795
208127708,0.0,0.0,68200000,68200000,0,0,68200000,Null,Null,208127708,162945,28860
208128843,105.0,105.0,279000,193000,86000,31,279000,Null,Null,208128843,204895,23258
208129709,4.0,4.0,190000,96000,94000,49,190000,Null,Null,208129709,111461,15318
208135863,0.0,0.0,40000000,40000000,0,0,40000000,Null,Null,208135863,931671,23834
208137010,0.0,0.0,40000000,40000000,0,0,40000000,Null,Null,208137010,931671,27128
208137098,0.0,0.0,38000000,38000000,0,0,38000000,Null,Null,208137098,931671,27128
208168845,0.0,0.0,38000000,38000000,0,0,38000000,Null,Null,208168845,931671,23834
208169913,0.0,0.0,3549000,3549000,0,0,3549000,Null,Null,208169913,27449,2340
208171115,1.0,1.0,3990000,3990000,0,0,3990000,Null,Null,208171115,112735,1795
208176017,0.0,0.0,124999,124999,0,0,124999,Null,Null,208176017,111461,28576
208183922,5.0,5.0,95000,95000,0,0,95000,Null,Null,208183922,111461,2
208183960,0.0,0.0,98227000,86439760,11787240,12,98227000,Null,Null,208183960,167287,6653
208185161,0.0,0.0,130000,117000,13000,10,130000,Null,Null,208185161,111461,15250
208186085,0.0,0.0,700000,630000,70000,10,700000,Null,Null,208186085,111461,15250
208189272,27.0,27.0,200000,168000,32000,16,200000,Null,Null,208189272,111461,28576
208192685,26.0,26.0,469000,469000,0,0,469000,Null,Null,208192685,111461,23714
208192847,1.0,1.0,690000,690000,0,0,690000,Null,Null,208192847,111461,15318
208193365,12.0,12.0,2990000,2990000,0,0,2990000,Null,Null,208193365,18802,1795
208193462,6.0,6.0,3990000,3190000,800000,20,3990000,Null,Null,208193462,18802,1795
208193909,0.0,0.0,21800000,21364000,436000,2,21800000,Null,Null,208193909,162945,28860
208196269,0.0,0.0,82067000,72218960,9848040,12,82067000,Null,Null,208196269,167287,6653
208196299,59.0,59.0,15948,14499,1449,9,15948,Null,Null,208196299,111461,53074
208207271,221.0,221.0,399000,189000,210000,53,399000,Null,Null,208207271,314675,8400
208213582,1.0,1.0,99000,99000,0,0,99000,Null,Null,208213582,111461,15320
208214305,0.0,0.0,4480000,4121600,358400,8,4480000,Null,Null,208214305,560095,11857
208218028,0.0,0.0,2500,2500,0,0,2500,Null,Null,208218028,111461,1883
208226982,0.0,0.0,1000,1000,0,0,1000,Null,Null,208226982,111461,2363
208227148,116.0,116.0,209000,209000,0,0,209000,Null,Null,208227148,18604,5531
208227259,0.0,0.0,9500,6500,3000,32,9500,Null,Null,208227259,111461,28480
208228256,0.0,0.0,10000,5000,5000,50,10000,Null,Null,208228256,293765,1613
208234887,33.0,33.0,69000,69000,0,0,69000,Null,Null,208234887,5272071,20244
208235151,1.0,1.0,52000,52000,0,0,52000,Null,Null,208235151,111461,15320
208250665,0.0,0.0,41999000,35699000,6300000,15,41999000,Null,Null,208250665,18985,4428
208250671,0.0,0.0,68999000,62099000,6900000,10,68999000,Null,Null,208250671,18985,8067
208255762,0.0,0.0,39800000,32636000,7164000,18,39800000,Null,Null,208255762,162945,11518
208264431,5.0,5.0,8000,7920,80,1,8000,Null,Null,208264431,111461,8309
208264473,5.0,5.0,119000,119000,0,0,119000,Null,Null,208264473,111461,2016
208265006,0.0,0.0,2500,2500,0,0,2500,Null,Null,208265006,111461,23104
208266579,0.0,0.0,2500,2500,0,0,2500,Null,Null,208266579,111461,23104
208267221,1.0,1.0,4830000,3400000,1430000,30,4830000,Null,Null,208267221,47448,1636
208269701,2.0,2.0,6500,6500,0,0,6500,Null,Null,208269701,111461,2
208273199,32.0,32.0,135000,119000,16000,12,135000,Null,Null,208273199,5703717,3177
208286229,0.0,0.0,51566000,45378080,6187920,12,51566000,Null,Null,208286229,167287,6653
208288769,0.0,0.0,56260000,49508800,6751200,12,56260000,Null,Null,208288769,167287,6653
208288896,0.0,0.0,13500000,12800000,700000,5,13500000,Null,Null,208288896,111461,11516
208289268,0.0,0.0,9000,9000,0,0,9000,Null,Null,208289268,111461,8305
208289280,0.0,0.0,102902000,90553760,12348240,12,102902000,Null,Null,208289280,167287,6653
208290305,0.0,0.0,70928000,62416640,8511360,12,70928000,Null,Null,208290305,167287,6653
208290310,0.0,0.0,66500000,64505000,1995000,3,66500000,Null,Null,208290310,162945,28860
208295199,0.0,0.0,22320,18600,3720,17,22320,Null,Null,208295199,111461,2
208295203,0.0,0.0,18000,15000,3000,17,18000,Null,Null,208295203,111461,15236
208295205,0.0,0.0,10800,9000,1800,17,10800,Null,Null,208295205,111461,15236
208295225,0.0,0.0,16560,13800,2760,17,16560,Null,Null,208295225,111461,2
208295250,5.0,5.0,9360,7800,1560,17,9360,Null,Null,208295250,111461,2
208295251,0.0,0.0,16560,13800,2760,17,16560,Null,Null,208295251,111461,2
208295335,0.0,0.0,13680,11400,2280,17,13680,Null,Null,208295335,111461,2
208295398,0.0,0.0,19440,16200,3240,17,19440,Null,Null,208295398,111461,2
208295426,0.0,0.0,22320,18600,3720,17,22320,Null,Null,208295426,111461,2
208295529,1.0,1.0,16560,13800,2760,17,16560,Null,Null,208295529,111461,2
208295604,0.0,0.0,22320,18600,3720,17,22320,Null,Null,208295604,111461,2
208295703,0.0,0.0,7800,7800,0,0,7800,Null,Null,208295703,111461,2
208295814,0.0,0.0,22320,18600,3720,17,22320,Null,Null,208295814,111461,2
208295945,0.0,0.0,22320,18600,3720,17,22320,Null,Null,208295945,111461,2
208296015,1.0,1.0,23760,19800,3960,17,23760,Null,Null,208296015,111461,2
208296066,0.0,0.0,22320,18600,3720,17,22320,Null,Null,208296066,111461,2
208296194,0.0,0.0,13680,11400,2280,17,13680,Null,Null,208296194,111461,2
208296197,0.0,0.0,13680,11400,2280,17,13680,Null,Null,208296197,111461,2
208296209,0.0,0.0,22320,18600,3720,17,22320,Null,Null,208296209,111461,2
208296267,1.0,1.0,19440,16200,3240,17,19440,Null,Null,208296267,111461,2
208296415,0.0,0.0,10080,8400,1680,17,10080,Null,Null,208296415,111461,2
208296417,0.0,0.0,22800,19000,3800,17,22800,Null,Null,208296417,111461,15236
208296444,0.0,0.0,16560,13800,2760,17,16560,Null,Null,208296444,111461,2
208296453,0.0,0.0,22320,18600,3720,17,22320,Null,Null,208296453,111461,2
208296472,0.0,0.0,18000,15000,3000,17,18000,Null,Null,208296472,111461,2
208296480,0.0,0.0,19440,16200,3240,17,19440,Null,Null,208296480,111461,2
208296506,0.0,0.0,22320,18600,3720,17,22320,Null,Null,208296506,111461,2
208296512,0.0,0.0,22320,18600,3720,17,22320,Null,Null,208296512,111461,2
208296546,0.0,0.0,22320,18600,3720,17,22320,Null,Null,208296546,111461,2
208296603,1.0,1.0,18000,15000,3000,17,18000,Null,Null,208296603,111461,2
208296609,0.0,0.0,19440,16200,3240,17,19440,Null,Null,208296609,111461,2
208296622,0.0,0.0,19440,16200,3240,17,19440,Null,Null,208296622,111461,2
208296650,0.0,0.0,22320,18600,3720,17,22320,Null,Null,208296650,111461,2
208296651,0.0,0.0,22320,18600,3720,17,22320,Null,Null,208296651,111461,2
208296738,0.0,0.0,13680,11400,2280,17,13680,Null,Null,208296738,111461,2
208296752,0.0,0.0,7800,7800,0,0,7800,Null,Null,208296752,111461,2
208296767,0.0,0.0,7800,7800,0,0,7800,Null,Null,208296767,111461,2
208296981,1.0,1.0,23760,19800,3960,17,23760,Null,Null,208296981,111461,2
208297000,1.0,1.0,22320,18600,3720,17,22320,Null,Null,208297000,111461,2
208297039,0.0,0.0,18000,15000,3000,17,18000,Null,Null,208297039,111461,2
208297059,0.0,0.0,22320,18600,3720,17,22320,Null,Null,208297059,111461,2
208297157,0.0,0.0,22320,18600,3720,17,22320,Null,Null,208297157,111461,2
208297402,1.0,1.0,19440,16200,3240,17,19440,Null,Null,208297402,111461,2
208297536,0.0,0.0,7200,7200,0,0,7200,Null,Null,208297536,111461,2
208297650,0.0,0.0,21600,18000,3600,17,21600,Null,Null,208297650,111461,2
208297680,0.0,0.0,22800,19000,3800,17,22800,Null,Null,208297680,111461,15236
208297704,0.0,0.0,20880,17400,3480,17,20880,Null,Null,208297704,111461,2
208297815,1.0,1.0,13680,11400,2280,17,13680,Null,Null,208297815,111461,2
208297890,0.0,0.0,22320,18600,3720,17,22320,Null,Null,208297890,111461,2
208297923,0.0,0.0,7800,7800,0,0,7800,Null,Null,208297923,111461,2
208297989,0.0,0.0,22320,18600,3720,17,22320,Null,Null,208297989,111461,2
208297994,0.0,0.0,22320,18600,3720,17,22320,Null,Null,208297994,111461,2
208298006,0.0,0.0,22320,18600,3720,17,22320,Null,Null,208298006,111461,2
208298014,0.0,0.0,8640,7200,1440,17,8640,Null,Null,208298014,111461,2
208298021,0.0,0.0,22320,18600,3720,17,22320,Null,Null,208298021,111461,2
208298035,1.0,1.0,36720,30600,6120,17,36720,Null,Null,208298035,111461,2
208298126,0.0,0.0,13680,11400,2280,17,13680,Null,Null,208298126,111461,2
208298195,1.0,1.0,12240,10200,2040,17,12240,Null,Null,208298195,111461,2
208298235,0.0,0.0,9600,8000,1600,17,9600,Null,Null,208298235,111461,15236
208298323,1.0,1.0,17280,14400,2880,17,17280,Null,Null,208298323,111461,2
208298498,0.0,0.0,18000,15000,3000,17,18000,Null,Null,208298498,111461,2
208298694,0.0,0.0,12960,10800,2160,17,12960,Null,Null,208298694,111461,2
208298744,0.0,0.0,7800,7800,0,0,7800,Null,Null,208298744,111461,2
208303315,2305.0,2305.0,550000,275000,275000,50,550000,Null,Null,208303315,143130,1520
208306354,365.0,365.0,600000,300000,300000,50,600000,Null,Null,208306354,143130,1520
208307487,0.0,0.0,36000000,36000000,0,0,36000000,Null,Null,208307487,111461,23596
208307771,0.0,0.0,23633000,20797040,2835960,12,23633000,Null,Null,208307771,167287,6653
208310613,0.0,0.0,42000000,42000000,0,0,42000000,Null,Null,208310613,111461,23596
208311637,1700.0,1700.0,590000,215000,375000,64,590000,Null,Null,208311637,143130,1520
208315037,0.0,0.0,23151000,23151000,0,0,23151000,Null,Null,208315037,167287,6653
208315064,0.0,0.0,50000000,50000000,0,0,50000000,Null,Null,208315064,111461,23072
208315602,0.0,0.0,39800000,32636000,7164000,18,39800000,Null,Null,208315602,162945,11518
208316413,0.0,0.0,19297000,16981360,2315640,12,19297000,Null,Null,208316413,167287,6653
208323143,0.0,0.0,6941935,6941935,0,0,6941935,Null,Null,208323143,7873343,15250
208323308,0.0,0.0,21850000,21850000,0,0,21850000,Null,Null,208323308,162945,8073
208347289,0.0,0.0,33829000,29769520,4059480,12,33829000,Null,Null,208347289,167287,6653
208347309,0.0,0.0,195000,195000,0,0,195000,Null,Null,208347309,111461,15236
208358685,0.0,0.0,41000000,41000000,0,0,41000000,Null,Null,208358685,111461,23072
208358781,0.0,0.0,4000,4000,0,0,4000,Null,Null,208358781,111461,8205
208358782,0.0,0.0,1999,1999,0,0,1999,Null,Null,208358782,111461,8205
208358813,0.0,0.0,5400,5400,0,0,5400,Null,Null,208358813,111461,8205
208358815,0.0,0.0,5999,5999,0,0,5999,Null,Null,208358815,111461,8205
208358822,0.0,0.0,6960,6960,0,0,6960,Null,Null,208358822,111461,8205
208358823,0.0,0.0,6960,6960,0,0,6960,Null,Null,208358823,111461,8205
208358829,0.0,0.0,6960,6960,0,0,6960,Null,Null,208358829,111461,8205
208358844,0.0,0.0,1999,1999,0,0,1999,Null,Null,208358844,111461,8205
208358858,0.0,0.0,1999,1999,0,0,1999,Null,Null,208358858,111461,8205
208358893,0.0,0.0,6960,6960,0,0,6960,Null,Null,208358893,111461,8205
208358909,0.0,0.0,8000,8000,0,0,8000,Null,Null,208358909,111461,8205
208358912,0.0,0.0,6960,6960,0,0,6960,Null,Null,208358912,111461,8205
208358916,0.0,0.0,10000,10000,0,0,10000,Null,Null,208358916,111461,8205
208358939,0.0,0.0,4200,4200,0,0,4200,Null,Null,208358939,111461,8205
208359114,0.0,0.0,8139570,8139570,0,0,8139570,Null,Null,208359114,7873343,15250
208359147,5.0,5.0,28000,28000,0,0,28000,Null,Null,208359147,111461,2
208359377,1.0,1.0,6000,6000,0,0,6000,Null,Null,208359377,111461,2
208359452,3.0,3.0,149000,149000,0,0,149000,Null,Null,208359452,111461,2
208359562,14.0,14.0,33000,33000,0,0,33000,Null,Null,208359562,111461,49722
208359669,3.0,3.0,54000,54000,0,0,54000,Null,Null,208359669,111461,2
208359777,1.0,1.0,120000,120000,0,0,120000,Null,Null,208359777,111461,2
208359905,2.0,2.0,44000,44000,0,0,44000,Null,Null,208359905,111461,2
208360050,0.0,0.0,1500,1500,0,0,1500,Null,Null,208360050,111461,2
208360070,0.0,0.0,3000,3000,0,0,3000,Null,Null,208360070,111461,2
208360940,23.0,23.0,33000,33000,0,0,33000,Null,Null,208360940,111461,49722
208371329,8.0,8.0,399000,349000,50000,13,399000,Null,Null,208371329,209501,3428
208379729,0.0,0.0,57879000,50933520,6945480,12,57879000,Null,Null,208379729,167287,6653
208386443,0.0,0.0,96448000,84874240,11573760,12,96448000,Null,Null,208386443,167287,6653
208386650,27.0,27.0,200000,200000,0,0,200000,Null,Null,208386650,111461,23276
208402065,0.0,0.0,10000,7000,3000,30,10000,Null,Null,208402065,111461,28480
208403384,0.0,0.0,45000000,45000000,0,0,45000000,Null,Null,208403384,4558659,2340
208403793,0.0,0.0,604000,604000,0,0,604000,Null,Null,208403793,111461,23376
208404790,40.0,40.0,750000,520000,230000,31,750000,Null,Null,208404790,5128115,53350
208404811,30.0,30.0,11000,11000,0,0,11000,Null,Null,208404811,111461,28574
208404893,0.0,0.0,5999000,3899350,2099650,35,5999000,Null,Null,208404893,111461,2340
208408764,114.0,114.0,95000,92000,3000,3,95000,Null,Null,208408764,111461,2
208409574,1.0,1.0,8500,8500,0,0,8500,Null,Null,208409574,886923,1520
208411197,13.0,13.0,375000,375000,0,0,375000,Null,Null,208411197,41391,1883
208411972,3.0,3.0,189000,189000,0,0,189000,Null,Null,208411972,111461,49722
208412807,3.0,3.0,340000,340000,0,0,340000,Null,Null,208412807,41391,1883
208412843,0.0,0.0,17278000,15204640,2073360,12,17278000,Null,Null,208412843,167287,6653
208412888,0.0,0.0,3000,3000,0,0,3000,Null,Null,208412888,111461,8068
208413993,2682.0,2682.0,343000,343000,0,0,343000,Null,Null,208413993,523789,1883
208415213,0.0,0.0,8500,8500,0,0,8500,Null,Null,208415213,111461,8068
208415557,0.0,0.0,12400000,12400000,0,0,12400000,Null,Null,208415557,50331,6653
208418576,34.0,34.0,165000,165000,0,0,165000,Null,Null,208418576,111461,28574
208418804,8.0,8.0,536000,536000,0,0,536000,Null,Null,208418804,5519233,3426
208419062,5.0,5.0,745000,745000,0,0,745000,Null,Null,208419062,5519233,53350
208423823,15.0,15.0,249000,225000,24000,10,249000,Null,Null,208423823,4973949,20244
208427603,0.0,0.0,890000,890000,0,0,890000,Null,Null,208427603,40626,17170
208433202,84.0,84.0,9000,9000,0,0,9000,Null,Null,208433202,4671129,8602
208443049,0.0,0.0,6090000,5786000,304000,5,6090000,Null,Null,208443049,207367,15318
208458845,2.0,2.0,90000,90000,0,0,90000,Null,Null,208458845,111461,15250
208526304,0.0,0.0,4000,3960,40,1,4000,Null,Null,208526304,111461,2
208526511,11.0,11.0,58000,58000,0,0,58000,Null,Null,208526511,111461,2
208568661,203.0,203.0,300000,189000,111000,37,300000,Null,Null,208568661,836453,1883
208587270,0.0,0.0,5500000,4400000,1100000,20,5500000,Null,Null,208587270,258977,3424
208587707,2.0,2.0,4300000,3440000,860000,20,4300000,Null,Null,208587707,416127,1597
208595555,2.0,2.0,850000,850000,0,0,850000,Null,Null,208595555,7401397,28644
208595706,19.0,19.0,935000,850000,85000,9,935000,Null,Null,208595706,7401397,28644
208613683,5.0,5.0,650000,650000,0,0,650000,Null,Null,208613683,516735,53350
208617693,0.0,0.0,8000,8000,0,0,8000,Null,Null,208617693,111461,2
208617781,0.0,0.0,1600,1600,0,0,1600,Null,Null,208617781,111461,2
208617791,5.0,5.0,5000,5000,0,0,5000,Null,Null,208617791,111461,2
208617928,0.0,0.0,8000,8000,0,0,8000,Null,Null,208617928,111461,2
208620686,2.0,2.0,55000,55000,0,0,55000,Null,Null,208620686,111461,49722
208620907,1.0,1.0,120000,120000,0,0,120000,Null,Null,208620907,111461,15236
208621272,3.0,3.0,65000,65000,0,0,65000,Null,Null,208621272,111461,49722
208623373,38.0,38.0,1500000,1100000,400000,27,1500000,Null,Null,208623373,7401397,28644
208623624,3.0,3.0,285000,285000,0,0,285000,Null,Null,208623624,111461,49726
208623782,52.0,52.0,380000,365000,15000,4,380000,Null,Null,208623782,4011099,12590
208623841,1.0,1.0,15000,15000,0,0,15000,Null,Null,208623841,111461,49726
208628673,179.0,179.0,169000,89000,80000,47,169000,Null,Null,208628673,148559,1883
208629582,0.0,0.0,2000,2000,0,0,2000,Null,Null,208629582,111461,8167
208629848,0.0,0.0,2000,2000,0,0,2000,Null,Null,208629848,111461,8205
208630389,0.0,0.0,6500,6500,0,0,6500,Null,Null,208630389,111461,49726
208634554,0.0,0.0,7000,7000,0,0,7000,Null,Null,208634554,111461,8205
208642003,1.0,1.0,60000,30000,30000,50,60000,Null,Null,208642003,111461,1520
208642546,7.0,7.0,10500,10500,0,0,10500,Null,Null,208642546,111461,2
208642621,0.0,0.0,19000,19000,0,0,19000,Null,Null,208642621,111461,2
208642654,0.0,0.0,19000,19000,0,0,19000,Null,Null,208642654,111461,2
208642657,0.0,0.0,14000,14000,0,0,14000,Null,Null,208642657,111461,2
208642661,3.0,3.0,10500,10500,0,0,10500,Null,Null,208642661,111461,2
208642665,0.0,0.0,13000,13000,0,0,13000,Null,Null,208642665,111461,2
208642667,0.0,0.0,19000,19000,0,0,19000,Null,Null,208642667,111461,2
208642694,1.0,1.0,14000,14000,0,0,14000,Null,Null,208642694,111461,2
208642695,1.0,1.0,13000,13000,0,0,13000,Null,Null,208642695,111461,2
208642707,0.0,0.0,10500,10500,0,0,10500,Null,Null,208642707,111461,2
208642796,0.0,0.0,19000,19000,0,0,19000,Null,Null,208642796,111461,2
208642856,2.0,2.0,19000,19000,0,0,19000,Null,Null,208642856,111461,2
208642982,0.0,0.0,10500,10500,0,0,10500,Null,Null,208642982,111461,2
208643088,16.0,16.0,19000,19000,0,0,19000,Null,Null,208643088,111461,2
208643136,0.0,0.0,13000,13000,0,0,13000,Null,Null,208643136,111461,2
208643187,0.0,0.0,10500,10500,0,0,10500,Null,Null,208643187,111461,2
208643925,0.0,0.0,299000,299000,0,0,299000,Null,Null,208643925,191821,28454
208643966,6.0,6.0,1900000,951000,949000,50,1900000,Null,Null,208643966,111461,27212
208644838,7.0,7.0,145000,145000,0,0,145000,Null,Null,208644838,111461,49722
208645157,3.0,3.0,108000,108000,0,0,108000,Null,Null,208645157,111461,2
208645303,2.0,2.0,40000,40000,0,0,40000,Null,Null,208645303,111461,2
208645522,2.0,2.0,59000,59000,0,0,59000,Null,Null,208645522,111461,2
208645696,3.0,3.0,79000,79000,0,0,79000,Null,Null,208645696,111461,2
208658631,1.0,1.0,195000,195000,0,0,195000,Null,Null,208658631,111461,15318
208662917,1.0,1.0,9600,9600,0,0,9600,Null,Null,208662917,111443,1831
208663199,1.0,1.0,120000,120000,0,0,120000,Null,Null,208663199,111461,15318
208678885,1.0,1.0,803000,626340,176660,22,803000,Null,Null,208678885,26150,8511
208679561,1.0,1.0,4000,4000,0,0,4000,Null,Null,208679561,111461,2
208679579,30.0,30.0,2000,2000,0,0,2000,Null,Null,208679579,111461,2238
208680122,0.0,0.0,9900,9900,0,0,9900,Null,Null,208680122,111461,2
208683362,100.0,100.0,39000,39000,0,0,39000,Null,Null,208683362,4298221,28682
208684786,25.0,25.0,38000,38000,0,0,38000,Null,Null,208684786,4298221,28482
208685392,2.0,2.0,51000,32000,19000,37,51000,Null,Null,208685392,111461,15250
208686803,120.0,120.0,300000,300000,0,0,300000,Null,Null,208686803,7882195,28480
208710626,3.0,3.0,45000,28000,17000,38,45000,Null,Null,208710626,111461,15250
208735241,5.0,5.0,39000,32900,6100,16,39000,Null,Null,208735241,111461,15320
208741093,1.0,1.0,6000,6000,0,0,6000,Null,Null,208741093,111461,28434
208762150,27.0,27.0,49900,49900,0,0,49900,Null,Null,208762150,111461,2
208762203,49.0,49.0,49900,49900,0,0,49900,Null,Null,208762203,111461,2
208764396,2.0,2.0,4500000,4500000,0,0,4500000,Null,Null,208764396,111461,2340
208772104,241.0,241.0,199000,199000,0,0,199000,Null,Null,208772104,111461,2225
208779324,296.0,296.0,150000,75000,75000,50,150000,Null,Null,208779324,7400131,15318
208787812,5.0,5.0,750000,750000,0,0,750000,Null,Null,208787812,516735,53350
208789345,8.0,8.0,650000,650000,0,0,650000,Null,Null,208789345,516735,53350
208887143,27.0,27.0,1890000,1749000,141000,7,1890000,Null,Null,208887143,25422,8043
208904899,8.0,8.0,150000,150000,0,0,150000,Null,Null,208904899,111461,15318
208905639,18.0,18.0,1210000,1100000,110000,9,1210000,Null,Null,208905639,7401397,28644
208905997,14.0,14.0,168900,168900,0,0,168900,Null,Null,208905997,111461,28598
208906005,0.0,0.0,11000,9989,1011,9,11000,Null,Null,208906005,111461,7064
208906554,0.0,0.0,22900000,22900000,0,0,22900000,Null,Null,208906554,50307,2324
208907275,24.0,24.0,350000,199000,151000,43,350000,Null,Null,208907275,4244853,12908
208914464,0.0,0.0,23500000,23500000,0,0,23500000,Null,Null,208914464,167287,2324
208950173,0.0,0.0,60500000,60500000,0,0,60500000,Null,Null,208950173,167287,11518
209004790,0.0,0.0,62500000,62500000,0,0,62500000,Null,Null,209004790,167287,11518
209069007,1.0,1.0,8200000,8200000,0,0,8200000,Null,Null,209069007,860053,8371
209123860,0.0,0.0,170000,147899,22101,13,170000,Null,Null,209123860,111461,28596
209165246,0.0,0.0,168000,168000,0,0,168000,Null,Null,209165246,111461,2
209171777,4.0,4.0,5500,5500,0,0,5500,Null,Null,209171777,111461,5905
209299763,0.0,0.0,1490000,1490000,0,0,1490000,Null,Null,209299763,111684,1795
209304265,0.0,0.0,6000,6000,0,0,6000,Null,Null,209304265,111461,2
209304282,10.0,10.0,4000,4000,0,0,4000,Null,Null,209304282,111461,2
209304306,0.0,0.0,9000,9000,0,0,9000,Null,Null,209304306,111461,2
209304385,0.0,0.0,5000,5000,0,0,5000,Null,Null,209304385,111461,2
209304415,0.0,0.0,9000,9000,0,0,9000,Null,Null,209304415,111461,2
209304452,0.0,0.0,7900,7900,0,0,7900,Null,Null,209304452,111461,2
209304461,0.0,0.0,3500,3500,0,0,3500,Null,Null,209304461,111461,2
209304463,7.0,7.0,5900,5900,0,0,5900,Null,Null,209304463,111461,2
209304486,0.0,0.0,2900,2900,0,0,2900,Null,Null,209304486,111461,2
209304499,0.0,0.0,1250,1250,0,0,1250,Null,Null,209304499,111461,2
209304740,0.0,0.0,7900,7900,0,0,7900,Null,Null,209304740,111461,2
209304930,0.0,0.0,8000,8000,0,0,8000,Null,Null,209304930,111461,2
209304933,0.0,0.0,1999000,1999000,0,0,1999000,Null,Null,209304933,4702981,2324
209305237,34.0,34.0,230000,230000,0,0,230000,Null,Null,209305237,8066475,8309
209306407,16.0,16.0,10900000,9600000,1300000,12,10900000,Null,Null,209306407,20215,2324
209318518,3.0,3.0,13600000,13600000,0,0,13600000,Null,Null,209318518,111461,2657
209318767,64.0,64.0,178000,178000,0,0,178000,Null,Null,209318767,200189,11857
209331207,79.0,79.0,112000,112000,0,0,112000,Null,Null,209331207,200189,11851
209349550,70.0,70.0,70000,59000,11000,16,70000,Null,Null,209349550,4244853,28480
209350910,0.0,0.0,2900,2900,0,0,2900,Null,Null,209350910,111461,8167
209350967,0.0,0.0,3990,3990,0,0,3990,Null,Null,209350967,111461,8167
209351002,0.0,0.0,13900000,13900000,0,0,13900000,Null,Null,209351002,111461,8167
209351063,0.0,0.0,3000,3000,0,0,3000,Null,Null,209351063,111461,8167
209351194,0.0,0.0,19900000,19900000,0,0,19900000,Null,Null,209351194,111461,8167
209351319,0.0,0.0,15900000,15900000,0,0,15900000,Null,Null,209351319,111461,2
209351373,12.0,12.0,9000,4500,4500,50,9000,Null,Null,209351373,111461,8167
209351417,0.0,0.0,16990000,16990000,0,0,16990000,Null,Null,209351417,111461,8167
209351446,0.0,0.0,19500000,19500000,0,0,19500000,Null,Null,209351446,111461,2
209351587,90.0,90.0,3500,3500,0,0,3500,Null,Null,209351587,111461,2
209351737,0.0,0.0,20000000,20000000,0,0,20000000,Null,Null,209351737,111461,8167
209351749,0.0,0.0,20000000,20000000,0,0,20000000,Null,Null,209351749,111461,8167
209351855,0.0,0.0,9900,9900,0,0,9900,Null,Null,209351855,111461,2
209363624,1.0,1.0,110000,110000,0,0,110000,Null,Null,209363624,111461,15320
209378509,1.0,1.0,1200000,1200000,0,0,1200000,Null,Null,209378509,25697,8061
209379972,0.0,0.0,1000,1000,0,0,1000,Null,Null,209379972,111461,23596
209385055,0.0,0.0,10990000,10990000,0,0,10990000,Null,Null,209385055,18802,1795
209386721,0.0,0.0,5900000,5900000,0,0,5900000,Null,Null,209386721,111461,15318
209387107,0.0,0.0,38000000,38000000,0,0,38000000,Null,Null,209387107,111461,11858
209387390,20.0,20.0,168999,168999,0,0,168999,Null,Null,209387390,5207801,11923
209387491,0.0,0.0,17000000,17000000,0,0,17000000,Null,Null,209387491,111461,2
209387568,0.0,0.0,13000000,13000000,0,0,13000000,Null,Null,209387568,111461,2
209387598,0.0,0.0,120000000,120000000,0,0,120000000,Null,Null,209387598,111461,2
209387678,0.0,0.0,50000000,50000000,0,0,50000000,Null,Null,209387678,111461,2
209388034,19.0,19.0,168900,168900,0,0,168900,Null,Null,209388034,5207801,11923
209388747,1.0,1.0,177000,177000,0,0,177000,Null,Null,209388747,111461,2020
209389809,120.0,120.0,6290000,5690000,600000,10,6290000,Null,Null,209389809,183637,28856
209391268,253.0,253.0,1600000,928000,672000,42,1600000,Null,Null,209391268,4524605,2
209391316,0.0,0.0,53864000,47400320,6463680,12,53864000,Null,Null,209391316,167287,6653
209399423,22.0,22.0,11000,11000,0,0,11000,Null,Null,209399423,111461,28576
209399977,1.0,1.0,9590000,9590000,0,0,9590000,Null,Null,209399977,183637,28856
209399979,1.0,1.0,980000,499000,481000,49,980000,Null,Null,209399979,4647777,15250
209400551,0.0,0.0,150000,89000,61000,41,150000,Null,Null,209400551,111461,3177
209400804,0.0,0.0,24780000,21806400,2973600,12,24780000,Null,Null,209400804,167287,6653
209403390,0.0,0.0,60645000,53367600,7277400,12,60645000,Null,Null,209403390,167287,6653
209407817,0.0,0.0,11000000,11000000,0,0,11000000,Null,Null,209407817,111461,8167
209407860,0.0,0.0,15000000,15000000,0,0,15000000,Null,Null,209407860,111461,2
209407875,0.0,0.0,3000,3000,0,0,3000,Null,Null,209407875,111461,2
209407880,0.0,0.0,9000,9000,0,0,9000,Null,Null,209407880,111461,2
209407952,14.0,14.0,6000,3000,3000,50,6000,Null,Null,209407952,111461,2
209407981,0.0,0.0,19990000,19990000,0,0,19990000,Null,Null,209407981,111461,8167
209408015,0.0,0.0,19900000,19900000,0,0,19900000,Null,Null,209408015,111461,8167
209408022,0.0,0.0,6990000,6990000,0,0,6990000,Null,Null,209408022,111461,2
209408063,0.0,0.0,20000000,20000000,0,0,20000000,Null,Null,209408063,111461,8167
209408065,0.0,0.0,8000,8000,0,0,8000,Null,Null,209408065,111461,2
209408137,0.0,0.0,20000000,20000000,0,0,20000000,Null,Null,209408137,111461,2
209408150,0.0,0.0,20000000,20000000,0,0,20000000,Null,Null,209408150,111461,2
209408189,0.0,0.0,20000000,20000000,0,0,20000000,Null,Null,209408189,111461,8167
209408223,0.0,0.0,5000,5000,0,0,5000,Null,Null,209408223,111461,2
209408243,0.0,0.0,10900000,10900000,0,0,10900000,Null,Null,209408243,111461,2
209408276,0.0,0.0,8100000,8100000,0,0,8100000,Null,Null,209408276,111461,2
209408283,0.0,0.0,20000000,20000000,0,0,20000000,Null,Null,209408283,111461,2
209408317,0.0,0.0,9900,9900,0,0,9900,Null,Null,209408317,111461,2
209408348,0.0,0.0,4500,4500,0,0,4500,Null,Null,209408348,111461,2
209408359,0.0,0.0,13900000,13900000,0,0,13900000,Null,Null,209408359,111461,8167
209408439,0.0,0.0,13000000,13000000,0,0,13000000,Null,Null,209408439,111461,2
209408508,0.0,0.0,50000000,50000000,0,0,50000000,Null,Null,209408508,111461,2
209408528,0.0,0.0,38000000,38000000,0,0,38000000,Null,Null,209408528,111461,2
209408598,0.0,0.0,120000000,120000000,0,0,120000000,Null,Null,209408598,111461,2
209418727,114.0,114.0,389000,325000,64000,16,389000,Null,Null,209418727,929841,11935
209419753,0.0,0.0,140000000,140000000,0,0,140000000,Null,Null,209419753,4558659,2340
209432168,13.0,13.0,230000,230000,0,0,230000,Null,Null,209432168,243693,28688
209558037,0.0,0.0,5993548,5993548,0,0,5993548,Null,Null,209558037,7873343,15250
209561536,1.0,1.0,120000,120000,0,0,120000,Null,Null,209561536,111461,15250
209572630,23.0,23.0,29000,29000,0,0,29000,Null,Null,209572630,4973949,20244
209580167,0.0,0.0,6290000,6290000,0,0,6290000,Null,Null,209580167,183637,28856
209602705,33.0,33.0,205000,205000,0,0,205000,Null,Null,209602705,7282629,8172
209603615,197.0,197.0,1705000,1374000,331000,19,1705000,Null,Null,209603615,4250493,1883
209603741,0.0,0.0,1000,1000,0,0,1000,Null,Null,209603741,111461,2363
209606076,0.0,0.0,150000,135000,15000,10,150000,Null,Null,209606076,111461,15318
209608175,0.0,0.0,82000,82000,0,0,82000,Null,Null,209608175,111461,28682
209611417,0.0,0.0,39550000,39550000,0,0,39550000,Null,Null,209611417,111461,2
209863739,11.0,11.0,250000,250000,0,0,250000,Null,Null,209863739,111461,1815
209865206,13.0,13.0,545000,545000,0,0,545000,Null,Null,209865206,7428177,28574
209872337,27.0,27.0,3100000,2751000,349000,11,3100000,Null,Null,209872337,147856,28856
209877208,0.0,0.0,3850000,3850000,0,0,3850000,Null,Null,209877208,234023,11911
209887488,38.0,38.0,400000,320000,80000,20,400000,Null,Null,209887488,423495,3177
209906521,0.0,0.0,5000,5000,0,0,5000,Null,Null,209906521,111461,2
209908758,0.0,0.0,8000,8000,0,0,8000,Null,Null,209908758,111461,2
209921298,0.0,0.0,12750000,12750000,0,0,12750000,Null,Null,209921298,749425,28870
209927605,49.0,49.0,3100000,3100000,0,0,3100000,Null,Null,209927605,147856,28856
210126059,0.0,0.0,24880000,18660000,6220000,25,24880000,Null,Null,210126059,174699,8513
210126064,0.0,0.0,25750000,19312500,6437500,25,25750000,Null,Null,210126064,174699,8513
210126073,0.0,0.0,18860000,14145000,4715000,25,18860000,Null,Null,210126073,174699,8513
210126079,0.0,0.0,10100000,7575000,2525000,25,10100000,Null,Null,210126079,174699,8513
210126081,0.0,0.0,16020000,12015000,4005000,25,16020000,Null,Null,210126081,174699,8513
210126085,0.0,0.0,17200000,12900000,4300000,25,17200000,Null,Null,210126085,174699,8513
210126087,0.0,0.0,20580000,15435000,5145000,25,20580000,Null,Null,210126087,174699,8513
210126089,0.0,0.0,6060000,4545000,1515000,25,6060000,Null,Null,210126089,174699,8513
210126091,0.0,0.0,7900000,5925000,1975000,25,7900000,Null,Null,210126091,174699,8513
210126093,0.0,0.0,8960000,6720000,2240000,25,8960000,Null,Null,210126093,174699,8513
210126094,0.0,0.0,12400000,9300000,3100000,25,12400000,Null,Null,210126094,174699,8513
210126097,0.0,0.0,19460000,14595000,4865000,25,19460000,Null,Null,210126097,174699,8513
210126099,0.0,0.0,10100000,7575000,2525000,25,10100000,Null,Null,210126099,174699,8513
210126103,0.0,0.0,19460000,14595000,4865000,25,19460000,Null,Null,210126103,174699,8513
210126109,0.0,0.0,10800000,8100000,2700000,25,10800000,Null,Null,210126109,174699,8513
210126117,0.0,0.0,8050000,6037500,2012500,25,8050000,Null,Null,210126117,174699,8516
210126121,0.0,0.0,11220000,8415000,2805000,25,11220000,Null,Null,210126121,174699,8513
210126123,0.0,0.0,24880000,18660000,6220000,25,24880000,Null,Null,210126123,174699,8513
210126127,0.0,0.0,18250000,13687500,4562500,25,18250000,Null,Null,210126127,174699,8513
210126129,0.0,0.0,9000000,6750000,2250000,25,9000000,Null,Null,210126129,174699,8513
210126131,0.0,0.0,13000000,9750000,3250000,25,13000000,Null,Null,210126131,174699,8513
210126135,0.0,0.0,24880000,18660000,6220000,25,24880000,Null,Null,210126135,174699,8513
210126141,0.0,0.0,25750000,19312500,6437500,25,25750000,Null,Null,210126141,174699,8513
210126143,0.0,0.0,9772000,7329000,2443000,25,9772000,Null,Null,210126143,174699,8513
210126149,0.0,0.0,7800000,5850000,1950000,25,7800000,Null,Null,210126149,174699,8513
210126159,0.0,0.0,9000000,6750000,2250000,25,9000000,Null,Null,210126159,174699,8513
210126161,0.0,0.0,9410000,7057500,2352500,25,9410000,Null,Null,210126161,174699,8516
210126168,0.0,0.0,25750000,19312500,6437500,25,25750000,Null,Null,210126168,174699,8513
210126172,0.0,0.0,19460000,14595000,4865000,25,19460000,Null,Null,210126172,174699,8513
210126176,0.0,0.0,8980000,6735000,2245000,25,8980000,Null,Null,210126176,174699,8513
210126178,0.0,0.0,23160000,17370000,5790000,25,23160000,Null,Null,210126178,174699,8513
210126182,0.0,0.0,8000000,6000000,2000000,25,8000000,Null,Null,210126182,174699,8513
210126184,0.0,0.0,8300000,6225000,2075000,25,8300000,Null,Null,210126184,174699,8513
210126188,0.0,0.0,12400000,9300000,3100000,25,12400000,Null,Null,210126188,174699,8513
210126192,0.0,0.0,11220000,8415000,2805000,25,11220000,Null,Null,210126192,174699,8513
210126194,0.0,0.0,8500000,6375000,2125000,25,8500000,Null,Null,210126194,174699,8513
210126198,0.0,0.0,7990000,5992500,1997500,25,7990000,Null,Null,210126198,174699,8513
210126204,0.0,0.0,19500000,14625000,4875000,25,19500000,Null,Null,210126204,174699,8513
210126206,0.0,0.0,8600000,6450000,2150000,25,8600000,Null,Null,210126206,174699,8513
210126210,0.0,0.0,24280000,18210000,6070000,25,24280000,Null,Null,210126210,174699,8513
210126212,0.0,0.0,24280000,18210000,6070000,25,24280000,Null,Null,210126212,174699,8513
210126214,0.0,0.0,11220000,8415000,2805000,25,11220000,Null,Null,210126214,174699,8513
210126216,0.0,0.0,19200000,14400000,4800000,25,19200000,Null,Null,210126216,174699,8513
210126218,0.0,0.0,8320000,6240000,2080000,25,8320000,Null,Null,210126218,174699,8516
210126220,0.0,0.0,20060000,15045000,5015000,25,20060000,Null,Null,210126220,174699,8513
210126222,0.0,0.0,8510000,6382500,2127500,25,8510000,Null,Null,210126222,174699,8513
210126228,1.0,1.0,11220000,8415000,2805000,25,11220000,Null,Null,210126228,174699,8513
210126230,0.0,0.0,8050000,6037500,2012500,25,8050000,Null,Null,210126230,174699,8516
210126238,0.0,0.0,7800000,6450000,1350000,17,7800000,Null,Null,210126238,174699,8513
210126246,0.0,0.0,8320000,6240000,2080000,25,8320000,Null,Null,210126246,174699,8516
210126250,0.0,0.0,8140000,6105000,2035000,25,8140000,Null,Null,210126250,174699,8513
210133106,0.0,0.0,5000,5000,0,0,5000,Null,Null,210133106,111461,8205
210133555,0.0,0.0,199999,199999,0,0,199999,Null,Null,210133555,111461,2340
210145024,316.0,316.0,50000,50000,0,0,50000,Null,Null,210145024,520061,27180
210145114,2281.0,2281.0,85000,55000,30000,35,85000,Null,Null,210145114,245063,1520
210145739,1.0,1.0,32990000,32990000,0,0,32990000,Null,Null,210145739,5232357,6653
210155164,5.0,5.0,750000,750000,0,0,750000,Null,Null,210155164,5660745,11741
210155364,4.0,4.0,750000,750000,0,0,750000,Null,Null,210155364,5660745,11741
210155429,0.0,0.0,44800000,44800000,0,0,44800000,Null,Null,210155429,622025,12590
210155453,0.0,0.0,44000000,44000000,0,0,44000000,Null,Null,210155453,622025,23576
210155584,0.0,0.0,85850000,85850000,0,0,85850000,Null,Null,210155584,622025,23576
210163818,0.0,0.0,15500000,15500000,0,0,15500000,Null,Null,210163818,111461,8066
210164006,0.0,0.0,49000000,44100000,4900000,10,49000000,Null,Null,210164006,850093,23710
210165487,0.0,0.0,13990000,13990000,0,0,13990000,Null,Null,210165487,111461,8066
210273569,0.0,0.0,12500000,12500000,0,0,12500000,Null,Null,210273569,111461,28870
210273613,0.0,0.0,4008000,4008000,0,0,4008000,Null,Null,210273613,25643,1795
210275857,0.0,0.0,56000000,56000000,0,0,56000000,Null,Null,210275857,111461,2
210275859,0.0,0.0,36000000,36000000,0,0,36000000,Null,Null,210275859,111461,2
210275868,0.0,0.0,60000000,60000000,0,0,60000000,Null,Null,210275868,111461,2
210275872,0.0,0.0,39000000,39000000,0,0,39000000,Null,Null,210275872,111461,2
210275876,0.0,0.0,56000000,56000000,0,0,56000000,Null,Null,210275876,111461,2
210275889,0.0,0.0,51000000,51000000,0,0,51000000,Null,Null,210275889,111461,2
210276277,0.0,0.0,1000,1000,0,0,1000,Null,Null,210276277,111461,2
210276349,60.0,60.0,36000,19900,16100,45,36000,Null,Null,210276349,154455,23416
210280612,0.0,0.0,6290000,5690000,600000,10,6290000,Null,Null,210280612,25643,1795
210399317,1.0,1.0,150000,150000,0,0,150000,Null,Null,210399317,111461,15236
210399669,1.0,1.0,3890000,3890000,0,0,3890000,Null,Null,210399669,18804,2334
210400058,0.0,0.0,99000,62000,37000,37,99000,Null,Null,210400058,111461,2340
210403445,0.0,0.0,5000,5000,0,0,5000,Null,Null,210403445,111461,8205
210417481,17.0,17.0,60000,40000,20000,33,60000,Null,Null,210417481,7881679,27214
210418503,0.0,0.0,14390000,14390000,0,0,14390000,Null,Null,210418503,111461,11516
210426536,0.0,0.0,179999999,179999999,0,0,179999999,Null,Null,210426536,542569,2340
210427921,2.0,2.0,400000,360000,40000,10,400000,Null,Null,210427921,111461,15250
210435920,0.0,0.0,9000,9000,0,0,9000,Null,Null,210435920,111461,8205
210435964,0.0,0.0,5000,5000,0,0,5000,Null,Null,210435964,111461,8205
210435971,0.0,0.0,7000,7000,0,0,7000,Null,Null,210435971,111461,8205
210435975,1.0,1.0,7500,7500,0,0,7500,Null,Null,210435975,111461,8205
210436107,0.0,0.0,7000,7000,0,0,7000,Null,Null,210436107,111461,8205
210436139,0.0,0.0,9000,9000,0,0,9000,Null,Null,210436139,111461,8205
210436190,0.0,0.0,9000,9000,0,0,9000,Null,Null,210436190,111461,8205
210436192,0.0,0.0,6000,6000,0,0,6000,Null,Null,210436192,111461,8205
210436193,0.0,0.0,9000,9000,0,0,9000,Null,Null,210436193,111461,8205
210436196,0.0,0.0,9000,9000,0,0,9000,Null,Null,210436196,111461,8205
210436230,0.0,0.0,9000,9000,0,0,9000,Null,Null,210436230,111461,8205
210436270,3.0,3.0,9000,9000,0,0,9000,Null,Null,210436270,111461,8205
210436274,0.0,0.0,9000,9000,0,0,9000,Null,Null,210436274,111461,8205
210436305,0.0,0.0,5000,5000,0,0,5000,Null,Null,210436305,111461,8205
210436380,0.0,0.0,9000,9000,0,0,9000,Null,Null,210436380,111461,8205
210436410,0.0,0.0,2000,2000,0,0,2000,Null,Null,210436410,111461,8205
210436415,4.0,4.0,7000,7000,0,0,7000,Null,Null,210436415,111461,8205
210436419,0.0,0.0,9000,9000,0,0,9000,Null,Null,210436419,111461,8205
210436427,0.0,0.0,9000,9000,0,0,9000,Null,Null,210436427,111461,8205
210436445,0.0,0.0,9000,9000,0,0,9000,Null,Null,210436445,111461,8205
210436477,0.0,0.0,9000,9000,0,0,9000,Null,Null,210436477,111461,8205
210436497,0.0,0.0,9000,9000,0,0,9000,Null,Null,210436497,111461,8205
210436506,0.0,0.0,4000,4000,0,0,4000,Null,Null,210436506,111461,8205
210436651,0.0,0.0,9000,9000,0,0,9000,Null,Null,210436651,111461,8202
210436693,1.0,1.0,5000,5000,0,0,5000,Null,Null,210436693,111461,8205
210436695,0.0,0.0,9000,9000,0,0,9000,Null,Null,210436695,111461,8205
210441088,95.0,95.0,140000,70000,70000,50,140000,Null,Null,210441088,174069,1815
210444653,58.0,58.0,44900,44900,0,0,44900,Null,Null,210444653,5706641,7713
210458939,445.0,445.0,25000,25000,0,0,25000,Null,Null,210458939,5706641,2514
210640771,0.0,0.0,27900000,27900000,0,0,27900000,Null,Null,210640771,7480987,2977
210645975,0.0,0.0,17950000,17950000,0,0,17950000,Null,Null,210645975,7480987,2977
210702707,0.0,0.0,18100000,18100000,0,0,18100000,Null,Null,210702707,7480987,2977
210763480,2.0,2.0,35000,35000,0,0,35000,Null,Null,210763480,111461,2
210763499,4.0,4.0,25000,25000,0,0,25000,Null,Null,210763499,111461,2
210938221,27.0,27.0,65000,65000,0,0,65000,Null,Null,210938221,111461,2514
210938274,5.0,5.0,450000,450000,0,0,450000,Null,Null,210938274,4228599,53350
210946702,28.0,28.0,140000,70000,70000,50,140000,Null,Null,210946702,111461,53048
210966402,24.0,24.0,254700,239000,15700,6,254700,Null,Null,210966402,21274,4413
210966404,66.0,66.0,254700,240000,14700,6,254700,Null,Null,210966404,21274,4413
210968407,1.0,1.0,4360000,4360000,0,0,4360000,Null,Null,210968407,405211,8511
211026139,0.0,0.0,9500,9500,0,0,9500,Null,Null,211026139,111461,2
211026171,0.0,0.0,8280,8280,0,0,8280,Null,Null,211026171,111461,2
211026978,0.0,0.0,9000,9000,0,0,9000,Null,Null,211026978,111461,2
211027346,0.0,0.0,3960000,3960000,0,0,3960000,Null,Null,211027346,111461,2
211027390,0.0,0.0,3360000,3360000,0,0,3360000,Null,Null,211027390,111461,2
211027748,0.0,0.0,3360000,3360000,0,0,3360000,Null,Null,211027748,111461,2
211106550,43.0,43.0,2000,2000,0,0,2000,Null,Null,211106550,111461,27214
211287503,0.0,0.0,22000,22000,0,0,22000,Null,Null,211287503,111461,2
211300611,58.0,58.0,259000,259000,0,0,259000,Null,Null,211300611,111461,2
211925726,30.0,30.0,200000,137000,63000,32,200000,Null,Null,211925726,868633,23258
211926469,60.0,60.0,200000,137000,63000,32,200000,Null,Null,211926469,868633,23258
211936081,49.0,49.0,1355000,1355000,0,0,1355000,Null,Null,211936081,2630119,2657
211961006,34.0,34.0,49900,49900,0,0,49900,Null,Null,211961006,111461,6305
211961875,45.0,45.0,45000,45000,0,0,45000,Null,Null,211961875,5706641,2225
211966421,4.0,4.0,850000,850000,0,0,850000,Null,Null,211966421,464767,8206
211998542,38.0,38.0,70000,59000,11000,16,70000,Null,Null,211998542,4244853,12908
212035287,0.0,0.0,31348000,31348000,0,0,31348000,Null,Null,212035287,50307,11518
212036619,636.0,636.0,179100,169000,10100,6,179100,Null,Null,212036619,21265,8220
212036623,737.0,737.0,199000,169000,30000,15,199000,Null,Null,212036623,21265,8220
212036624,495.0,495.0,199000,169000,30000,15,199000,Null,Null,212036624,21265,8220
212036625,23.0,23.0,391000,358000,33000,8,391000,Null,Null,212036625,21265,8223
212036633,36.0,36.0,89100,86000,3100,3,89100,Null,Null,212036633,21266,8308
212040689,0.0,0.0,2800000,2139000,661000,24,2800000,Null,Null,212040689,18802,1795
212040697,9.0,9.0,2990000,1950000,1040000,35,2990000,Null,Null,212040697,18802,1795
212041281,1.0,1.0,2750000,2475000,275000,10,2750000,Null,Null,212041281,704815,15250
212041344,1.0,1.0,8000,8000,0,0,8000,Null,Null,212041344,111461,28480
212052026,255.0,255.0,1600000,809000,791000,49,1600000,Null,Null,212052026,4524605,2
212053643,0.0,0.0,17000000,17000000,0,0,17000000,Null,Null,212053643,111461,2
212054319,26.0,26.0,300000,259000,41000,14,300000,Null,Null,212054319,4244853,28596
212080088,1.0,1.0,1220000,1098000,122000,10,1220000,Null,Null,212080088,704815,15236
212083883,1.0,1.0,120000,120000,0,0,120000,Null,Null,212083883,111461,15236
212109576,0.0,0.0,53500000,53500000,0,0,53500000,Null,Null,212109576,167287,7079
212109587,0.0,0.0,63970000,47977500,15992500,25,63970000,Null,Null,212109587,167287,7079
212109606,0.0,0.0,30500000,30500000,0,0,30500000,Null,Null,212109606,167287,11518
212109652,0.0,0.0,31970000,31970000,0,0,31970000,Null,Null,212109652,167287,7079
212109664,0.0,0.0,31970000,31970000,0,0,31970000,Null,Null,212109664,167287,7079
212112841,105.0,105.0,48000,39000,9000,19,48000,Null,Null,212112841,7986307,2685
212114493,478.0,478.0,35000,18000,17000,49,35000,Null,Null,212114493,7986307,2685
212142932,76.0,76.0,1400000,1400000,0,0,1400000,Null,Null,212142932,2630119,2657
212211967,0.0,0.0,4500000,4450000,50000,1,4500000,Null,Null,212211967,111461,2340
212219580,5670.0,5670.0,1664000,832000,832000,50,1664000,Null,Null,212219580,48077,11833
212251150,0.0,0.0,20000000,20000000,0,0,20000000,Null,Null,212251150,111461,2
212251159,0.0,0.0,15000000,15000000,0,0,15000000,Null,Null,212251159,111461,2
212251277,0.0,0.0,8200000,8200000,0,0,8200000,Null,Null,212251277,111461,2
212251322,0.0,0.0,8000,8000,0,0,8000,Null,Null,212251322,111461,2
212251326,0.0,0.0,12000000,12000000,0,0,12000000,Null,Null,212251326,111461,8167
212251408,91.0,91.0,3500,3500,0,0,3500,Null,Null,212251408,111461,2
212251503,0.0,0.0,19990000,19990000,0,0,19990000,Null,Null,212251503,111461,8167
212251537,0.0,0.0,9900,9900,0,0,9900,Null,Null,212251537,111461,2
212251573,0.0,0.0,20000000,20000000,0,0,20000000,Null,Null,212251573,111461,2
212251584,0.0,0.0,2900,2900,0,0,2900,Null,Null,212251584,111461,2
212251586,0.0,0.0,17900000,17900000,0,0,17900000,Null,Null,212251586,111461,8167
212251863,0.0,0.0,20000000,20000000,0,0,20000000,Null,Null,212251863,111461,8167
212251867,0.0,0.0,14900000,14900000,0,0,14900000,Null,Null,212251867,111461,8167
212251873,0.0,0.0,19000000,19000000,0,0,19000000,Null,Null,212251873,111461,2
212251927,0.0,0.0,19900000,19900000,0,0,19900000,Null,Null,212251927,111461,8167
212251983,10.0,10.0,3500,3500,0,0,3500,Null,Null,212251983,111461,2
212252016,0.0,0.0,20000000,20000000,0,0,20000000,Null,Null,212252016,111461,8167
212252044,0.0,0.0,5900000,5900000,0,0,5900000,Null,Null,212252044,111461,2
212252105,0.0,0.0,9000,9000,0,0,9000,Null,Null,212252105,111461,2
212252129,0.0,0.0,20000000,20000000,0,0,20000000,Null,Null,212252129,111461,8167
212252183,0.0,0.0,17000000,17000000,0,0,17000000,Null,Null,212252183,111461,8167
212252274,0.0,0.0,14990000,14990000,0,0,14990000,Null,Null,212252274,111461,2
212252358,0.0,0.0,9900,9900,0,0,9900,Null,Null,212252358,111461,2
212252380,0.0,0.0,3000,3000,0,0,3000,Null,Null,212252380,111461,2
212253912,0.0,0.0,87000000,87000000,0,0,87000000,Null,Null,212253912,111461,23072
212254795,0.0,0.0,12500000,12500000,0,0,12500000,Null,Null,212254795,426805,2340
212256585,0.0,0.0,75000000,75000000,0,0,75000000,Null,Null,212256585,111461,23642
212256596,104.0,104.0,385000,312000,73000,19,385000,Null,Null,212256596,22393,11867
212261734,13.0,13.0,799000,656000,143000,18,799000,Null,Null,212261734,112638,1796
212263564,0.0,0.0,14800000,14800000,0,0,14800000,Null,Null,212263564,50368,7079
212265002,110.0,110.0,500000,259000,241000,48,500000,Null,Null,212265002,4244853,28480
212266213,24.0,24.0,400000,349000,51000,13,400000,Null,Null,212266213,4244853,28682
212284040,0.0,0.0,27500000,27500000,0,0,27500000,Null,Null,212284040,144527,11518
212284053,0.0,0.0,27500000,27500000,0,0,27500000,Null,Null,212284053,144527,11518
212305321,0.0,0.0,2000,2000,0,0,2000,Null,Null,212305321,111461,1883
212307364,0.0,0.0,1000,1000,0,0,1000,Null,Null,212307364,111461,2
212315272,3.0,3.0,24999,24999,0,0,24999,Null,Null,212315272,111461,28482
212315417,45.0,45.0,260000,156000,104000,40,260000,Null,Null,212315417,4224691,2016
212317072,240.0,240.0,1734000,683000,1051000,61,1734000,Null,Null,212317072,560863,1520
212317160,357.0,357.0,1358000,546000,812000,60,1358000,Null,Null,212317160,145337,1520
212317974,0.0,0.0,1300,1300,0,0,1300,Null,Null,212317974,111461,2
212324916,0.0,0.0,7956000,7956000,0,0,7956000,Null,Null,212324916,25643,1795
212325991,2.0,2.0,3990000,3090000,900000,23,3990000,Null,Null,212325991,18802,1795
212326387,1.0,1.0,3990000,3090000,900000,23,3990000,Null,Null,212326387,18802,1795
212329190,0.0,0.0,8784000,8784000,0,0,8784000,Null,Null,212329190,25643,1795
212329629,0.0,0.0,3990000,3090000,900000,23,3990000,Null,Null,212329629,18802,1795
212329857,0.0,0.0,2088000,2088000,0,0,2088000,Null,Null,212329857,25422,1795
212358089,0.0,0.0,3800,3800,0,0,3800,Null,Null,212358089,111461,8167
212426710,2.0,2.0,5340000,5340000,0,0,5340000,Null,Null,212426710,5158377,1520
212437190,97.0,97.0,1500,1500,0,0,1500,Null,Null,212437190,111461,2
212437578,0.0,0.0,2500,2500,0,0,2500,Null,Null,212437578,111461,2
212438296,0.0,0.0,1500,1500,0,0,1500,Null,Null,212438296,111461,2
212441034,4.0,4.0,1790000,1550000,240000,13,1790000,Null,Null,212441034,19673,1795
212461378,0.0,0.0,3450000,3450000,0,0,3450000,Null,Null,212461378,18804,1626
212470196,0.0,0.0,96368800,96368800,0,0,96368800,Null,Null,212470196,50307,20170
212470482,0.0,0.0,20000000,12300000,7700000,39,20000000,Null,Null,212470482,233903,1795
212475633,18.0,18.0,115000,115000,0,0,115000,Null,Null,212475633,111461,23228
212480216,0.0,0.0,1899,1899,0,0,1899,Null,Null,212480216,111461,2337
212480238,0.0,0.0,1800,1800,0,0,1800,Null,Null,212480238,111461,2337
212579759,0.0,0.0,17500000,16500000,1000000,6,17500000,Null,Null,212579759,111461,7079
212581012,5.0,5.0,326000,326000,0,0,326000,Null,Null,212581012,8045451,2512
212598370,21.0,21.0,420000,299000,121000,29,420000,Null,Null,212598370,454561,11821
212603809,7.0,7.0,53900,52000,1900,4,53900,Null,Null,212603809,111461,12294
212610521,8.0,8.0,399000,399000,0,0,399000,Null,Null,212610521,111461,20172
212877516,2.0,2.0,46000,46000,0,0,46000,Null,Null,212877516,111461,15320
212920866,0.0,0.0,3000,2970,30,1,3000,Null,Null,212920866,111461,8194
212920878,20.0,20.0,6000,6000,0,0,6000,Null,Null,212920878,111461,8194
212920886,0.0,0.0,4000,3000,1000,25,4000,Null,Null,212920886,111461,8194
212920898,1.0,1.0,8000,6000,2000,25,8000,Null,Null,212920898,111461,7064
212924392,5.0,5.0,1590000,1489000,101000,6,1590000,Null,Null,212924392,19673,1796
212926651,20.0,20.0,12490000,8689000,3801000,30,12490000,Null,Null,212926651,18802,1795
212933615,0.0,0.0,62700000,62700000,0,0,62700000,Null,Null,212933615,4558659,2340
212937639,0.0,0.0,10500,7000,3500,33,10500,Null,Null,212937639,111461,2
212937720,0.0,0.0,10500,7000,3500,33,10500,Null,Null,212937720,111461,2
212939102,272.0,272.0,55000,46750,8250,15,55000,Null,Null,212939102,111461,1883
212964538,13.0,13.0,1069000,989000,80000,7,1069000,Null,Null,212964538,146479,5531
212965949,3.0,3.0,469000,469000,0,0,469000,Null,Null,212965949,5073869,28682
212981004,146.0,146.0,30000,28000,2000,7,30000,Null,Null,212981004,111461,1815
212981027,541.0,541.0,25000,23000,2000,8,25000,Null,Null,212981027,111461,1815
212981758,2.0,2.0,230000,230000,0,0,230000,Null,Null,212981758,111461,1815
212981900,529.0,529.0,19000,18050,950,5,19000,Null,Null,212981900,111461,1520
212981915,0.0,0.0,6685000,6685000,0,0,6685000,Null,Null,212981915,25502,8511
212981956,1896.0,1896.0,155000,142600,12400,8,155000,Null,Null,212981956,111461,1520
212981958,51.0,51.0,250000,237500,12500,5,250000,Null,Null,212981958,111461,8371
212982010,240.0,240.0,45000,42750,2250,5,45000,Null,Null,212982010,111461,1520
212983311,0.0,0.0,13385000,13385000,0,0,13385000,Null,Null,212983311,25502,8511
212985953,287.0,287.0,20000,19000,1000,5,20000,Null,Null,212985953,111461,1883
212986033,3.0,3.0,60000,60000,0,0,60000,Null,Null,212986033,111461,1883
212986423,287.0,287.0,45000,40500,4500,10,45000,Null,Null,212986423,111461,1520
212987456,270.0,270.0,30000,26700,3300,11,30000,Null,Null,212987456,111461,1883
212989598,23.0,23.0,1000,1000,0,0,1000,Null,Null,212989598,111461,2363
212991350,0.0,0.0,6685000,6685000,0,0,6685000,Null,Null,212991350,25502,8511
213127543,0.0,0.0,122839200,122839200,0,0,122839200,Null,Null,213127543,50307,20170
213488317,0.0,0.0,80652000,80652000,0,0,80652000,Null,Null,213488317,50307,20170
213490467,0.0,0.0,87507200,87507200,0,0,87507200,Null,Null,213490467,50307,20170
213490729,541.0,541.0,1189000,739000,450000,38,1189000,Null,Null,213490729,146479,1811
213491032,3.0,3.0,548000,548000,0,0,548000,Null,Null,213491032,886169,1883
213491413,52.0,52.0,175000,175000,0,0,175000,Null,Null,213491413,215231,1815
213495385,0.0,0.0,87507200,87507200,0,0,87507200,Null,Null,213495385,50307,20170
213499929,1.0,1.0,2000,2000,0,0,2000,Null,Null,213499929,111461,23576
213516869,73.0,73.0,130000,94000,36000,28,130000,Null,Null,213516869,7986307,1883
213517500,513.0,513.0,45000,42750,2250,5,45000,Null,Null,213517500,111461,1520
213521442,0.0,0.0,4080000,4080000,0,0,4080000,Null,Null,213521442,111461,2
213521743,0.0,0.0,4080000,4080000,0,0,4080000,Null,Null,213521743,111461,2
213522498,1.0,1.0,50000000,34990000,15010000,30,50000000,Null,Null,213522498,18851,12864
213523286,1.0,1.0,99000,96030,2970,3,99000,Null,Null,213523286,111461,15236
213523398,0.0,0.0,75275200,75275200,0,0,75275200,Null,Null,213523398,50307,20170
213524047,1.0,1.0,11416000,11416000,0,0,11416000,Null,Null,213524047,167287,1805
213524622,18.0,18.0,299000,293020,5980,2,299000,Null,Null,213524622,8078587,1978
213544275,0.0,0.0,34500000,33465000,1035000,3,34500000,Null,Null,213544275,50307,20170
213548889,0.0,0.0,99600000,81672000,17928000,18,99600000,Null,Null,213548889,50307,6653
213548920,0.0,0.0,17400000,13050000,4350000,25,17400000,Null,Null,213548920,50307,20170
213558352,22.0,22.0,179000,179000,0,0,179000,Null,Null,213558352,111461,2
213560025,0.0,0.0,8500,8500,0,0,8500,Null,Null,213560025,111461,2
213560227,0.0,0.0,1400,1400,0,0,1400,Null,Null,213560227,111461,2
213560310,0.0,0.0,4499,4499,0,0,4499,Null,Null,213560310,111461,2
213562696,4.0,4.0,190000,169585,20415,11,190000,Null,Null,213562696,4973949,28428
213564074,32.0,32.0,199000,199000,0,0,199000,Null,Null,213564074,8062221,53348
213564093,65.0,65.0,650001,650001,0,0,650001,Null,Null,213564093,2630119,2657
213565184,90.0,90.0,129000,129000,0,0,129000,Null,Null,213565184,111461,23052
213568542,7.0,7.0,3999000,3013000,986000,25,3999000,Null,Null,213568542,18984,5264
213580871,0.0,0.0,17400000,13050000,4350000,25,17400000,Null,Null,213580871,50307,20170
213581778,0.0,0.0,99600000,81672000,17928000,18,99600000,Null,Null,213581778,50307,6653
213585719,0.0,0.0,96368800,93477736,2891064,3,96368800,Null,Null,213585719,50307,20170
213587929,0.0,0.0,2135000,2135000,0,0,2135000,Null,Null,213587929,18802,1795
213591008,66.0,66.0,165000,140250,24750,15,165000,Null,Null,213591008,726687,11821
213598665,0.0,0.0,87507200,84881984,2625216,3,87507200,Null,Null,213598665,50307,20170
213598840,0.0,0.0,87507200,84881984,2625216,3,87507200,Null,Null,213598840,50307,20170
213669919,51.0,51.0,18000,9000,9000,50,18000,Null,Null,213669919,4246951,8602
213672639,0.0,0.0,565000,565000,0,0,565000,Null,Null,213672639,33203,20258
213672886,0.0,0.0,122839200,119154024,3685176,3,122839200,Null,Null,213672886,50307,20170
213672911,0.0,0.0,565000,565000,0,0,565000,Null,Null,213672911,33203,20258
213673173,0.0,0.0,565000,565000,0,0,565000,Null,Null,213673173,33203,20258
213673341,0.0,0.0,565000,565000,0,0,565000,Null,Null,213673341,33203,20258
213673427,0.0,0.0,565000,565000,0,0,565000,Null,Null,213673427,33203,20258
213674099,15.0,15.0,295000,295000,0,0,295000,Null,Null,213674099,8081277,1627
213674222,0.0,0.0,2000,2000,0,0,2000,Null,Null,213674222,111461,23104
213674261,0.0,0.0,2000,2000,0,0,2000,Null,Null,213674261,111461,23622
213674266,0.0,0.0,2000,2000,0,0,2000,Null,Null,213674266,111461,23104
213674290,0.0,0.0,1500,1500,0,0,1500,Null,Null,213674290,111461,23112
213674408,0.0,0.0,565000,565000,0,0,565000,Null,Null,213674408,33203,20258
213674718,0.0,0.0,565000,565000,0,0,565000,Null,Null,213674718,33203,20258
213674869,0.0,0.0,565000,565000,0,0,565000,Null,Null,213674869,33203,20258
213675111,0.0,0.0,565000,565000,0,0,565000,Null,Null,213675111,33203,20258
213676877,0.0,0.0,565000,565000,0,0,565000,Null,Null,213676877,33203,20258
213676953,0.0,0.0,400000,400000,0,0,400000,Null,Null,213676953,33203,20492
213677123,0.0,0.0,400000,400000,0,0,400000,Null,Null,213677123,33203,20492
213677462,0.0,0.0,400000,400000,0,0,400000,Null,Null,213677462,33203,20492
213677541,0.0,0.0,375000,375000,0,0,375000,Null,Null,213677541,33203,20492
213678014,0.0,0.0,375000,375000,0,0,375000,Null,Null,213678014,33203,20492
213683638,2.0,2.0,149000,149000,0,0,149000,Null,Null,213683638,111461,2
213683890,0.0,0.0,48500000,48500000,0,0,48500000,Null,Null,213683890,50307,6653
213684259,724.0,724.0,330000,320100,9900,3,330000,Null,Null,213684259,421185,1520
213684918,0.0,0.0,55300000,55300000,0,0,55300000,Null,Null,213684918,50307,6653
213688337,0.0,0.0,35000000,32200000,2800000,8,35000000,Null,Null,213688337,50307,20170
213692049,34.0,34.0,150000,119000,31000,21,150000,Null,Null,213692049,111461,23678
213697606,0.0,0.0,11085000,11085000,0,0,11085000,Null,Null,213697606,25502,8511
213698030,0.0,0.0,22720000,22720000,0,0,22720000,Null,Null,213698030,185209,26652
213698600,150.0,150.0,18000,9000,9000,50,18000,Null,Null,213698600,4246951,8602
213699149,0.0,0.0,48490000,43640000,4850000,10,48490000,Null,Null,213699149,18641,28868
213700492,0.0,0.0,31990000,28790000,3200000,10,31990000,Null,Null,213700492,18641,8067
213701520,146.0,146.0,49000,44000,5000,10,49000,Null,Null,213701520,4973949,1831
213701543,0.0,0.0,13990000,12590000,1400000,10,13990000,Null,Null,213701543,18641,8067
213703377,0.0,0.0,18800000,17296000,1504000,8,18800000,Null,Null,213703377,50307,20170
213703719,0.0,0.0,82990000,82990000,0,0,82990000,Null,Null,213703719,18641,1803
213703931,0.0,0.0,34990000,34990000,0,0,34990000,Null,Null,213703931,18641,1803
213704068,43.0,43.0,650000,552500,97500,15,650000,Null,Null,213704068,423495,3177
213704069,53.0,53.0,650000,552500,97500,15,650000,Null,Null,213704069,423495,3177
213704078,87.0,87.0,650000,552500,97500,15,650000,Null,Null,213704078,423495,3177
213704895,67.0,67.0,79000,79000,0,0,79000,Null,Null,213704895,111461,20492
213708355,0.0,0.0,16730000,16730000,0,0,16730000,Null,Null,213708355,50307,20170
213708603,0.0,0.0,14722400,14722400,0,0,14722400,Null,Null,213708603,50307,20170
213710307,396.0,396.0,139000,139000,0,0,139000,Null,Null,213710307,569677,1883
213710576,1.0,1.0,175000,175000,0,0,175000,Null,Null,213710576,111461,15236
213711382,0.0,0.0,6000,6000,0,0,6000,Null,Null,213711382,5714829,11921
213714531,0.0,0.0,450000,450000,0,0,450000,Null,Null,213714531,33203,20252
213714626,0.0,0.0,450000,450000,0,0,450000,Null,Null,213714626,33203,20252
213715031,0.0,0.0,2990000,2270000,720000,24,2990000,Null,Null,213715031,111461,1795
213715321,0.0,0.0,69200000,63664000,5536000,8,69200000,Null,Null,213715321,50307,20170
213718782,0.0,0.0,144716000,144716000,0,0,144716000,Null,Null,213718782,50307,20170
213720287,0.0,0.0,30694400,30694400,0,0,30694400,Null,Null,213720287,50307,20170
213731018,12.0,12.0,380000,190000,190000,50,380000,Null,Null,213731018,111461,15318
213740950,0.0,0.0,3290000,2649000,641000,19,3290000,Null,Null,213740950,111461,1795
213742250,0.0,0.0,2590000,2258000,332000,13,2590000,Null,Null,213742250,111461,1795
213767721,0.0,0.0,1900,1900,0,0,1900,Null,Null,213767721,111461,2
213774367,1.0,1.0,479000,479000,0,0,479000,Null,Null,213774367,111461,15318
213775928,0.0,0.0,8600,8600,0,0,8600,Null,Null,213775928,111461,2
213808726,10.0,10.0,2000,2000,0,0,2000,Null,Null,213808726,111461,2
213809226,1.0,1.0,599000,599000,0,0,599000,Null,Null,213809226,111461,15318
213830181,0.0,0.0,7700,7700,0,0,7700,Null,Null,213830181,111461,2
213830368,2.0,2.0,8400,8400,0,0,8400,Null,Null,213830368,111461,2
213830430,0.0,0.0,12000,12000,0,0,12000,Null,Null,213830430,111461,2
213830782,0.0,0.0,2000,2000,0,0,2000,Null,Null,213830782,111461,5450
213840695,0.0,0.0,19700000,18124000,1576000,8,19700000,Null,Null,213840695,50307,20170
213842271,0.0,0.0,5540000,4420000,1120000,20,5540000,Null,Null,213842271,111461,1795
213846637,0.0,0.0,3970000,3240000,730000,18,3970000,Null,Null,213846637,111461,1795
213847375,0.0,0.0,20800000,20800000,0,0,20800000,Null,Null,213847375,50307,20170
213848231,0.0,0.0,38880000,38880000,0,0,38880000,Null,Null,213848231,50307,20170
213851317,3.0,3.0,2500,2500,0,0,2500,Null,Null,213851317,111461,2
213851415,7.0,7.0,329000,329000,0,0,329000,Null,Null,213851415,111461,2
213851603,0.0,0.0,1500,1500,0,0,1500,Null,Null,213851603,111461,2
213851629,0.0,0.0,3500,3500,0,0,3500,Null,Null,213851629,111461,2
213851668,0.0,0.0,9000,9000,0,0,9000,Null,Null,213851668,111461,2
213855927,0.0,0.0,3420000,2776000,644000,19,3420000,Null,Null,213855927,111461,1795
213858174,0.0,0.0,4690000,4690000,0,0,4690000,Null,Null,213858174,18802,1794
213865898,0.0,0.0,3700000,3650000,50000,1,3700000,Null,Null,213865898,199801,11885
213867027,0.0,0.0,8900000,8800000,100000,1,8900000,Null,Null,213867027,199801,11885
213868303,0.0,0.0,4000,4000,0,0,4000,Null,Null,213868303,111461,8224
213868487,0.0,0.0,1000,1000,0,0,1000,Null,Null,213868487,111461,5450
213869049,0.0,0.0,4190000,4190000,0,0,4190000,Null,Null,213869049,25643,1795
213869527,0.0,0.0,9900,9900,0,0,9900,Null,Null,213869527,111461,15320
213872094,1.0,1.0,9900,9900,0,0,9900,Null,Null,213872094,111461,15320
213883908,1.0,1.0,290000,180000,110000,38,290000,Null,Null,213883908,111461,15318
213892321,0.0,0.0,4250000,4250000,0,0,4250000,Null,Null,213892321,18802,1795
213892728,0.0,0.0,3270000,2449000,821000,25,3270000,Null,Null,213892728,18802,1795
213893316,0.0,0.0,9975000,9975000,0,0,9975000,Null,Null,213893316,18802,1795
213894484,0.0,0.0,9990000,9990000,0,0,9990000,Null,Null,213894484,18802,1795
213912320,0.0,0.0,6250000,5080000,1170000,19,6250000,Null,Null,213912320,18802,1795
213912743,0.0,0.0,52900000,52900000,0,0,52900000,Null,Null,213912743,31701,2340
213912894,0.0,0.0,26550000,26550000,0,0,26550000,Null,Null,213912894,50331,11518
213913762,0.0,0.0,5690000,5690000,0,0,5690000,Null,Null,213913762,18802,1795
213914131,127.0,127.0,210000,210000,0,0,210000,Null,Null,213914131,156239,1936
213914447,0.0,0.0,26550000,26550000,0,0,26550000,Null,Null,213914447,50331,11518
213922375,0.0,0.0,74250000,74250000,0,0,74250000,Null,Null,213922375,50307,11518
213924158,20.0,20.0,119000,116000,3000,3,119000,Null,Null,213924158,149308,28576
213925303,0.0,0.0,4950000,3845000,1105000,22,4950000,Null,Null,213925303,18802,1795
213926485,0.0,0.0,5390000,4200000,1190000,22,5390000,Null,Null,213926485,18802,1795
213930100,0.0,0.0,31086000,31086000,0,0,31086000,Null,Null,213930100,50307,8067
213931136,0.0,0.0,15372000,15372000,0,0,15372000,Null,Null,213931136,50307,11518
213931247,0.0,0.0,3370000,3370000,0,0,3370000,Null,Null,213931247,18802,1795
213935079,0.0,0.0,39537000,39537000,0,0,39537000,Null,Null,213935079,50307,2324
213936914,4.0,4.0,290000,170810,119190,41,290000,Null,Null,213936914,318953,11857
213949527,0.0,0.0,23600000,23600000,0,0,23600000,Null,Null,213949527,162945,28860
213950069,0.0,0.0,1000,1000,0,0,1000,Null,Null,213950069,111461,2
213951157,0.0,0.0,1000,1000,0,0,1000,Null,Null,213951157,111461,2
213951997,0.0,0.0,31653000,31653000,0,0,31653000,Null,Null,213951997,50307,11518
213952135,0.0,0.0,3090000,2569000,521000,17,3090000,Null,Null,213952135,18802,1795
213952670,0.0,0.0,40302000,40302000,0,0,40302000,Null,Null,213952670,50307,8067
213953263,20.0,20.0,647000,647000,0,0,647000,Null,Null,213953263,111461,11859
213953706,0.0,0.0,1000,1000,0,0,1000,Null,Null,213953706,111461,2
213953778,0.0,0.0,2750000,2258000,492000,18,2750000,Null,Null,213953778,18802,1795
213954130,0.0,0.0,3150000,2592000,558000,18,3150000,Null,Null,213954130,18802,1795
213954520,0.0,0.0,43056000,43056000,0,0,43056000,Null,Null,213954520,50307,28860
213954863,0.0,0.0,12375000,12375000,0,0,12375000,Null,Null,213954863,50307,28866
213955260,0.0,0.0,80667000,80667000,0,0,80667000,Null,Null,213955260,50307,8067
213955438,0.0,0.0,23734000,23734000,0,0,23734000,Null,Null,213955438,50307,28860
213958821,0.0,0.0,8190000,8190000,0,0,8190000,Null,Null,213958821,25502,8513
213963207,0.0,0.0,4000,4000,0,0,4000,Null,Null,213963207,111461,7064
213963749,0.0,0.0,5800000,5800000,0,0,5800000,Null,Null,213963749,111461,15318
213964274,0.0,0.0,23734000,23734000,0,0,23734000,Null,Null,213964274,50307,28860
213964494,0.0,0.0,80667000,80667000,0,0,80667000,Null,Null,213964494,50307,8067
213964784,0.0,0.0,12375000,12375000,0,0,12375000,Null,Null,213964784,50307,28866
213964811,0.0,0.0,4260000,3385000,875000,21,4260000,Null,Null,213964811,25643,1795
213964858,0.0,0.0,43056000,43056000,0,0,43056000,Null,Null,213964858,50307,28860
213965396,0.0,0.0,38000000,38000000,0,0,38000000,Null,Null,213965396,50307,8067
213965556,0.0,0.0,31653000,31653000,0,0,31653000,Null,Null,213965556,50307,11518
213965739,0.0,0.0,35800000,35800000,0,0,35800000,Null,Null,213965739,50307,2324
213965838,0.0,0.0,15372000,15372000,0,0,15372000,Null,Null,213965838,50307,11518
213966012,0.0,0.0,29500000,29500000,0,0,29500000,Null,Null,213966012,50307,8067
213966191,0.0,0.0,69500000,66025000,3475000,5,69500000,Null,Null,213966191,50307,11518
213968859,0.0,0.0,34200000,34200000,0,0,34200000,Null,Null,213968859,50307,11516
213969615,0.0,0.0,9950000,9450000,500000,5,9950000,Null,Null,213969615,25643,1795
213987981,32.0,32.0,490000,289000,201000,41,490000,Null,Null,213987981,18802,1815
213998389,0.0,0.0,15000000,15000000,0,0,15000000,Null,Null,213998389,111461,28868
213998701,0.0,0.0,17000000,17000000,0,0,17000000,Null,Null,213998701,111461,28868
213998734,0.0,0.0,24000000,24000000,0,0,24000000,Null,Null,213998734,111461,28868
214003108,2.0,2.0,29000,29000,0,0,29000,Null,Null,214003108,111461,15320
214005482,0.0,0.0,31890000,31252200,637800,2,31890000,Null,Null,214005482,50307,2324
214005705,0.0,0.0,42590000,41312300,1277700,3,42590000,Null,Null,214005705,50307,2324
214006393,0.0,0.0,17950000,17950000,0,0,17950000,Null,Null,214006393,50307,2324
214009013,4.0,4.0,57500,47000,10500,18,57500,Null,Null,214009013,111461,23244
214009033,0.0,0.0,14100000,14100000,0,0,14100000,Null,Null,214009033,50307,2324
214009252,0.0,0.0,18500000,18500000,0,0,18500000,Null,Null,214009252,50307,2324
214009931,0.0,0.0,36900000,35793000,1107000,3,36900000,Null,Null,214009931,50307,11516
214010916,0.0,0.0,15000,15000,0,0,15000,Null,Null,214010916,185677,15318
214014514,0.0,0.0,6000,6000,0,0,6000,Null,Null,214014514,111461,20222
214064585,34.0,34.0,129000,91000,38000,29,129000,Null,Null,214064585,8076595,2513
214068338,41.0,41.0,390000,360000,30000,8,390000,Null,Null,214068338,8095661,2659
214073018,0.0,0.0,1000,1000,0,0,1000,Null,Null,214073018,111461,2
214074550,0.0,0.0,6000,6000,0,0,6000,Null,Null,214074550,111461,20222
214075208,88.0,88.0,204000,204000,0,0,204000,Null,Null,214075208,746615,23258
214076170,0.0,0.0,38400000,38400000,0,0,38400000,Null,Null,214076170,111461,23430
214076595,0.0,0.0,1000,1000,0,0,1000,Null,Null,214076595,111461,2
214077258,0.0,0.0,1000,1000,0,0,1000,Null,Null,214077258,111461,2
214080318,0.0,0.0,1000,1000,0,0,1000,Null,Null,214080318,111461,2
214083395,0.0,0.0,749000,620000,129000,17,749000,Null,Null,214083395,150568,1796
214088304,0.0,0.0,16200000,15714000,486000,3,16200000,Null,Null,214088304,52315,6653
214088323,0.0,0.0,539000,539000,0,0,539000,Null,Null,214088323,886169,23034
214088337,0.0,0.0,36490000,36490000,0,0,36490000,Null,Null,214088337,52315,2324
214088725,0.0,0.0,177150000,177150000,0,0,177150000,Null,Null,214088725,111461,23102
214088857,0.0,0.0,17900000,17900000,0,0,17900000,Null,Null,214088857,50307,2324
214088981,0.0,0.0,16300000,16300000,0,0,16300000,Null,Null,214088981,52315,2324
214089019,0.0,0.0,13900000,13900000,0,0,13900000,Null,Null,214089019,50307,2324
214089072,0.0,0.0,42590000,42590000,0,0,42590000,Null,Null,214089072,50307,2324
214089360,0.0,0.0,161000000,161000000,0,0,161000000,Null,Null,214089360,111461,23102
214089814,43.0,43.0,293000,240000,53000,18,293000,Null,Null,214089814,22653,4413
214097385,3.0,3.0,13000,13000,0,0,13000,Null,Null,214097385,111461,2
214097401,1.0,1.0,59000,59000,0,0,59000,Null,Null,214097401,111461,15236
214097675,0.0,0.0,16500,16500,0,0,16500,Null,Null,214097675,111461,15236
214097794,0.0,0.0,8000,8000,0,0,8000,Null,Null,214097794,111461,2
214098091,0.0,0.0,12000,12000,0,0,12000,Null,Null,214098091,111461,2
214098831,0.0,0.0,15000,15000,0,0,15000,Null,Null,214098831,111461,2
214098901,0.0,0.0,15000,15000,0,0,15000,Null,Null,214098901,111461,2
214099220,0.0,0.0,1000,1000,0,0,1000,Null,Null,214099220,111461,2
214099346,2.0,2.0,139000,139000,0,0,139000,Null,Null,214099346,111461,2
214099700,3.0,3.0,9000,9000,0,0,9000,Null,Null,214099700,111461,2
214099722,0.0,0.0,16900,16900,0,0,16900,Null,Null,214099722,111461,15236
214099732,0.0,0.0,9900,9900,0,0,9900,Null,Null,214099732,111461,2
214099963,0.0,0.0,15000,15000,0,0,15000,Null,Null,214099963,111461,2
214101073,0.0,0.0,16000,16000,0,0,16000,Null,Null,214101073,111461,2
214101276,84.0,84.0,350000,169000,181000,52,350000,Null,Null,214101276,5379677,3177
214101372,29869.0,29869.0,414000,220000,194000,47,414000,Null,Null,214101372,185075,1583
214101654,221.0,221.0,275000,275000,0,0,275000,Null,Null,214101654,111461,1613
214115117,532.0,532.0,7000,4700,2300,33,7000,Null,Null,214115117,4524605,1520
214117614,0.0,0.0,6900,6900,0,0,6900,Null,Null,214117614,111461,28472
214132298,0.0,0.0,3700000,3515000,185000,5,3700000,Null,Null,214132298,5382095,2
214132520,0.0,0.0,3800000,3610000,190000,5,3800000,Null,Null,214132520,5382095,2
214132545,0.0,0.0,3800000,3610000,190000,5,3800000,Null,Null,214132545,5382095,2
214132584,0.0,0.0,9200000,8740000,460000,5,9200000,Null,Null,214132584,5382095,2
214132894,0.0,0.0,5500000,5500000,0,0,5500000,Null,Null,214132894,5382095,2
214133206,0.0,0.0,9500000,9025000,475000,5,9500000,Null,Null,214133206,5382095,2
214133221,0.0,0.0,5200000,4940000,260000,5,5200000,Null,Null,214133221,5382095,2
214133263,0.0,0.0,7500000,7125000,375000,5,7500000,Null,Null,214133263,5382095,2
214143153,25.0,25.0,1890000,1651100,238900,13,1890000,Null,Null,214143153,147856,28856
214151172,30.0,30.0,1000,1000,0,0,1000,Null,Null,214151172,111461,2
214151723,35.0,35.0,55000,55000,0,0,55000,Null,Null,214151723,418727,1883
214154015,509.0,509.0,259000,249000,10000,4,259000,Null,Null,214154015,4244853,1815
214154630,0.0,0.0,29900000,29900000,0,0,29900000,Null,Null,214154630,939519,28862
214155220,0.0,0.0,32900000,32900000,0,0,32900000,Null,Null,214155220,939519,28862
214168962,421.0,421.0,290000,250000,40000,14,290000,Null,Null,214168962,20215,4428
214189806,9.0,9.0,65000,50998,14002,22,65000,Null,Null,214189806,111461,28574
214194630,13.0,13.0,38000,38000,0,0,38000,Null,Null,214194630,111461,9052
214195933,0.0,0.0,8700000,7917000,783000,9,8700000,Null,Null,214195933,560095,11873
214196813,9.0,9.0,603000,572000,31000,5,603000,Null,Null,214196813,114328,2347
214230523,2899.0,2899.0,3004000,1165000,1839000,61,3004000,Null,Null,214230523,259827,1520
214231996,20.0,20.0,42000,25200,16800,40,42000,Null,Null,214231996,111461,15318
214238901,6.0,6.0,3450,3450,0,0,3450,Null,Null,214238901,111461,28472
214239185,0.0,0.0,6900,6900,0,0,6900,Null,Null,214239185,111461,28472
214239253,3.0,3.0,34500,34500,0,0,34500,Null,Null,214239253,111461,28472
214239290,0.0,0.0,9200,9200,0,0,9200,Null,Null,214239290,111461,28472
214239331,0.0,0.0,11730000,11730000,0,0,11730000,Null,Null,214239331,111461,28472
214239474,0.0,0.0,15985000,15985000,0,0,15985000,Null,Null,214239474,111461,28472
214240221,0.0,0.0,5750,5750,0,0,5750,Null,Null,214240221,111461,28472
214240309,0.0,0.0,8050,8050,0,0,8050,Null,Null,214240309,111461,28472
214240325,0.0,0.0,9200,9200,0,0,9200,Null,Null,214240325,111461,28472
214240334,0.0,0.0,14835000,14835000,0,0,14835000,Null,Null,214240334,111461,28472
214240340,0.0,0.0,5750,5750,0,0,5750,Null,Null,214240340,111461,28472
214240342,0.0,0.0,5750,5750,0,0,5750,Null,Null,214240342,111461,28472
214241497,0.0,0.0,5750,5750,0,0,5750,Null,Null,214241497,111461,28472
214241693,0.0,0.0,6900,6900,0,0,6900,Null,Null,214241693,111461,28472
214241748,0.0,0.0,5175,5175,0,0,5175,Null,Null,214241748,111461,28472
214241751,5.0,5.0,8050,8050,0,0,8050,Null,Null,214241751,111461,28472
214241808,0.0,0.0,5750,5750,0,0,5750,Null,Null,214241808,111461,28472
214242270,0.0,0.0,5750,5750,0,0,5750,Null,Null,214242270,111461,28472
214242357,0.0,0.0,5750,5750,0,0,5750,Null,Null,214242357,111461,28472
214242664,164.0,164.0,7932000,3404000,4528000,57,7932000,Null,Null,214242664,239653,1520
214487322,1.0,1.0,13690000,11820000,1870000,14,13690000,Null,Null,214487322,21673,2324
214488337,0.0,0.0,18990000,16400000,2590000,14,18990000,Null,Null,214488337,21673,7079
214490597,44.0,44.0,39000,37000,2000,5,39000,Null,Null,214490597,111461,12294
214498115,0.0,0.0,10000,9000,1000,10,10000,Null,Null,214498115,4238765,13878
214502510,7.0,7.0,1050000,945000,105000,10,1050000,Null,Null,214502510,704815,15320
214502861,38.0,38.0,5000000,3600000,1400000,28,5000000,Null,Null,214502861,631569,2340
214503686,2.0,2.0,119000,106000,13000,11,119000,Null,Null,214503686,111461,15318
214509232,0.0,0.0,1000,1000,0,0,1000,Null,Null,214509232,111461,2
214511295,0.0,0.0,2000,2000,0,0,2000,Null,Null,214511295,111461,2
214511757,0.0,0.0,1000,1000,0,0,1000,Null,Null,214511757,111461,2
214515827,2.0,2.0,840000,490000,350000,42,840000,Null,Null,214515827,281769,49722
214578715,0.0,0.0,29000,29000,0,0,29000,Null,Null,214578715,111461,15318
214583407,3.0,3.0,98000,98000,0,0,98000,Null,Null,214583407,111461,3990
214591205,8.0,8.0,1390000,1390000,0,0,1390000,Null,Null,214591205,3216013,12864
214591703,9.0,9.0,289000,225000,64000,22,289000,Null,Null,214591703,111461,28454
214592281,18.0,18.0,60000,55000,5000,8,60000,Null,Null,214592281,592131,27180
214594983,95.0,95.0,64000,64000,0,0,64000,Null,Null,214594983,111461,2
214603586,0.0,0.0,2690000,2006000,684000,25,2690000,Null,Null,214603586,18802,1795
214608398,0.0,0.0,9000,9000,0,0,9000,Null,Null,214608398,111461,2
214610861,0.0,0.0,10000,9000,1000,10,10000,Null,Null,214610861,111461,2
214610906,0.0,0.0,10000,9000,1000,10,10000,Null,Null,214610906,111461,2
214612355,0.0,0.0,9000,8000,1000,11,9000,Null,Null,214612355,111461,2
214614554,203.0,203.0,210000,201000,9000,4,210000,Null,Null,214614554,111461,1883
214614720,0.0,0.0,3500000,3500000,0,0,3500000,Null,Null,214614720,258977,2347
214615864,144.0,144.0,1734000,1734000,0,0,1734000,Null,Null,214615864,145335,1520
214618500,0.0,0.0,1950000,1950000,0,0,1950000,Null,Null,214618500,111461,4380
214619069,0.0,0.0,5000,4950,50,1,5000,Null,Null,214619069,111461,2
214619184,127.0,127.0,170000,79000,91000,54,170000,Null,Null,214619184,111461,23634
214621635,0.0,0.0,36775973,36775973,0,0,36775973,Null,Null,214621635,111461,2
214621780,0.0,0.0,2452,2452,0,0,2452,Null,Null,214621780,111461,2
214623224,0.0,0.0,42292369,42292369,0,0,42292369,Null,Null,214623224,111461,2
214623308,0.0,0.0,38000000,38000000,0,0,38000000,Null,Null,214623308,111461,2
214624390,0.0,0.0,48000000,48000000,0,0,48000000,Null,Null,214624390,111461,2
214624553,0.0,0.0,42750000,42750000,0,0,42750000,Null,Null,214624553,111461,2
214624878,0.0,0.0,41368832,41368832,0,0,41368832,Null,Null,214624878,111461,2
214624938,0.0,0.0,36000000,36000000,0,0,36000000,Null,Null,214624938,111461,2
214625349,0.0,0.0,40000000,40000000,0,0,40000000,Null,Null,214625349,111461,2
214629213,0.0,0.0,36775973,36775973,0,0,36775973,Null,Null,214629213,111461,2
214629308,0.0,0.0,2452,2452,0,0,2452,Null,Null,214629308,111461,2
214630083,0.0,0.0,42292369,42292369,0,0,42292369,Null,Null,214630083,111461,2
214630341,0.0,0.0,38000000,38000000,0,0,38000000,Null,Null,214630341,111461,2
214637347,3.0,3.0,65000,65000,0,0,65000,Null,Null,214637347,111461,2
214637369,2.0,2.0,69000,69000,0,0,69000,Null,Null,214637369,111461,2
214637403,1.0,1.0,99000,99000,0,0,99000,Null,Null,214637403,111461,2
214655666,0.0,0.0,9000,9000,0,0,9000,Null,Null,214655666,111461,2
214656356,0.0,0.0,12000,12000,0,0,12000,Null,Null,214656356,111461,2
214656460,0.0,0.0,9300000,8835000,465000,5,9300000,Null,Null,214656460,5180143,15318
214656768,0.0,0.0,6000,6000,0,0,6000,Null,Null,214656768,111461,2
214656918,0.0,0.0,9000,9000,0,0,9000,Null,Null,214656918,111461,2
214656993,0.0,0.0,7000,7000,0,0,7000,Null,Null,214656993,111461,2
214657024,0.0,0.0,6000,6000,0,0,6000,Null,Null,214657024,111461,2
214658087,0.0,0.0,9000,9000,0,0,9000,Null,Null,214658087,111461,2
214660982,0.0,0.0,7000,7000,0,0,7000,Null,Null,214660982,111461,2
214663780,0.0,0.0,36775973,36775973,0,0,36775973,Null,Null,214663780,111461,2
214664928,103.0,103.0,180000,95000,85000,47,180000,Null,Null,214664928,7896671,1609
214667375,0.0,0.0,18000,18000,0,0,18000,Null,Null,214667375,111461,2
214678260,0.0,0.0,19990000,19990000,0,0,19990000,Null,Null,214678260,162957,4428
214678266,1.0,1.0,752000,564000,188000,25,752000,Null,Null,214678266,26150,8513
214690119,0.0,0.0,15490000,15490000,0,0,15490000,Null,Null,214690119,162957,4428
214690433,0.0,0.0,9000,9000,0,0,9000,Null,Null,214690433,111461,2
214690688,0.0,0.0,11490000,11490000,0,0,11490000,Null,Null,214690688,162957,4428
214692228,0.0,0.0,19990000,19990000,0,0,19990000,Null,Null,214692228,162957,20170
214701245,26.0,26.0,280000,273000,7000,3,280000,Null,Null,214701245,4973949,20244
214718743,2.0,2.0,4000,4000,0,0,4000,Null,Null,214718743,111461,9013
214731114,0.0,0.0,3580000,3580000,0,0,3580000,Null,Null,214731114,111461,1634
214731612,8.0,8.0,450000,313000,137000,30,450000,Null,Null,214731612,21651,12908
214732580,0.0,0.0,12990000,12990000,0,0,12990000,Null,Null,214732580,114527,2657
214735543,5.0,5.0,175500,171000,4500,3,175500,Null,Null,214735543,166419,28576
214735712,0.0,0.0,14290000,14290000,0,0,14290000,Null,Null,214735712,114527,8043
214737374,0.0,0.0,48000000,48000000,0,0,48000000,Null,Null,214737374,162957,1803
214737570,0.0,0.0,12990000,12990000,0,0,12990000,Null,Null,214737570,162957,1803
214743666,73.0,73.0,15000,15000,0,0,15000,Null,Null,214743666,469547,15936
214744446,0.0,0.0,11000,5500,5500,50,11000,Null,Null,214744446,111461,15250
214754901,0.0,0.0,15490000,15490000,0,0,15490000,Null,Null,214754901,114527,8043
214755184,111.0,111.0,90000,85500,4500,5,90000,Null,Null,214755184,837721,1883
214756052,3.0,3.0,14900000,13085000,1815000,12,14900000,Null,Null,214756052,20215,1805
214756058,175.0,175.0,3190000,2700000,490000,15,3190000,Null,Null,214756058,147856,28856
214756285,0.0,0.0,7000,7000,0,0,7000,Null,Null,214756285,111461,1520
214759592,30.0,30.0,420000,336000,84000,20,420000,Null,Null,214759592,423495,3177
214766975,0.0,0.0,12990000,12990000,0,0,12990000,Null,Null,214766975,114527,2657
214767257,2.0,2.0,499000,463000,36000,7,499000,Null,Null,214767257,21651,12908
214789248,6.0,6.0,79000,79000,0,0,79000,Null,Null,214789248,4973949,20244
214789316,0.0,0.0,539000,539000,0,0,539000,Null,Null,214789316,886169,23034
214790086,0.0,0.0,2500,2500,0,0,2500,Null,Null,214790086,111461,2
214790119,0.0,0.0,0,2000,0,0,2000,Null,Null,214790119,111461,0
214790252,0.0,0.0,0,2000,0,0,2000,Null,Null,214790252,111461,0
214799047,87.0,87.0,50000,45000,5000,10,50000,Null,Null,214799047,111461,15250
214806232,0.0,0.0,3350000,3350000,0,0,3350000,Null,Null,214806232,111461,2340
214810330,0.0,0.0,15490000,15490000,0,0,15490000,Null,Null,214810330,114527,2657
214811323,0.0,0.0,15490000,15490000,0,0,15490000,Null,Null,214811323,114527,2657
214813869,0.0,0.0,7000,7000,0,0,7000,Null,Null,214813869,111461,2
214815448,0.0,0.0,7000,7000,0,0,7000,Null,Null,214815448,111461,2
214824270,0.0,0.0,12700000,8300000,4400000,35,12700000,Null,Null,214824270,416127,8227
214825094,22.0,22.0,60000,53000,7000,12,60000,Null,Null,214825094,111461,914
214825868,0.0,0.0,8820,8820,0,0,8820,Null,Null,214825868,111461,2
214837785,0.0,0.0,12590000,11990000,600000,5,12590000,Null,Null,214837785,144779,1805
214846799,18.0,18.0,450000,450000,0,0,450000,Null,Null,214846799,7882195,28480
214856989,10.0,10.0,4990000,3990000,1000000,20,4990000,Null,Null,214856989,208841,2340
214856994,0.0,0.0,4990000,4990000,0,0,4990000,Null,Null,214856994,208841,2340
214860410,0.0,0.0,175000,157500,17500,10,175000,Null,Null,214860410,111461,15320
214869701,50.0,50.0,70000,70000,0,0,70000,Null,Null,214869701,111461,28484
214885130,109.0,109.0,25000,24000,1000,4,25000,Null,Null,214885130,7986307,2685
214885257,0.0,0.0,2000,2000,0,0,2000,Null,Null,214885257,111461,2
214885707,0.0,0.0,2199,2199,0,0,2199,Null,Null,214885707,111461,2
214890633,0.0,0.0,12000,12000,0,0,12000,Null,Null,214890633,111461,2
214890654,0.0,0.0,9800000,9800000,0,0,9800000,Null,Null,214890654,111461,2
214891534,0.0,0.0,6250000,6250000,0,0,6250000,Null,Null,214891534,111461,2
214891713,0.0,0.0,3000,3000,0,0,3000,Null,Null,214891713,111461,2
214891911,0.0,0.0,6250000,6250000,0,0,6250000,Null,Null,214891911,111461,2
214891982,0.0,0.0,13500000,13500000,0,0,13500000,Null,Null,214891982,111461,2
214892608,0.0,0.0,8000,8000,0,0,8000,Null,Null,214892608,111461,2
214909632,0.0,0.0,3400000,3400000,0,0,3400000,Null,Null,214909632,5632183,8172
214910037,0.0,0.0,3400000,3400000,0,0,3400000,Null,Null,214910037,5632183,8172
214912454,54.0,54.0,139000,139000,0,0,139000,Null,Null,214912454,21653,12918
214921209,0.0,0.0,18000000,14399000,3601000,20,18000000,Null,Null,214921209,19288,8513
214921224,0.0,0.0,16400000,14399000,2001000,12,16400000,Null,Null,214921224,19288,8513
214921226,0.0,0.0,15000000,14399000,601000,4,15000000,Null,Null,214921226,19288,8516
214921230,0.0,0.0,17100000,17100000,0,0,17100000,Null,Null,214921230,19288,8513
214921234,0.0,0.0,15000000,14399000,601000,4,15000000,Null,Null,214921234,19288,8516
214921243,0.0,0.0,21000000,16799000,4201000,20,21000000,Null,Null,214921243,19288,8513
214921245,0.0,0.0,16400000,14399000,2001000,12,16400000,Null,Null,214921245,19288,8513
214921256,0.0,0.0,14000000,13279000,721000,5,14000000,Null,Null,214921256,19288,8516
214921275,0.0,0.0,16400000,13119000,3281000,20,16400000,Null,Null,214921275,19288,8513
214921277,0.0,0.0,14000000,13279000,721000,5,14000000,Null,Null,214921277,19288,8516
214921285,0.0,0.0,18000000,14399000,3601000,20,18000000,Null,Null,214921285,19288,5385
214921297,0.0,0.0,14700000,11759000,2941000,20,14700000,Null,Null,214921297,19288,5385
214921325,0.0,0.0,14700000,11759000,2941000,20,14700000,Null,Null,214921325,19288,8511
214925145,30.0,30.0,1000,1000,0,0,1000,Null,Null,214925145,111461,2
214925748,0.0,0.0,5900,5900,0,0,5900,Null,Null,214925748,111461,2
214925815,4.0,4.0,150000,150000,0,0,150000,Null,Null,214925815,111461,2
214926721,0.0,0.0,9000,9000,0,0,9000,Null,Null,214926721,111461,2
214927001,0.0,0.0,15000,15000,0,0,15000,Null,Null,214927001,111461,2
214927061,1.0,1.0,250000,250000,0,0,250000,Null,Null,214927061,111461,2
214927117,0.0,0.0,48900000,36675000,12225000,25,48900000,Null,Null,214927117,111461,27214
214936812,0.0,0.0,0,599000,0,0,599000,Null,Null,214936812,8076595,0
214937231,23.0,23.0,49900,49900,0,0,49900,Null,Null,214937231,111461,2
214937337,14.0,14.0,2500000,1290000,1210000,48,2500000,Null,Null,214937337,51302,27170
214939406,4.0,4.0,294900,279000,15900,5,294900,Null,Null,214939406,111461,9013
214945361,0.0,0.0,6000,6000,0,0,6000,Null,Null,214945361,111461,2
214952769,18.0,18.0,410000,288000,122000,30,410000,Null,Null,214952769,47663,8223
214960936,41.0,41.0,180000,175000,5000,3,180000,Null,Null,214960936,111461,5995
215051849,16.0,16.0,550000,550000,0,0,550000,Null,Null,215051849,189445,20244
215052007,10.0,10.0,120000,120000,0,0,120000,Null,Null,215052007,111461,20244
215078987,0.0,0.0,5000,5000,0,0,5000,Null,Null,215078987,111461,26658
215093951,32.0,32.0,95000,90250,4750,5,95000,Null,Null,215093951,4269901,23040
215097578,0.0,0.0,650000,650000,0,0,650000,Null,Null,215097578,150568,1796
215100785,7.0,7.0,1500000,855000,645000,43,1500000,Null,Null,215100785,7242233,5531
215101989,282.0,282.0,346000,249000,97000,28,346000,Null,Null,215101989,41661,1627
215104820,106.0,106.0,165000,129000,36000,22,165000,Null,Null,215104820,41661,1627
215119245,0.0,0.0,680000,680000,0,0,680000,Null,Null,215119245,150568,1796
215119500,13.0,13.0,506000,369000,137000,27,506000,Null,Null,215119500,41661,1627
215122704,0.0,0.0,13199000,11687000,1512000,11,13199000,Null,Null,215122704,18776,7273
215122788,1.0,1.0,865000,865000,0,0,865000,Null,Null,215122788,150568,1796
215122816,17.0,17.0,3499000,2089000,1410000,40,3499000,Null,Null,215122816,48077,2136
215125094,0.0,0.0,760000,760000,0,0,760000,Null,Null,215125094,150568,1796
215128955,6.0,6.0,441000,436590,4410,1,441000,Null,Null,215128955,567645,11851
215129312,20.0,20.0,10000,10000,0,0,10000,Null,Null,215129312,111461,8167
215129322,0.0,0.0,5000,5000,0,0,5000,Null,Null,215129322,111461,8167
215129324,0.0,0.0,7000,7000,0,0,7000,Null,Null,215129324,111461,8167
215129341,0.0,0.0,5000,5000,0,0,5000,Null,Null,215129341,111461,8167
215129357,23.0,23.0,5800,5800,0,0,5800,Null,Null,215129357,111461,8167
215129467,0.0,0.0,6000,6000,0,0,6000,Null,Null,215129467,111461,8167
215129587,25.0,25.0,7000,7000,0,0,7000,Null,Null,215129587,111461,8167
215135773,0.0,0.0,520000,520000,0,0,520000,Null,Null,215135773,150568,1796
215135944,0.0,0.0,4500000,4500000,0,0,4500000,Null,Null,215135944,625577,7449
215166458,0.0,0.0,0,15000000,0,0,15000000,Null,Null,215166458,111461,0
215174797,0.0,0.0,6600000,6600000,0,0,6600000,Null,Null,215174797,111643,5384
215174802,0.0,0.0,6030000,6030000,0,0,6030000,Null,Null,215174802,111643,5385
215184084,0.0,0.0,6000,6000,0,0,6000,Null,Null,215184084,111461,2
215190020,0.0,0.0,7000,7000,0,0,7000,Null,Null,215190020,111461,2
215192969,0.0,0.0,9000,9000,0,0,9000,Null,Null,215192969,111461,2
215193416,0.0,0.0,6000,6000,0,0,6000,Null,Null,215193416,111461,2
215193774,0.0,0.0,4000,4000,0,0,4000,Null,Null,215193774,111461,2
215193787,0.0,0.0,7000,7000,0,0,7000,Null,Null,215193787,111461,2
215197407,0.0,0.0,9000,9000,0,0,9000,Null,Null,215197407,111461,2
215206049,4.0,4.0,40000,15000,25000,63,40000,Null,Null,215206049,111461,15250
215209205,0.0,0.0,5750,5750,0,0,5750,Null,Null,215209205,111461,28468
215209242,0.0,0.0,5750,5750,0,0,5750,Null,Null,215209242,111461,28468
215209272,0.0,0.0,5750,5750,0,0,5750,Null,Null,215209272,111461,28468
215209309,0.0,0.0,5750,5750,0,0,5750,Null,Null,215209309,111461,28468
215209341,0.0,0.0,5750,5750,0,0,5750,Null,Null,215209341,111461,28468
215209535,0.0,0.0,5750,5750,0,0,5750,Null,Null,215209535,111461,28468
215209583,0.0,0.0,9200,9200,0,0,9200,Null,Null,215209583,111461,28468
215209757,0.0,0.0,9200,9200,0,0,9200,Null,Null,215209757,111461,28468
215209877,0.0,0.0,5750,5750,0,0,5750,Null,Null,215209877,111461,28468
215209965,0.0,0.0,8050,8050,0,0,8050,Null,Null,215209965,111461,28468
215209977,10.0,10.0,8050,8050,0,0,8050,Null,Null,215209977,111461,28468
215210037,0.0,0.0,9200,9200,0,0,9200,Null,Null,215210037,111461,28468
215212838,0.0,0.0,8050,8050,0,0,8050,Null,Null,215212838,111461,28468
215212935,0.0,0.0,5750,5750,0,0,5750,Null,Null,215212935,111461,28468
215213034,0.0,0.0,8050,8050,0,0,8050,Null,Null,215213034,111461,28468
215213108,0.0,0.0,6325,6325,0,0,6325,Null,Null,215213108,111461,28468
215213195,0.0,0.0,9200,9200,0,0,9200,Null,Null,215213195,111461,28468
215213442,0.0,0.0,9200,9200,0,0,9200,Null,Null,215213442,111461,28468
215213473,0.0,0.0,8050,8050,0,0,8050,Null,Null,215213473,111461,28468
215214243,2.0,2.0,5750,5750,0,0,5750,Null,Null,215214243,111461,28468
215214331,0.0,0.0,8050,8050,0,0,8050,Null,Null,215214331,111461,28468
215214794,0.0,0.0,5750,5750,0,0,5750,Null,Null,215214794,111461,28468
215215313,0.0,0.0,5750,5750,0,0,5750,Null,Null,215215313,111461,28468
215215379,0.0,0.0,9200,9200,0,0,9200,Null,Null,215215379,111461,28468
215215913,30.0,30.0,5750,5750,0,0,5750,Null,Null,215215913,111461,28468
215216124,5.0,5.0,8050,8050,0,0,8050,Null,Null,215216124,111461,28468
215216158,3.0,3.0,8050,8050,0,0,8050,Null,Null,215216158,111461,28468
215216251,0.0,0.0,5750,5750,0,0,5750,Null,Null,215216251,111461,28468
215220953,0.0,0.0,5750,5750,0,0,5750,Null,Null,215220953,111461,28472
215257760,127.0,127.0,37000,37000,0,0,37000,Null,Null,215257760,4452467,8305
215297088,0.0,0.0,2000,2000,0,0,2000,Null,Null,215297088,111461,27214
215297217,0.0,0.0,2000,2000,0,0,2000,Null,Null,215297217,111461,27214
215297223,0.0,0.0,2000,2000,0,0,2000,Null,Null,215297223,111461,27214
215297228,0.0,0.0,2000,2000,0,0,2000,Null,Null,215297228,111461,27214
215297233,0.0,0.0,2000,2000,0,0,2000,Null,Null,215297233,111461,27214
215297238,0.0,0.0,2000,2000,0,0,2000,Null,Null,215297238,111461,27214
215297256,0.0,0.0,2000,2000,0,0,2000,Null,Null,215297256,111461,27214
215297261,0.0,0.0,2000,2000,0,0,2000,Null,Null,215297261,111461,27214
215297266,0.0,0.0,2000,2000,0,0,2000,Null,Null,215297266,111461,27214
215297764,0.0,0.0,2000,2000,0,0,2000,Null,Null,215297764,111461,27214
215299442,0.0,0.0,2000,2000,0,0,2000,Null,Null,215299442,111461,27214
215299510,0.0,0.0,2000,2000,0,0,2000,Null,Null,215299510,111461,27214
215299518,0.0,0.0,2000,2000,0,0,2000,Null,Null,215299518,111461,27214
215299523,0.0,0.0,2000,2000,0,0,2000,Null,Null,215299523,111461,27214
215299531,0.0,0.0,2000,2000,0,0,2000,Null,Null,215299531,111461,27214
215299565,0.0,0.0,2000,2000,0,0,2000,Null,Null,215299565,111461,27214
215299575,0.0,0.0,2000,2000,0,0,2000,Null,Null,215299575,111461,27214
215299586,0.0,0.0,2000,2000,0,0,2000,Null,Null,215299586,111461,27214
215299593,0.0,0.0,2000,2000,0,0,2000,Null,Null,215299593,111461,27214
215299598,0.0,0.0,2000,2000,0,0,2000,Null,Null,215299598,111461,27214
215299603,0.0,0.0,2000,2000,0,0,2000,Null,Null,215299603,111461,27214
215299620,0.0,0.0,2000,2000,0,0,2000,Null,Null,215299620,111461,27214
215299629,0.0,0.0,2000,2000,0,0,2000,Null,Null,215299629,111461,27214
215299787,0.0,0.0,2000,2000,0,0,2000,Null,Null,215299787,111461,27214
215299797,0.0,0.0,2000,2000,0,0,2000,Null,Null,215299797,111461,27214
215299802,0.0,0.0,2000,2000,0,0,2000,Null,Null,215299802,111461,27214
215299812,0.0,0.0,2000,2000,0,0,2000,Null,Null,215299812,111461,27214
215299817,0.0,0.0,2000,2000,0,0,2000,Null,Null,215299817,111461,27214
215299824,0.0,0.0,2000,2000,0,0,2000,Null,Null,215299824,111461,27214
215299829,0.0,0.0,2000,2000,0,0,2000,Null,Null,215299829,111461,27214
215299834,0.0,0.0,2000,2000,0,0,2000,Null,Null,215299834,111461,27214
215299841,0.0,0.0,2000,2000,0,0,2000,Null,Null,215299841,111461,27214
215299846,0.0,0.0,2000,2000,0,0,2000,Null,Null,215299846,111461,27214
215299851,0.0,0.0,2000,2000,0,0,2000,Null,Null,215299851,111461,27214
215299884,0.0,0.0,2000,2000,0,0,2000,Null,Null,215299884,111461,27214
215299889,0.0,0.0,2000,2000,0,0,2000,Null,Null,215299889,111461,27214
215299895,0.0,0.0,2000,2000,0,0,2000,Null,Null,215299895,111461,27214
215299901,0.0,0.0,2000,2000,0,0,2000,Null,Null,215299901,111461,27214
215299906,0.0,0.0,2000,2000,0,0,2000,Null,Null,215299906,111461,27214
215299915,0.0,0.0,2000,2000,0,0,2000,Null,Null,215299915,111461,27214
215299938,0.0,0.0,2000,2000,0,0,2000,Null,Null,215299938,111461,27214
215299943,0.0,0.0,2000,2000,0,0,2000,Null,Null,215299943,111461,27214
215299948,0.0,0.0,2000,2000,0,0,2000,Null,Null,215299948,111461,27214
215300146,0.0,0.0,2000,2000,0,0,2000,Null,Null,215300146,111461,27214
215300151,0.0,0.0,2000,2000,0,0,2000,Null,Null,215300151,111461,27214
215300156,0.0,0.0,2000,2000,0,0,2000,Null,Null,215300156,111461,27214
215300173,0.0,0.0,2000,2000,0,0,2000,Null,Null,215300173,111461,27214
215300198,0.0,0.0,2000,2000,0,0,2000,Null,Null,215300198,111461,27214
215341570,1.0,1.0,19000,19000,0,0,19000,Null,Null,215341570,111461,15320
215379402,13.0,13.0,259000,259000,0,0,259000,Null,Null,215379402,25277,28452
215388950,0.0,0.0,22000000,17550000,4450000,20,22000000,Null,Null,215388950,8066963,2340
215437357,18.0,18.0,525000,515000,10000,2,525000,Null,Null,215437357,50662,1583
215438345,6.0,6.0,290000,290000,0,0,290000,Null,Null,215438345,4973949,28428
215455584,5.0,5.0,1590000,1519000,71000,4,1590000,Null,Null,215455584,19673,1796
215459471,1796.0,1796.0,327000,246000,81000,25,327000,Null,Null,215459471,86206,1583
215465188,11.0,11.0,199000,189000,10000,5,199000,Null,Null,215465188,4973949,28428
215477276,0.0,0.0,14999,14999,0,0,14999,Null,Null,215477276,111461,20236
215518920,39.0,39.0,180000,90000,90000,50,180000,Null,Null,215518920,18845,1815
215519873,0.0,0.0,12590000,12590000,0,0,12590000,Null,Null,215519873,636739,8066
215534932,0.0,0.0,55000000,25250000,29750000,54,55000000,Null,Null,215534932,8066963,2340
215539080,6065.0,6065.0,14900,14900,0,0,14900,Null,Null,215539080,886923,1520
215543460,1.0,1.0,5190000,4301000,889000,17,5190000,Null,Null,215543460,18802,1795
215543876,0.0,0.0,8000,5880,2120,27,8000,Null,Null,215543876,111461,1819
215548352,3.0,3.0,169000,135000,34000,20,169000,Null,Null,215548352,19588,23006
215606986,7.0,7.0,23000,23000,0,0,23000,Null,Null,215606986,111461,2
215617756,3.0,3.0,5190000,3949000,1241000,24,5190000,Null,Null,215617756,18802,1795
215695284,0.0,0.0,5000,2000,3000,60,5000,Null,Null,215695284,111461,2
215726589,0.0,0.0,4290000,3499000,791000,18,4290000,Null,Null,215726589,247549,1795
215727300,0.0,0.0,76000,76000,0,0,76000,Null,Null,215727300,111461,2018
215730735,8.0,8.0,35000,35000,0,0,35000,Null,Null,215730735,111461,49728
215746871,0.0,0.0,9990000,9990000,0,0,9990000,Null,Null,215746871,25643,1795
215746882,0.0,0.0,8490000,8490000,0,0,8490000,Null,Null,215746882,25643,1795
215748307,0.0,0.0,109000,109000,0,0,109000,Null,Null,215748307,111461,1936
215748479,0.0,0.0,9000,9000,0,0,9000,Null,Null,215748479,111461,8202
215841411,5.0,5.0,3550000,3390000,160000,5,3550000,Null,Null,215841411,7917161,11879
215873057,0.0,0.0,1000,1000,0,0,1000,Null,Null,215873057,111461,23134
215888912,10.0,10.0,779000,525000,254000,33,779000,Null,Null,215888912,111461,4381
215889335,197.0,197.0,499000,379000,120000,24,499000,Null,Null,215889335,111461,4381
215891369,0.0,0.0,12000,6000,6000,50,12000,Null,Null,215891369,111461,28480
215891498,107.0,107.0,30000,30000,0,0,30000,Null,Null,215891498,5706641,53074
215897010,17.0,17.0,35000,35000,0,0,35000,Null,Null,215897010,5706641,2363
215898655,0.0,0.0,2400,2400,0,0,2400,Null,Null,215898655,111461,2
215898756,5.0,5.0,1800,1800,0,0,1800,Null,Null,215898756,111461,2
215898846,2.0,2.0,2400,2400,0,0,2400,Null,Null,215898846,111461,2
215899634,0.0,0.0,2000,2000,0,0,2000,Null,Null,215899634,111461,2
215899808,0.0,0.0,1900,1900,0,0,1900,Null,Null,215899808,111461,2
215899978,0.0,0.0,2100,2100,0,0,2100,Null,Null,215899978,111461,2
215900099,0.0,0.0,1700,1700,0,0,1700,Null,Null,215900099,111461,2
215900782,0.0,0.0,2500,2500,0,0,2500,Null,Null,215900782,111461,2
215900816,0.0,0.0,1500,1500,0,0,1500,Null,Null,215900816,111461,2
215901023,20.0,20.0,1800,1800,0,0,1800,Null,Null,215901023,111461,2
215901583,0.0,0.0,1500,1500,0,0,1500,Null,Null,215901583,111461,2
215902961,39.0,39.0,1699000,1083000,616000,36,1699000,Null,Null,215902961,111684,1795
215910941,28.0,28.0,79900,61000,18900,24,79900,Null,Null,215910941,5195449,1520
215914983,104.0,104.0,90000,90000,0,0,90000,Null,Null,215914983,226401,1811
215915474,47.0,47.0,95000,95000,0,0,95000,Null,Null,215915474,111461,1811
215970097,0.0,0.0,2990000,2780000,210000,7,2990000,Null,Null,215970097,111461,7081
215985421,45.0,45.0,750000,599000,151000,20,750000,Null,Null,215985421,4244853,28682
215996982,45.0,45.0,18000,15000,3000,17,18000,Null,Null,215996982,111461,1634
215997746,220.0,220.0,218000,99000,119000,55,218000,Null,Null,215997746,86206,1583
215999307,59.0,59.0,990000,728000,262000,26,990000,Null,Null,215999307,885047,5531
216006461,0.0,0.0,6360000,6360000,0,0,6360000,Null,Null,216006461,111643,8511
216006462,0.0,0.0,6360000,6360000,0,0,6360000,Null,Null,216006462,111643,8511
216006465,0.0,0.0,6190000,6190000,0,0,6190000,Null,Null,216006465,111643,5384
216006469,0.0,0.0,6030000,6030000,0,0,6030000,Null,Null,216006469,111643,5384
216006470,0.0,0.0,6360000,6360000,0,0,6360000,Null,Null,216006470,111643,8511
216006471,0.0,0.0,6360000,6360000,0,0,6360000,Null,Null,216006471,111643,8511
216006477,0.0,0.0,6360000,6360000,0,0,6360000,Null,Null,216006477,111643,8511
216006478,0.0,0.0,6360000,6360000,0,0,6360000,Null,Null,216006478,111643,8511
216006481,0.0,0.0,6190000,6190000,0,0,6190000,Null,Null,216006481,111643,5384
216006578,0.0,0.0,9492000,9492000,0,0,9492000,Null,Null,216006578,25643,1795
216022792,0.0,0.0,37000,18500,18500,50,37000,Null,Null,216022792,111461,15318
216087198,175.0,175.0,135000,126900,8100,6,135000,Null,Null,216087198,4269901,1883
216090646,0.0,0.0,10392000,10392000,0,0,10392000,Null,Null,216090646,25643,1795
216092766,0.0,0.0,8136000,8136000,0,0,8136000,Null,Null,216092766,25643,1795
216095067,40.0,40.0,365000,189000,176000,48,365000,Null,Null,216095067,8115963,3515
216098538,0.0,0.0,1000,1000,0,0,1000,Null,Null,216098538,5707537,23244
216104458,27.0,27.0,499000,313000,186000,37,499000,Null,Null,216104458,25422,8400
216107577,0.0,0.0,10392000,10392000,0,0,10392000,Null,Null,216107577,25643,1795
216107950,0.0,0.0,1850000,1665000,185000,10,1850000,Null,Null,216107950,704815,15320
216108035,0.0,0.0,1850000,1665000,185000,10,1850000,Null,Null,216108035,704815,15320
216123372,0.0,0.0,7000,7000,0,0,7000,Null,Null,216123372,111461,28480
216123899,0.0,0.0,25000,18000,7000,28,25000,Null,Null,216123899,111461,15320
216125490,0.0,0.0,12848000,12848000,0,0,12848000,Null,Null,216125490,5740935,8400
216133629,0.0,0.0,1000,1000,0,0,1000,Null,Null,216133629,111461,3177
216137026,0.0,0.0,1000,1000,0,0,1000,Null,Null,216137026,111461,3178
216155755,0.0,0.0,3090000,1840000,1250000,40,3090000,Null,Null,216155755,153088,2657
216157031,0.0,0.0,11000,11000,0,0,11000,Null,Null,216157031,111461,23244
216157035,0.0,0.0,114000,114000,0,0,114000,Null,Null,216157035,111461,23432
216157089,0.0,0.0,120000,120000,0,0,120000,Null,Null,216157089,111461,3175
216157108,0.0,0.0,3500,3500,0,0,3500,Null,Null,216157108,111461,23276
216157118,0.0,0.0,118000,118000,0,0,118000,Null,Null,216157118,111461,2514
216157152,0.0,0.0,39000,39000,0,0,39000,Null,Null,216157152,111461,2266
216159845,672.0,672.0,180000,90000,90000,50,180000,Null,Null,216159845,174069,1815
216168294,0.0,0.0,1680,1680,0,0,1680,Null,Null,216168294,111461,2
216171796,0.0,0.0,23491000,20665000,2826000,12,23491000,Null,Null,216171796,18802,1795
216172784,0.0,0.0,2450,2450,0,0,2450,Null,Null,216172784,111461,2
216173180,4.0,4.0,24990000,18990000,6000000,24,24990000,Null,Null,216173180,18802,1795
216174231,2.0,2.0,26990000,21990000,5000000,19,26990000,Null,Null,216174231,18802,1795
216174672,1.0,1.0,29990000,24990000,5000000,17,29990000,Null,Null,216174672,18802,1795
216174917,17.0,17.0,31990000,25490000,6500000,20,31990000,Null,Null,216174917,18802,1795
216175253,5.0,5.0,36990000,28990000,8000000,22,36990000,Null,Null,216175253,18802,1795
216175761,0.0,0.0,42000000,36000000,6000000,14,42000000,Null,Null,216175761,18802,1795
216195999,12.0,12.0,20000,20000,0,0,20000,Null,Null,216195999,111461,2342
216203382,5.0,5.0,150000,135000,15000,10,150000,Null,Null,216203382,111461,15936
216203411,0.0,0.0,1000,1000,0,0,1000,Null,Null,216203411,111461,23622
216210160,0.0,0.0,10000,5000,5000,50,10000,Null,Null,216210160,111461,7064
216210351,0.0,0.0,8000,4000,4000,50,8000,Null,Null,216210351,111461,1634
216211166,957.0,957.0,280000,203000,77000,28,280000,Null,Null,216211166,930377,1520
216211340,0.0,0.0,25000,25000,0,0,25000,Null,Null,216211340,113006,28458
216211344,0.0,0.0,79000,79000,0,0,79000,Null,Null,216211344,113006,12908
216211352,0.0,0.0,77000,77000,0,0,77000,Null,Null,216211352,113006,3805
216211354,0.0,0.0,99000,99000,0,0,99000,Null,Null,216211354,111461,28460
216211356,0.0,0.0,160000,160000,0,0,160000,Null,Null,216211356,111461,1813
216211360,0.0,0.0,49000,49000,0,0,49000,Null,Null,216211360,111461,20174
216211368,0.0,0.0,49000,49000,0,0,49000,Null,Null,216211368,111461,3805
216215562,14.0,14.0,350000,195000,155000,44,350000,Null,Null,216215562,4627197,5531
216216465,0.0,0.0,2500,2500,0,0,2500,Null,Null,216216465,111461,2337
216217005,0.0,0.0,1000,1000,0,0,1000,Null,Null,216217005,111461,23622
216225932,3.0,3.0,15000,15000,0,0,15000,Null,Null,216225932,111461,15320
216227809,3.0,3.0,17000,17000,0,0,17000,Null,Null,216227809,111461,15320
216227892,4.0,4.0,330000,239000,91000,28,330000,Null,Null,216227892,321545,8192
216228086,93.0,93.0,123000,123000,0,0,123000,Null,Null,216228086,111461,1639
216234763,1.0,1.0,677600,677600,0,0,677600,Null,Null,216234763,111461,2
216238849,0.0,0.0,228999,228999,0,0,228999,Null,Null,216238849,111454,28460
216245156,0.0,0.0,1800,1800,0,0,1800,Null,Null,216245156,111461,2
216246238,16.0,16.0,41000,37994,3006,7,41000,Null,Null,216246238,111461,28484
216247030,0.0,0.0,1350,1350,0,0,1350,Null,Null,216247030,111461,2
216247034,0.0,0.0,2500,2500,0,0,2500,Null,Null,216247034,111461,2
216247041,0.0,0.0,2000,2000,0,0,2000,Null,Null,216247041,111461,2
216247103,0.0,0.0,1500,1500,0,0,1500,Null,Null,216247103,111461,23678
216247106,0.0,0.0,2000,2000,0,0,2000,Null,Null,216247106,111461,23678
216247108,0.0,0.0,1000,1000,0,0,1000,Null,Null,216247108,111461,2
216247114,0.0,0.0,2000,2000,0,0,2000,Null,Null,216247114,111461,2
216247227,0.0,0.0,1700,1700,0,0,1700,Null,Null,216247227,111461,2
216247309,0.0,0.0,2000,2000,0,0,2000,Null,Null,216247309,111461,2
216247385,0.0,0.0,1750,1750,0,0,1750,Null,Null,216247385,111461,2
216247405,0.0,0.0,1800,1800,0,0,1800,Null,Null,216247405,111461,2
216247447,0.0,0.0,2000,2000,0,0,2000,Null,Null,216247447,111461,23678
216247480,0.0,0.0,1600,1600,0,0,1600,Null,Null,216247480,111461,2
216247553,0.0,0.0,2500,2500,0,0,2500,Null,Null,216247553,111461,2
216247558,0.0,0.0,2500,2500,0,0,2500,Null,Null,216247558,111461,2
216247587,0.0,0.0,1000,1000,0,0,1000,Null,Null,216247587,111461,2
216247773,0.0,0.0,2500,2500,0,0,2500,Null,Null,216247773,111461,2
216326861,1.0,1.0,1850000,1850000,0,0,1850000,Null,Null,216326861,5653553,49724
216350734,98.0,98.0,145000,145000,0,0,145000,Null,Null,216350734,111461,17162
216351048,23.0,23.0,300000,263000,37000,12,300000,Null,Null,216351048,143353,28576
216352966,0.0,0.0,5349000,5349000,0,0,5349000,Null,Null,216352966,19018,1634
216356748,0.0,0.0,5349000,5349000,0,0,5349000,Null,Null,216356748,19018,1634
216369176,0.0,0.0,34590000,34590000,0,0,34590000,Null,Null,216369176,111461,2340
216371363,0.0,0.0,12000,8400,3600,30,12000,Null,Null,216371363,111461,2
216371555,0.0,0.0,9000,6300,2700,30,9000,Null,Null,216371555,111461,2
216371595,3.0,3.0,13000,9100,3900,30,13000,Null,Null,216371595,111461,2
216371611,0.0,0.0,7000,4900,2100,30,7000,Null,Null,216371611,111461,2
216371895,29.0,29.0,5000,3500,1500,30,5000,Null,Null,216371895,111461,2
216379736,0.0,0.0,25900000,25900000,0,0,25900000,Null,Null,216379736,111461,2340
216385443,73.0,73.0,170000,115000,55000,32,170000,Null,Null,216385443,926913,1752
216388988,0.0,0.0,16400000,16400000,0,0,16400000,Null,Null,216388988,167287,28872
216397164,0.0,0.0,36000,36000,0,0,36000,Null,Null,216397164,111461,23244
216401127,10.0,10.0,75000,75000,0,0,75000,Null,Null,216401127,111461,8511
216406375,286.0,286.0,790000,758000,32000,4,790000,Null,Null,216406375,189445,1815
216406933,5.0,5.0,165000,156750,8250,5,165000,Null,Null,216406933,711229,11899
216407250,38.0,38.0,80000,57000,23000,29,80000,Null,Null,216407250,48077,2555
216409332,8.0,8.0,1474000,905000,569000,39,1474000,Null,Null,216409332,48077,1984
216435737,9.0,9.0,729000,729000,0,0,729000,Null,Null,216435737,46363,977
216450973,0.0,0.0,8217000,6162750,2054250,25,8217000,Null,Null,216450973,26150,8513
216459200,1.0,1.0,949000,949000,0,0,949000,Null,Null,216459200,46363,5385
216460818,0.0,0.0,8500000,8500000,0,0,8500000,Null,Null,216460818,633815,2
216472834,484.0,484.0,130000,106000,24000,18,130000,Null,Null,216472834,930377,1520
216473085,0.0,0.0,123000000,123000000,0,0,123000000,Null,Null,216473085,4093985,2340
216562744,160.0,160.0,2100,1850,250,12,2100,Null,Null,216562744,4409909,23134
216681924,0.0,0.0,49000000,49000000,0,0,49000000,Null,Null,216681924,111461,2340
216714803,1.0,1.0,80000,65000,15000,19,80000,Null,Null,216714803,111461,1883
216773653,6.0,6.0,990000,990000,0,0,990000,Null,Null,216773653,152306,28576
216854453,0.0,0.0,450000,441000,9000,2,450000,Null,Null,216854453,111461,15318
216906941,0.0,0.0,1900,1900,0,0,1900,Null,Null,216906941,111461,2
216918388,0.0,0.0,4999000,4999000,0,0,4999000,Null,Null,216918388,111461,2340
216919807,19.0,19.0,69900,69900,0,0,69900,Null,Null,216919807,111461,28458
216924380,0.0,0.0,15000,15000,0,0,15000,Null,Null,216924380,111461,15936
216933713,0.0,0.0,1000,1000,0,0,1000,Null,Null,216933713,111461,53054
216934468,2.0,2.0,5190000,3989000,1201000,23,5190000,Null,Null,216934468,18802,1795
216936421,24.0,24.0,380000,361000,19000,5,380000,Null,Null,216936421,312329,4593
216946631,0.0,0.0,15999,15999,0,0,15999,Null,Null,216946631,111461,15320
217087770,0.0,0.0,16900000,16900000,0,0,16900000,Null,Null,217087770,111461,2340
217103820,27.0,27.0,175000,145000,30000,17,175000,Null,Null,217103820,512067,53074
217103883,55.0,55.0,599000,494000,105000,18,599000,Null,Null,217103883,150568,1789
217111392,52.0,52.0,150000,85200,64800,43,150000,Null,Null,217111392,111461,27128
217124983,0.0,0.0,11000000,11000000,0,0,11000000,Null,Null,217124983,111461,23642
217126934,0.0,0.0,4750000,3800000,950000,20,4750000,Null,Null,217126934,49253,1636
217140833,0.0,0.0,9900,9900,0,0,9900,Null,Null,217140833,111461,2
217143518,0.0,0.0,15985000,15985000,0,0,15985000,Null,Null,217143518,47424,2342
217143560,6.0,6.0,40000,36000,4000,10,40000,Null,Null,217143560,111461,2
217144448,3.0,3.0,45000,45000,0,0,45000,Null,Null,217144448,111461,2
217145037,595.0,595.0,100800,56000,44800,44,100800,Null,Null,217145037,46703,1883
217147894,63.0,63.0,513000,349000,164000,32,513000,Null,Null,217147894,204895,1883
217158529,1.0,1.0,4153000,2817000,1336000,32,4153000,Null,Null,217158529,18802,1789
217158870,0.0,0.0,8000000,5324000,2676000,33,8000000,Null,Null,217158870,18802,1789
217168042,4.0,4.0,10000,10000,0,0,10000,Null,Null,217168042,111461,2
217168305,0.0,0.0,14500,14500,0,0,14500,Null,Null,217168305,111461,2
217169398,0.0,0.0,4000,4000,0,0,4000,Null,Null,217169398,111461,2
217169839,0.0,0.0,9000,9000,0,0,9000,Null,Null,217169839,111461,2
217169997,0.0,0.0,2000,2000,0,0,2000,Null,Null,217169997,111461,2
217170027,0.0,0.0,1900,1900,0,0,1900,Null,Null,217170027,111461,2
217170163,0.0,0.0,2000,2000,0,0,2000,Null,Null,217170163,111461,2
217170197,0.0,0.0,8000,8000,0,0,8000,Null,Null,217170197,111461,2
217170372,0.0,0.0,10000,10000,0,0,10000,Null,Null,217170372,111461,2
217171253,0.0,0.0,9500,9500,0,0,9500,Null,Null,217171253,111461,2
217174306,2009.0,2009.0,70000,69000,1000,1,70000,Null,Null,217174306,284315,1520
217178993,0.0,0.0,6200000,6200000,0,0,6200000,Null,Null,217178993,111461,11943
217179091,0.0,0.0,46000000,46000000,0,0,46000000,Null,Null,217179091,4093985,2340
217184481,5.0,5.0,129000,129000,0,0,129000,Null,Null,217184481,111461,2140
217186363,15.0,15.0,1290000,759000,531000,41,1290000,Null,Null,217186363,18802,28576
217188412,27.0,27.0,160000,160000,0,0,160000,Null,Null,217188412,113128,1630
217189892,0.0,0.0,41600000,41600000,0,0,41600000,Null,Null,217189892,4093985,2340
217191627,2.0,2.0,269000,245000,24000,9,269000,Null,Null,217191627,205953,5006
217195741,0.0,0.0,5000,5000,0,0,5000,Null,Null,217195741,111461,8205
217195758,20.0,20.0,2000,2000,0,0,2000,Null,Null,217195758,111461,8205
217196050,0.0,0.0,2500,2500,0,0,2500,Null,Null,217196050,111461,8205
217196084,0.0,0.0,1000,1000,0,0,1000,Null,Null,217196084,111461,8205
217196106,0.0,0.0,25900000,25900000,0,0,25900000,Null,Null,217196106,4093985,2340
217198928,0.0,0.0,94000000,94000000,0,0,94000000,Null,Null,217198928,4093985,2340
217258270,210.0,210.0,57000,54150,2850,5,57000,Null,Null,217258270,839837,1883
217263084,2.0,2.0,499000,413000,86000,17,499000,Null,Null,217263084,150568,1796
217263524,0.0,0.0,57308580,57308580,0,0,57308580,Null,Null,217263524,25229,1979
217267741,0.0,0.0,639000,564000,75000,12,639000,Null,Null,217267741,150568,1796
217276360,3.0,3.0,670000,556000,114000,17,670000,Null,Null,217276360,22017,1796
217285642,0.0,0.0,60000000,60000000,0,0,60000000,Null,Null,217285642,7999559,27212
217288079,11.0,11.0,49000,49000,0,0,49000,Null,Null,217288079,111461,8371
217288343,0.0,0.0,2200,2200,0,0,2200,Null,Null,217288343,111461,2225
217291931,0.0,0.0,399000,294000,105000,26,399000,Null,Null,217291931,5717579,1634
217315182,0.0,0.0,60000000,60000000,0,0,60000000,Null,Null,217315182,7999559,2
217315183,0.0,0.0,47000000,47000000,0,0,47000000,Null,Null,217315183,111461,2
217315188,0.0,0.0,42000000,42000000,0,0,42000000,Null,Null,217315188,111461,2
217315194,0.0,0.0,60000000,60000000,0,0,60000000,Null,Null,217315194,111461,2
217315202,0.0,0.0,75000000,75000000,0,0,75000000,Null,Null,217315202,111461,2
217315208,0.0,0.0,79000000,79000000,0,0,79000000,Null,Null,217315208,111461,2
217315212,0.0,0.0,76000000,76000000,0,0,76000000,Null,Null,217315212,111461,2
217315491,7.0,7.0,1129000,945000,184000,16,1129000,Null,Null,217315491,4238147,11759
217321591,0.0,0.0,3990000,3990000,0,0,3990000,Null,Null,217321591,111461,11943
217323359,0.0,0.0,1500,1500,0,0,1500,Null,Null,217323359,111461,2
217327253,0.0,0.0,3168000,3168000,0,0,3168000,Null,Null,217327253,25643,1795
217327875,0.0,0.0,4650000,4650000,0,0,4650000,Null,Null,217327875,111461,11943
217335953,90.0,90.0,168000,150000,18000,11,168000,Null,Null,217335953,18802,1820
217336254,42.0,42.0,499000,499000,0,0,499000,Null,Null,217336254,111461,23544
217376753,0.0,0.0,65500000,65500000,0,0,65500000,Null,Null,217376753,50307,1805
217385621,0.0,0.0,1500,1500,0,0,1500,Null,Null,217385621,111461,2
217385644,0.0,0.0,8900,8900,0,0,8900,Null,Null,217385644,111461,2
217385691,0.0,0.0,1250,1250,0,0,1250,Null,Null,217385691,111461,2
217385709,0.0,0.0,7900,7900,0,0,7900,Null,Null,217385709,111461,2
217385719,0.0,0.0,3900,3900,0,0,3900,Null,Null,217385719,111461,2
217385733,0.0,0.0,1600,1600,0,0,1600,Null,Null,217385733,111461,2
217385812,0.0,0.0,9000,9000,0,0,9000,Null,Null,217385812,111461,8167
217385816,0.0,0.0,2000,2000,0,0,2000,Null,Null,217385816,111461,2
217386542,0.0,0.0,479000,479000,0,0,479000,Null,Null,217386542,45991,2324
217412334,390.0,390.0,120000,75000,45000,38,120000,Null,Null,217412334,182863,1520
217417613,363.0,363.0,75000,52000,23000,31,75000,Null,Null,217417613,182863,1520
217422737,0.0,0.0,19990000,16990000,3000000,15,19990000,Null,Null,217422737,198543,1795
217428066,0.0,0.0,112000,103000,9000,8,112000,Null,Null,217428066,19588,23006
217438313,0.0,0.0,12363000,9272250,3090750,25,12363000,Null,Null,217438313,26150,8513
217442409,0.0,0.0,8000,8000,0,0,8000,Null,Null,217442409,111461,2
217442462,0.0,0.0,8000,8000,0,0,8000,Null,Null,217442462,111461,2
217442514,0.0,0.0,9000,9000,0,0,9000,Null,Null,217442514,111461,2
217442522,0.0,0.0,5000,5000,0,0,5000,Null,Null,217442522,111461,2
217471762,24.0,24.0,18000,18000,0,0,18000,Null,Null,217471762,111461,2
217474792,0.0,0.0,71000,58000,13000,18,71000,Null,Null,217474792,19588,53190
217474909,0.0,0.0,7300000,7300000,0,0,7300000,Null,Null,217474909,27449,11933
217474961,473.0,473.0,39600,22000,17600,44,39600,Null,Null,217474961,46703,2
217475007,22.0,22.0,170000,120000,50000,29,170000,Null,Null,217475007,926913,1752
217475015,141.0,141.0,150000,142500,7500,5,150000,Null,Null,217475015,111461,914
217475096,20.0,20.0,170000,120000,50000,29,170000,Null,Null,217475096,926913,1752
217476295,21.0,21.0,170000,120000,50000,29,170000,Null,Null,217476295,926913,1752
217478209,148.0,148.0,1050000,799000,251000,24,1050000,Null,Null,217478209,19018,1520
217481911,0.0,0.0,57500000,57500000,0,0,57500000,Null,Null,217481911,4093985,2340
217482379,0.0,0.0,32110000,28890000,3220000,10,32110000,Null,Null,217482379,5740935,2977
217487007,0.0,0.0,4800,4800,0,0,4800,Null,Null,217487007,111461,2
217489084,0.0,0.0,9000,9000,0,0,9000,Null,Null,217489084,168885,5006
217499264,27.0,27.0,360000,360000,0,0,360000,Null,Null,217499264,143353,28576
217504285,2.0,2.0,2190000,1999100,190900,9,2190000,Null,Null,217504285,147856,28856
217505430,0.0,0.0,1990000,1990000,0,0,1990000,Null,Null,217505430,147856,28856
217505504,1.0,1.0,2790000,2683100,106900,4,2790000,Null,Null,217505504,147856,28856
217506923,0.0,0.0,5950000,5950000,0,0,5950000,Null,Null,217506923,48649,1634
217506959,0.0,0.0,10100000,10100000,0,0,10100000,Null,Null,217506959,48649,1634
217506982,0.0,0.0,9599000,9599000,0,0,9599000,Null,Null,217506982,48649,1634
217506984,0.0,0.0,9599000,9599000,0,0,9599000,Null,Null,217506984,48649,1634
217509135,0.0,0.0,7980000,7980000,0,0,7980000,Null,Null,217509135,48649,1634
217509607,0.0,0.0,1600,1280,320,20,1600,Null,Null,217509607,111461,2
217510181,0.0,0.0,12500000,12500000,0,0,12500000,Null,Null,217510181,228187,11941
217510456,17.0,17.0,350000,280000,70000,20,350000,Null,Null,217510456,423495,3177
217511597,55.0,55.0,1911000,1911000,0,0,1911000,Null,Null,217511597,523789,1883
217511921,2.0,2.0,799000,647000,152000,19,799000,Null,Null,217511921,150568,1796
217520819,5.0,5.0,3990000,2750000,1240000,31,3990000,Null,Null,217520819,247549,1795
217523640,1.0,1.0,45000,40000,5000,11,45000,Null,Null,217523640,111461,15250
217525683,0.0,0.0,6900000,4990000,1910000,28,6900000,Null,Null,217525683,208841,2340
217535292,0.0,0.0,49960000,45000000,4960000,10,49960000,Null,Null,217535292,5740935,2324
217539600,0.0,0.0,20000000,11880000,8120000,41,20000000,Null,Null,217539600,18802,1795
217539886,296.0,296.0,1300005,815000,485005,37,1300005,Null,Null,217539886,21271,53348
217540528,0.0,0.0,5541000,5541000,0,0,5541000,Null,Null,217540528,18802,1795
217548767,0.0,0.0,8700,8700,0,0,8700,Null,Null,217548767,111461,2
217549460,15.0,15.0,220000,131000,89000,40,220000,Null,Null,217549460,47663,8226
217559440,0.0,0.0,0,2990000,0,0,2990000,Null,Null,217559440,18802,0
217560479,0.0,0.0,3500000,1817000,1683000,48,3500000,Null,Null,217560479,18802,1795
217560641,0.0,0.0,10000000,6946000,3054000,31,10000000,Null,Null,217560641,18802,1794
217561341,0.0,0.0,10490000,9759000,731000,7,10490000,Null,Null,217561341,25422,1794
217561628,0.0,0.0,3168000,3036000,132000,4,3168000,Null,Null,217561628,25643,1795
217562200,0.0,0.0,22800000,22800000,0,0,22800000,Null,Null,217562200,4093985,2340
217570128,0.0,0.0,9900,9900,0,0,9900,Null,Null,217570128,111461,2
217610779,146.0,146.0,350000,175000,175000,50,350000,Null,Null,217610779,111461,1883
217614333,0.0,0.0,3990000,2929000,1061000,27,3990000,Null,Null,217614333,247549,1795
217624457,0.0,0.0,3990000,3259000,731000,18,3990000,Null,Null,217624457,247549,1795
217627416,5.0,5.0,890000,890000,0,0,890000,Null,Null,217627416,257333,1795
217636293,0.0,0.0,134000,95867,38133,28,134000,Null,Null,217636293,149308,28576
217636355,10.0,10.0,249000,225000,24000,10,249000,Null,Null,217636355,149308,28426
217639833,0.0,0.0,159000,147000,12000,8,159000,Null,Null,217639833,19588,53190
217640502,1.0,1.0,15990000,12240000,3750000,23,15990000,Null,Null,217640502,147856,28856
217640513,0.0,0.0,224000,208000,16000,7,224000,Null,Null,217640513,19588,53190
217641551,0.0,0.0,32800000,32800000,0,0,32800000,Null,Null,217641551,939519,11518
217642039,18.0,18.0,45000,43000,2000,4,45000,Null,Null,217642039,21274,5900
217645692,2.0,2.0,4590000,3871000,719000,16,4590000,Null,Null,217645692,147856,28856
217645972,1.0,1.0,1200,1200,0,0,1200,Null,Null,217645972,111461,2
217647603,0.0,0.0,2160,2160,0,0,2160,Null,Null,217647603,111461,2
217649383,5.0,5.0,22000,22000,0,0,22000,Null,Null,217649383,111461,2
217706932,370.0,370.0,3690000,2850000,840000,23,3690000,Null,Null,217706932,147856,1789
217714140,2777.0,2777.0,15000,15000,0,0,15000,Null,Null,217714140,5063093,1883
217719685,0.0,0.0,15000,15000,0,0,15000,Null,Null,217719685,111461,2
217720275,6.0,6.0,1199000,609000,590000,49,1199000,Null,Null,217720275,246045,8400
217723985,0.0,0.0,0,150000,0,0,150000,Null,Null,217723985,837721,0
217729020,76.0,76.0,79000,79000,0,0,79000,Null,Null,217729020,201253,1520
217730911,0.0,0.0,34800000,34800000,0,0,34800000,Null,Null,217730911,939519,8067
217733319,0.0,0.0,22000000,22000000,0,0,22000000,Null,Null,217733319,939519,28860
217736127,79.0,79.0,250000,169000,81000,32,250000,Null,Null,217736127,697923,1883
217750982,30.0,30.0,135000,120000,15000,11,135000,Null,Null,217750982,512067,23228
217751124,0.0,0.0,16500,16500,0,0,16500,Null,Null,217751124,111461,15236
217751438,7.0,7.0,225000,215000,10000,4,225000,Null,Null,217751438,512067,23228
217764494,1.0,1.0,62290000,62290000,0,0,62290000,Null,Null,217764494,114527,2657
217772462,1.0,1.0,150000,135000,15000,10,150000,Null,Null,217772462,111461,15320
217772541,30.0,30.0,479000,333000,146000,30,479000,Null,Null,217772541,18802,28426
217775128,0.0,0.0,6000,6000,0,0,6000,Null,Null,217775128,111461,8167
217776752,5.0,5.0,650000,599000,51000,8,650000,Null,Null,217776752,18802,1819
217777323,0.0,0.0,21590000,21590000,0,0,21590000,Null,Null,217777323,313739,20170
217777790,0.0,0.0,37390000,37390000,0,0,37390000,Null,Null,217777790,5710451,20170
217778316,0.0,0.0,8000,8000,0,0,8000,Null,Null,217778316,111461,26658
217778590,25.0,25.0,85000,75000,10000,12,85000,Null,Null,217778590,512067,53074
217781054,6.0,6.0,359000,309000,50000,14,359000,Null,Null,217781054,312329,9013
217815966,770.0,770.0,28000,14000,14000,50,28000,Null,Null,217815966,111461,28484
217889831,36.0,36.0,58000,51000,7000,12,58000,Null,Null,217889831,7986307,2685
217889872,251.0,251.0,25000,25000,0,0,25000,Null,Null,217889872,7986307,2685
218732277,0.0,0.0,1000,1000,0,0,1000,Null,Null,218732277,111461,2
218736564,0.0,0.0,64240000,54604000,9636000,15,64240000,Null,Null,218736564,5740935,8067
218748295,0.0,0.0,14959,9000,5959,40,14959,Null,Null,218748295,111461,2
218748317,0.0,0.0,21000,21000,0,0,21000,Null,Null,218748317,529455,2
218748321,1.0,1.0,195000,120000,75000,38,195000,Null,Null,218748321,163213,8305
218750008,12.0,12.0,535000,535000,0,0,535000,Null,Null,218750008,4202899,4380
218750072,0.0,0.0,1599,1599,0,0,1599,Null,Null,218750072,111461,2
218750303,0.0,0.0,6000,6000,0,0,6000,Null,Null,218750303,111461,1622
218750391,0.0,0.0,3000,3000,0,0,3000,Null,Null,218750391,111461,8205
218750495,0.0,0.0,6500,6500,0,0,6500,Null,Null,218750495,111461,8205
218751454,0.0,0.0,2500,2500,0,0,2500,Null,Null,218751454,111461,8205
218751780,37.0,37.0,180000,91000,89000,49,180000,Null,Null,218751780,845973,4428
218755521,0.0,0.0,8500,8500,0,0,8500,Null,Null,218755521,111461,2
218755533,0.0,0.0,2000,2000,0,0,2000,Null,Null,218755533,111461,2
218755563,0.0,0.0,8400,8400,0,0,8400,Null,Null,218755563,111461,2
218755627,0.0,0.0,6636,6636,0,0,6636,Null,Null,218755627,111461,8205
218755779,0.0,0.0,6500,6500,0,0,6500,Null,Null,218755779,111461,2
218755792,0.0,0.0,5000,5000,0,0,5000,Null,Null,218755792,111461,2
218755864,0.0,0.0,7040,7040,0,0,7040,Null,Null,218755864,111461,2
218755870,0.0,0.0,5950,5950,0,0,5950,Null,Null,218755870,111461,2
218758201,0.0,0.0,1000,1000,0,0,1000,Null,Null,218758201,111461,2
218758424,0.0,0.0,1000,990,10,1,1000,Null,Null,218758424,111461,2
218760286,0.0,0.0,1500,1000,500,33,1500,Null,Null,218760286,111461,2
218760357,0.0,0.0,1000,990,10,1,1000,Null,Null,218760357,111461,2
218760483,1.0,1.0,3920,2000,1920,49,3920,Null,Null,218760483,111461,2
218762886,1.0,1.0,119999,89585,30414,25,119999,Null,Null,218762886,163707,28576
218952383,0.0,0.0,2500,2500,0,0,2500,Null,Null,218952383,111461,2
219132972,35.0,35.0,220000,132000,88000,40,220000,Null,Null,219132972,5085219,27128
219133243,0.0,0.0,140000,126000,14000,10,140000,Null,Null,219133243,111461,15320
219133572,0.0,0.0,115000,103500,11500,10,115000,Null,Null,219133572,111461,15320
219136738,1.0,1.0,90000,90000,0,0,90000,Null,Null,219136738,111461,2
219144594,19.0,19.0,890000,399000,491000,55,890000,Null,Null,219144594,111461,8400
219144758,11.0,11.0,890000,399000,491000,55,890000,Null,Null,219144758,111461,8400
219145930,0.0,0.0,2000,2000,0,0,2000,Null,Null,219145930,111461,2
219147638,0.0,0.0,2000,2000,0,0,2000,Null,Null,219147638,111461,8205
219157130,3.0,3.0,390000,390000,0,0,390000,Null,Null,219157130,25422,28454
219162142,16.0,16.0,60000,60000,0,0,60000,Null,Null,219162142,162313,28576
219163659,0.0,0.0,19999000,17855000,2144000,11,19999000,Null,Null,219163659,18985,4428
219186791,26.0,26.0,200000,105000,95000,48,200000,Null,Null,219186791,4627197,28674
219392186,0.0,0.0,3276000,3276000,0,0,3276000,Null,Null,219392186,25643,1795
219397711,0.0,0.0,5080000,4301000,779000,15,5080000,Null,Null,219397711,18802,1795
219400421,0.0,0.0,3276000,3276000,0,0,3276000,Null,Null,219400421,25643,1795
219406434,0.0,0.0,3500,3500,0,0,3500,Null,Null,219406434,111461,8073
219456560,32.0,32.0,16200,9000,7200,44,16200,Null,Null,219456560,46703,2
219457652,0.0,0.0,1990,1990,0,0,1990,Null,Null,219457652,111461,2
219457996,0.0,0.0,1500,1500,0,0,1500,Null,Null,219457996,111461,2
219462069,0.0,0.0,12999000,12999000,0,0,12999000,Null,Null,219462069,111461,2340
220656915,0.0,0.0,1800,1800,0,0,1800,Null,Null,220656915,111461,2
220669546,0.0,0.0,1300,1300,0,0,1300,Null,Null,220669546,111461,2
220669553,0.0,0.0,1300,1300,0,0,1300,Null,Null,220669553,111461,2
220669652,0.0,0.0,1300,1300,0,0,1300,Null,Null,220669652,111461,2
220669668,0.0,0.0,1990000,1990000,0,0,1990000,Null,Null,220669668,147856,1789
220670303,0.0,0.0,2800000,2800000,0,0,2800000,Null,Null,220670303,472079,8061
220678495,0.0,0.0,2200000,2200000,0,0,2200000,Null,Null,220678495,472079,8061
220680981,22.0,22.0,7190000,5690000,1500000,21,7190000,Null,Null,220680981,247549,1795
220681117,8.0,8.0,9990000,8690000,1300000,13,9990000,Null,Null,220681117,25643,1795
220681954,0.0,0.0,1300,1300,0,0,1300,Null,Null,220681954,111461,2
220682020,35.0,35.0,202000,186000,16000,8,202000,Null,Null,220682020,523789,4380
220682107,0.0,0.0,1300,1300,0,0,1300,Null,Null,220682107,111461,2
220682815,0.0,0.0,1300,1300,0,0,1300,Null,Null,220682815,111461,2
220682848,0.0,0.0,1300,1300,0,0,1300,Null,Null,220682848,111461,2
220684237,0.0,0.0,1300,1300,0,0,1300,Null,Null,220684237,111461,2
220684412,37.0,37.0,15000,15000,0,0,15000,Null,Null,220684412,111461,23416
220684420,0.0,0.0,1300,1300,0,0,1300,Null,Null,220684420,111461,2
220684562,0.0,0.0,1300,1300,0,0,1300,Null,Null,220684562,111461,2
220684575,0.0,0.0,1300,1300,0,0,1300,Null,Null,220684575,111461,2
220684617,7.0,7.0,8690000,8690000,0,0,8690000,Null,Null,220684617,25422,1795
220684683,0.0,0.0,9900000,7289000,2611000,26,9900000,Null,Null,220684683,47424,2342
220684876,13.0,13.0,399000,315000,84000,21,399000,Null,Null,220684876,18984,1836
220697805,0.0,0.0,15000000,15000000,0,0,15000000,Null,Null,220697805,111461,15318
220701017,0.0,0.0,6490000,6490000,0,0,6490000,Null,Null,220701017,25422,1795
220724241,0.0,0.0,6800000,6800000,0,0,6800000,Null,Null,220724241,111461,15318
220746965,0.0,0.0,6500000,6500000,0,0,6500000,Null,Null,220746965,111461,15318
220764483,0.0,0.0,10800000,10800000,0,0,10800000,Null,Null,220764483,111461,15318
220795312,0.0,0.0,12800000,12800000,0,0,12800000,Null,Null,220795312,111461,15318
220821045,0.0,0.0,8800000,8800000,0,0,8800000,Null,Null,220821045,111461,15318
220823902,0.0,0.0,13800000,13800000,0,0,13800000,Null,Null,220823902,111461,15318
221011957,44.0,44.0,180000,180000,0,0,180000,Null,Null,221011957,7304183,5995
221045340,0.0,0.0,1130000,1130000,0,0,1130000,Null,Null,221045340,111461,49724
221223439,0.0,0.0,90000,81000,9000,10,90000,Null,Null,221223439,111461,15320
221230373,19.0,19.0,250000,250000,0,0,250000,Null,Null,221230373,18804,1626
221230394,0.0,0.0,40990000,28693000,12297000,30,40990000,Null,Null,221230394,18802,1795
221231171,12.0,12.0,59000,39000,20000,34,59000,Null,Null,221231171,18845,23362
221238129,0.0,0.0,6750000,4750000,2000000,30,6750000,Null,Null,221238129,47424,2342
221240631,0.0,0.0,23500000,13490000,10010000,43,23500000,Null,Null,221240631,47424,2340
221243405,0.0,0.0,9900000,7289000,2611000,26,9900000,Null,Null,221243405,47424,2340
221244356,0.0,0.0,5349000,5349000,0,0,5349000,Null,Null,221244356,19018,1634
221252755,103.0,103.0,115000,72000,43000,37,115000,Null,Null,221252755,111461,18860
221256638,8.0,8.0,60000,58800,1200,2,60000,Null,Null,221256638,21653,28484
221258367,0.0,0.0,3600000,3600000,0,0,3600000,Null,Null,221258367,253413,8172
221258427,0.0,0.0,6000000,6000000,0,0,6000000,Null,Null,221258427,111461,15318
221259149,0.0,0.0,2000,2000,0,0,2000,Null,Null,221259149,111461,27214
221262944,0.0,0.0,2000,2000,0,0,2000,Null,Null,221262944,111461,27214
221267660,42.0,42.0,470000,470000,0,0,470000,Null,Null,221267660,2630119,27546
221269640,0.0,0.0,20000000,20000000,0,0,20000000,Null,Null,221269640,47424,2342
221274391,27.0,27.0,2490000,2290000,200000,8,2490000,Null,Null,221274391,162007,1795
221515651,2.0,2.0,8000,8000,0,0,8000,Null,Null,221515651,111461,11877
221518066,1.0,1.0,6789000,5695506,1093494,16,6789000,Null,Null,221518066,147856,28856
221703613,0.0,0.0,12800000,12800000,0,0,12800000,Null,Null,221703613,317587,2342
221703622,0.0,0.0,10900000,10900000,0,0,10900000,Null,Null,221703622,111461,2342
221708090,0.0,0.0,3900,2000,1900,49,3900,Null,Null,221708090,111461,2
221708929,0.0,0.0,9499000,9499000,0,0,9499000,Null,Null,221708929,48649,1634
221728236,0.0,0.0,7990000,7990000,0,0,7990000,Null,Null,221728236,48649,1634
221739098,0.0,0.0,7400000,7400000,0,0,7400000,Null,Null,221739098,48649,1634
221803503,0.0,0.0,9800000,9800000,0,0,9800000,Null,Null,221803503,48649,1634
221819293,0.0,0.0,1500,1000,500,33,1500,Null,Null,221819293,111461,2
221820944,0.0,0.0,4000000,3600000,400000,10,4000000,Null,Null,221820944,111461,11877
221826901,0.0,0.0,5500000,5500000,0,0,5500000,Null,Null,221826901,48649,1634
222321965,61.0,61.0,390000,349000,41000,11,390000,Null,Null,222321965,47489,17170
222326237,53.0,53.0,635000,569000,66000,10,635000,Null,Null,222326237,47489,17170
222347660,0.0,0.0,4750000,4750000,0,0,4750000,Null,Null,222347660,111461,8167
222367659,0.0,0.0,3950000,3950000,0,0,3950000,Null,Null,222367659,111461,8167
222370671,0.0,0.0,6100000,6100000,0,0,6100000,Null,Null,222370671,111461,1634
222377858,0.0,0.0,4000,4000,0,0,4000,Null,Null,222377858,111461,28478
222398015,0.0,0.0,6200000,6200000,0,0,6200000,Null,Null,222398015,48649,1634
222402727,0.0,0.0,10700000,10700000,0,0,10700000,Null,Null,222402727,111461,11923
222414899,0.0,0.0,4990000,4990000,0,0,4990000,Null,Null,222414899,48649,1634
222428783,0.0,0.0,5990000,5990000,0,0,5990000,Null,Null,222428783,48649,1634
222432718,6.0,6.0,5990000,4790000,1200000,20,5990000,Null,Null,222432718,208841,2340
222458345,0.0,0.0,36900000,36900000,0,0,36900000,Null,Null,222458345,4093985,2340
222463171,0.0,0.0,42900000,42900000,0,0,42900000,Null,Null,222463171,4093985,2340
222467489,0.0,0.0,57000000,57000000,0,0,57000000,Null,Null,222467489,4093985,2340
222469386,0.0,0.0,6800000,6800000,0,0,6800000,Null,Null,222469386,111461,15318
222473874,0.0,0.0,83000000,83000000,0,0,83000000,Null,Null,222473874,4093985,2340
222497739,33.0,33.0,90000,61000,29000,32,90000,Null,Null,222497739,111461,28574
222533246,29.0,29.0,108000,88000,20000,19,108000,Null,Null,222533246,111461,28574
222577456,0.0,0.0,11850000,11850000,0,0,11850000,Null,Null,222577456,8130821,12876
222624566,0.0,0.0,4000,4000,0,0,4000,Null,Null,222624566,111461,2
222629732,0.0,0.0,39000,39000,0,0,39000,Null,Null,222629732,111461,28574
222635313,9.0,9.0,99000,73000,26000,26,99000,Null,Null,222635313,111461,28574
222638357,18.0,18.0,350000,350000,0,0,350000,Null,Null,222638357,512067,2340
222655400,39.0,39.0,175000,175000,0,0,175000,Null,Null,222655400,111461,8167
222655437,0.0,0.0,40000,29000,11000,28,40000,Null,Null,222655437,111461,1883
222655713,0.0,0.0,3380000,3380000,0,0,3380000,Null,Null,222655713,47424,2342
222659440,56.0,56.0,320000,299000,21000,7,320000,Null,Null,222659440,4182359,3426
222661952,0.0,0.0,61350000,61350000,0,0,61350000,Null,Null,222661952,622025,2
222663520,0.0,0.0,6200000,5580000,620000,10,6200000,Null,Null,222663520,253413,8172
222665353,0.0,0.0,5750000,5175000,575000,10,5750000,Null,Null,222665353,253413,8172
222665518,99.0,99.0,2000,2000,0,0,2000,Null,Null,222665518,111461,53074
222677592,3.0,3.0,399000,399000,0,0,399000,Null,Null,222677592,236337,49722
222679626,0.0,0.0,1140000,1140000,0,0,1140000,Null,Null,222679626,111461,2514
222682041,0.0,0.0,40818000,40818000,0,0,40818000,Null,Null,222682041,41408,2266
222682116,0.0,0.0,14000,9500,4500,32,14000,Null,Null,222682116,31581,2
222682118,0.0,0.0,12000,9500,2500,21,12000,Null,Null,222682118,31581,2
222682120,0.0,0.0,14000,9500,4500,32,14000,Null,Null,222682120,31581,2
222682124,0.0,0.0,14000,9500,4500,32,14000,Null,Null,222682124,31581,2
222682190,0.0,0.0,127963,127963,0,0,127963,Null,Null,222682190,111461,1936
222682303,0.0,0.0,14500000,14500000,0,0,14500000,Null,Null,222682303,111461,11943
222683724,0.0,0.0,10120000,9108000,1012000,10,10120000,Null,Null,222683724,253413,8172
222688428,0.0,0.0,1250,1250,0,0,1250,Null,Null,222688428,111461,2
222693555,0.0,0.0,3500,2000,1500,43,3500,Null,Null,222693555,111461,2
222693614,0.0,0.0,1000,990,10,1,1000,Null,Null,222693614,111461,2
222693626,0.0,0.0,1000,990,10,1,1000,Null,Null,222693626,111461,2
222693645,0.0,0.0,2000,1000,1000,50,2000,Null,Null,222693645,111461,2
222694846,0.0,0.0,5890000,5595500,294500,5,5890000,Null,Null,222694846,194385,8512
222713777,3.0,3.0,590000,349000,241000,41,590000,Null,Null,222713777,25422,2
222713999,0.0,0.0,3000,3000,0,0,3000,Null,Null,222713999,111461,8205
222723309,0.0,0.0,11180000,11180000,0,0,11180000,Null,Null,222723309,25502,8511
222723424,0.0,0.0,12600000,12600000,0,0,12600000,Null,Null,222723424,25502,8511
222723430,0.0,0.0,2000,2000,0,0,2000,Null,Null,222723430,111461,8205
222723535,0.0,0.0,3000,3000,0,0,3000,Null,Null,222723535,111461,8205
222723567,0.0,0.0,5000,5000,0,0,5000,Null,Null,222723567,111461,8205
223727594,67.0,67.0,179000,119500,59500,33,179000,Null,Null,223727594,5382095,2
223784157,0.0,0.0,2000,2000,0,0,2000,Null,Null,223784157,111461,8205
223818904,0.0,0.0,9000,8910,90,1,9000,Null,Null,223818904,5382095,8172
223819111,0.0,0.0,7500,7425,75,1,7500,Null,Null,223819111,5382095,8172
223859345,0.0,0.0,730000,730000,0,0,730000,Null,Null,223859345,112638,1796
223881880,2.0,2.0,449000,380000,69000,15,449000,Null,Null,223881880,112638,1796
224052503,0.0,0.0,2000,2000,0,0,2000,Null,Null,224052503,111461,27214
224095217,0.0,0.0,449000,396000,53000,12,449000,Null,Null,224095217,112638,1796
224129723,0.0,0.0,7000,7000,0,0,7000,Null,Null,224129723,111461,20254
224186586,1.0,1.0,499000,440000,59000,12,499000,Null,Null,224186586,112638,1796
224253128,0.0,0.0,5000,5000,0,0,5000,Null,Null,224253128,624697,49722
224254109,0.0,0.0,579000,511000,68000,12,579000,Null,Null,224254109,112638,1796
224442434,50.0,50.0,2500,2500,0,0,2500,Null,Null,224442434,111461,53074
224471397,0.0,0.0,14000,9500,4500,32,14000,Null,Null,224471397,31581,1601
224527020,0.0,0.0,14000,9500,4500,32,14000,Null,Null,224527020,31581,1601
224617962,0.0,0.0,2000,2000,0,0,2000,Null,Null,224617962,111461,27214
224629452,0.0,0.0,2000,2000,0,0,2000,Null,Null,224629452,111461,27214
224639612,0.0,0.0,2000,2000,0,0,2000,Null,Null,224639612,111461,27214
224651215,0.0,0.0,2000,2000,0,0,2000,Null,Null,224651215,111461,27214
224663657,0.0,0.0,2000,2000,0,0,2000,Null,Null,224663657,111461,27214
224692385,0.0,0.0,2000,2000,0,0,2000,Null,Null,224692385,111461,27214
224703378,0.0,0.0,2000,2000,0,0,2000,Null,Null,224703378,111461,27214
224726582,0.0,0.0,2000,2000,0,0,2000,Null,Null,224726582,111461,27214
224761452,0.0,0.0,2000,2000,0,0,2000,Null,Null,224761452,111461,27214
224771663,0.0,0.0,2000,2000,0,0,2000,Null,Null,224771663,111461,27214
224778306,0.0,0.0,2000,2000,0,0,2000,Null,Null,224778306,111461,27214
224785284,0.0,0.0,2000,2000,0,0,2000,Null,Null,224785284,111461,27214
224791050,0.0,0.0,2000,2000,0,0,2000,Null,Null,224791050,111461,27214
224798741,0.0,0.0,2000,2000,0,0,2000,Null,Null,224798741,111461,27214
224805540,0.0,0.0,2000,2000,0,0,2000,Null,Null,224805540,111461,27214
224815328,0.0,0.0,2000,2000,0,0,2000,Null,Null,224815328,111461,27214
224822507,0.0,0.0,2000,2000,0,0,2000,Null,Null,224822507,111461,27214
224828565,0.0,0.0,2000,2000,0,0,2000,Null,Null,224828565,111461,27214
224834844,0.0,0.0,2000,2000,0,0,2000,Null,Null,224834844,111461,27214
224841821,0.0,0.0,2000,2000,0,0,2000,Null,Null,224841821,111461,27214
224873580,1.0,1.0,579000,561630,17370,3,579000,Null,Null,224873580,112638,1796
224980332,357.0,357.0,255000,235000,20000,8,255000,Null,Null,224980332,111461,1815
224990491,101.0,101.0,255000,229000,26000,10,255000,Null,Null,224990491,837721,1815
225172279,2.0,2.0,5990000,5990000,0,0,5990000,Null,Null,225172279,25422,1795
225174273,0.0,0.0,1137,1137,0,0,1137,Null,Null,225174273,111461,2
225175114,0.0,0.0,3590000,3590000,0,0,3590000,Null,Null,225175114,25422,1795
225191892,1.0,1.0,20000,20000,0,0,20000,Null,Null,225191892,111461,2
225192235,0.0,0.0,1000,1000,0,0,1000,Null,Null,225192235,111461,2
225196029,9.0,9.0,495000,495000,0,0,495000,Null,Null,225196029,7863833,1815
225196178,0.0,0.0,8285000,8285000,0,0,8285000,Null,Null,225196178,25502,7449
225206390,23.0,23.0,80000,50005,29995,37,80000,Null,Null,225206390,111461,1883
225208069,0.0,0.0,1000,1000,0,0,1000,Null,Null,225208069,111461,2363
225209672,0.0,0.0,3400000,3400000,0,0,3400000,Null,Null,225209672,665101,8227
225210578,18.0,18.0,80000,52000,28000,35,80000,Null,Null,225210578,111461,8167
225210695,0.0,0.0,2500,2500,0,0,2500,Null,Null,225210695,111461,18860
225210924,0.0,0.0,2150,2150,0,0,2150,Null,Null,225210924,111461,9052
225214532,4.0,4.0,99000,97000,2000,2,99000,Null,Null,225214532,166419,20244
225222366,22.0,22.0,229000,115000,114000,50,229000,Null,Null,225222366,7270983,1831
225224915,0.0,0.0,1000,1000,0,0,1000,Null,Null,225224915,111461,23112
225225975,13.0,13.0,229000,119000,110000,48,229000,Null,Null,225225975,7270983,1831
225228869,0.0,0.0,30071000,23253000,6818000,23,30071000,Null,Null,225228869,18802,1795
225229761,4.0,4.0,64000,64000,0,0,64000,Null,Null,225229761,111461,2
225230602,14.0,14.0,2999000,1865000,1134000,38,2999000,Null,Null,225230602,19813,2136
225230688,0.0,0.0,18900000,11350000,7550000,40,18900000,Null,Null,225230688,47424,8172
225231572,4.0,4.0,31990000,20990000,11000000,34,31990000,Null,Null,225231572,18802,1795
225231932,0.0,0.0,15000,15000,0,0,15000,Null,Null,225231932,624697,49724
225234424,0.0,0.0,34000000,28439000,5561000,16,34000000,Null,Null,225234424,18802,1795
225235024,0.0,0.0,17490000,17490000,0,0,17490000,Null,Null,225235024,111461,2340
225235791,0.0,0.0,42000000,36000000,6000000,14,42000000,Null,Null,225235791,18802,1795
225239956,0.0,0.0,13543000,9064000,4479000,33,13543000,Null,Null,225239956,241109,11935
225240034,9.0,9.0,1159000,664000,495000,43,1159000,Null,Null,225240034,19813,1984
225241398,0.0,0.0,25000000,19260000,5740000,23,25000000,Null,Null,225241398,18802,1795
225242723,0.0,0.0,28000000,22431000,5569000,20,28000000,Null,Null,225242723,18802,1795
225243333,0.0,0.0,25000000,19260000,5740000,23,25000000,Null,Null,225243333,18802,1795
225243804,0.0,0.0,28000000,28000000,0,0,28000000,Null,Null,225243804,18802,1795
225246744,0.0,0.0,25000000,19260000,5740000,23,25000000,Null,Null,225246744,18802,1795
225247922,0.0,0.0,28000000,22431000,5569000,20,28000000,Null,Null,225247922,18802,1795
225251266,0.0,0.0,25000000,19260000,5740000,23,25000000,Null,Null,225251266,18802,1795
225255032,16.0,16.0,35000,28000,7000,20,35000,Null,Null,225255032,111461,27256
225260921,0.0,0.0,28000000,22431000,5569000,20,28000000,Null,Null,225260921,18802,1795
225263865,2.0,2.0,31990000,22590000,9400000,29,31990000,Null,Null,225263865,18802,1795
225264029,0.0,0.0,23491000,20665000,2826000,12,23491000,Null,Null,225264029,18802,1795
225266084,10.0,10.0,12990000,7450000,5540000,43,12990000,Null,Null,225266084,18802,1794
225266165,6.0,6.0,499000,329000,170000,34,499000,Null,Null,225266165,21282,1520
225266660,3.0,3.0,499000,329000,170000,34,499000,Null,Null,225266660,21282,1520
225267444,0.0,0.0,33000000,28439000,4561000,14,33000000,Null,Null,225267444,18802,1795
225271277,0.0,0.0,23491000,20665000,2826000,12,23491000,Null,Null,225271277,18802,1795
225289486,0.0,0.0,5900000,5900000,0,0,5900000,Null,Null,225289486,4267617,8165
225298417,0.0,0.0,23000000,19260000,3740000,16,23000000,Null,Null,225298417,18802,1795
225381612,3.0,3.0,31990000,23250000,8740000,27,31990000,Null,Null,225381612,18802,1795
225906638,0.0,0.0,24500000,17150000,7350000,30,24500000,Null,Null,225906638,111461,2324
225907773,0.0,0.0,6500000,6500000,0,0,6500000,Null,Null,225907773,4267617,11935
225909405,0.0,0.0,247000,247000,0,0,247000,Null,Null,225909405,111461,8198
225909891,0.0,0.0,5100000,5100000,0,0,5100000,Null,Null,225909891,4267617,11935
225910615,0.0,0.0,3600000,3600000,0,0,3600000,Null,Null,225910615,253413,8172
225910655,0.0,0.0,30000000,23253000,6747000,22,30000000,Null,Null,225910655,18802,1795
225911057,2.0,2.0,99000,99000,0,0,99000,Null,Null,225911057,111461,15250
225912019,0.0,0.0,21000000,21000000,0,0,21000000,Null,Null,225912019,162945,11518
225912237,1.0,1.0,150000,150000,0,0,150000,Null,Null,225912237,111461,2
225912433,5.0,5.0,150000,150000,0,0,150000,Null,Null,225912433,111461,2
225912504,0.0,0.0,519000,451000,68000,13,519000,Null,Null,225912504,150568,1796
225915390,17.0,17.0,310000,310000,0,0,310000,Null,Null,225915390,7520663,53350
225915409,0.0,0.0,17900000,17363000,537000,3,17900000,Null,Null,225915409,162945,7079
225918977,0.0,0.0,16200000,16200000,0,0,16200000,Null,Null,225918977,162945,28872
225919812,4.0,4.0,3150000,3150000,0,0,3150000,Null,Null,225919812,8131421,2324
225920500,0.0,0.0,18500000,18500000,0,0,18500000,Null,Null,225920500,162945,7079
225920758,0.0,0.0,34771000,28439000,6332000,18,34771000,Null,Null,225920758,18802,1795
225920923,1.0,1.0,13200000,13200000,0,0,13200000,Null,Null,225920923,162945,7079
225921921,0.0,0.0,26550000,26550000,0,0,26550000,Null,Null,225921921,50331,11518
225924581,0.0,0.0,16500000,14850000,1650000,10,16500000,Null,Null,225924581,253413,8172
225926114,0.0,0.0,5000,5000,0,0,5000,Null,Null,225926114,111461,8205
225928819,0.0,0.0,84700000,84700000,0,0,84700000,Null,Null,225928819,148818,23710
225933804,11.0,11.0,271000,261000,10000,4,271000,Null,Null,225933804,47663,8226
225934002,12.0,12.0,39500,37525,1975,5,39500,Null,Null,225934002,111461,28484
225936344,6.0,6.0,6990000,5550000,1440000,21,6990000,Null,Null,225936344,18802,1794
225938248,16.0,16.0,1008000,595000,413000,41,1008000,Null,Null,225938248,5173405,23362
225938665,2.0,2.0,15990000,15120000,870000,5,15990000,Null,Null,225938665,183637,28856
225940372,0.0,0.0,13320000,13320000,0,0,13320000,Null,Null,225940372,162945,7079
225940990,0.0,0.0,21150000,21150000,0,0,21150000,Null,Null,225940990,162945,11518
225941065,4.0,4.0,429000,189000,240000,56,429000,Null,Null,225941065,314675,8400
225941452,0.0,0.0,17850000,17314500,535500,3,17850000,Null,Null,225941452,162945,7079
225941563,23.0,23.0,182500,138000,44500,24,182500,Null,Null,225941563,47664,8223
225947051,0.0,0.0,548000,274000,274000,50,548000,Null,Null,225947051,111461,15236
225952604,0.0,0.0,2000,2000,0,0,2000,Null,Null,225952604,111461,2
225956294,0.0,0.0,3810000,3810000,0,0,3810000,Null,Null,225956294,262661,53350
225956348,0.0,0.0,5920000,5920000,0,0,5920000,Null,Null,225956348,262661,5893
225956895,0.0,0.0,5215000,5215000,0,0,5215000,Null,Null,225956895,262661,5893
225957843,12.0,12.0,250000,250000,0,0,250000,Null,Null,225957843,111461,11856
225957987,0.0,0.0,20250000,15800000,4450000,22,20250000,Null,Null,225957987,18802,1789
225958846,0.0,0.0,22200000,17160000,5040000,23,22200000,Null,Null,225958846,18802,1789
225959581,0.0,0.0,23491000,20665000,2826000,12,23491000,Null,Null,225959581,18802,1795
225960096,0.0,0.0,25000000,19260000,5740000,23,25000000,Null,Null,225960096,18802,1795
225961272,0.0,0.0,30000000,23253000,6747000,22,30000000,Null,Null,225961272,18802,1795
225961588,0.0,0.0,1000,1000,0,0,1000,Null,Null,225961588,111461,2
225967423,20.0,20.0,1500,1500,0,0,1500,Null,Null,225967423,111461,2
225969894,0.0,0.0,11900000,11900000,0,0,11900000,Null,Null,225969894,4649279,8066
225971148,182.0,182.0,520000,311000,209000,40,520000,Null,Null,225971148,19034,1815
225987405,0.0,0.0,13300000,13300000,0,0,13300000,Null,Null,225987405,162945,7079
226011011,0.0,0.0,26550000,26550000,0,0,26550000,Null,Null,226011011,50331,11518
226029015,0.0,0.0,18935474,18935474,0,0,18935474,Null,Null,226029015,229849,10413
226033460,0.0,0.0,12000,12000,0,0,12000,Null,Null,226033460,111461,2
226033505,0.0,0.0,12000,12000,0,0,12000,Null,Null,226033505,111461,2
226033558,0.0,0.0,13726,13726,0,0,13726,Null,Null,226033558,111461,2
226033563,0.0,0.0,15000,15000,0,0,15000,Null,Null,226033563,111461,2
226033564,1.0,1.0,8400,8400,0,0,8400,Null,Null,226033564,111461,2
226033585,0.0,0.0,11000,11000,0,0,11000,Null,Null,226033585,111461,2
226033586,0.0,0.0,6000,6000,0,0,6000,Null,Null,226033586,111461,2
226033588,1.0,1.0,8400,8400,0,0,8400,Null,Null,226033588,111461,2
226033732,0.0,0.0,17000,17000,0,0,17000,Null,Null,226033732,111461,2
226034011,0.0,0.0,14000,14000,0,0,14000,Null,Null,226034011,111461,2
226034069,0.0,0.0,8000,8000,0,0,8000,Null,Null,226034069,111461,2
226034104,1.0,1.0,9800,9800,0,0,9800,Null,Null,226034104,111461,2
226036798,283.0,283.0,549000,277000,272000,50,549000,Null,Null,226036798,48077,1936
226043852,209.0,209.0,153000,146000,7000,5,153000,Null,Null,226043852,111461,1883
226049015,0.0,0.0,13320000,12920400,399600,3,13320000,Null,Null,226049015,162945,7079
226093407,18.0,18.0,1980000,990000,990000,50,1980000,Null,Null,226093407,33652,2136
226106395,0.0,0.0,16500000,16500000,0,0,16500000,Null,Null,226106395,253413,2342
226399119,25.0,25.0,684000,479000,205000,30,684000,Null,Null,226399119,204895,6305
226552005,119.0,119.0,539000,539000,0,0,539000,Null,Null,226552005,18804,1789
226671139,1.0,1.0,125000,111250,13750,11,125000,Null,Null,226671139,111461,2
226671147,2.0,2.0,399000,355110,43890,11,399000,Null,Null,226671147,111461,2
226757028,0.0,0.0,18500000,18500000,0,0,18500000,Null,Null,226757028,253413,8172
226781154,8.0,8.0,490000,490000,0,0,490000,Null,Null,226781154,4827915,11879
226884421,9.0,9.0,999000,489000,510000,51,999000,Null,Null,226884421,625853,28454
226904305,49.0,49.0,250000,159000,91000,36,250000,Null,Null,226904305,5147565,2659
227131147,0.0,0.0,9820000,8838000,982000,10,9820000,Null,Null,227131147,253413,8172
227177885,0.0,0.0,12585000,12585000,0,0,12585000,Null,Null,227177885,25502,8511
227234512,11.0,11.0,249000,225000,24000,10,249000,Null,Null,227234512,4973949,28428
227490134,111.0,111.0,180000,90000,90000,50,180000,Null,Null,227490134,18845,1815
227746564,34.0,34.0,169000,168799,201,0,169000,Null,Null,227746564,5126697,28484
228660058,4.0,4.0,800000,800000,0,0,800000,Null,Null,228660058,111461,2324
228821573,1.0,1.0,340000,340000,0,0,340000,Null,Null,228821573,111461,7081
229696751,1.0,1.0,59000,59000,0,0,59000,Null,Null,229696751,111461,2
229696872,1.0,1.0,115000,115000,0,0,115000,Null,Null,229696872,111461,2
229697030,1.0,1.0,115000,115000,0,0,115000,Null,Null,229697030,111461,2
229697033,1.0,1.0,39000,39000,0,0,39000,Null,Null,229697033,111461,2
229697075,2.0,2.0,115000,115000,0,0,115000,Null,Null,229697075,111461,2
229697147,3.0,3.0,68000,68000,0,0,68000,Null,Null,229697147,111461,2
229697948,26.0,26.0,390000,259000,131000,34,390000,Null,Null,229697948,25422,1813
229698525,0.0,0.0,39700000,39700000,0,0,39700000,Null,Null,229698525,5710451,20170
229698635,0.0,0.0,10000,5000,5000,50,10000,Null,Null,229698635,111461,15318
229701402,28.0,28.0,159000,129000,30000,19,159000,Null,Null,229701402,7288833,2784
229703799,0.0,0.0,12500000,12500000,0,0,12500000,Null,Null,229703799,412133,1813
229704165,0.0,0.0,1850,1850,0,0,1850,Null,Null,229704165,111461,2
229722230,0.0,0.0,37657182,37657182,0,0,37657182,Null,Null,229722230,41408,23526
229724135,0.0,0.0,48740317,48740317,0,0,48740317,Null,Null,229724135,41408,23544
229724461,0.0,0.0,48918526,48918526,0,0,48918526,Null,Null,229724461,41408,2266
229724915,0.0,0.0,63107572,63107572,0,0,63107572,Null,Null,229724915,41408,2266
229725151,0.0,0.0,43928658,43928658,0,0,43928658,Null,Null,229725151,41408,2266
229725649,0.0,0.0,11900000,11900000,0,0,11900000,Null,Null,229725649,4649279,8066
229726382,0.0,0.0,159000,159000,0,0,159000,Null,Null,229726382,111461,2
229726409,0.0,0.0,179000,179000,0,0,179000,Null,Null,229726409,111461,2
229726576,259.0,259.0,9900,9900,0,0,9900,Null,Null,229726576,111461,23042
229727013,36.0,36.0,150000,77000,73000,49,150000,Null,Null,229727013,31600,1820
229735554,0.0,0.0,12750000,12750000,0,0,12750000,Null,Null,229735554,412133,1813
229760648,1.0,1.0,2000,2000,0,0,2000,Null,Null,229760648,111461,2
229760649,0.0,0.0,2000,2000,0,0,2000,Null,Null,229760649,111461,2
229760650,0.0,0.0,2500,2500,0,0,2500,Null,Null,229760650,111461,2
229765302,92.0,92.0,250000,250000,0,0,250000,Null,Null,229765302,2630119,2657
229784444,0.0,0.0,13500,11000,2500,19,13500,Null,Null,229784444,111461,49728
229800545,0.0,0.0,3900000,3510000,390000,10,3900000,Null,Null,229800545,282179,53350
229800551,0.0,0.0,3900000,3510000,390000,10,3900000,Null,Null,229800551,282179,17170
229800566,0.0,0.0,5400000,4860000,540000,10,5400000,Null,Null,229800566,282179,53350
229800589,0.0,0.0,4000000,3600000,400000,10,4000000,Null,Null,229800589,282179,17170
229800593,0.0,0.0,3900000,3510000,390000,10,3900000,Null,Null,229800593,282179,17170
229800595,0.0,0.0,3900000,3510000,390000,10,3900000,Null,Null,229800595,282179,53350
229800599,0.0,0.0,3900000,3510000,390000,10,3900000,Null,Null,229800599,282179,53350
229802076,0.0,0.0,1800,1800,0,0,1800,Null,Null,229802076,111461,2
229805481,0.0,0.0,5700000,5700000,0,0,5700000,Null,Null,229805481,111461,1634
229974103,0.0,0.0,4300000,4300000,0,0,4300000,Null,Null,229974103,253413,8172
230004334,0.0,0.0,2000,2000,0,0,2000,Null,Null,230004334,111461,2
230004346,0.0,0.0,1990,1990,0,0,1990,Null,Null,230004346,111461,2
230008424,0.0,0.0,24990000,16300000,8690000,35,24990000,Null,Null,230008424,18802,1795
230019468,0.0,0.0,84550000,84550000,0,0,84550000,Null,Null,230019468,162945,11518
230032116,0.0,0.0,79500000,77115000,2385000,3,79500000,Null,Null,230032116,162945,11518
230038148,0.0,0.0,15990000,15990000,0,0,15990000,Null,Null,230038148,74999,11516
230038783,0.0,0.0,108000,108000,0,0,108000,Null,Null,230038783,111461,2513
230039312,0.0,0.0,12990000,12990000,0,0,12990000,Null,Null,230039312,74999,11516
230040416,0.0,0.0,7500,7500,0,0,7500,Null,Null,230040416,111461,2
230050507,0.0,0.0,63970000,47977500,15992500,25,63970000,Null,Null,230050507,162945,7079
230051146,0.0,0.0,63970000,47977500,15992500,25,63970000,Null,Null,230051146,162945,7079
230054555,0.0,0.0,31970000,23977500,7992500,25,31970000,Null,Null,230054555,162945,28874
230054671,16.0,16.0,119000,89000,30000,25,119000,Null,Null,230054671,25422,1520
230054673,2.0,2.0,199000,129000,70000,35,199000,Null,Null,230054673,25422,2
230054675,49.0,49.0,155000,155000,0,0,155000,Null,Null,230054675,25422,1520
230055130,0.0,0.0,10392000,10392000,0,0,10392000,Null,Null,230055130,25643,1795
230056086,0.0,0.0,9492000,9492000,0,0,9492000,Null,Null,230056086,25643,1795
230081581,0.0,0.0,135999000,79999999,55999001,41,135999000,Null,Null,230081581,542569,2340
230082250,0.0,0.0,9990000,8389000,1601000,16,9990000,Null,Null,230082250,25643,1795
230082946,37.0,37.0,1150000,1150000,0,0,1150000,Null,Null,230082946,2630119,28444
230083492,3.0,3.0,1490000,1490000,0,0,1490000,Null,Null,230083492,20215,2324
230098289,0.0,0.0,545000,545000,0,0,545000,Null,Null,230098289,111461,53074
230098530,19.0,19.0,79000,75000,4000,5,79000,Null,Null,230098530,512067,27180
230155305,26.0,26.0,3990000,2659000,1331000,33,3990000,Null,Null,230155305,25422,1795
230157205,10.0,10.0,4190000,2899000,1291000,31,4190000,Null,Null,230157205,25422,1795
230198460,0.0,0.0,12585000,12585000,0,0,12585000,Null,Null,230198460,25502,5385
230199860,0.0,0.0,1200,1200,0,0,1200,Null,Null,230199860,111461,2
230200518,0.0,0.0,570000,570000,0,0,570000,Null,Null,230200518,111461,23708
230200525,0.0,0.0,1900,1900,0,0,1900,Null,Null,230200525,111461,2
230200728,0.0,0.0,3900000,3783000,117000,3,3900000,Null,Null,230200728,111461,2340
230201072,0.0,0.0,3900000,3783000,117000,3,3900000,Null,Null,230201072,111461,2340
230201155,9.0,9.0,330000,289060,40940,12,330000,Null,Null,230201155,143353,28576
230202441,0.0,0.0,7199000,7199000,0,0,7199000,Null,Null,230202441,48649,1634
230202593,0.0,0.0,7990000,7990000,0,0,7990000,Null,Null,230202593,48649,1634
230203035,8.0,8.0,10000,10000,0,0,10000,Null,Null,230203035,111461,27180
230203067,3.0,3.0,4590000,3120000,1470000,32,4590000,Null,Null,230203067,25643,1795
230203401,9.0,9.0,250000,180000,70000,28,250000,Null,Null,230203401,111461,28576
230211162,0.0,0.0,92600000,92600000,0,0,92600000,Null,Null,230211162,162945,7079
230212302,0.0,0.0,91500000,91500000,0,0,91500000,Null,Null,230212302,162945,7079
230219168,0.0,0.0,10750000,10750000,0,0,10750000,Null,Null,230219168,48649,1634
230225344,27.0,27.0,250000,199000,51000,20,250000,Null,Null,230225344,312329,2657
230249671,4.0,4.0,330000,280000,50000,15,330000,Null,Null,230249671,143353,28576
230250771,0.0,0.0,11490000,8617500,2872500,25,11490000,Null,Null,230250771,174699,8513
230250773,0.0,0.0,13480000,10110000,3370000,25,13480000,Null,Null,230250773,174699,8513
230250774,0.0,0.0,8510000,6382500,2127500,25,8510000,Null,Null,230250774,174699,8513
230250777,0.0,0.0,6800623,6800623,0,0,6800623,Null,Null,230250777,174699,8513
230250783,0.0,0.0,12850000,9637500,3212500,25,12850000,Null,Null,230250783,174699,8513
230250785,0.0,0.0,7900000,5925000,1975000,25,7900000,Null,Null,230250785,174699,8513
230250787,0.0,0.0,13480000,10110000,3370000,25,13480000,Null,Null,230250787,174699,8513
230250791,0.0,0.0,9320000,6990000,2330000,25,9320000,Null,Null,230250791,174699,8513
230250793,0.0,0.0,10400000,7800000,2600000,25,10400000,Null,Null,230250793,174699,8513
230250814,0.0,0.0,7636843,7636843,0,0,7636843,Null,Null,230250814,174699,8513
230253070,5.0,5.0,489000,297000,192000,39,489000,Null,Null,230253070,5048343,28736
230313735,3.0,3.0,2000,2000,0,0,2000,Null,Null,230313735,111461,2
230313793,0.0,0.0,7000,7000,0,0,7000,Null,Null,230313793,111461,2
230314039,0.0,0.0,7000,7000,0,0,7000,Null,Null,230314039,111461,2
230615437,0.0,0.0,2000,2000,0,0,2000,Null,Null,230615437,111461,2
230897684,0.0,0.0,9000,9000,0,0,9000,Null,Null,230897684,111461,26658
232040209,0.0,0.0,95000,95000,0,0,95000,Null,Null,232040209,111461,23692
232446295,1.0,1.0,5000,5000,0,0,5000,Null,Null,232446295,505165,2
232710390,177.0,177.0,1799000,1399000,400000,22,1799000,Null,Null,232710390,4250493,23634
233238208,0.0,0.0,9685000,9685000,0,0,9685000,Null,Null,233238208,25502,5385
233290529,0.0,0.0,9000,9000,0,0,9000,Null,Null,233290529,111461,1622
233483339,0.0,0.0,8085000,8085000,0,0,8085000,Null,Null,233483339,25502,5385
233546880,0.0,0.0,10085000,10085000,0,0,10085000,Null,Null,233546880,25502,5385
235368612,12.0,12.0,700000,350000,350000,50,700000,Null,Null,235368612,111461,12908
235505799,0.0,0.0,13000,13000,0,0,13000,Null,Null,235505799,111461,27546
235731436,24.0,24.0,815000,815000,0,0,815000,Null,Null,235731436,7481227,17186
235734781,24.0,24.0,400000,290000,110000,28,400000,Null,Null,235734781,8051609,53348
235856188,0.0,0.0,41000000,41000000,0,0,41000000,Null,Null,235856188,162945,20170
235856727,9.0,9.0,405000,329000,76000,19,405000,Null,Null,235856727,111461,28454
235874926,0.0,0.0,1300,1300,0,0,1300,Null,Null,235874926,111461,2
235874983,0.0,0.0,1300,1300,0,0,1300,Null,Null,235874983,111461,2
235875333,0.0,0.0,2179,2179,0,0,2179,Null,Null,235875333,111461,2
235875373,0.0,0.0,2327,2327,0,0,2327,Null,Null,235875373,111461,2
235876129,0.0,0.0,2343,2343,0,0,2343,Null,Null,235876129,111461,2
235876238,0.0,0.0,1788,1788,0,0,1788,Null,Null,235876238,111461,2
235876653,0.0,0.0,2179,2179,0,0,2179,Null,Null,235876653,111461,2
235876841,0.0,0.0,2123,2123,0,0,2123,Null,Null,235876841,111461,2
235876848,0.0,0.0,1340,1340,0,0,1340,Null,Null,235876848,111461,2
235876907,0.0,0.0,1300,1300,0,0,1300,Null,Null,235876907,111461,2
235876933,0.0,0.0,1300,1300,0,0,1300,Null,Null,235876933,111461,2
235877129,0.0,0.0,1984,1984,0,0,1984,Null,Null,235877129,111461,2
235877156,0.0,0.0,1788,1788,0,0,1788,Null,Null,235877156,111461,2
235877169,0.0,0.0,2163,2163,0,0,2163,Null,Null,235877169,111461,2
235877194,0.0,0.0,2245,2245,0,0,2245,Null,Null,235877194,111461,2
236157089,0.0,0.0,2500,2500,0,0,2500,Null,Null,236157089,111461,2
236157768,0.0,0.0,2500,2500,0,0,2500,Null,Null,236157768,111461,2
236158657,0.0,0.0,2500,2500,0,0,2500,Null,Null,236158657,111461,2
236477823,22.0,22.0,49000,49000,0,0,49000,Null,Null,236477823,111461,5454
236886216,0.0,0.0,10200000,10200000,0,0,10200000,Null,Null,236886216,48649,1634
236945230,0.0,0.0,7990000,7990000,0,0,7990000,Null,Null,236945230,48649,1634
237012954,0.0,0.0,8100000,8100000,0,0,8100000,Null,Null,237012954,48649,1634
237379988,0.0,0.0,10300000,10300000,0,0,10300000,Null,Null,237379988,48649,1634
237402759,0.0,0.0,5380000,5380000,0,0,5380000,Null,Null,237402759,48649,1634
237857064,2.0,2.0,1240000,1116000,124000,10,1240000,Null,Null,237857064,144018,49722
238233089,0.0,0.0,2500,2500,0,0,2500,Null,Null,238233089,111461,2
238235373,0.0,0.0,2500,2500,0,0,2500,Null,Null,238235373,111461,2
238236128,0.0,0.0,2500,2500,0,0,2500,Null,Null,238236128,111461,2
239297317,0.0,0.0,15200000,11690000,3510000,23,15200000,Null,Null,239297317,4649279,11516
239358181,0.0,0.0,17499000,17499000,0,0,17499000,Null,Null,239358181,18641,8042
239711504,2.0,2.0,39000,39000,0,0,39000,Null,Null,239711504,111461,2
239965655,6.0,6.0,650000,650000,0,0,650000,Null,Null,239965655,143017,17184
240088158,8.0,8.0,590000,590000,0,0,590000,Null,Null,240088158,726687,2
240245661,7.0,7.0,979000,979000,0,0,979000,Null,Null,240245661,160905,1636
240277394,4.0,4.0,269000,269000,0,0,269000,Null,Null,240277394,4973949,28428
240365564,13.0,13.0,50000,47500,2500,5,50000,Null,Null,240365564,111461,8198
240535174,0.0,0.0,15500000,15500000,0,0,15500000,Null,Null,240535174,111461,2342
240656577,0.0,0.0,12000,12000,0,0,12000,Null,Null,240656577,111461,2
240712890,0.0,0.0,199000,179100,19900,10,199000,Null,Null,240712890,21651,12908
240751042,16.0,16.0,300000,145000,155000,52,300000,Null,Null,240751042,21651,5006
241224021,12.0,12.0,3395,3395,0,0,3395,Null,Null,241224021,111461,1815
241582202,11.0,11.0,7500,7500,0,0,7500,Null,Null,241582202,111461,2
241635069,0.0,0.0,17990000,17990000,0,0,17990000,Null,Null,241635069,144779,2324
241672501,0.0,0.0,7000,7000,0,0,7000,Null,Null,241672501,111461,2
241672732,0.0,0.0,4000,4000,0,0,4000,Null,Null,241672732,111461,2
241673184,0.0,0.0,4000,4000,0,0,4000,Null,Null,241673184,111461,2
241673186,0.0,0.0,4000,4000,0,0,4000,Null,Null,241673186,111461,2
241673208,0.0,0.0,8000,8000,0,0,8000,Null,Null,241673208,111461,2
241673248,0.0,0.0,8000,8000,0,0,8000,Null,Null,241673248,111461,2
241673878,1.0,1.0,8000,8000,0,0,8000,Null,Null,241673878,111461,2
241675035,0.0,0.0,4000,4000,0,0,4000,Null,Null,241675035,111461,2
241675064,0.0,0.0,8000,8000,0,0,8000,Null,Null,241675064,111461,2
241675078,0.0,0.0,5000,5000,0,0,5000,Null,Null,241675078,111461,2
241675083,0.0,0.0,8000,8000,0,0,8000,Null,Null,241675083,111461,2
241675107,0.0,0.0,10000,10000,0,0,10000,Null,Null,241675107,111461,2
241675186,0.0,0.0,8000,8000,0,0,8000,Null,Null,241675186,111461,2
241675370,0.0,0.0,8000,8000,0,0,8000,Null,Null,241675370,111461,2
241738356,6.0,6.0,65000,49000,16000,25,65000,Null,Null,241738356,222917,27256
241755605,2.0,2.0,650000,425000,225000,35,650000,Null,Null,241755605,111461,15250
241765944,24.0,24.0,53000,53000,0,0,53000,Null,Null,241765944,111461,17162
241774921,0.0,0.0,8000,8000,0,0,8000,Null,Null,241774921,111461,2
241774940,0.0,0.0,4000,4000,0,0,4000,Null,Null,241774940,111461,2
241774952,0.0,0.0,5000,5000,0,0,5000,Null,Null,241774952,111461,2
241774969,0.0,0.0,10000,10000,0,0,10000,Null,Null,241774969,111461,2
241776493,0.0,0.0,30000,30000,0,0,30000,Null,Null,241776493,111461,2
241776495,0.0,0.0,10000,10000,0,0,10000,Null,Null,241776495,111461,2
241779604,0.0,0.0,8000,8000,0,0,8000,Null,Null,241779604,111461,2
241780159,0.0,0.0,3000,3000,0,0,3000,Null,Null,241780159,111461,2
241783173,2.0,2.0,9000,9000,0,0,9000,Null,Null,241783173,111461,2
241783180,0.0,0.0,2000,2000,0,0,2000,Null,Null,241783180,111461,2
241783181,0.0,0.0,8000,8000,0,0,8000,Null,Null,241783181,111461,2
241783191,0.0,0.0,5000,5000,0,0,5000,Null,Null,241783191,111461,2
241784297,0.0,0.0,3000,3000,0,0,3000,Null,Null,241784297,111461,2
241784298,0.0,0.0,5000,5000,0,0,5000,Null,Null,241784298,111461,2
241785782,0.0,0.0,8500,8500,0,0,8500,Null,Null,241785782,111461,2
241785795,0.0,0.0,8000,8000,0,0,8000,Null,Null,241785795,111461,2
241785803,0.0,0.0,5000,5000,0,0,5000,Null,Null,241785803,111461,2
241787523,0.0,0.0,8000,8000,0,0,8000,Null,Null,241787523,111461,2
241787586,0.0,0.0,8000,8000,0,0,8000,Null,Null,241787586,111461,2
241787670,0.0,0.0,8000,8000,0,0,8000,Null,Null,241787670,111461,2
241788705,0.0,0.0,4000,4000,0,0,4000,Null,Null,241788705,111461,2
241788739,0.0,0.0,10000,10000,0,0,10000,Null,Null,241788739,111461,2
241788857,0.0,0.0,1000,1000,0,0,1000,Null,Null,241788857,111461,2
241789645,0.0,0.0,8000,8000,0,0,8000,Null,Null,241789645,111461,2
241789893,0.0,0.0,8000,8000,0,0,8000,Null,Null,241789893,111461,2
241791711,0.0,0.0,7000,7000,0,0,7000,Null,Null,241791711,111461,2
241791823,0.0,0.0,7000,7000,0,0,7000,Null,Null,241791823,111461,2
241791835,0.0,0.0,5000,5000,0,0,5000,Null,Null,241791835,111461,2
241793255,0.0,0.0,10000,10000,0,0,10000,Null,Null,241793255,111461,2
241799251,0.0,0.0,3000,3000,0,0,3000,Null,Null,241799251,111461,2
241799321,0.0,0.0,2500,2500,0,0,2500,Null,Null,241799321,111461,2
241799627,0.0,0.0,5000,5000,0,0,5000,Null,Null,241799627,111461,2
241799635,0.0,0.0,5000,5000,0,0,5000,Null,Null,241799635,111461,2
241804451,10187.0,10187.0,15000,15000,0,0,15000,Null,Null,241804451,5063093,1883
241805597,9707.0,9707.0,12000,12000,0,0,12000,Null,Null,241805597,5063093,1883
241828309,4.0,4.0,5000000,5000000,0,0,5000000,Null,Null,241828309,218061,2334
241885132,0.0,0.0,2500,2500,0,0,2500,Null,Null,241885132,111461,2
241885311,0.0,0.0,1500,1500,0,0,1500,Null,Null,241885311,111461,2
241886089,0.0,0.0,1000,1000,0,0,1000,Null,Null,241886089,111461,2
241886148,0.0,0.0,2500,2500,0,0,2500,Null,Null,241886148,111461,2
241886202,0.0,0.0,2500,2500,0,0,2500,Null,Null,241886202,111461,2
241886523,0.0,0.0,2000,2000,0,0,2000,Null,Null,241886523,111461,2
241912901,0.0,0.0,2000,2000,0,0,2000,Null,Null,241912901,111461,28456
241984851,0.0,0.0,2000,2000,0,0,2000,Null,Null,241984851,111461,8205
241993868,0.0,0.0,16800000,16800000,0,0,16800000,Null,Null,241993868,472079,4880
241994721,3.0,3.0,49000,44000,5000,10,49000,Null,Null,241994721,111461,5007
242023970,0.0,0.0,10000,5000,5000,50,10000,Null,Null,242023970,8137269,2
242023975,0.0,0.0,10000,5000,5000,50,10000,Null,Null,242023975,7476847,2
242027089,0.0,0.0,79000,79000,0,0,79000,Null,Null,242027089,113006,28464
242052978,0.0,0.0,40700000,40700000,0,0,40700000,Null,Null,242052978,180963,11518
242058698,0.0,0.0,76300000,76300000,0,0,76300000,Null,Null,242058698,180963,11518
242070066,0.0,0.0,10000,10000,0,0,10000,Null,Null,242070066,111461,8205
242075552,232.0,232.0,1249000,999000,250000,20,1249000,Null,Null,242075552,4250493,23634
242086158,64.0,64.0,250000,189000,61000,24,250000,Null,Null,242086158,5262001,5995
242090651,71.0,71.0,278000,139000,139000,50,278000,Null,Null,242090651,4259829,1778
242099007,1.0,1.0,3990000,3990000,0,0,3990000,Null,Null,242099007,195489,2162
242116570,0.0,0.0,5000,5000,0,0,5000,Null,Null,242116570,111461,1634
242148000,8.0,8.0,180000,180000,0,0,180000,Null,Null,242148000,111461,28596
242154090,0.0,0.0,140000,126899,13101,9,140000,Null,Null,242154090,111461,28596
242175822,14.0,14.0,73997,73997,0,0,73997,Null,Null,242175822,111461,2
242193411,7.0,7.0,200000,119000,81000,41,200000,Null,Null,242193411,21651,2173
242394859,0.0,0.0,1000,1000,0,0,1000,Null,Null,242394859,111461,2
242423101,2.0,2.0,298000,288999,9001,3,298000,Null,Null,242423101,149308,28486
242423377,9.0,9.0,140000,140000,0,0,140000,Null,Null,242423377,7899545,28576
242433299,20.0,20.0,2400000,1294000,1106000,46,2400000,Null,Null,242433299,4403239,8165
242434782,26.0,26.0,2990000,2740000,250000,8,2990000,Null,Null,242434782,147856,28856
242435259,0.0,0.0,7000,7000,0,0,7000,Null,Null,242435259,111461,8205
242441510,0.0,0.0,20000000,14899000,5101000,26,20000000,Null,Null,242441510,47424,2342
242442372,0.0,0.0,40800000,40800000,0,0,40800000,Null,Null,242442372,111461,11518
242442869,0.0,0.0,76300000,74011000,2289000,3,76300000,Null,Null,242442869,111461,28868
242484740,2.0,2.0,10000,10000,0,0,10000,Null,Null,242484740,111461,2
242484765,0.0,0.0,5700,5700,0,0,5700,Null,Null,242484765,111461,2
242484776,0.0,0.0,7400,7400,0,0,7400,Null,Null,242484776,111461,2
242484783,0.0,0.0,6500,6500,0,0,6500,Null,Null,242484783,111461,2
242484792,0.0,0.0,6825,6825,0,0,6825,Null,Null,242484792,111461,2
242484965,7.0,7.0,5850,5850,0,0,5850,Null,Null,242484965,111461,2
242485044,0.0,0.0,49212000,49212000,0,0,49212000,Null,Null,242485044,111461,11858
242492596,0.0,0.0,2000,2000,0,0,2000,Null,Null,242492596,111461,8167
242495754,9.0,9.0,69000,65000,4000,6,69000,Null,Null,242495754,5132069,11935
242498697,0.0,0.0,6000,6000,0,0,6000,Null,Null,242498697,111461,20258
242499359,0.0,0.0,46500000,46500000,0,0,46500000,Null,Null,242499359,111461,11518
242500207,13.0,13.0,599000,399000,200000,33,599000,Null,Null,242500207,18802,28460
242621469,0.0,0.0,5000,5000,0,0,5000,Null,Null,242621469,111461,28480
242625619,1.0,1.0,189000,168210,20790,11,189000,Null,Null,242625619,111461,2
242625698,0.0,0.0,850000,748000,102000,12,850000,Null,Null,242625698,111461,2
242625700,2.0,2.0,940000,827200,112800,12,940000,Null,Null,242625700,111461,2
242625709,1.0,1.0,200000,178000,22000,11,200000,Null,Null,242625709,111461,2
242625749,2.0,2.0,1065000,937200,127800,12,1065000,Null,Null,242625749,111461,2
242625819,1.0,1.0,475000,422750,52250,11,475000,Null,Null,242625819,111461,2
242628009,0.0,0.0,49500000,48015000,1485000,3,49500000,Null,Null,242628009,111461,11518
242635843,0.0,0.0,24990000,24990000,0,0,24990000,Null,Null,242635843,18802,1795
242645670,0.0,0.0,2000,2000,0,0,2000,Null,Null,242645670,111461,2
242650619,0.0,0.0,6000000,6000000,0,0,6000000,Null,Null,242650619,7982659,8512
242652794,0.0,0.0,38680000,29010000,9670000,25,38680000,Null,Null,242652794,111461,8073
242654461,1.0,1.0,5810000,3990000,1820000,31,5810000,Null,Null,242654461,7982659,8512
242656466,0.0,0.0,2900000,1450000,1450000,50,2900000,Null,Null,242656466,111461,15318
242656600,0.0,0.0,3850000,3850000,0,0,3850000,Null,Null,242656600,41048,2
242657500,4.0,4.0,509000,509000,0,0,509000,Null,Null,242657500,41048,2
242657652,0.0,0.0,26990000,26990000,0,0,26990000,Null,Null,242657652,18802,1795
242658065,0.0,0.0,19320000,14490000,4830000,25,19320000,Null,Null,242658065,111461,28874
242658327,0.0,0.0,29990000,29990000,0,0,29990000,Null,Null,242658327,18802,1795
242658363,0.0,0.0,38680000,34812000,3868000,10,38680000,Null,Null,242658363,111461,7079
242658373,0.0,0.0,19300000,14475000,4825000,25,19300000,Null,Null,242658373,111461,28874
242662356,0.0,0.0,56000000,56000000,0,0,56000000,Null,Null,242662356,111461,2
242662366,0.0,0.0,36000000,36000000,0,0,36000000,Null,Null,242662366,111461,2
242662398,0.0,0.0,99999999,99999999,0,0,99999999,Null,Null,242662398,111461,2
242662399,0.0,0.0,43000000,43000000,0,0,43000000,Null,Null,242662399,111461,2
242662400,0.0,0.0,90000000,90000000,0,0,90000000,Null,Null,242662400,111461,2
242662472,0.0,0.0,44000000,44000000,0,0,44000000,Null,Null,242662472,111461,2
242662477,0.0,0.0,38000000,38000000,0,0,38000000,Null,Null,242662477,111461,2
242662482,0.0,0.0,77000000,77000000,0,0,77000000,Null,Null,242662482,111461,2
242662498,0.0,0.0,46000000,46000000,0,0,46000000,Null,Null,242662498,111461,2
242662510,0.0,0.0,67000000,67000000,0,0,67000000,Null,Null,242662510,111461,2
242662528,0.0,0.0,44000000,44000000,0,0,44000000,Null,Null,242662528,111461,2
242662584,0.0,0.0,99999999,99999999,0,0,99999999,Null,Null,242662584,111461,2
242662590,0.0,0.0,56000000,56000000,0,0,56000000,Null,Null,242662590,111461,2
242662616,0.0,0.0,99999999,99999999,0,0,99999999,Null,Null,242662616,111461,2
242662621,0.0,0.0,51000000,51000000,0,0,51000000,Null,Null,242662621,111461,2
242662622,0.0,0.0,52000000,52000000,0,0,52000000,Null,Null,242662622,111461,2
242662636,0.0,0.0,99999999,99999999,0,0,99999999,Null,Null,242662636,111461,2
242662645,0.0,0.0,60000000,60000000,0,0,60000000,Null,Null,242662645,111461,2
242662656,0.0,0.0,42000000,42000000,0,0,42000000,Null,Null,242662656,111461,2
242662665,0.0,0.0,70000000,70000000,0,0,70000000,Null,Null,242662665,111461,2
242662674,0.0,0.0,75000000,75000000,0,0,75000000,Null,Null,242662674,111461,2
242662677,0.0,0.0,55000000,55000000,0,0,55000000,Null,Null,242662677,111461,2
242662721,0.0,0.0,44000000,44000000,0,0,44000000,Null,Null,242662721,111461,2
242662722,0.0,0.0,50000000,50000000,0,0,50000000,Null,Null,242662722,111461,2
242662738,0.0,0.0,51000000,51000000,0,0,51000000,Null,Null,242662738,111461,2
242663035,0.0,0.0,3490000,3420200,69800,2,3490000,Null,Null,242663035,5382095,2
242663045,0.0,0.0,8850000,8673000,177000,2,8850000,Null,Null,242663045,5382095,2
242663073,0.0,0.0,10900000,10682000,218000,2,10900000,Null,Null,242663073,5382095,2
242663083,0.0,0.0,7990000,7830200,159800,2,7990000,Null,Null,242663083,5382095,2
242663117,0.0,0.0,3500000,3500000,0,0,3500000,Null,Null,242663117,5382095,2
242663121,0.0,0.0,7890000,7732200,157800,2,7890000,Null,Null,242663121,5382095,2
242663125,0.0,0.0,6300000,6174000,126000,2,6300000,Null,Null,242663125,5382095,2
242663128,0.0,0.0,4790000,4694200,95800,2,4790000,Null,Null,242663128,5382095,2
242663130,0.0,0.0,3550000,3479000,71000,2,3550000,Null,Null,242663130,5382095,2
242663135,0.0,0.0,3990000,3910200,79800,2,3990000,Null,Null,242663135,5382095,2
242663139,0.0,0.0,4790000,4694200,95800,2,4790000,Null,Null,242663139,5382095,2
242663149,0.0,0.0,11600000,11600000,0,0,11600000,Null,Null,242663149,5382095,2
242663182,0.0,0.0,3790000,3714200,75800,2,3790000,Null,Null,242663182,5382095,2
242663217,0.0,0.0,8250000,8085000,165000,2,8250000,Null,Null,242663217,5382095,2
242663243,0.0,0.0,8350000,8183000,167000,2,8350000,Null,Null,242663243,5382095,2
242663255,0.0,0.0,11900000,11662000,238000,2,11900000,Null,Null,242663255,5382095,2
242663261,0.0,0.0,7290000,7144200,145800,2,7290000,Null,Null,242663261,5382095,2
242665662,165.0,165.0,229000,101000,128000,56,229000,Null,Null,242665662,361359,1831
242667287,32.0,32.0,229000,112000,117000,51,229000,Null,Null,242667287,361359,1831
242671102,0.0,0.0,5800000,5800000,0,0,5800000,Null,Null,242671102,111461,2
242675774,0.0,0.0,52800000,52800000,0,0,52800000,Null,Null,242675774,111461,2
242676861,0.0,0.0,5440000,5440000,0,0,5440000,Null,Null,242676861,111461,2
242677581,0.0,0.0,64200000,64200000,0,0,64200000,Null,Null,242677581,111461,2
242678295,0.0,0.0,5450000,5450000,0,0,5450000,Null,Null,242678295,111461,2
242679199,0.0,0.0,5790000,5790000,0,0,5790000,Null,Null,242679199,111461,2
242682906,0.0,0.0,49680000,49680000,0,0,49680000,Null,Null,242682906,111461,2
242684634,0.0,0.0,39984000,39984000,0,0,39984000,Null,Null,242684634,111461,2
242686047,0.0,0.0,52800000,52800000,0,0,52800000,Null,Null,242686047,111461,2
242687364,0.0,0.0,73920000,73920000,0,0,73920000,Null,Null,242687364,111461,2
242687691,0.0,0.0,38500000,38500000,0,0,38500000,Null,Null,242687691,111461,1883
242689351,0.0,0.0,40320000,40320000,0,0,40320000,Null,Null,242689351,111461,1883
242689671,0.0,0.0,39200000,39200000,0,0,39200000,Null,Null,242689671,111461,2
242696322,36.0,36.0,25500,25500,0,0,25500,Null,Null,242696322,5706641,2363
242712374,0.0,0.0,31990000,31990000,0,0,31990000,Null,Null,242712374,18802,1795
242712931,0.0,0.0,36990000,27790000,9200000,25,36990000,Null,Null,242712931,18802,1795
242727962,1.0,1.0,1399000,1199000,200000,14,1399000,Null,Null,242727962,46363,5385
242731241,0.0,0.0,6000,3000,3000,50,6000,Null,Null,242731241,111461,2
242731246,0.0,0.0,3000,1500,1500,50,3000,Null,Null,242731246,111461,2
242731358,0.0,0.0,6000,3000,3000,50,6000,Null,Null,242731358,111461,2
242731475,0.0,0.0,6000,6000,0,0,6000,Null,Null,242731475,111461,28484
242731560,1.0,1.0,19000,9500,9500,50,19000,Null,Null,242731560,111461,2
242731711,2.0,2.0,3000,3000,0,0,3000,Null,Null,242731711,111461,28484
242731768,0.0,0.0,3000,3000,0,0,3000,Null,Null,242731768,111461,28484
242731871,0.0,0.0,14000,7000,7000,50,14000,Null,Null,242731871,111461,2
242731874,0.0,0.0,6000,3000,3000,50,6000,Null,Null,242731874,111461,2
242731990,0.0,0.0,5000,5000,0,0,5000,Null,Null,242731990,111461,28484
242732014,0.0,0.0,3000,1500,1500,50,3000,Null,Null,242732014,111461,2
242732019,8.0,8.0,6000,6000,0,0,6000,Null,Null,242732019,111461,28484
242732116,0.0,0.0,16000,8000,8000,50,16000,Null,Null,242732116,111461,2
242732170,0.0,0.0,3000,1500,1500,50,3000,Null,Null,242732170,111461,2
242739287,0.0,0.0,4000,4000,0,0,4000,Null,Null,242739287,111461,28484
242739300,0.0,0.0,6000,3000,3000,50,6000,Null,Null,242739300,111461,28484
242739317,0.0,0.0,3000,1500,1500,50,3000,Null,Null,242739317,111461,2
242739328,0.0,0.0,7000,7000,0,0,7000,Null,Null,242739328,111461,2
242739336,0.0,0.0,12000,6000,6000,50,12000,Null,Null,242739336,111461,28484
242739356,0.0,0.0,3000,1500,1500,50,3000,Null,Null,242739356,111461,2
242739360,0.0,0.0,8000,4000,4000,50,8000,Null,Null,242739360,111461,28484
242739496,0.0,0.0,10000,5000,5000,50,10000,Null,Null,242739496,111461,28484
242739599,0.0,0.0,4000,4000,0,0,4000,Null,Null,242739599,111461,28484
242739619,0.0,0.0,6000,3000,3000,50,6000,Null,Null,242739619,111461,2
242739620,0.0,0.0,10000,5000,5000,50,10000,Null,Null,242739620,111461,28594
242739626,0.0,0.0,4000,4000,0,0,4000,Null,Null,242739626,111461,28484
242739681,0.0,0.0,2000,2000,0,0,2000,Null,Null,242739681,111461,28484
242739766,0.0,0.0,4000,4000,0,0,4000,Null,Null,242739766,111461,28484
242739919,0.0,0.0,7900,7900,0,0,7900,Null,Null,242739919,111461,28484
242740045,0.0,0.0,16000,8000,8000,50,16000,Null,Null,242740045,111461,28484
242740111,0.0,0.0,3000,3000,0,0,3000,Null,Null,242740111,111461,2
242740230,0.0,0.0,8000,4000,4000,50,8000,Null,Null,242740230,111461,2
242740254,0.0,0.0,2888,2888,0,0,2888,Null,Null,242740254,111461,2
242740293,0.0,0.0,3000,3000,0,0,3000,Null,Null,242740293,111461,28484
242740334,0.0,0.0,3000,3000,0,0,3000,Null,Null,242740334,111461,28484
242740484,1.0,1.0,4000,4000,0,0,4000,Null,Null,242740484,111461,28484
242740499,0.0,0.0,3000,3000,0,0,3000,Null,Null,242740499,111461,2
242740572,0.0,0.0,16000,8000,8000,50,16000,Null,Null,242740572,111461,2
242740743,0.0,0.0,5000,5000,0,0,5000,Null,Null,242740743,111461,2
242740772,0.0,0.0,7900,7900,0,0,7900,Null,Null,242740772,111461,2
242743131,5.0,5.0,35000,35000,0,0,35000,Null,Null,242743131,5706641,3177
242744890,305.0,305.0,999000,615000,384000,38,999000,Null,Null,242744890,4250493,1883
242748525,1.0,1.0,899000,549000,350000,39,899000,Null,Null,242748525,46363,5384
242749215,1.0,1.0,1199000,989000,210000,18,1199000,Null,Null,242749215,46363,5384
242750697,10.0,10.0,99000,97000,2000,2,99000,Null,Null,242750697,419129,28576
242751709,1.0,1.0,1999000,1689000,310000,16,1999000,Null,Null,242751709,46363,5385
242753331,0.0,0.0,9350000,7293000,2057000,22,9350000,Null,Null,242753331,174699,8511
242753883,1.0,1.0,1199000,997000,202000,17,1199000,Null,Null,242753883,46363,5384
242758821,0.0,0.0,350000,179000,171000,49,350000,Null,Null,242758821,7245301,15320
242766024,1.0,1.0,2100000,1789000,311000,15,2100000,Null,Null,242766024,46363,5385
242767053,0.0,0.0,4500000,3128000,1372000,30,4500000,Null,Null,242767053,18802,1795
242767896,3.0,3.0,1090000,989000,101000,9,1090000,Null,Null,242767896,46363,5385
242768815,51.0,51.0,350000,350000,0,0,350000,Null,Null,242768815,639127,2
242771940,0.0,0.0,2990000,2050000,940000,31,2990000,Null,Null,242771940,18802,1795
242781276,0.0,0.0,8690000,6162000,2528000,29,8690000,Null,Null,242781276,174699,8511
242781280,1.0,1.0,3500000,1817000,1683000,48,3500000,Null,Null,242781280,18802,1795
242788690,14.0,14.0,600000,325000,275000,46,600000,Null,Null,242788690,111461,12908
242842481,0.0,0.0,6000,6000,0,0,6000,Null,Null,242842481,111461,2
242842523,0.0,0.0,7000,7000,0,0,7000,Null,Null,242842523,111461,2
242880524,0.0,0.0,1000,1000,0,0,1000,Null,Null,242880524,111461,23042
242897650,13.0,13.0,349000,230000,119000,34,349000,Null,Null,242897650,929841,11941
242992984,0.0,0.0,3400000,3400000,0,0,3400000,Null,Null,242992984,111461,1634
242995763,0.0,0.0,7890000,7890000,0,0,7890000,Null,Null,242995763,111461,1634
242998869,0.0,0.0,1500,1500,0,0,1500,Null,Null,242998869,111461,2
242999577,0.0,0.0,5490000,5490000,0,0,5490000,Null,Null,242999577,111461,1634
242999912,0.0,0.0,8980000,5803200,3176800,35,8980000,Null,Null,242999912,174699,8511
243001190,0.0,0.0,8980000,5803200,3176800,35,8980000,Null,Null,243001190,174699,8511
243001848,0.0,0.0,5190000,5190000,0,0,5190000,Null,Null,243001848,111461,1634
243002013,0.0,0.0,10400000,7012200,3387800,33,10400000,Null,Null,243002013,174699,7449
243002401,0.0,0.0,13120000,9414600,3705400,28,13120000,Null,Null,243002401,174699,7449
243004699,0.0,0.0,15970000,15970000,0,0,15970000,Null,Null,243004699,174699,8512
243020382,7.0,7.0,1325000,1325000,0,0,1325000,Null,Null,243020382,191823,2
243024421,0.0,0.0,7290000,7290000,0,0,7290000,Null,Null,243024421,111461,1634
243025108,0.0,0.0,7290000,7290000,0,0,7290000,Null,Null,243025108,111461,1634
243032346,0.0,0.0,11560000,9016800,2543200,22,11560000,Null,Null,243032346,174699,8511
243033075,0.0,0.0,8890000,6934200,1955800,22,8890000,Null,Null,243033075,174699,8511
243033444,0.0,0.0,11470000,8946600,2523400,22,11470000,Null,Null,243033444,174699,8513
243034744,0.0,0.0,9040000,7051200,1988800,22,9040000,Null,Null,243034744,174699,8511
243035604,1.0,1.0,1199000,989000,210000,18,1199000,Null,Null,243035604,46363,5385
243043970,1.0,1.0,1090000,989000,101000,9,1090000,Null,Null,243043970,46363,5385
243044027,0.0,0.0,59500000,57715000,1785000,3,59500000,Null,Null,243044027,111461,7079
243044626,0.0,0.0,39500000,38315000,1185000,3,39500000,Null,Null,243044626,111461,7079
243047449,0.0,0.0,33100000,32107000,993000,3,33100000,Null,Null,243047449,111461,7079
243047799,0.0,0.0,5290000,5290000,0,0,5290000,Null,Null,243047799,111461,1634
243051066,1.0,1.0,1199000,699000,500000,42,1199000,Null,Null,243051066,46363,5385
243051222,0.0,0.0,35100000,34047000,1053000,3,35100000,Null,Null,243051222,111461,7079
243054802,0.0,0.0,29500000,28615000,885000,3,29500000,Null,Null,243054802,111461,7079
243057724,0.0,0.0,25850000,25074500,775500,3,25850000,Null,Null,243057724,111461,7079
243059310,1.0,1.0,6380000,4490000,1890000,30,6380000,Null,Null,243059310,7982659,8512
243080487,0.0,0.0,3900000,3900000,0,0,3900000,Null,Null,243080487,27449,8172
243080699,0.0,0.0,4190000,4190000,0,0,4190000,Null,Null,243080699,111461,1634
243081877,0.0,0.0,4980000,4980000,0,0,4980000,Null,Null,243081877,111461,1634
243082353,0.0,0.0,9100000,9100000,0,0,9100000,Null,Null,243082353,111461,1634
243083205,0.0,0.0,19000,19000,0,0,19000,Null,Null,243083205,111461,15250
243083935,34.0,34.0,1001,1000,1,0,1001,Null,Null,243083935,111461,23134
243088208,1.0,1.0,699000,529000,170000,24,699000,Null,Null,243088208,111461,1796
243088224,0.0,0.0,559000,479000,80000,14,559000,Null,Null,243088224,111461,1796
243088229,0.0,0.0,599000,479000,120000,20,599000,Null,Null,243088229,111461,1796
243088234,2.0,2.0,769000,559000,210000,27,769000,Null,Null,243088234,111461,1796
243088260,0.0,0.0,399000,399000,0,0,399000,Null,Null,243088260,111461,1796
243088268,0.0,0.0,589000,509000,80000,14,589000,Null,Null,243088268,111461,1796
243088270,0.0,0.0,559000,499000,60000,11,559000,Null,Null,243088270,111461,1796
243088494,0.0,0.0,2000,2000,0,0,2000,Null,Null,243088494,111461,2
243088514,0.0,0.0,1125,1125,0,0,1125,Null,Null,243088514,111461,2
243088598,57.0,57.0,945000,945000,0,0,945000,Null,Null,243088598,2630119,2657
243089027,3.0,3.0,179000,179000,0,0,179000,Null,Null,243089027,111461,49722
243089689,1.0,1.0,189000,189000,0,0,189000,Null,Null,243089689,111461,49722
243091115,0.0,0.0,25850000,25074500,775500,3,25850000,Null,Null,243091115,111461,7079
243091216,2.0,2.0,109000,109000,0,0,109000,Null,Null,243091216,111461,49722
243091350,0.0,0.0,47200000,45784000,1416000,3,47200000,Null,Null,243091350,111461,7079
243091766,0.0,0.0,35850000,34774500,1075500,3,35850000,Null,Null,243091766,111461,7079
243091786,4.0,4.0,109000,109000,0,0,109000,Null,Null,243091786,111461,49722
243092214,8.0,8.0,300000,195000,105000,35,300000,Null,Null,243092214,111461,15250
243094012,0.0,0.0,88866000,87977340,888660,1,88866000,Null,Null,243094012,111461,7079
243094517,16.0,16.0,300000,195000,105000,35,300000,Null,Null,243094517,111461,15250
243094610,0.0,0.0,64850000,62904500,1945500,3,64850000,Null,Null,243094610,111461,7079
243095146,6.0,6.0,130000,130000,0,0,130000,Null,Null,243095146,111461,49722
243096168,0.0,0.0,51900000,51381000,519000,1,51900000,Null,Null,243096168,111461,7079
243097594,0.0,0.0,17990000,14990000,3000000,17,17990000,Null,Null,243097594,144779,1805
243105494,0.0,0.0,97000000,97000000,0,0,97000000,Null,Null,243105494,197095,2340
243123875,0.0,0.0,68000000,68000000,0,0,68000000,Null,Null,243123875,197095,2340
243140182,0.0,0.0,58000000,58000000,0,0,58000000,Null,Null,243140182,197095,2340
243140705,0.0,0.0,36800000,36800000,0,0,36800000,Null,Null,243140705,197095,2340
243145652,0.0,0.0,48000000,48000000,0,0,48000000,Null,Null,243145652,197095,2340
243146011,0.0,0.0,32800000,32800000,0,0,32800000,Null,Null,243146011,197095,2340
243146091,0.0,0.0,66800000,66800000,0,0,66800000,Null,Null,243146091,197095,2340
243165179,3.0,3.0,8490000,7450000,1040000,12,8490000,Null,Null,243165179,25643,1795
243244414,8.0,8.0,189000,189000,0,0,189000,Null,Null,243244414,111461,23184
243258536,0.0,0.0,2000,2000,0,0,2000,Null,Null,243258536,111461,2
243299927,0.0,0.0,5290000,5290000,0,0,5290000,Null,Null,243299927,111461,1634
243300456,0.0,0.0,6890000,6890000,0,0,6890000,Null,Null,243300456,111461,1634
243300520,0.0,0.0,5290000,5290000,0,0,5290000,Null,Null,243300520,52232,1795
243300813,0.0,0.0,3690000,3690000,0,0,3690000,Null,Null,243300813,111461,1634
243301155,0.0,0.0,8000,8000,0,0,8000,Null,Null,243301155,111461,2
243322609,0.0,0.0,2000,2000,0,0,2000,Null,Null,243322609,111461,2
243323177,0.0,0.0,2000,2000,0,0,2000,Null,Null,243323177,111461,2
243804485,0.0,0.0,6890000,6890000,0,0,6890000,Null,Null,243804485,111461,1634
243804560,0.0,0.0,3790000,3790000,0,0,3790000,Null,Null,243804560,111461,1634
243807096,0.0,0.0,4690000,4690000,0,0,4690000,Null,Null,243807096,111461,1634
243807400,0.0,0.0,4390000,4390000,0,0,4390000,Null,Null,243807400,111461,1634
244132024,0.0,0.0,5690000,5690000,0,0,5690000,Null,Null,244132024,111461,1634
244132224,139.0,139.0,1785714,1250000,535714,30,1785714,Null,Null,244132224,610057,914
244138888,0.0,0.0,9000,8910,90,1,9000,Null,Null,244138888,111461,2
244139069,0.0,0.0,5000,4950,50,1,5000,Null,Null,244139069,111461,2
244145113,15.0,15.0,9000,8910,90,1,9000,Null,Null,244145113,111461,2
244167093,18.0,18.0,5000,5000,0,0,5000,Null,Null,244167093,111461,7273
244167098,4.0,4.0,3590000,2790000,800000,22,3590000,Null,Null,244167098,25422,1795
244167354,25.0,25.0,1800000,980000,820000,46,1800000,Null,Null,244167354,631569,2340
244168988,2.0,2.0,3190000,3190000,0,0,3190000,Null,Null,244168988,25422,1795
244171536,1.0,1.0,866000,866000,0,0,866000,Null,Null,244171536,46363,8512
244173672,1.0,1.0,1599000,1389000,210000,13,1599000,Null,Null,244173672,46363,8512
244173959,22.0,22.0,3190000,2200000,990000,31,3190000,Null,Null,244173959,18802,1795
244177969,2.0,2.0,840000,490000,350000,42,840000,Null,Null,244177969,281769,49722
244181386,0.0,0.0,7599000,7599000,0,0,7599000,Null,Null,244181386,46363,8512
244181969,1.0,1.0,1699000,1699000,0,0,1699000,Null,Null,244181969,46363,8512
244182370,0.0,0.0,44990000,32490000,12500000,28,44990000,Null,Null,244182370,18802,1795
244222880,2.0,2.0,1089000,829000,260000,24,1089000,Null,Null,244222880,46363,5384
244253504,1.0,1.0,1388000,1189000,199000,14,1388000,Null,Null,244253504,46363,5385
244282596,1.0,1.0,1199000,998000,201000,17,1199000,Null,Null,244282596,46363,5385
244289662,1.0,1.0,990000,799000,191000,19,990000,Null,Null,244289662,46363,5385
244289790,0.0,0.0,9426000,7069500,2356500,25,9426000,Null,Null,244289790,26150,8513
244290118,2.0,2.0,1090000,829000,261000,24,1090000,Null,Null,244290118,46363,5384
244296612,0.0,0.0,17273000,12954750,4318250,25,17273000,Null,Null,244296612,26150,8513
244299450,0.0,0.0,19000000,14250000,4750000,25,19000000,Null,Null,244299450,26150,8513
244299800,0.0,0.0,27360000,27360000,0,0,27360000,Null,Null,244299800,197095,1520
244301355,0.0,0.0,2500,2500,0,0,2500,Null,Null,244301355,111461,2
244301680,1.0,1.0,1299000,1089000,210000,16,1299000,Null,Null,244301680,46363,5384
244303202,15.0,15.0,4490000,3336000,1154000,26,4490000,Null,Null,244303202,18802,1795
244306829,0.0,0.0,60000,60000,0,0,60000,Null,Null,244306829,111461,1978
244308977,51.0,51.0,3590000,2750000,840000,23,3590000,Null,Null,244308977,25422,1795
244309061,4.0,4.0,38498,34999,3499,9,38498,Null,Null,244309061,111461,28576
244317353,20.0,20.0,300000,145000,155000,52,300000,Null,Null,244317353,21651,12908
244317716,22.0,22.0,300000,145000,155000,52,300000,Null,Null,244317716,21651,12908
244332381,0.0,0.0,2990000,2990000,0,0,2990000,Null,Null,244332381,18802,1795
244347482,0.0,0.0,42500000,36550000,5950000,14,42500000,Null,Null,244347482,111461,7079
244355503,0.0,0.0,3990000,3990000,0,0,3990000,Null,Null,244355503,18802,1795
244408489,0.0,0.0,42600000,40470000,2130000,5,42600000,Null,Null,244408489,111461,28874
245303927,5.0,5.0,295000,295000,0,0,295000,Null,Null,245303927,7282629,20172
245767182,0.0,0.0,42600000,42174000,426000,1,42600000,Null,Null,245767182,111461,28874
245767362,0.0,0.0,42000000,42000000,0,0,42000000,Null,Null,245767362,111461,2392
245767371,0.0,0.0,49200000,48708000,492000,1,49200000,Null,Null,245767371,111461,7079
245767589,1.0,1.0,1449000,1299000,150000,10,1449000,Null,Null,245767589,46363,5385
245767590,0.0,0.0,55000000,55000000,0,0,55000000,Null,Null,245767590,111461,23708
245768623,10.0,10.0,1595000,1595000,0,0,1595000,Null,Null,245768623,7864191,2
245769514,1.0,1.0,2289000,1990000,299000,13,2289000,Null,Null,245769514,18802,1795
245770248,1.0,1.0,3590000,2729000,861000,24,3590000,Null,Null,245770248,25422,1795
245770363,0.0,0.0,2990000,2269000,721000,24,2990000,Null,Null,245770363,18802,1795
245770806,0.0,0.0,4490000,3359000,1131000,25,4490000,Null,Null,245770806,18802,1795
245771621,0.0,0.0,5100000,3554000,1546000,30,5100000,Null,Null,245771621,416127,8227
245772077,64.0,64.0,399000,219000,180000,45,399000,Null,Null,245772077,314675,5531
245772221,0.0,0.0,41700000,41700000,0,0,41700000,Null,Null,245772221,111461,23050
245772432,0.0,0.0,41700000,41700000,0,0,41700000,Null,Null,245772432,111461,23050
245772488,6.0,6.0,2180000,2180000,0,0,2180000,Null,Null,245772488,233859,5267
245772798,11.0,11.0,99000,99000,0,0,99000,Null,Null,245772798,162313,28484
245774722,0.0,0.0,2990,2990,0,0,2990,Null,Null,245774722,111461,2
245774774,0.0,0.0,2900,2900,0,0,2900,Null,Null,245774774,111461,2
245774919,0.0,0.0,2000,2000,0,0,2000,Null,Null,245774919,111461,2
245774932,0.0,0.0,5900,5900,0,0,5900,Null,Null,245774932,111461,2
245774939,0.0,0.0,4900,4900,0,0,4900,Null,Null,245774939,111461,2
245774942,0.0,0.0,9999,9999,0,0,9999,Null,Null,245774942,111461,2
245775203,0.0,0.0,6900,6900,0,0,6900,Null,Null,245775203,111461,2
245775396,0.0,0.0,1000,1000,0,0,1000,Null,Null,245775396,111461,2
245775437,0.0,0.0,4900,4900,0,0,4900,Null,Null,245775437,111461,2
245775457,0.0,0.0,7000,7000,0,0,7000,Null,Null,245775457,111461,2
245775462,0.0,0.0,5000,5000,0,0,5000,Null,Null,245775462,111461,2
245775649,0.0,0.0,5000,5000,0,0,5000,Null,Null,245775649,111461,2
245775737,0.0,0.0,6000,6000,0,0,6000,Null,Null,245775737,111461,2
245775840,0.0,0.0,1000,1000,0,0,1000,Null,Null,245775840,111461,2
245776430,50.0,50.0,69000,69000,0,0,69000,Null,Null,245776430,111461,2514
245782523,0.0,0.0,3495000,3495000,0,0,3495000,Null,Null,245782523,111461,2
245782570,0.0,0.0,1500,1500,0,0,1500,Null,Null,245782570,111461,2
245782607,0.0,0.0,5000,5000,0,0,5000,Null,Null,245782607,111461,2
245782691,5.0,5.0,273000,259350,13650,5,273000,Null,Null,245782691,111461,11859
245787203,0.0,0.0,6500000,6500000,0,0,6500000,Null,Null,245787203,111461,1634
245790327,0.0,0.0,5650000,5650000,0,0,5650000,Null,Null,245790327,48649,1634
245807438,3.0,3.0,139000,126490,12510,9,139000,Null,Null,245807438,111461,2
245848698,4.0,4.0,650000,650000,0,0,650000,Null,Null,245848698,5519233,53350
245978178,6.0,6.0,129000,129000,0,0,129000,Null,Null,245978178,162313,28426
246091344,0.0,0.0,18990000,18290000,700000,4,18990000,Null,Null,246091344,17826,1795
246140938,52.0,52.0,65000,44000,21000,32,65000,Null,Null,246140938,637535,8199
246157371,32.0,32.0,2500,2500,0,0,2500,Null,Null,246157371,567779,1883
246160605,6.0,6.0,409000,388550,20450,5,409000,Null,Null,246160605,111461,11865
246160745,0.0,0.0,3500000,3500000,0,0,3500000,Null,Null,246160745,4206489,2340
246161784,12.0,12.0,845000,845000,0,0,845000,Null,Null,246161784,5097143,53352
246163082,0.0,0.0,2290000,1687000,603000,26,2290000,Null,Null,246163082,19673,1795
246163274,4.0,4.0,470000,437000,33000,7,470000,Null,Null,246163274,5763205,5531
246163546,11.0,11.0,750000,750000,0,0,750000,Null,Null,246163546,5097143,53352
246164536,11.0,11.0,496000,496000,0,0,496000,Null,Null,246164536,198523,2
246167380,5.0,5.0,18990000,10200000,8790000,46,18990000,Null,Null,246167380,18802,1795
246167977,99.0,99.0,190000,190000,0,0,190000,Null,Null,246167977,746615,23022
246193239,75.0,75.0,135000,105000,30000,22,135000,Null,Null,246193239,4820811,3177
246208239,0.0,0.0,87500000,78750000,8750000,10,87500000,Null,Null,246208239,111461,28874
246208895,0.0,0.0,34500000,31050000,3450000,10,34500000,Null,Null,246208895,111461,28874
246293253,0.0,0.0,20880000,18792000,2088000,10,20880000,Null,Null,246293253,111461,28874
246380810,1.0,1.0,2150000,1827500,322500,15,2150000,Null,Null,246380810,8130109,5385
246770532,7.0,7.0,2790000,2790000,0,0,2790000,Null,Null,246770532,147856,28856
246770606,0.0,0.0,3500,3500,0,0,3500,Null,Null,246770606,111461,2
246772222,0.0,0.0,10000,10000,0,0,10000,Null,Null,246772222,111461,15320
246772307,0.0,0.0,8000,8000,0,0,8000,Null,Null,246772307,111461,15320
246772581,0.0,0.0,8000,8000,0,0,8000,Null,Null,246772581,111461,15320
246851504,12.0,12.0,238000,238000,0,0,238000,Null,Null,246851504,550159,8073
246852394,20.0,20.0,245000,245000,0,0,245000,Null,Null,246852394,550159,8073
246852433,30.0,30.0,1900,1900,0,0,1900,Null,Null,246852433,111461,1978
246857368,0.0,0.0,5300000,5300000,0,0,5300000,Null,Null,246857368,27449,8167
246888802,0.0,0.0,44500000,40050000,4450000,10,44500000,Null,Null,246888802,111461,28874
246889023,0.0,0.0,39900000,39900000,0,0,39900000,Null,Null,246889023,111461,23678
246889145,0.0,0.0,12800000,12800000,0,0,12800000,Null,Null,246889145,27449,8165
246932003,2.0,2.0,699000,699000,0,0,699000,Null,Null,246932003,46363,5384
246945990,0.0,0.0,20880000,18792000,2088000,10,20880000,Null,Null,246945990,111461,7079
246971535,4.0,4.0,3300000,2800000,500000,15,3300000,Null,Null,246971535,147856,28856
246971927,0.0,0.0,18900000,18900000,0,0,18900000,Null,Null,246971927,111461,2324
247016383,4.0,4.0,3490000,2743000,747000,21,3490000,Null,Null,247016383,25422,1795
247020771,52.0,52.0,235000,235000,0,0,235000,Null,Null,247020771,7882195,28480
247061239,0.0,0.0,9990,9990,0,0,9990,Null,Null,247061239,111461,5450
247222132,0.0,0.0,17890000,17890000,0,0,17890000,Null,Null,247222132,18641,8042
247238801,13.0,13.0,89000,79000,10000,11,89000,Null,Null,247238801,929841,1520
247238807,0.0,0.0,6500000,6500000,0,0,6500000,Null,Null,247238807,7400143,53350
247240294,20.0,20.0,40000,30000,10000,25,40000,Null,Null,247240294,929841,8167
247241360,14.0,14.0,99000,65000,34000,34,99000,Null,Null,247241360,929841,8167
247253760,3.0,3.0,760000,760000,0,0,760000,Null,Null,247253760,293201,28680
247254173,17.0,17.0,99000,89000,10000,10,99000,Null,Null,247254173,111461,23246
247257033,8.0,8.0,353000,353000,0,0,353000,Null,Null,247257033,7864191,1979
247262833,27.0,27.0,28420,28420,0,0,28420,Null,Null,247262833,197767,2
247263538,30.0,30.0,2200,2200,0,0,2200,Null,Null,247263538,111461,2
247266836,11.0,11.0,1150000,685000,465000,40,1150000,Null,Null,247266836,625099,27128
247271670,0.0,0.0,4596000,4596000,0,0,4596000,Null,Null,247271670,111461,2340
247271843,0.0,0.0,4596000,4596000,0,0,4596000,Null,Null,247271843,111461,2340
247274725,0.0,0.0,1940,1940,0,0,1940,Null,Null,247274725,111461,2
247274830,0.0,0.0,2500,2500,0,0,2500,Null,Null,247274830,111461,2
247274840,13.0,13.0,53350,53350,0,0,53350,Null,Null,247274840,111461,2784
247274875,0.0,0.0,1940,1940,0,0,1940,Null,Null,247274875,111461,2
247274910,0.0,0.0,1891,1891,0,0,1891,Null,Null,247274910,111461,2
247275420,0.0,0.0,5000,5000,0,0,5000,Null,Null,247275420,111461,2
247286696,913.0,913.0,115000,102000,13000,11,115000,Null,Null,247286696,185875,1613
247286830,0.0,0.0,3600000,3600000,0,0,3600000,Null,Null,247286830,111461,1626
247287157,35.0,35.0,260000,211000,49000,19,260000,Null,Null,247287157,22013,17170
247287400,0.0,0.0,18950000,18760500,189500,1,18950000,Null,Null,247287400,111461,11516
247287827,0.0,0.0,5000,5000,0,0,5000,Null,Null,247287827,111461,2
247287843,0.0,0.0,2900,2900,0,0,2900,Null,Null,247287843,111461,2
247287866,0.0,0.0,5000,5000,0,0,5000,Null,Null,247287866,111461,2
247287878,0.0,0.0,3000,3000,0,0,3000,Null,Null,247287878,111461,2
247287900,0.0,0.0,10000,10000,0,0,10000,Null,Null,247287900,111461,2
247288001,0.0,0.0,5400,5400,0,0,5400,Null,Null,247288001,111461,2
247290265,0.0,0.0,9000,9000,0,0,9000,Null,Null,247290265,111461,2
247290330,0.0,0.0,2565,2565,0,0,2565,Null,Null,247290330,111461,2
247290364,0.0,0.0,4500,4500,0,0,4500,Null,Null,247290364,111461,2
247290404,0.0,0.0,7000,7000,0,0,7000,Null,Null,247290404,111461,2
247290405,0.0,0.0,1300,1300,0,0,1300,Null,Null,247290405,111461,2
247290430,0.0,0.0,9777,9777,0,0,9777,Null,Null,247290430,111461,2
247290496,0.0,0.0,10000,10000,0,0,10000,Null,Null,247290496,111461,2
247290539,0.0,0.0,10000,10000,0,0,10000,Null,Null,247290539,111461,2
247290636,0.0,0.0,1200,1200,0,0,1200,Null,Null,247290636,111461,2
247290647,0.0,0.0,9900,9900,0,0,9900,Null,Null,247290647,111461,2
247290716,0.0,0.0,9000,9000,0,0,9000,Null,Null,247290716,111461,2
247290730,0.0,0.0,9000,9000,0,0,9000,Null,Null,247290730,111461,2
247290736,0.0,0.0,6000,6000,0,0,6000,Null,Null,247290736,111461,2
247290742,0.0,0.0,10000,10000,0,0,10000,Null,Null,247290742,111461,2
247291707,0.0,0.0,26800000,24656000,2144000,8,26800000,Null,Null,247291707,111461,11516
247292396,0.0,0.0,26800000,24656000,2144000,8,26800000,Null,Null,247292396,111461,11516
247294845,143.0,143.0,48000,48000,0,0,48000,Null,Null,247294845,111461,2
247298318,80.0,80.0,45000,45000,0,0,45000,Null,Null,247298318,5706641,5995
247299188,6.0,6.0,3290000,2133000,1157000,35,3290000,Null,Null,247299188,162007,1795
247300543,126.0,126.0,120000,120000,0,0,120000,Null,Null,247300543,111461,8602
247305229,19.0,19.0,25000,25000,0,0,25000,Null,Null,247305229,5706641,2514
247306200,0.0,0.0,3600000,3600000,0,0,3600000,Null,Null,247306200,4206489,8172
247306520,36.0,36.0,219000,64000,155000,71,219000,Null,Null,247306520,505907,12294
247316560,0.0,0.0,16000,16000,0,0,16000,Null,Null,247316560,111461,2
247318928,1.0,1.0,799000,689000,110000,14,799000,Null,Null,247318928,46363,5384
247320366,0.0,0.0,8000,8000,0,0,8000,Null,Null,247320366,111461,2
247323953,0.0,0.0,81880000,73692000,8188000,10,81880000,Null,Null,247323953,111461,7079
247326724,0.0,0.0,38880000,34992000,3888000,10,38880000,Null,Null,247326724,111461,7079
247327005,0.0,0.0,2900,2000,900,31,2900,Null,Null,247327005,111461,2514
247329259,0.0,0.0,4000,4000,0,0,4000,Null,Null,247329259,111461,2
247330451,0.0,0.0,5400000,5400000,0,0,5400000,Null,Null,247330451,199043,11873
247330704,0.0,0.0,20880000,18792000,2088000,10,20880000,Null,Null,247330704,111461,7079
247337386,0.0,0.0,10610000,7390000,3220000,30,10610000,Null,Null,247337386,7982659,8512
247340544,3.0,3.0,82000,82000,0,0,82000,Null,Null,247340544,111461,1883
247340556,0.0,0.0,76880000,70729600,6150400,8,76880000,Null,Null,247340556,111461,7079
247341025,17.0,17.0,1000000,494000,506000,51,1000000,Null,Null,247341025,111461,2
247345398,0.0,0.0,93000000,93000000,0,0,93000000,Null,Null,247345398,111461,2
247347044,0.0,0.0,26880000,24729600,2150400,8,26880000,Null,Null,247347044,111461,7079
247354746,0.0,0.0,18880000,17369600,1510400,8,18880000,Null,Null,247354746,111461,28874
247376096,0.0,0.0,9000,9000,0,0,9000,Null,Null,247376096,111461,8198
247401335,9.0,9.0,1390000,719000,671000,48,1390000,Null,Null,247401335,31627,1984
247401472,3.0,3.0,119000,119000,0,0,119000,Null,Null,247401472,111461,49728
247403124,0.0,0.0,10000,10000,0,0,10000,Null,Null,247403124,111461,2
247403380,0.0,0.0,2500,2500,0,0,2500,Null,Null,247403380,111461,2
247403458,0.0,0.0,1000,1000,0,0,1000,Null,Null,247403458,111461,2
247403759,0.0,0.0,1500,1500,0,0,1500,Null,Null,247403759,111461,2
247404212,0.0,0.0,8000,8000,0,0,8000,Null,Null,247404212,111461,2
247404221,0.0,0.0,8000,8000,0,0,8000,Null,Null,247404221,111461,2
247404275,0.0,0.0,1000,1000,0,0,1000,Null,Null,247404275,111461,2
247405840,0.0,0.0,42990000,42990000,0,0,42990000,Null,Null,247405840,111461,23576
247405845,0.0,0.0,81880000,73692000,8188000,10,81880000,Null,Null,247405845,111461,7079
247405853,4.0,4.0,790000,508000,282000,36,790000,Null,Null,247405853,41048,2334
247405956,0.0,0.0,33500000,33500000,0,0,33500000,Null,Null,247405956,111461,7079
247408291,0.0,0.0,20800000,18720000,2080000,10,20800000,Null,Null,247408291,111461,7079
247409365,0.0,0.0,76880000,69192000,7688000,10,76880000,Null,Null,247409365,111461,7079
247414352,0.0,0.0,1000,1000,0,0,1000,Null,Null,247414352,111461,23104
247427990,1.0,1.0,2990000,2990000,0,0,2990000,Null,Null,247427990,147856,28856
247436959,0.0,0.0,41500000,41500000,0,0,41500000,Null,Null,247436959,111461,11516
247438692,0.0,0.0,41500000,41500000,0,0,41500000,Null,Null,247438692,111461,11516
247445058,0.0,0.0,1200,1200,0,0,1200,Null,Null,247445058,111461,2
247445089,0.0,0.0,7900,7900,0,0,7900,Null,Null,247445089,111461,2
247447976,0.0,0.0,5900,5900,0,0,5900,Null,Null,247447976,111461,2
247448115,0.0,0.0,45000,30000,15000,33,45000,Null,Null,247448115,111461,2
247448456,0.0,0.0,9900,9900,0,0,9900,Null,Null,247448456,111461,2
247448585,0.0,0.0,2900,2500,400,14,2900,Null,Null,247448585,111461,2
247448589,0.0,0.0,9000,9000,0,0,9000,Null,Null,247448589,111461,2
247448927,18.0,18.0,299000,299000,0,0,299000,Null,Null,247448927,312329,28480
247449608,0.0,0.0,329000,329000,0,0,329000,Null,Null,247449608,21653,8400
247451178,42.0,42.0,3190000,2250000,940000,29,3190000,Null,Null,247451178,247549,1795
247451256,16.0,16.0,999000,999000,0,0,999000,Null,Null,247451256,4820071,27170
247451287,11.0,11.0,1125000,1125000,0,0,1125000,Null,Null,247451287,4820071,27170
247460073,0.0,0.0,19000000,15000000,4000000,21,19000000,Null,Null,247460073,5700191,2340
247461464,0.0,0.0,26000000,19900000,6100000,23,26000000,Null,Null,247461464,5700191,2340
247462467,0.0,0.0,18000,9000,9000,50,18000,Null,Null,247462467,111461,15318
247466224,2.0,2.0,169000,118300,50700,30,169000,Null,Null,247466224,4058421,2
247466372,1.0,1.0,200000,140000,60000,30,200000,Null,Null,247466372,4058421,2
247471196,0.0,0.0,5190000,5190000,0,0,5190000,Null,Null,247471196,18802,1795
247472850,151.0,151.0,89000,89000,0,0,89000,Null,Null,247472850,111461,23112
247562640,0.0,0.0,9900,9900,0,0,9900,Null,Null,247562640,111461,2
247645582,0.0,0.0,15000,15000,0,0,15000,Null,Null,247645582,111461,2
247650101,0.0,0.0,6740000,6740000,0,0,6740000,Null,Null,247650101,7982659,8512
247655573,0.0,0.0,5280000,5280000,0,0,5280000,Null,Null,247655573,7308945,11873
247656527,3.0,3.0,6000,6000,0,0,6000,Null,Null,247656527,111461,8197
247661852,13.0,13.0,49000,49000,0,0,49000,Null,Null,247661852,111461,17162
247667352,2.0,2.0,395000,395000,0,0,395000,Null,Null,247667352,26150,8511
247678685,0.0,0.0,3950000,3950000,0,0,3950000,Null,Null,247678685,111461,2
247678688,0.0,0.0,5860000,5860000,0,0,5860000,Null,Null,247678688,111461,2
247678690,0.0,0.0,5800000,5800000,0,0,5800000,Null,Null,247678690,111461,2
247678698,0.0,0.0,3950000,3950000,0,0,3950000,Null,Null,247678698,111461,2
247678707,0.0,0.0,4550000,4550000,0,0,4550000,Null,Null,247678707,111461,2
247678714,0.0,0.0,3950000,3950000,0,0,3950000,Null,Null,247678714,111461,2
247678726,0.0,0.0,3800000,3800000,0,0,3800000,Null,Null,247678726,111461,2
247678744,0.0,0.0,3900000,3900000,0,0,3900000,Null,Null,247678744,111461,2
247678771,0.0,0.0,7480000,7480000,0,0,7480000,Null,Null,247678771,496837,5893
247678776,0.0,0.0,3800000,3800000,0,0,3800000,Null,Null,247678776,111461,2
247678796,0.0,0.0,6000000,6000000,0,0,6000000,Null,Null,247678796,111461,2
247678798,0.0,0.0,3950000,3950000,0,0,3950000,Null,Null,247678798,111461,2
247678802,0.0,0.0,3950000,3950000,0,0,3950000,Null,Null,247678802,111461,2
247678807,0.0,0.0,3800000,3800000,0,0,3800000,Null,Null,247678807,111461,2
247678822,0.0,0.0,4200000,4200000,0,0,4200000,Null,Null,247678822,496837,53350
247681187,4.0,4.0,20000,12000,8000,40,20000,Null,Null,247681187,4647777,15318
247681305,32.0,32.0,274000,168000,106000,39,274000,Null,Null,247681305,48077,53048
247704414,0.0,0.0,15000,9600,5400,36,15000,Null,Null,247704414,4647777,15318
247704870,95.0,95.0,850000,680000,170000,20,850000,Null,Null,247704870,293805,17170
247706048,0.0,0.0,6000,6000,0,0,6000,Null,Null,247706048,111461,2
247717689,19.0,19.0,150000,79000,71000,47,150000,Null,Null,247717689,21653,28460
247718758,1.0,1.0,2315000,1850000,465000,20,2315000,Null,Null,247718758,212883,8512
247719548,1.0,1.0,3690000,3690000,0,0,3690000,Null,Null,247719548,48649,1634
247720861,0.0,0.0,2390000,2390000,0,0,2390000,Null,Null,247720861,25422,1795
247721905,12.0,12.0,169000,155000,14000,8,169000,Null,Null,247721905,111461,28644
247724927,78.0,78.0,219000,178000,41000,19,219000,Null,Null,247724927,111461,23010
247730110,14.0,14.0,400000,320000,80000,20,400000,Null,Null,247730110,8095865,4380
247730209,28.0,28.0,8490000,6990000,1500000,18,8490000,Null,Null,247730209,18802,1795
247730281,31.0,31.0,10490000,8650000,1840000,18,10490000,Null,Null,247730281,18802,1795
247731336,24.0,24.0,11490000,8990000,2500000,22,11490000,Null,Null,247731336,18802,1795
247731424,0.0,0.0,22300000,22300000,0,0,22300000,Null,Null,247731424,111461,20250
247731860,0.0,0.0,9000,9000,0,0,9000,Null,Null,247731860,111461,2
247746003,0.0,0.0,2200,2200,0,0,2200,Null,Null,247746003,111461,2
247746979,0.0,0.0,43666361,43666361,0,0,43666361,Null,Null,247746979,111461,2
247747726,0.0,0.0,44902697,44902697,0,0,44902697,Null,Null,247747726,111461,2
247761926,7.0,7.0,115000,115000,0,0,115000,Null,Null,247761926,111461,1883
247762543,9.0,9.0,83000,83000,0,0,83000,Null,Null,247762543,4964421,28454
247764877,0.0,0.0,59000,59000,0,0,59000,Null,Null,247764877,111461,2
247785090,88.0,88.0,45000,29000,16000,36,45000,Null,Null,247785090,111461,23236
247787064,39.0,39.0,270738,149000,121738,45,270738,Null,Null,247787064,46703,23362
247788136,0.0,0.0,11587000,11587000,0,0,11587000,Null,Null,247788136,111461,2
247788316,0.0,0.0,7096000,7096000,0,0,7096000,Null,Null,247788316,111461,2
247788479,0.0,0.0,6300000,6300000,0,0,6300000,Null,Null,247788479,111461,2
247788646,0.0,0.0,7672000,7672000,0,0,7672000,Null,Null,247788646,111461,2
247788996,0.0,0.0,1890000,1890000,0,0,1890000,Null,Null,247788996,111461,2
247789132,0.0,0.0,5791000,5791000,0,0,5791000,Null,Null,247789132,111461,2
247790574,0.0,0.0,13900000,9443000,4457000,32,13900000,Null,Null,247790574,416127,3424
247793897,21.0,21.0,65000,50000,15000,23,65000,Null,Null,247793897,4642933,11857
247794543,34.0,34.0,75000,50000,25000,33,75000,Null,Null,247794543,156043,11873
247794599,12.0,12.0,156000,120000,36000,23,156000,Null,Null,247794599,156043,11857
247796984,0.0,0.0,6800000,5990000,810000,12,6800000,Null,Null,247796984,208841,2340
247798226,0.0,0.0,5300000,5300000,0,0,5300000,Null,Null,247798226,111461,2334
247801632,1.0,1.0,85000,85000,0,0,85000,Null,Null,247801632,111461,2
247801662,0.0,0.0,85000,85000,0,0,85000,Null,Null,247801662,111461,2
247802117,2.0,2.0,965000,965000,0,0,965000,Null,Null,247802117,111461,2
247802485,0.0,0.0,9000,9000,0,0,9000,Null,Null,247802485,5713881,2
247802555,0.0,0.0,8000,8000,0,0,8000,Null,Null,247802555,5713881,2
247804779,8.0,8.0,165000,165000,0,0,165000,Null,Null,247804779,111461,28732
247806111,0.0,0.0,12499000,12499000,0,0,12499000,Null,Null,247806111,111461,2340
247806746,16.0,16.0,390000,299000,91000,23,390000,Null,Null,247806746,19246,1838
247807011,4.0,4.0,6000,6000,0,0,6000,Null,Null,247807011,111461,11803
247809291,2.0,2.0,250000,250000,0,0,250000,Null,Null,247809291,5706641,2140
247823295,5.0,5.0,790000,630000,160000,20,790000,Null,Null,247823295,20215,2324
247823537,56.0,56.0,4790000,3990000,800000,17,4790000,Null,Null,247823537,247549,1795
247829297,17.0,17.0,5690000,4750000,940000,17,5690000,Null,Null,247829297,247549,1795
247829841,0.0,0.0,2250,2250,0,0,2250,Null,Null,247829841,111461,2
247829978,0.0,0.0,4100,4100,0,0,4100,Null,Null,247829978,111461,2
247830845,0.0,0.0,2500,2500,0,0,2500,Null,Null,247830845,111461,23706
247855639,0.0,0.0,99910000,57850000,42060000,42,99910000,Null,Null,247855639,708263,23246
247862439,10.0,10.0,1000,1000,0,0,1000,Null,Null,247862439,111461,2
247862462,10.0,10.0,1000,1000,0,0,1000,Null,Null,247862462,111461,2
247862485,11.0,11.0,1000,1000,0,0,1000,Null,Null,247862485,111461,2
247862491,10.0,10.0,1000,1000,0,0,1000,Null,Null,247862491,111461,2
247862503,10.0,10.0,1000,1000,0,0,1000,Null,Null,247862503,111461,2
247862539,0.0,0.0,9209000,9209000,0,0,9209000,Null,Null,247862539,111461,8170
247862604,0.0,0.0,11989000,11989000,0,0,11989000,Null,Null,247862604,111461,8170
247863753,77.0,77.0,6000,6000,0,0,6000,Null,Null,247863753,111461,2
247865258,0.0,0.0,1290,1290,0,0,1290,Null,Null,247865258,111461,2
247879187,26.0,26.0,18000,18000,0,0,18000,Null,Null,247879187,111461,23416
247879757,1.0,1.0,840000,490000,350000,42,840000,Null,Null,247879757,281769,49722
247883892,4.0,4.0,169000,162000,7000,4,169000,Null,Null,247883892,111461,28598
247888100,0.0,0.0,2000,2000,0,0,2000,Null,Null,247888100,111461,2
247892308,0.0,0.0,82600000,80122000,2478000,3,82600000,Null,Null,247892308,111461,7079
247892324,0.0,0.0,82600000,80948000,1652000,2,82600000,Null,Null,247892324,111461,7079
247901245,0.0,0.0,7800,7800,0,0,7800,Null,Null,247901245,111461,2
247906338,0.0,0.0,5001,5001,0,0,5001,Null,Null,247906338,111461,2
247906634,0.0,0.0,8640,8640,0,0,8640,Null,Null,247906634,111461,2
247907000,0.0,0.0,8412,8412,0,0,8412,Null,Null,247907000,111461,2
247907069,0.0,0.0,9000,9000,0,0,9000,Null,Null,247907069,111461,2
247907095,0.0,0.0,9570,9570,0,0,9570,Null,Null,247907095,111461,2
247907104,0.0,0.0,12514,12514,0,0,12514,Null,Null,247907104,111461,2
247907280,0.0,0.0,9000,9000,0,0,9000,Null,Null,247907280,111461,2
247907319,0.0,0.0,6050,6050,0,0,6050,Null,Null,247907319,111461,2
247925719,10.0,10.0,4490000,4490000,0,0,4490000,Null,Null,247925719,18802,1795
247931698,0.0,0.0,0,1350,0,0,1350,Null,Null,247931698,111461,0
247937155,0.0,0.0,3637000,3637000,0,0,3637000,Null,Null,247937155,5191813,11731
247940676,26.0,26.0,1210000,1024000,186000,15,1210000,Null,Null,247940676,8170223,1631
247955149,403.0,403.0,1638000,1638000,0,0,1638000,Null,Null,247955149,259827,1520
247965266,328.0,328.0,1638000,745000,893000,55,1638000,Null,Null,247965266,259827,1520
247974684,0.0,0.0,15000,9600,5400,36,15000,Null,Null,247974684,4647777,15318
247999867,2045.0,2045.0,159000,159000,0,0,159000,Null,Null,247999867,415739,1520
248003864,0.0,0.0,1500,1500,0,0,1500,Null,Null,248003864,111461,53074
248005118,0.0,0.0,7853000,7164000,689000,9,7853000,Null,Null,248005118,18802,1795
248062787,2.0,2.0,985000,690000,295000,30,985000,Null,Null,248062787,147730,5385
248067036,3.0,3.0,15000,15000,0,0,15000,Null,Null,248067036,111461,28482
248075526,9.0,9.0,150000,103500,46500,31,150000,Null,Null,248075526,111461,28598
248077848,1.0,1.0,2225000,1780000,445000,20,2225000,Null,Null,248077848,147730,8512
248079387,0.0,0.0,39744000,39744000,0,0,39744000,Null,Null,248079387,111461,2
248084336,2.0,2.0,225000,225000,0,0,225000,Null,Null,248084336,111461,2
248084410,0.0,0.0,139000,139000,0,0,139000,Null,Null,248084410,111461,2
248084614,1.0,1.0,369000,369000,0,0,369000,Null,Null,248084614,111461,2
248126284,2.0,2.0,249000,249000,0,0,249000,Null,Null,248126284,111461,2
248130895,0.0,0.0,2500,2500,0,0,2500,Null,Null,248130895,111461,23678
248154660,0.0,0.0,7999000,7999000,0,0,7999000,Null,Null,248154660,48649,1634
248159428,0.0,0.0,9700000,9700000,0,0,9700000,Null,Null,248159428,48649,1634
248163647,0.0,0.0,3408000,3408000,0,0,3408000,Null,Null,248163647,5191813,53350
248168432,48.0,48.0,270000,250000,20000,7,270000,Null,Null,248168432,18845,1820
248172338,10.0,10.0,89000,89000,0,0,89000,Null,Null,248172338,63747,4452
248176413,0.0,0.0,29499000,29499000,0,0,29499000,Null,Null,248176413,8168015,20248
248180148,0.0,0.0,13900000,13900000,0,0,13900000,Null,Null,248180148,18641,28392
248180235,0.0,0.0,11500000,11500000,0,0,11500000,Null,Null,248180235,18641,2
248180304,0.0,0.0,11500000,11500000,0,0,11500000,Null,Null,248180304,18641,2
248180311,1.0,1.0,15500000,15500000,0,0,15500000,Null,Null,248180311,18641,28392
248185228,0.0,0.0,719000,609000,110000,15,719000,Null,Null,248185228,112638,1796
248185860,0.0,0.0,700000,592000,108000,15,700000,Null,Null,248185860,112638,1796
248185991,0.0,0.0,1345,1345,0,0,1345,Null,Null,248185991,8167517,23678
248186096,31.0,31.0,85000,65000,20000,24,85000,Null,Null,248186096,111461,23652
248210336,0.0,0.0,1012,1012,0,0,1012,Null,Null,248210336,8167517,23678
248215271,0.0,0.0,7000,7000,0,0,7000,Null,Null,248215271,111461,7064
248225744,0.0,0.0,55600000,54488000,1112000,2,55600000,Null,Null,248225744,111461,7079
248230244,0.0,0.0,3500000,3500000,0,0,3500000,Null,Null,248230244,872001,11873
248230301,0.0,0.0,650000,589000,61000,9,650000,Null,Null,248230301,112638,1796
248235765,0.0,0.0,640000,554000,86000,13,640000,Null,Null,248235765,112638,1796
248239660,0.0,0.0,57600000,57600000,0,0,57600000,Null,Null,248239660,111461,2
248240340,0.0,0.0,5800000,5800000,0,0,5800000,Null,Null,248240340,111461,2
248241961,0.0,0.0,43200000,43200000,0,0,43200000,Null,Null,248241961,111461,2
248242065,0.0,0.0,42000000,42000000,0,0,42000000,Null,Null,248242065,111461,2
248242095,0.0,0.0,54000000,54000000,0,0,54000000,Null,Null,248242095,111461,2
248242217,0.0,0.0,51000000,51000000,0,0,51000000,Null,Null,248242217,111461,2
248242361,0.0,0.0,72000000,72000000,0,0,72000000,Null,Null,248242361,111461,2
248248083,32.0,32.0,2000,2000,0,0,2000,Null,Null,248248083,111461,18876
248258315,14.0,14.0,39000,39000,0,0,39000,Null,Null,248258315,111461,53054
248259275,0.0,0.0,55600000,52820000,2780000,5,55600000,Null,Null,248259275,111461,7079
248260018,0.0,0.0,90000000,90000000,0,0,90000000,Null,Null,248260018,400077,1883
248330037,0.0,0.0,1900,1900,0,0,1900,Null,Null,248330037,111461,2
248330897,21.0,21.0,90000,45000,45000,50,90000,Null,Null,248330897,111461,2
248330900,18.0,18.0,150000,75000,75000,50,150000,Null,Null,248330900,111461,2
248347946,13.0,13.0,69000,67000,2000,3,69000,Null,Null,248347946,111461,1883
248352281,0.0,0.0,88030000,83628500,4401500,5,88030000,Null,Null,248352281,111461,7079
248352466,0.0,0.0,1000,1000,0,0,1000,Null,Null,248352466,869625,2
248352817,0.0,0.0,1180,1180,0,0,1180,Null,Null,248352817,869625,2
248354422,0.0,0.0,88030000,86269400,1760600,2,88030000,Null,Null,248354422,111461,7079
248355640,0.0,0.0,8800000,8800000,0,0,8800000,Null,Null,248355640,165403,2340
248357436,8.0,8.0,500000,375000,125000,25,500000,Null,Null,248357436,423495,3177
248357441,17.0,17.0,700000,700000,0,0,700000,Null,Null,248357441,423495,3177
248357457,11.0,11.0,550000,522500,27500,5,550000,Null,Null,248357457,423495,3177
248359104,1.0,1.0,3870000,3753900,116100,3,3870000,Null,Null,248359104,505925,2340
248359386,20.0,20.0,178000,137000,41000,23,178000,Null,Null,248359386,53040,13878
248361436,29.0,29.0,330000,320000,10000,3,330000,Null,Null,248361436,18845,1820
248365358,1.0,1.0,50000,19000,31000,62,50000,Null,Null,248365358,111461,15320
248396512,0.0,0.0,110000000,77000000,33000000,30,110000000,Null,Null,248396512,601737,2340
248396992,0.0,0.0,3599000,3599000,0,0,3599000,Null,Null,248396992,366783,8172
248397785,10.0,10.0,15000,9000,6000,40,15000,Null,Null,248397785,111461,11923
248401531,0.0,0.0,96900000,94962000,1938000,2,96900000,Null,Null,248401531,111461,7079
248402048,0.0,0.0,96900000,92055000,4845000,5,96900000,Null,Null,248402048,111461,7079
248404909,0.0,0.0,1000,1000,0,0,1000,Null,Null,248404909,111461,2
248411627,0.0,0.0,1500,1500,0,0,1500,Null,Null,248411627,111461,2
248414611,14.0,14.0,40000,31000,9000,23,40000,Null,Null,248414611,47663,1637
248420700,42.0,42.0,250200,139000,111200,44,250200,Null,Null,248420700,46703,53190
248426957,0.0,0.0,130000,130000,0,0,130000,Null,Null,248426957,111461,49722
248428116,0.0,0.0,69200000,65740000,3460000,5,69200000,Null,Null,248428116,111461,7079
248429451,0.0,0.0,69200000,67816000,1384000,2,69200000,Null,Null,248429451,111461,7079
248445327,0.0,0.0,10500000,9600000,900000,9,10500000,Null,Null,248445327,111461,11857
248445615,4.0,4.0,15000,9600,5400,36,15000,Null,Null,248445615,4647777,15318
248461776,9.0,9.0,59000,59000,0,0,59000,Null,Null,248461776,111461,28674
248469947,0.0,0.0,3990000,3690000,300000,8,3990000,Null,Null,248469947,25643,1795
248474144,5.0,5.0,50000,28800,21200,42,50000,Null,Null,248474144,4647777,15318
248475624,4.0,4.0,5550000,5550000,0,0,5550000,Null,Null,248475624,594805,1636
248476263,25.0,25.0,250000,250000,0,0,250000,Null,Null,248476263,4307205,4429
248476827,1.0,1.0,4950000,4950000,0,0,4950000,Null,Null,248476827,594805,1636
248477254,0.0,0.0,3999000,3999000,0,0,3999000,Null,Null,248477254,839873,1636
248478136,0.0,0.0,55600000,54488000,1112000,2,55600000,Null,Null,248478136,111461,7079
248481001,0.0,0.0,3899000,3899000,0,0,3899000,Null,Null,248481001,711599,1637
248484681,0.0,0.0,83520000,83520000,0,0,83520000,Null,Null,248484681,111461,2
248484904,0.0,0.0,40000000,40000000,0,0,40000000,Null,Null,248484904,111461,2
248489431,18.0,18.0,165000,165000,0,0,165000,Null,Null,248489431,111461,28574
248492611,107.0,107.0,500000,262000,238000,48,500000,Null,Null,248492611,4224691,5531
248494524,0.0,0.0,5880000,4880000,1000000,17,5880000,Null,Null,248494524,111461,11885
248496069,8.0,8.0,1095000,1095000,0,0,1095000,Null,Null,248496069,4702981,2324
248497439,35.0,35.0,5000,2000,3000,60,5000,Null,Null,248497439,111461,2
248519752,0.0,0.0,10300000,10300000,0,0,10300000,Null,Null,248519752,48649,1634
248523366,20.0,20.0,99000,99000,0,0,99000,Null,Null,248523366,110481,2
248537817,0.0,0.0,33500000,33500000,0,0,33500000,Null,Null,248537817,111461,28876
248538502,0.0,0.0,33700000,33700000,0,0,33700000,Null,Null,248538502,111461,28876
248538902,0.0,0.0,9000,9000,0,0,9000,Null,Null,248538902,4469567,28484
248539405,15.0,15.0,500000,146000,354000,71,500000,Null,Null,248539405,21651,8400
248540530,0.0,0.0,1100000,850000,250000,23,1100000,Null,Null,248540530,173547,15250
248543983,0.0,0.0,82600000,78470000,4130000,5,82600000,Null,Null,248543983,111461,7079
248547072,10.0,10.0,50000,28800,21200,42,50000,Null,Null,248547072,4647777,15318
248552885,344.0,344.0,65000,65000,0,0,65000,Null,Null,248552885,592131,1883
248574995,1.0,1.0,190000,169100,20900,11,190000,Null,Null,248574995,111461,2
248575377,2.0,2.0,163000,145070,17930,11,163000,Null,Null,248575377,111461,2
248589485,0.0,0.0,1000,1000,0,0,1000,Null,Null,248589485,111461,8205
248590019,1.0,1.0,3590000,2199000,1391000,39,3590000,Null,Null,248590019,25422,1795
248590133,0.0,0.0,5000,5000,0,0,5000,Null,Null,248590133,111461,8205
248596193,0.0,0.0,9000,9000,0,0,9000,Null,Null,248596193,111461,2
248598224,6.0,6.0,550000,488000,62000,11,550000,Null,Null,248598224,110682,8519
248600160,4.0,4.0,315000,240000,75000,24,315000,Null,Null,248600160,110682,8519
248606943,0.0,0.0,179000,179000,0,0,179000,Null,Null,248606943,111461,23588
248613625,3.0,3.0,4990000,3599000,1391000,28,4990000,Null,Null,248613625,247549,1795
248616060,3.0,3.0,8000,8000,0,0,8000,Null,Null,248616060,111461,11803
248618745,0.0,0.0,5600000,5600000,0,0,5600000,Null,Null,248618745,111461,2334
248619516,22.0,22.0,350000,195000,155000,44,350000,Null,Null,248619516,4234729,2514
248632033,1.0,1.0,289000,289000,0,0,289000,Null,Null,248632033,195495,28722
248635022,5.0,5.0,450000,450000,0,0,450000,Null,Null,248635022,508513,3422
248639063,0.0,0.0,7500000,6750000,750000,10,7500000,Null,Null,248639063,704815,15250
248639943,0.0,0.0,6550000,5895000,655000,10,6550000,Null,Null,248639943,704815,15250
248642398,0.0,0.0,2500,2500,0,0,2500,Null,Null,248642398,111461,2
248642419,0.0,0.0,1500,1500,0,0,1500,Null,Null,248642419,111461,2
248642494,0.0,0.0,4500,4500,0,0,4500,Null,Null,248642494,111461,2
248642535,0.0,0.0,1900,1900,0,0,1900,Null,Null,248642535,111461,2
248643379,15.0,15.0,485000,449000,36000,7,485000,Null,Null,248643379,25422,1811
248644364,0.0,0.0,64570000,64570000,0,0,64570000,Null,Null,248644364,245551,20492
248644506,0.0,0.0,91800000,91800000,0,0,91800000,Null,Null,248644506,245551,20492
248644680,6.0,6.0,250000,145000,105000,42,250000,Null,Null,248644680,201253,2659
248644685,0.0,0.0,76900000,76900000,0,0,76900000,Null,Null,248644685,245551,20492
248651144,0.0,0.0,45000000,45000000,0,0,45000000,Null,Null,248651144,111461,11856
248653644,5.0,5.0,490000,466000,24000,5,490000,Null,Null,248653644,4973949,28428
248654107,40.0,40.0,19000,19000,0,0,19000,Null,Null,248654107,5706641,3177
248655651,0.0,0.0,5190000,3750000,1440000,28,5190000,Null,Null,248655651,18802,1795
248655757,302.0,302.0,51000,31000,20000,39,51000,Null,Null,248655757,111461,1831
248656181,15.0,15.0,32000,28000,4000,13,32000,Null,Null,248656181,111461,2
248656217,0.0,0.0,57000,57000,0,0,57000,Null,Null,248656217,111461,2340
248656223,18.0,18.0,45000,39000,6000,13,45000,Null,Null,248656223,111461,2
248667113,4.0,4.0,939000,939000,0,0,939000,Null,Null,248667113,21717,28428
248683258,12.0,12.0,130000,130000,0,0,130000,Null,Null,248683258,18984,5263
248684056,30.0,30.0,38000,33500,4500,12,38000,Null,Null,248684056,112887,11605
248684057,33.0,33.0,240000,222000,18000,8,240000,Null,Null,248684057,22013,8227
248684062,14.0,14.0,260000,243000,17000,7,260000,Null,Null,248684062,22013,8227
248684066,12.0,12.0,148000,148000,0,0,148000,Null,Null,248684066,112887,3422
248685161,17.0,17.0,78000,62000,16000,21,78000,Null,Null,248685161,111461,28574
248685833,14.0,14.0,60000,49000,11000,18,60000,Null,Null,248685833,111461,28574
248686312,112.0,112.0,63000,35000,28000,44,63000,Null,Null,248686312,46703,3877
248688169,0.0,0.0,10490000,7799000,2691000,26,10490000,Null,Null,248688169,18802,1795
248704393,7.0,7.0,490000,329000,161000,33,490000,Null,Null,248704393,18802,28484
248704404,2.0,2.0,4490000,3350000,1140000,25,4490000,Null,Null,248704404,18802,1795
248739922,1.0,1.0,403300,373000,30300,8,403300,Null,Null,248739922,27918,1613
248739924,481.0,481.0,194000,160000,34000,18,194000,Null,Null,248739924,21265,17162
248739936,515.0,515.0,194000,160000,34000,18,194000,Null,Null,248739936,21265,17162
248742039,0.0,0.0,12500000,12500000,0,0,12500000,Null,Null,248742039,111461,1634
248745868,3.0,3.0,4990000,4990000,0,0,4990000,Null,Null,248745868,25422,1795
248746153,0.0,0.0,16150000,16150000,0,0,16150000,Null,Null,248746153,111461,28872
248754485,0.0,0.0,16000000,16000000,0,0,16000000,Null,Null,248754485,111461,28872
248754839,1.0,1.0,3290000,2790000,500000,15,3290000,Null,Null,248754839,25643,1795
248755344,0.0,0.0,8290000,8290000,0,0,8290000,Null,Null,248755344,111461,2340
248758105,5.0,5.0,1950000,1950000,0,0,1950000,Null,Null,248758105,7383163,53350
248761700,15.0,15.0,695000,695000,0,0,695000,Null,Null,248761700,146202,1811
248761768,0.0,0.0,4750000,4750000,0,0,4750000,Null,Null,248761768,234023,2342
248762051,0.0,0.0,8490000,6516000,1974000,23,8490000,Null,Null,248762051,18802,1795
248762370,8.0,8.0,120000,99000,21000,18,120000,Null,Null,248762370,5534927,11853
248762760,0.0,0.0,2500,2500,0,0,2500,Null,Null,248762760,111461,2
248762801,0.0,0.0,1800,1800,0,0,1800,Null,Null,248762801,111461,2
248762811,0.0,0.0,1500,1500,0,0,1500,Null,Null,248762811,111461,2
248762881,5.0,5.0,1000,1000,0,0,1000,Null,Null,248762881,111461,2
248762951,0.0,0.0,1000,1000,0,0,1000,Null,Null,248762951,111461,2
248763183,0.0,0.0,1500,1500,0,0,1500,Null,Null,248763183,111461,2
248763318,0.0,0.0,1000,1000,0,0,1000,Null,Null,248763318,111461,2
248763329,9.0,9.0,1000,1000,0,0,1000,Null,Null,248763329,111461,2
248763368,0.0,0.0,2000,2000,0,0,2000,Null,Null,248763368,111461,2
248763385,0.0,0.0,1700,1700,0,0,1700,Null,Null,248763385,111461,2
248763462,0.0,0.0,1000,1000,0,0,1000,Null,Null,248763462,111461,2
248763468,0.0,0.0,2500,2500,0,0,2500,Null,Null,248763468,111461,2
248763609,0.0,0.0,2500,2500,0,0,2500,Null,Null,248763609,111461,2
248763635,0.0,0.0,2500,2500,0,0,2500,Null,Null,248763635,111461,2
248763697,0.0,0.0,2500,2500,0,0,2500,Null,Null,248763697,111461,2
248763900,8.0,8.0,160000,149000,11000,7,160000,Null,Null,248763900,5534927,11845
248764643,0.0,0.0,6700000,6700000,0,0,6700000,Null,Null,248764643,111461,1634
248764783,7.0,7.0,150000,99000,51000,34,150000,Null,Null,248764783,5534927,3426
248766283,6.0,6.0,3299000,3010000,289000,9,3299000,Null,Null,248766283,147856,28856
248766356,0.0,0.0,6900000,6900000,0,0,6900000,Null,Null,248766356,111461,1634
248766500,13.0,13.0,390000,349000,41000,11,390000,Null,Null,248766500,47489,8227
248768719,0.0,0.0,14500000,14500000,0,0,14500000,Null,Null,248768719,111461,28872
248768971,23.0,23.0,390000,364000,26000,7,390000,Null,Null,248768971,47489,8227
248770224,0.0,0.0,14500000,14500000,0,0,14500000,Null,Null,248770224,111461,28872
248775155,7.0,7.0,99000,79000,20000,20,99000,Null,Null,248775155,8169571,11857
248777899,5.0,5.0,300000,146000,154000,51,300000,Null,Null,248777899,111461,5006
248784623,0.0,0.0,4299000,4299000,0,0,4299000,Null,Null,248784623,561913,1636
248791957,127.0,127.0,25000,25000,0,0,25000,Null,Null,248791957,839837,8309
248797183,0.0,0.0,6000,6000,0,0,6000,Null,Null,248797183,111461,20222
248797227,0.0,0.0,70000,63000,7000,10,70000,Null,Null,248797227,111461,15320
248798122,3.0,3.0,990000,990000,0,0,990000,Null,Null,248798122,111461,2340
248799307,0.0,0.0,11490000,10449000,1041000,9,11490000,Null,Null,248799307,25422,1795
248801922,0.0,0.0,20000000,20000000,0,0,20000000,Null,Null,248801922,601737,2340
248802052,8.0,8.0,309000,296000,13000,4,309000,Null,Null,248802052,111461,13878
248803935,0.0,0.0,5000,5000,0,0,5000,Null,Null,248803935,111461,2
248804015,0.0,0.0,2000,2000,0,0,2000,Null,Null,248804015,111461,2
248804241,0.0,0.0,1300,1300,0,0,1300,Null,Null,248804241,111461,2
248804606,0.0,0.0,3000,3000,0,0,3000,Null,Null,248804606,111461,2
248807309,0.0,0.0,29100000,28518000,582000,2,29100000,Null,Null,248807309,111461,7079
248819031,0.0,0.0,29100000,28809000,291000,1,29100000,Null,Null,248819031,111461,7079
248828053,0.0,0.0,10000,10000,0,0,10000,Null,Null,248828053,111461,2
248828174,0.0,0.0,10000,10000,0,0,10000,Null,Null,248828174,111461,2
248829073,0.0,0.0,11000,11000,0,0,11000,Null,Null,248829073,111461,2
248829472,0.0,0.0,12000,12000,0,0,12000,Null,Null,248829472,111461,2
248829488,0.0,0.0,10000,10000,0,0,10000,Null,Null,248829488,111461,49728
248829542,0.0,0.0,10000,10000,0,0,10000,Null,Null,248829542,111461,2
248858613,0.0,0.0,8900000,8900000,0,0,8900000,Null,Null,248858613,111461,1634
248865886,0.0,0.0,8890000,8890000,0,0,8890000,Null,Null,248865886,111461,1634
248869767,0.0,0.0,58400000,57232000,1168000,2,58400000,Null,Null,248869767,111461,7079
248870327,0.0,0.0,58400000,57232000,1168000,2,58400000,Null,Null,248870327,111461,7079
248875686,0.0,0.0,85000000,67000000,18000000,21,85000000,Null,Null,248875686,601737,2340
248876561,11.0,11.0,250000,162500,87500,35,250000,Null,Null,248876561,111461,15318
248880287,0.0,0.0,3940000,3940000,0,0,3940000,Null,Null,248880287,48649,1634
248880482,0.0,0.0,4250000,4250000,0,0,4250000,Null,Null,248880482,48649,1634
248880498,0.0,0.0,23491000,20665000,2826000,12,23491000,Null,Null,248880498,18802,1795
248886140,0.0,0.0,10490000,7949000,2541000,24,10490000,Null,Null,248886140,18802,1795
248886952,2.0,2.0,239000,239000,0,0,239000,Null,Null,248886952,233859,28694
248894141,0.0,0.0,60000000,52000000,8000000,13,60000000,Null,Null,248894141,601737,2340
248896799,0.0,0.0,65000,36000,29000,45,65000,Null,Null,248896799,111461,15936
248902171,0.0,0.0,14999,14999,0,0,14999,Null,Null,248902171,111461,2
248902288,0.0,0.0,9999,9999,0,0,9999,Null,Null,248902288,111461,2
248903207,0.0,0.0,8999,8999,0,0,8999,Null,Null,248903207,111461,2
248905365,0.0,0.0,4999,4999,0,0,4999,Null,Null,248905365,111461,2
248906948,0.0,0.0,52000000,45000000,7000000,13,52000000,Null,Null,248906948,601737,2340
248911447,0.0,0.0,9860000,8190000,1670000,17,9860000,Null,Null,248911447,18802,1795
248911486,0.0,0.0,11900000,11900000,0,0,11900000,Null,Null,248911486,228187,2334
248911602,0.0,0.0,10790000,9464000,1326000,12,10790000,Null,Null,248911602,18802,1795
248914659,0.0,0.0,5190000,5190000,0,0,5190000,Null,Null,248914659,111461,8167
248928487,0.0,0.0,1500,1500,0,0,1500,Null,Null,248928487,111461,2
248928519,0.0,0.0,1000,1000,0,0,1000,Null,Null,248928519,111461,2
248928558,0.0,0.0,5500,5500,0,0,5500,Null,Null,248928558,111461,2
248928583,0.0,0.0,1500,1500,0,0,1500,Null,Null,248928583,111461,2
248928604,0.0,0.0,1500,1500,0,0,1500,Null,Null,248928604,111461,2
248928816,0.0,0.0,9900,9900,0,0,9900,Null,Null,248928816,111461,2
248928833,0.0,0.0,1700,1700,0,0,1700,Null,Null,248928833,111461,2
248929458,0.0,0.0,8490000,6599000,1891000,22,8490000,Null,Null,248929458,18802,1795
248930258,23.0,23.0,235000,180000,55000,23,235000,Null,Null,248930258,156043,53352
248930329,0.0,0.0,1000,1000,0,0,1000,Null,Null,248930329,111461,23010
248931925,9.0,9.0,800000,450000,350000,44,800000,Null,Null,248931925,111461,8400
248934954,0.0,0.0,83000000,60000000,23000000,28,83000000,Null,Null,248934954,601737,2
248935091,0.0,0.0,294000,294000,0,0,294000,Null,Null,248935091,111461,23042
248935224,21.0,21.0,124200,69000,55200,44,124200,Null,Null,248935224,46703,2
248935902,0.0,0.0,65000000,57000000,8000000,12,65000000,Null,Null,248935902,601737,2
248936968,0.0,0.0,37380000,37380000,0,0,37380000,Null,Null,248936968,4001441,11856
248937110,3.0,3.0,857143,600000,257143,30,857143,Null,Null,248937110,147730,1778
248983230,0.0,0.0,1500,1500,0,0,1500,Null,Null,248983230,869625,2
248983243,0.0,0.0,1180,1180,0,0,1180,Null,Null,248983243,869625,2
248983335,0.0,0.0,1500,1500,0,0,1500,Null,Null,248983335,869625,2
248983339,0.0,0.0,1000,1000,0,0,1000,Null,Null,248983339,869625,2
248983431,0.0,0.0,1000,1000,0,0,1000,Null,Null,248983431,869625,2
248983517,0.0,0.0,1500,1500,0,0,1500,Null,Null,248983517,869625,2
248983964,0.0,0.0,1500,1500,0,0,1500,Null,Null,248983964,869625,2
248984213,0.0,0.0,1000,1000,0,0,1000,Null,Null,248984213,869625,2
248984337,0.0,0.0,1000,1000,0,0,1000,Null,Null,248984337,869625,2
248989413,0.0,0.0,55300000,55300000,0,0,55300000,Null,Null,248989413,4001441,11856
248989861,1.0,1.0,120000,120000,0,0,120000,Null,Null,248989861,111461,15236
248992452,0.0,0.0,1500,1500,0,0,1500,Null,Null,248992452,617815,2
248993264,0.0,0.0,1000,1000,0,0,1000,Null,Null,248993264,617815,2
248993273,0.0,0.0,1000,1000,0,0,1000,Null,Null,248993273,617815,2
248993348,0.0,0.0,1000,1000,0,0,1000,Null,Null,248993348,617815,2
248993569,0.0,0.0,1500,1500,0,0,1500,Null,Null,248993569,617815,2
248993597,0.0,0.0,1000,1000,0,0,1000,Null,Null,248993597,617815,2
249005653,0.0,0.0,15500,15500,0,0,15500,Null,Null,249005653,111461,2
249005738,0.0,0.0,14400,14400,0,0,14400,Null,Null,249005738,111461,2
249006184,0.0,0.0,1785714,1250000,535714,30,1785714,Null,Null,249006184,212883,7449
249007408,0.0,0.0,26730000,26730000,0,0,26730000,Null,Null,249007408,5740935,2324
249009198,0.0,0.0,85000000,72000000,13000000,15,85000000,Null,Null,249009198,601737,2340
249010493,150.0,150.0,700000,368000,332000,47,700000,Null,Null,249010493,4224691,2340
249011875,0.0,0.0,57500000,45500000,12000000,21,57500000,Null,Null,249011875,601737,2340
249012748,0.0,0.0,142000000,142000000,0,0,142000000,Null,Null,249012748,601737,2340
249016626,18.0,18.0,30000,30000,0,0,30000,Null,Null,249016626,839837,17174
249016981,0.0,0.0,3650000,3650000,0,0,3650000,Null,Null,249016981,111461,2
249016995,0.0,0.0,3668000,3668000,0,0,3668000,Null,Null,249016995,111461,11845
249021245,0.0,0.0,45290000,45290000,0,0,45290000,Null,Null,249021245,4001441,11856
249022364,58.0,58.0,235000,180000,55000,23,235000,Null,Null,249022364,926913,8309
249022455,23.0,23.0,29000,29000,0,0,29000,Null,Null,249022455,111461,27240
249025827,0.0,0.0,3650000,3650000,0,0,3650000,Null,Null,249025827,111461,11845
249026626,15.0,15.0,155000,108000,47000,30,155000,Null,Null,249026626,156043,11877
249028687,12.0,12.0,595000,539000,56000,9,595000,Null,Null,249028687,26689,8227
249029556,54.0,54.0,35000,31000,4000,11,35000,Null,Null,249029556,111461,1883
249029592,0.0,0.0,52000000,42000000,10000000,19,52000000,Null,Null,249029592,601737,2340
249033328,1.0,1.0,19990000,17990000,2000000,10,19990000,Null,Null,249033328,25643,1795
249033703,12.0,12.0,120000,105000,15000,13,120000,Null,Null,249033703,5658897,11869
249033814,14.0,14.0,201000,170000,31000,15,201000,Null,Null,249033814,443985,11871
249035333,0.0,0.0,750000,750000,0,0,750000,Null,Null,249035333,245121,53350
249039195,3.0,3.0,980000,980000,0,0,980000,Null,Null,249039195,4228599,17170
249042608,0.0,0.0,14999000,14999000,0,0,14999000,Null,Null,249042608,450333,8066
249042620,0.0,0.0,5000,5000,0,0,5000,Null,Null,249042620,111461,1622
249042636,0.0,0.0,11286000,11286000,0,0,11286000,Null,Null,249042636,450333,8066
249042743,0.0,0.0,23499000,23499000,0,0,23499000,Null,Null,249042743,450333,8066
249042841,0.0,0.0,18500000,18500000,0,0,18500000,Null,Null,249042841,450333,8066
249052212,23.0,23.0,68326,68326,0,0,68326,Null,Null,249052212,5745605,28480
249052256,1.0,1.0,390000,390000,0,0,390000,Null,Null,249052256,111461,15320
249059042,0.0,0.0,18299000,18299000,0,0,18299000,Null,Null,249059042,111461,2340
249082228,33.0,33.0,65000,50000,15000,23,65000,Null,Null,249082228,156043,11857
249083678,15.0,15.0,235000,162000,73000,31,235000,Null,Null,249083678,156043,11869
249085257,0.0,0.0,8690000,8690000,0,0,8690000,Null,Null,249085257,48649,1634
249086478,0.0,0.0,7850000,7850000,0,0,7850000,Null,Null,249086478,48649,1634
249087141,5.0,5.0,998000,499000,499000,50,998000,Null,Null,249087141,111461,49724
249088138,0.0,0.0,10000,10000,0,0,10000,Null,Null,249088138,111461,2
249089297,0.0,0.0,1500,1500,0,0,1500,Null,Null,249089297,111461,2
249092041,11.0,11.0,59998,59998,0,0,59998,Null,Null,249092041,111461,1634
249113206,6.0,6.0,980000,980000,0,0,980000,Null,Null,249113206,4228599,53350
249114722,0.0,0.0,220000,200000,20000,9,220000,Null,Null,249114722,365727,11869
249135607,0.0,0.0,25500000,19900000,5600000,22,25500000,Null,Null,249135607,213611,8172
249143274,5.0,5.0,199000,194000,5000,3,199000,Null,Null,249143274,149308,28576
249143473,9.0,9.0,8490000,6750000,1740000,20,8490000,Null,Null,249143473,18802,1795
249144672,21.0,21.0,120000,90000,30000,25,120000,Null,Null,249144672,156043,11873
249145018,51.0,51.0,300000,175000,125000,42,300000,Null,Null,249145018,111461,11856
249146021,0.0,0.0,220000,200000,20000,9,220000,Null,Null,249146021,365727,11857
249149852,5.0,5.0,1675000,1675000,0,0,1675000,Null,Null,249149852,4228599,53350
249150742,0.0,0.0,5349000,5349000,0,0,5349000,Null,Null,249150742,19018,1634
249151803,2.0,2.0,10490000,8350000,2140000,20,10490000,Null,Null,249151803,18802,1795
249152878,0.0,0.0,16900000,14900000,2000000,12,16900000,Null,Null,249152878,20215,2324
249160284,0.0,0.0,666000,666000,0,0,666000,Null,Null,249160284,20683,28454
249167880,0.0,0.0,3490000,2790000,700000,20,3490000,Null,Null,249167880,52232,1795
249168159,0.0,0.0,3490000,2790000,700000,20,3490000,Null,Null,249168159,52232,1795
249168949,0.0,0.0,8490000,6990000,1500000,18,8490000,Null,Null,249168949,18802,1795
249168961,0.0,0.0,34200000,33858000,342000,1,34200000,Null,Null,249168961,111461,7079
249169209,0.0,0.0,35100000,34749000,351000,1,35100000,Null,Null,249169209,111461,7079
249169833,0.0,0.0,8490000,6990000,1500000,18,8490000,Null,Null,249169833,18802,1795
249177332,9.0,9.0,1750000,1399000,351000,20,1750000,Null,Null,249177332,218061,1520
249178196,0.0,0.0,8490000,6990000,1500000,18,8490000,Null,Null,249178196,18802,1795
249181886,1.0,1.0,5000,3500,1500,30,5000,Null,Null,249181886,111461,28482
249216836,0.0,0.0,3990000,3990000,0,0,3990000,Null,Null,249216836,48649,1634
249220200,0.0,0.0,4880000,4880000,0,0,4880000,Null,Null,249220200,48649,1634
249220214,0.0,0.0,8800000,8800000,0,0,8800000,Null,Null,249220214,111461,1634
249220793,0.0,0.0,77000,77000,0,0,77000,Null,Null,249220793,111461,3877
249226876,0.0,0.0,11000000,11000000,0,0,11000000,Null,Null,249226876,228187,2334
249228019,0.0,0.0,1392,1392,0,0,1392,Null,Null,249228019,8167517,23236
249237203,0.0,0.0,3240000,3240000,0,0,3240000,Null,Null,249237203,25422,1795
249238169,0.0,0.0,1500,1500,0,0,1500,Null,Null,249238169,111461,2
249238208,0.0,0.0,2300,2300,0,0,2300,Null,Null,249238208,111461,2
249238253,0.0,0.0,2500,2500,0,0,2500,Null,Null,249238253,111461,2
249243262,31.0,31.0,1295000,1064000,231000,18,1295000,Null,Null,249243262,8170223,1631
249245516,0.0,0.0,1940,1493,447,23,1940,Null,Null,249245516,111461,8193
249245783,0.0,0.0,2000,2000,0,0,2000,Null,Null,249245783,111461,2514
249257851,0.0,0.0,50000000,45490000,4510000,9,50000000,Null,Null,249257851,18851,12864
249257937,21.0,21.0,84000,66000,18000,21,84000,Null,Null,249257937,111461,28574
249258097,15.0,15.0,7020,5400,1620,23,7020,Null,Null,249258097,111461,28480
249259311,14.0,14.0,380000,361000,19000,5,380000,Null,Null,249259311,423495,3177
249259496,0.0,0.0,4000000,3820000,180000,5,4000000,Null,Null,249259496,499843,11865
249259556,0.0,0.0,10000,9900,100,1,10000,Null,Null,249259556,111461,2
249259618,0.0,0.0,4100000,3916000,184000,4,4100000,Null,Null,249259618,111461,11885
249260344,27.0,27.0,290000,290000,0,0,290000,Null,Null,249260344,147856,28598
249260738,0.0,0.0,11000000,11000000,0,0,11000000,Null,Null,249260738,228187,2334
249261932,4.0,4.0,1500000,1500000,0,0,1500000,Null,Null,249261932,4228599,53350
249269058,0.0,0.0,8000,8000,0,0,8000,Null,Null,249269058,111461,10413
249272851,7.0,7.0,150000,150000,0,0,150000,Null,Null,249272851,7294277,27544
249273295,0.0,0.0,16390000,16390000,0,0,16390000,Null,Null,249273295,453161,28392
249285315,1.0,1.0,5190000,4290000,900000,17,5190000,Null,Null,249285315,18802,1795
249285505,0.0,0.0,5190000,4290000,900000,17,5190000,Null,Null,249285505,18802,1795
249285518,1.0,1.0,168000,168000,0,0,168000,Null,Null,249285518,7506817,15318
249286069,0.0,0.0,5190000,4290000,900000,17,5190000,Null,Null,249286069,18802,1795
249286929,3.0,3.0,280000,280000,0,0,280000,Null,Null,249286929,7506817,15318
249287176,2.0,2.0,599000,528000,71000,12,599000,Null,Null,249287176,112638,1789
249287804,3.0,3.0,325000,325000,0,0,325000,Null,Null,249287804,7506817,15318
249288421,4.0,4.0,105000,105000,0,0,105000,Null,Null,249288421,7506817,15318
249290166,0.0,0.0,8000,8000,0,0,8000,Null,Null,249290166,111461,20254
249296022,0.0,0.0,30000,17000,13000,43,30000,Null,Null,249296022,111461,1520
249304647,0.0,0.0,6890000,6890000,0,0,6890000,Null,Null,249304647,113119,11516
249305596,0.0,0.0,135000,121500,13500,10,135000,Null,Null,249305596,111461,15320
249305676,9.0,9.0,24000,24000,0,0,24000,Null,Null,249305676,111461,28578
249306451,1.0,1.0,220000,132000,88000,40,220000,Null,Null,249306451,7294277,27544
249347447,140.0,140.0,450000,232000,218000,48,450000,Null,Null,249347447,4224691,1883
249347661,0.0,0.0,2828,2175,653,23,2828,Null,Null,249347661,111461,3179
249347749,0.0,0.0,1521,1170,351,23,1521,Null,Null,249347749,111461,2363
249348004,75.0,75.0,1200000,625000,575000,48,1200000,Null,Null,249348004,4224691,2340
249369390,0.0,0.0,9500,9500,0,0,9500,Null,Null,249369390,111461,20254
249373741,0.0,0.0,27500000,27500000,0,0,27500000,Null,Null,249373741,111461,11518
249382483,0.0,0.0,28500000,28500000,0,0,28500000,Null,Null,249382483,111461,11518
249384187,6.0,6.0,199000,129000,70000,35,199000,Null,Null,249384187,8169571,11845
249384296,0.0,0.0,54340000,52709800,1630200,3,54340000,Null,Null,249384296,111461,7079
249387958,0.0,0.0,13950000,13950000,0,0,13950000,Null,Null,249387958,111461,11518
249388086,35.0,35.0,999000,599000,400000,40,999000,Null,Null,249388086,204895,23588
249389373,0.0,0.0,12410000,12285900,124100,1,12410000,Null,Null,249389373,111461,2324
249391716,0.0,0.0,5899000,4400000,1499000,25,5899000,Null,Null,249391716,40734,2340
249393169,0.0,0.0,54340000,51623000,2717000,5,54340000,Null,Null,249393169,111461,7079
249395091,26.0,26.0,69000,69000,0,0,69000,Null,Null,249395091,111461,3710
249401200,0.0,0.0,14951000,13754920,1196080,8,14951000,Null,Null,249401200,111461,11518
249465478,0.0,0.0,1890,1890,0,0,1890,Null,Null,249465478,111461,2
249466085,0.0,0.0,1999,1999,0,0,1999,Null,Null,249466085,111461,2
249466237,0.0,0.0,2000,2000,0,0,2000,Null,Null,249466237,111461,2
249466676,0.0,0.0,2450,2450,0,0,2450,Null,Null,249466676,111461,2
249466990,0.0,0.0,5500,5500,0,0,5500,Null,Null,249466990,111461,2
249467673,0.0,0.0,1800,1800,0,0,1800,Null,Null,249467673,111461,2
249467771,0.0,0.0,1880,1880,0,0,1880,Null,Null,249467771,111461,2
249467922,0.0,0.0,8900,8900,0,0,8900,Null,Null,249467922,111461,2
249468650,0.0,0.0,6900,6900,0,0,6900,Null,Null,249468650,111461,26652
249468949,0.0,0.0,1300,1300,0,0,1300,Null,Null,249468949,111461,2
249468979,0.0,0.0,4500,4500,0,0,4500,Null,Null,249468979,111461,2
249494212,0.0,0.0,45000000,40000000,5000000,11,45000000,Null,Null,249494212,601737,2340
249502008,0.0,0.0,196000000,196000000,0,0,196000000,Null,Null,249502008,601737,2340
249531556,0.0,0.0,103436,103436,0,0,103436,Null,Null,249531556,111461,2
249531906,0.0,0.0,2500,2500,0,0,2500,Null,Null,249531906,111461,2
249534166,0.0,0.0,2500,2500,0,0,2500,Null,Null,249534166,111461,23082
249534908,11.0,11.0,2490000,1959000,531000,21,2490000,Null,Null,249534908,162007,1795
249534974,0.0,0.0,31000000,31000000,0,0,31000000,Null,Null,249534974,601737,2340
249570072,0.0,0.0,160000,144000,16000,10,160000,Null,Null,249570072,111461,15250
249570106,0.0,0.0,7158000,6943260,214740,3,7158000,Null,Null,249570106,875757,2
249570124,0.0,0.0,3800000,3686000,114000,3,3800000,Null,Null,249570124,875757,2
249570185,0.0,0.0,8900000,8633000,267000,3,8900000,Null,Null,249570185,875757,2
249570460,0.0,0.0,6800000,4443000,2357000,35,6800000,Null,Null,249570460,46007,8227
249575564,0.0,0.0,5000,5000,0,0,5000,Null,Null,249575564,111461,28716
249586190,0.0,0.0,9000,9000,0,0,9000,Null,Null,249586190,233859,28694
249586280,13.0,13.0,39000,39000,0,0,39000,Null,Null,249586280,111461,1883
249587380,0.0,0.0,1000,1000,0,0,1000,Null,Null,249587380,111461,23010
249589166,0.0,0.0,44000000,44000000,0,0,44000000,Null,Null,249589166,111461,2
249590170,0.0,0.0,23000000,13900000,9100000,40,23000000,Null,Null,249590170,601737,2340
249591080,10.0,10.0,6000,6000,0,0,6000,Null,Null,249591080,111461,20258
249591319,0.0,0.0,99000000,72500000,26500000,27,99000000,Null,Null,249591319,601737,2340
249596331,0.0,0.0,59500000,40000000,19500000,33,59500000,Null,Null,249596331,601737,2340
249599970,0.0,0.0,135000000,135000000,0,0,135000000,Null,Null,249599970,601737,2340
249604068,0.0,0.0,72500000,56000000,16500000,23,72500000,Null,Null,249604068,601737,2340
249604590,0.0,0.0,65000000,65000000,0,0,65000000,Null,Null,249604590,601737,2340
249607405,0.0,0.0,68000000,54000000,14000000,21,68000000,Null,Null,249607405,601737,2340
249609345,0.0,0.0,110000000,56000000,54000000,49,110000000,Null,Null,249609345,601737,2340
249609876,0.0,0.0,83000000,55000000,28000000,34,83000000,Null,Null,249609876,601737,2340
249614310,15.0,15.0,14400,14400,0,0,14400,Null,Null,249614310,111461,2
249636366,0.0,0.0,39000000,39000000,0,0,39000000,Null,Null,249636366,111461,2
249636608,0.0,0.0,43000000,43000000,0,0,43000000,Null,Null,249636608,111461,2
249657073,13.0,13.0,49900,49900,0,0,49900,Null,Null,249657073,111461,2
249657175,21.0,21.0,28500,28500,0,0,28500,Null,Null,249657175,111461,2
249662925,9.0,9.0,120000,90000,30000,25,120000,Null,Null,249662925,156043,11873
249664004,0.0,0.0,45000,45000,0,0,45000,Null,Null,249664004,8173019,3426
249667636,41.0,41.0,130000,89000,41000,32,130000,Null,Null,249667636,746615,23258
249667808,35.0,35.0,130000,89000,41000,32,130000,Null,Null,249667808,746615,6305
249669756,5.0,5.0,1350000,1350000,0,0,1350000,Null,Null,249669756,5262165,17170
249680631,0.0,0.0,3999000,3999000,0,0,3999000,Null,Null,249680631,111461,11859
249681677,1.0,1.0,225000,225000,0,0,225000,Null,Null,249681677,7368403,2
249681769,2.0,2.0,265000,265000,0,0,265000,Null,Null,249681769,7368403,2
249683281,0.0,0.0,22000000,20495000,1505000,7,22000000,Null,Null,249683281,114527,2657
249684295,0.0,0.0,5400000,5400000,0,0,5400000,Null,Null,249684295,111461,8167
249686450,0.0,0.0,1000,1000,0,0,1000,Null,Null,249686450,111461,2
249689396,0.0,0.0,341000,341000,0,0,341000,Null,Null,249689396,7368403,2
249694489,11.0,11.0,250000,250000,0,0,250000,Null,Null,249694489,577673,2225
249694816,0.0,0.0,15000,15000,0,0,15000,Null,Null,249694816,7368403,2
249697118,0.0,0.0,2200,2200,0,0,2200,Null,Null,249697118,111461,27214
249724398,0.0,0.0,1590000,1590000,0,0,1590000,Null,Null,249724398,636739,7079
249730334,0.0,0.0,619000,499000,120000,19,619000,Null,Null,249730334,112638,2
249730336,0.0,0.0,749000,679000,70000,9,749000,Null,Null,249730336,112638,2
249730338,0.0,0.0,799000,689000,110000,14,799000,Null,Null,249730338,112638,2
249730339,0.0,0.0,659000,519000,140000,21,659000,Null,Null,249730339,112638,2
249730342,0.0,0.0,630000,630000,0,0,630000,Null,Null,249730342,112638,2
249730344,0.0,0.0,529000,449000,80000,15,529000,Null,Null,249730344,112638,2
249734070,0.0,0.0,699000,589000,110000,16,699000,Null,Null,249734070,112638,2
249738562,0.0,0.0,5000,4500,500,10,5000,Null,Null,249738562,713425,4408
249738603,0.0,0.0,4860000,4140000,720000,15,4860000,Null,Null,249738603,713425,1752
249739963,1.0,1.0,360000,360000,0,0,360000,Null,Null,249739963,111461,15320
249766840,31.0,31.0,59000,59000,0,0,59000,Null,Null,249766840,111461,3877
249767525,5.0,5.0,1510000,1510000,0,0,1510000,Null,Null,249767525,5660745,3422
249768837,0.0,0.0,7000,7000,0,0,7000,Null,Null,249768837,111461,8167
249772075,0.0,0.0,7900000,7900000,0,0,7900000,Null,Null,249772075,616207,2340
249774366,0.0,0.0,6900000,6900000,0,0,6900000,Null,Null,249774366,111461,11875
249776559,0.0,0.0,3500000,3500000,0,0,3500000,Null,Null,249776559,111461,2
249776596,0.0,0.0,9000,9000,0,0,9000,Null,Null,249776596,111461,8172
249778262,0.0,0.0,4600,4600,0,0,4600,Null,Null,249778262,111461,2
249782771,0.0,0.0,2890000,2890000,0,0,2890000,Null,Null,249782771,8173499,1794
249789759,0.0,0.0,5600000,5600000,0,0,5600000,Null,Null,249789759,111461,11861
249789888,6.0,6.0,150000,86000,64000,43,150000,Null,Null,249789888,500047,4428
249791135,9.0,9.0,150000,86000,64000,43,150000,Null,Null,249791135,500047,4428
249791214,0.0,0.0,130000000,66000000,64000000,49,130000000,Null,Null,249791214,601737,2340
249794892,0.0,0.0,130000000,66000000,64000000,49,130000000,Null,Null,249794892,601737,2340
249802075,36.0,36.0,79000,79000,0,0,79000,Null,Null,249802075,111461,28452
249806896,0.0,0.0,47500000,39000000,8500000,18,47500000,Null,Null,249806896,601737,2340
249808020,5.0,5.0,250000,238000,12000,5,250000,Null,Null,249808020,4973949,28428
249808490,0.0,0.0,47500000,39000000,8500000,18,47500000,Null,Null,249808490,601737,2340
249813851,0.0,0.0,58600000,39000000,19600000,33,58600000,Null,Null,249813851,601737,2340
249817193,0.0,0.0,9900,9900,0,0,9900,Null,Null,249817193,111461,2
249817989,0.0,0.0,47500000,47500000,0,0,47500000,Null,Null,249817989,601737,2340
249845052,4.0,4.0,149000,149000,0,0,149000,Null,Null,249845052,195495,28738
249851724,0.0,0.0,719000,609000,110000,15,719000,Null,Null,249851724,112638,1796
249852027,0.0,0.0,3500000,3500000,0,0,3500000,Null,Null,249852027,111461,2
249855961,3.0,3.0,1350000,1350000,0,0,1350000,Null,Null,249855961,5660745,3422
249856246,0.0,0.0,7150000,4982000,2168000,30,7150000,Null,Null,249856246,416127,8227
249859785,3.0,3.0,93000,92070,930,1,93000,Null,Null,249859785,8173805,1836
249866232,7.0,7.0,250000,250000,0,0,250000,Null,Null,249866232,111461,8400
249867731,0.0,0.0,1500,1500,0,0,1500,Null,Null,249867731,111461,2
249869296,1.0,1.0,360000,360000,0,0,360000,Null,Null,249869296,111461,15318
249875336,4.0,4.0,120000,93000,27000,23,120000,Null,Null,249875336,463577,6742
249884104,0.0,0.0,1000,1000,0,0,1000,Null,Null,249884104,111461,23010
249890023,0.0,0.0,9000000,9000000,0,0,9000000,Null,Null,249890023,25422,1795
249890677,51.0,51.0,4990000,3979000,1011000,20,4990000,Null,Null,249890677,25422,1795
249892288,0.0,0.0,84900,80655,4245,5,84900,Null,Null,249892288,111461,28482
249893390,0.0,0.0,5270000,5111900,158100,3,5270000,Null,Null,249893390,875757,2
249893399,0.0,0.0,4300000,4171000,129000,3,4300000,Null,Null,249893399,875757,2
249893406,0.0,0.0,4100000,3977000,123000,3,4100000,Null,Null,249893406,875757,2
249897988,0.0,0.0,9000,9000,0,0,9000,Null,Null,249897988,111461,20258
249910178,0.0,0.0,4000,4000,0,0,4000,Null,Null,249910178,111461,20254
249915452,0.0,0.0,2200,2200,0,0,2200,Null,Null,249915452,111461,2
249918368,0.0,0.0,19600000,19600000,0,0,19600000,Null,Null,249918368,601737,2340
249919886,0.0,0.0,155000000,99000000,56000000,36,155000000,Null,Null,249919886,601737,2340
249920276,0.0,0.0,130000000,130000000,0,0,130000000,Null,Null,249920276,601737,2340
249921524,0.0,0.0,3780000,3780000,0,0,3780000,Null,Null,249921524,111461,1634
249924819,5.0,5.0,149000,149000,0,0,149000,Null,Null,249924819,4973949,1815
249937401,0.0,0.0,1900,1900,0,0,1900,Null,Null,249937401,111461,23024
249939944,0.0,0.0,1170,1000,170,15,1170,Null,Null,249939944,111461,2363
249942438,5.0,5.0,1100000,1100000,0,0,1100000,Null,Null,249942438,4228599,53350
249946452,0.0,0.0,1950,1500,450,23,1950,Null,Null,249946452,111461,23042
249955152,1.0,1.0,9000000,9000000,0,0,9000000,Null,Null,249955152,25422,1795
249956458,1.0,1.0,4990000,4079000,911000,18,4990000,Null,Null,249956458,25422,1795
249965452,91.0,91.0,40000,29000,11000,28,40000,Null,Null,249965452,111461,2
249981327,0.0,0.0,38400000,38400000,0,0,38400000,Null,Null,249981327,111461,23446
249982116,0.0,0.0,96000000,96000000,0,0,96000000,Null,Null,249982116,111461,6653
249999040,0.0,0.0,58000000,58000000,0,0,58000000,Null,Null,249999040,111461,11518
250001253,0.0,0.0,6728,5175,1553,23,6728,Null,Null,250001253,111461,1634
250001496,0.0,0.0,35755000,26816250,8938750,25,35755000,Null,Null,250001496,26150,8513
250001498,0.0,0.0,44694000,33520500,11173500,25,44694000,Null,Null,250001498,26150,8513
250001500,0.0,0.0,13818000,10363500,3454500,25,13818000,Null,Null,250001500,26150,8513
250001502,0.0,0.0,29323000,21992250,7330750,25,29323000,Null,Null,250001502,26150,8513
250006744,11.0,11.0,1200000,890000,310000,26,1200000,Null,Null,250006744,213321,17170
250007737,0.0,0.0,9680000,9680000,0,0,9680000,Null,Null,250007737,111461,2340
250014724,0.0,0.0,8450,6500,1950,23,8450,Null,Null,250014724,111461,8205
250020365,400.0,400.0,400000,225000,175000,44,400000,Null,Null,250020365,4224691,1520
250056555,10.0,10.0,235000,180000,55000,23,235000,Null,Null,250056555,926913,13878
250058942,0.0,0.0,98500000,98500000,0,0,98500000,Null,Null,250058942,111461,6653
250059548,0.0,0.0,58000000,58000000,0,0,58000000,Null,Null,250059548,111461,11518
250061054,0.0,0.0,8000,8000,0,0,8000,Null,Null,250061054,111461,2
250061140,0.0,0.0,15000,15000,0,0,15000,Null,Null,250061140,111461,2
250061178,0.0,0.0,15000,15000,0,0,15000,Null,Null,250061178,111461,2
250061237,0.0,0.0,2500,2500,0,0,2500,Null,Null,250061237,111461,2
250061334,0.0,0.0,7000,7000,0,0,7000,Null,Null,250061334,111461,2
250061461,0.0,0.0,6000,6000,0,0,6000,Null,Null,250061461,111461,2
250061476,0.0,0.0,8000,8000,0,0,8000,Null,Null,250061476,111461,2
250061918,0.0,0.0,8000,8000,0,0,8000,Null,Null,250061918,111461,2
250062788,0.0,0.0,57000000,57000000,0,0,57000000,Null,Null,250062788,111461,11518
250064230,0.0,0.0,47500000,47500000,0,0,47500000,Null,Null,250064230,111461,11518
250067047,15.0,15.0,84000,84000,0,0,84000,Null,Null,250067047,8164465,2238
250067476,0.0,0.0,96000000,96000000,0,0,96000000,Null,Null,250067476,111461,6653
250068634,0.0,0.0,57000000,57000000,0,0,57000000,Null,Null,250068634,111461,11518
250069445,0.0,0.0,47500000,47500000,0,0,47500000,Null,Null,250069445,111461,11518
250083031,0.0,0.0,4700000,4700000,0,0,4700000,Null,Null,250083031,111461,1520
250086358,0.0,0.0,3850000,3850000,0,0,3850000,Null,Null,250086358,111461,1634
250087767,21.0,21.0,898000,449000,449000,50,898000,Null,Null,250087767,111461,1634
250087987,0.0,0.0,6100000,6100000,0,0,6100000,Null,Null,250087987,111461,1520
250088112,20.0,20.0,738000,369000,369000,50,738000,Null,Null,250088112,111461,11925
250093237,3.0,3.0,149000,107280,41720,28,149000,Null,Null,250093237,111461,11923
250093588,3.0,3.0,149000,126650,22350,15,149000,Null,Null,250093588,111461,11923
250093770,5.0,5.0,520000,520000,0,0,520000,Null,Null,250093770,4228599,53350
250094042,28.0,28.0,618000,289000,329000,53,618000,Null,Null,250094042,111461,5531
250094366,4.0,4.0,120300,102255,18045,15,120300,Null,Null,250094366,111461,11923
250094571,3.0,3.0,138000,117300,20700,15,138000,Null,Null,250094571,111461,11923
250094847,3.0,3.0,136000,115600,20400,15,136000,Null,Null,250094847,111461,11923
250096141,3.0,3.0,149000,134100,14900,10,149000,Null,Null,250096141,111461,11923
250096374,0.0,0.0,5800000,5800000,0,0,5800000,Null,Null,250096374,111461,1520
250096589,3.0,3.0,138000,117300,20700,15,138000,Null,Null,250096589,111461,11923
250096702,0.0,0.0,4700000,4700000,0,0,4700000,Null,Null,250096702,111461,1520
250099609,0.0,0.0,5900000,5900000,0,0,5900000,Null,Null,250099609,111461,1520
250099955,3.0,3.0,139000,118150,20850,15,139000,Null,Null,250099955,111461,11923
250101170,13.0,13.0,698000,329000,369000,53,698000,Null,Null,250101170,111461,2340
250102509,13.0,13.0,101000,101000,0,0,101000,Null,Null,250102509,111461,11923
250103393,0.0,0.0,20500000,20500000,0,0,20500000,Null,Null,250103393,315481,2340
250104365,0.0,0.0,38000000,38000000,0,0,38000000,Null,Null,250104365,111461,23050
250104645,0.0,0.0,18900000,18900000,0,0,18900000,Null,Null,250104645,315481,2340
250106342,0.0,0.0,25900000,25900000,0,0,25900000,Null,Null,250106342,315481,2340
250106355,0.0,0.0,44700000,44700000,0,0,44700000,Null,Null,250106355,111461,23050
250109584,66.0,66.0,4990000,3950000,1040000,21,4990000,Null,Null,250109584,25422,1795
250113073,9.0,9.0,9490000,8590000,900000,9,9490000,Null,Null,250113073,25422,1795
250147923,0.0,0.0,7500,7500,0,0,7500,Null,Null,250147923,111461,2
250163770,0.0,0.0,9500,9500,0,0,9500,Null,Null,250163770,111461,2
250165594,0.0,0.0,2190,2190,0,0,2190,Null,Null,250165594,111461,2
250174550,0.0,0.0,2000,2000,0,0,2000,Null,Null,250174550,111461,2
250175271,0.0,0.0,1890,1890,0,0,1890,Null,Null,250175271,111461,2
250339544,0.0,0.0,375000,375000,0,0,375000,Null,Null,250339544,111461,7081
250340654,18.0,18.0,179000,175000,4000,2,179000,Null,Null,250340654,111461,4593
250466863,16.0,16.0,49000,49000,0,0,49000,Null,Null,250466863,111461,28458
250510440,0.0,0.0,1500,1500,0,0,1500,Null,Null,250510440,111461,2
250510471,0.0,0.0,1900,1900,0,0,1900,Null,Null,250510471,111461,2
250511061,0.0,0.0,1000,1000,0,0,1000,Null,Null,250511061,111461,2
250511066,0.0,0.0,1900,1900,0,0,1900,Null,Null,250511066,111461,2
250512089,358.0,358.0,280000,280000,0,0,280000,Null,Null,250512089,111461,1883
250586585,5.0,5.0,155000,79000,76000,49,155000,Null,Null,250586585,7378235,11868
250603530,5.0,5.0,255000,129000,126000,49,255000,Null,Null,250603530,7378235,11868
250756681,0.0,0.0,13500000,13500000,0,0,13500000,Null,Null,250756681,144538,8064
250941126,0.0,0.0,3000,1500,1500,50,3000,Null,Null,250941126,111461,2514
251014024,0.0,0.0,9900,9900,0,0,9900,Null,Null,251014024,111461,2
251022952,0.0,0.0,9900,9900,0,0,9900,Null,Null,251022952,111461,2
251065210,14.0,14.0,59000,59000,0,0,59000,Null,Null,251065210,111461,28482
251069884,2.0,2.0,399000,399000,0,0,399000,Null,Null,251069884,306417,8512
251070124,0.0,0.0,4620000,4620000,0,0,4620000,Null,Null,251070124,111461,2340
251076471,3.0,3.0,329000,329000,0,0,329000,Null,Null,251076471,8175461,8512
251151482,0.0,0.0,113000,113000,0,0,113000,Null,Null,251151482,111461,28638
251151776,0.0,0.0,120000,120000,0,0,120000,Null,Null,251151776,111461,2324
251194130,3.0,3.0,139000,133000,6000,4,139000,Null,Null,251194130,149308,1815
251253415,22.0,22.0,49000,49000,0,0,49000,Null,Null,251253415,111461,23622
251253832,3.0,3.0,999000,999000,0,0,999000,Null,Null,251253832,306417,8512
251254382,7.0,7.0,399000,319000,80000,20,399000,Null,Null,251254382,111461,1796
251254421,0.0,0.0,12500000,11500000,1000000,8,12500000,Null,Null,251254421,111461,11516
251254440,0.0,0.0,13000000,12000000,1000000,8,13000000,Null,Null,251254440,111461,11516
251254600,2.0,2.0,399000,319000,80000,20,399000,Null,Null,251254600,111461,1796
251257821,0.0,0.0,35000000,35000000,0,0,35000000,Null,Null,251257821,601737,2340
251258145,4.0,4.0,900000,900000,0,0,900000,Null,Null,251258145,4228599,53350
251262561,0.0,0.0,120000000,62500000,57500000,48,120000000,Null,Null,251262561,601737,2340
251262654,0.0,0.0,4500,4500,0,0,4500,Null,Null,251262654,111461,1634
251263237,0.0,0.0,110000000,110000000,0,0,110000000,Null,Null,251263237,601737,2340
251264985,0.0,0.0,152000000,152000000,0,0,152000000,Null,Null,251264985,720689,23622
251265080,0.0,0.0,110000000,110000000,0,0,110000000,Null,Null,251265080,601737,2340
251267054,0.0,0.0,220000,220000,0,0,220000,Null,Null,251267054,111461,53186
251267508,0.0,0.0,4490000,3550000,940000,21,4490000,Null,Null,251267508,18802,1795
251267710,1.0,1.0,4490000,3550000,940000,21,4490000,Null,Null,251267710,18802,1795
251268328,0.0,0.0,3900,3900,0,0,3900,Null,Null,251268328,111461,1634
251268330,1.0,1.0,4490000,3550000,940000,21,4490000,Null,Null,251268330,18802,1795
251268981,0.0,0.0,39400000,39400000,0,0,39400000,Null,Null,251268981,111461,23544
251274349,0.0,0.0,110000000,110000000,0,0,110000000,Null,Null,251274349,601737,2340
251274433,0.0,0.0,37500000,37500000,0,0,37500000,Null,Null,251274433,111461,23544
251274467,13.0,13.0,450000,233000,217000,48,450000,Null,Null,251274467,48077,2225
251274575,2.0,2.0,30000,30000,0,0,30000,Null,Null,251274575,111461,2
251274655,0.0,0.0,110000000,110000000,0,0,110000000,Null,Null,251274655,601737,2340
251275156,0.0,0.0,3999000,3999000,0,0,3999000,Null,Null,251275156,111461,1601
251275686,0.0,0.0,4632000,4632000,0,0,4632000,Null,Null,251275686,25643,1795
251275874,2245.0,2245.0,50000,48000,2000,4,50000,Null,Null,251275874,166773,1520
251276296,10.0,10.0,990000,399000,591000,60,990000,Null,Null,251276296,19057,8400
251276360,0.0,0.0,5000,5000,0,0,5000,Null,Null,251276360,111461,8197
251276433,0.0,0.0,37800000,37800000,0,0,37800000,Null,Null,251276433,111461,23544
251279502,0.0,0.0,68000000,68000000,0,0,68000000,Null,Null,251279502,601737,2340
251282283,5.0,5.0,250000,220000,30000,12,250000,Null,Null,251282283,111461,1815
251321978,0.0,0.0,2100,2100,0,0,2100,Null,Null,251321978,111461,2
251335625,22.0,22.0,15000,8000,7000,47,15000,Null,Null,251335625,417447,1626
251365214,8.0,8.0,1390000,1390000,0,0,1390000,Null,Null,251365214,111461,23136
251378663,0.0,0.0,9500,9500,0,0,9500,Null,Null,251378663,111461,5566
251384452,0.0,0.0,5000,5000,0,0,5000,Null,Null,251384452,111461,8167
251391740,0.0,0.0,1800,1800,0,0,1800,Null,Null,251391740,111461,2337
251392855,0.0,0.0,3000,1950,1050,35,3000,Null,Null,251392855,111461,53074
251395002,2.0,2.0,29000,21000,8000,28,29000,Null,Null,251395002,111461,23282
251395775,0.0,0.0,7480000,7480000,0,0,7480000,Null,Null,251395775,48649,1634
251396173,11.0,11.0,99000,49000,50000,51,99000,Null,Null,251396173,314675,4428
251401759,13.0,13.0,700000,439000,261000,37,700000,Null,Null,251401759,4878167,2340
251401829,0.0,0.0,30000,17000,13000,43,30000,Null,Null,251401829,111461,1520
251401993,32.0,32.0,9000,9000,0,0,9000,Null,Null,251401993,111461,1520
251402404,0.0,0.0,9000,9000,0,0,9000,Null,Null,251402404,111461,1520
251402910,0.0,0.0,3490000,3490000,0,0,3490000,Null,Null,251402910,7400143,2
251403028,0.0,0.0,7700000,7700000,0,0,7700000,Null,Null,251403028,111461,1634
251403186,14.0,14.0,800000,572000,228000,29,800000,Null,Null,251403186,4878167,2340
251407092,0.0,0.0,7853000,7164000,689000,9,7853000,Null,Null,251407092,18802,1795
251419016,30.0,30.0,48000,48000,0,0,48000,Null,Null,251419016,111461,2
251443402,0.0,0.0,4500,4500,0,0,4500,Null,Null,251443402,192113,5267
251444971,9.0,9.0,8990000,4495000,4495000,50,8990000,Null,Null,251444971,111461,23346
251445762,9.0,9.0,8990000,4495000,4495000,50,8990000,Null,Null,251445762,111461,23346
251446790,9.0,9.0,8990000,4495000,4495000,50,8990000,Null,Null,251446790,111461,23346
251448051,0.0,0.0,5006000,5006000,0,0,5006000,Null,Null,251448051,199801,11873
251448280,0.0,0.0,7853000,7164000,689000,9,7853000,Null,Null,251448280,18802,1795
251448498,0.0,0.0,5490000,5490000,0,0,5490000,Null,Null,251448498,111461,1636
251448550,0.0,0.0,9375000,9375000,0,0,9375000,Null,Null,251448550,199801,11873
251449582,0.0,0.0,3515000,3515000,0,0,3515000,Null,Null,251449582,199801,11885
251454194,0.0,0.0,41000000,41000000,0,0,41000000,Null,Null,251454194,21673,28862
251456035,0.0,0.0,69000000,69000000,0,0,69000000,Null,Null,251456035,21673,28862
251457609,8.0,8.0,419000,319000,100000,24,419000,Null,Null,251457609,111461,1796
251513894,5.0,5.0,198000,140000,58000,29,198000,Null,Null,251513894,111461,2
251514670,4.0,4.0,4990000,3959000,1031000,21,4990000,Null,Null,251514670,25422,1795
251516081,0.0,0.0,9000,9000,0,0,9000,Null,Null,251516081,111461,2
251518027,0.0,0.0,54999,49999,5000,9,54999,Null,Null,251518027,111454,5006
251520744,0.0,0.0,10000,10000,0,0,10000,Null,Null,251520744,111461,2340
251520938,0.0,0.0,14400000,14400000,0,0,14400000,Null,Null,251520938,20215,28862
251532919,1.0,1.0,3389000,3389000,0,0,3389000,Null,Null,251532919,254939,8172
251533421,0.0,0.0,12480000,12480000,0,0,12480000,Null,Null,251533421,21673,28866
251533562,1.0,1.0,22000000,17380000,4620000,21,22000000,Null,Null,251533562,21673,11516
251533752,0.0,0.0,3889000,3889000,0,0,3889000,Null,Null,251533752,254939,8172
251536304,0.0,0.0,9820,9000,820,8,9820,Null,Null,251536304,271491,2342
251545849,5.0,5.0,169000,157000,12000,7,169000,Null,Null,251545849,111461,28644
251545952,3.0,3.0,2590000,2109000,481000,19,2590000,Null,Null,251545952,162007,1795
251548147,0.0,0.0,5584000,5584000,0,0,5584000,Null,Null,251548147,111461,2324
251550655,0.0,0.0,8372000,8372000,0,0,8372000,Null,Null,251550655,111461,2324
251552129,0.0,0.0,15000,15000,0,0,15000,Null,Null,251552129,111461,2
251566427,1.0,1.0,690000,627900,62100,9,690000,Null,Null,251566427,111461,2
251566788,1.0,1.0,275000,250250,24750,9,275000,Null,Null,251566788,111461,2
251585542,3.0,3.0,135000,121500,13500,10,135000,Null,Null,251585542,111461,15250
251586548,0.0,0.0,4600000,3400000,1200000,26,4600000,Null,Null,251586548,49253,1636
251590902,27.0,27.0,198000,64000,134000,68,198000,Null,Null,251590902,111461,5995
251591872,0.0,0.0,9000,9000,0,0,9000,Null,Null,251591872,111461,2
251591918,0.0,0.0,1200,1200,0,0,1200,Null,Null,251591918,111461,2
251625001,0.0,0.0,1700,1700,0,0,1700,Null,Null,251625001,111461,27180
251625045,0.0,0.0,2500,2500,0,0,2500,Null,Null,251625045,111461,27180
251625355,0.0,0.0,1000,1000,0,0,1000,Null,Null,251625355,111461,27180
251625358,0.0,0.0,2100,2100,0,0,2100,Null,Null,251625358,111461,27180
251625421,0.0,0.0,1400,1400,0,0,1400,Null,Null,251625421,111461,27180
251631631,0.0,0.0,1700,1700,0,0,1700,Null,Null,251631631,111461,27180
251656070,41.0,41.0,50000,50000,0,0,50000,Null,Null,251656070,111461,2
251738153,0.0,0.0,3700000,3589000,111000,3,3700000,Null,Null,251738153,875757,2
251750506,0.0,0.0,14000000,14000000,0,0,14000000,Null,Null,251750506,111461,1634
251750577,0.0,0.0,8372000,8372000,0,0,8372000,Null,Null,251750577,111461,2324
251762186,0.0,0.0,4819000,4819000,0,0,4819000,Null,Null,251762186,111461,5566
251769252,1.0,1.0,490000,399000,91000,19,490000,Null,Null,251769252,112638,1796
251769614,19.0,19.0,30000,30000,0,0,30000,Null,Null,251769614,111461,1815
251772653,1.0,1.0,699000,659000,40000,6,699000,Null,Null,251772653,112638,1796
251773631,12.0,12.0,199000,199000,0,0,199000,Null,Null,251773631,111461,27212
251846831,0.0,0.0,5584000,5584000,0,0,5584000,Null,Null,251846831,111461,2324
251930331,0.0,0.0,2389000,1890000,499000,21,2389000,Null,Null,251930331,25422,1795
251930381,0.0,0.0,2699000,2699000,0,0,2699000,Null,Null,251930381,52232,2
251930431,0.0,0.0,2499000,2290000,209000,8,2499000,Null,Null,251930431,18802,1795
251930450,0.0,0.0,2290000,1890000,400000,17,2290000,Null,Null,251930450,111684,2
251930461,0.0,0.0,4999000,4390000,609000,12,4999000,Null,Null,251930461,18802,1795
251931122,0.0,0.0,9911000,9911000,0,0,9911000,Null,Null,251931122,111461,2324
251944399,0.0,0.0,5103000,5103000,0,0,5103000,Null,Null,251944399,111461,8073
251947434,5.0,5.0,80000,80000,0,0,80000,Null,Null,251947434,220233,1820
251967270,0.0,0.0,8177000,8177000,0,0,8177000,Null,Null,251967270,111461,2324
251984391,13.0,13.0,60000,50000,10000,17,60000,Null,Null,251984391,111461,28574
251998542,0.0,0.0,1000,1000,0,0,1000,Null,Null,251998542,111461,2
252005760,0.0,0.0,3900000,3900000,0,0,3900000,Null,Null,252005760,111461,2
252012545,0.0,0.0,2375,2375,0,0,2375,Null,Null,252012545,111461,2
252012589,0.0,0.0,1378,1378,0,0,1378,Null,Null,252012589,111461,2
252012711,0.0,0.0,1710,1710,0,0,1710,Null,Null,252012711,111461,2
252012757,0.0,0.0,1800,1800,0,0,1800,Null,Null,252012757,111461,2
252012786,0.0,0.0,1100,1100,0,0,1100,Null,Null,252012786,111461,2
252012803,0.0,0.0,5000,5000,0,0,5000,Null,Null,252012803,111461,2
252024681,0.0,0.0,170000,168000,2000,1,170000,Null,Null,252024681,529455,2
252024693,0.0,0.0,22000,21000,1000,5,22000,Null,Null,252024693,163213,17174
252024706,0.0,0.0,17000,8500,8500,50,17000,Null,Null,252024706,111461,2
252024710,1.0,1.0,136000,136000,0,0,136000,Null,Null,252024710,163213,17186
252024712,0.0,0.0,117500,110000,7500,6,117500,Null,Null,252024712,163213,8309
252035646,545.0,545.0,115000,98000,17000,15,115000,Null,Null,252035646,185875,1613
252036926,0.0,0.0,1300,1300,0,0,1300,Null,Null,252036926,111461,2
252037391,0.0,0.0,1094,1094,0,0,1094,Null,Null,252037391,111461,2
252044682,0.0,0.0,152000000,152000000,0,0,152000000,Null,Null,252044682,720689,23660
252049700,0.0,0.0,3630000,3630000,0,0,3630000,Null,Null,252049700,4907967,2
252049755,0.0,0.0,3990000,3990000,0,0,3990000,Null,Null,252049755,4907967,2
252049757,0.0,0.0,12500000,12500000,0,0,12500000,Null,Null,252049757,4907967,2
252049781,0.0,0.0,3490000,3490000,0,0,3490000,Null,Null,252049781,4907967,2
252049790,0.0,0.0,4500000,4500000,0,0,4500000,Null,Null,252049790,4584257,53350
252049840,0.0,0.0,3590000,3590000,0,0,3590000,Null,Null,252049840,4584257,53350
252049854,0.0,0.0,3750000,3750000,0,0,3750000,Null,Null,252049854,4584257,53350
252049856,0.0,0.0,3580000,3580000,0,0,3580000,Null,Null,252049856,4584257,53350
252049857,0.0,0.0,4500000,4500000,0,0,4500000,Null,Null,252049857,4584257,53350
252049886,0.0,0.0,3960000,3960000,0,0,3960000,Null,Null,252049886,4584257,53350
252049894,0.0,0.0,3490000,3490000,0,0,3490000,Null,Null,252049894,4584257,53350
252049902,0.0,0.0,3600000,3600000,0,0,3600000,Null,Null,252049902,4584257,53350
252049903,0.0,0.0,3450000,3450000,0,0,3450000,Null,Null,252049903,4584257,53350
252049908,0.0,0.0,5200000,5200000,0,0,5200000,Null,Null,252049908,4584257,53350
252049912,0.0,0.0,3560000,3560000,0,0,3560000,Null,Null,252049912,4584257,53350
252049946,0.0,0.0,4500000,4500000,0,0,4500000,Null,Null,252049946,4907967,2
252049955,0.0,0.0,3990000,3990000,0,0,3990000,Null,Null,252049955,4584257,53350
252050030,0.0,0.0,5200000,5200000,0,0,5200000,Null,Null,252050030,4584257,53350
252050032,0.0,0.0,4890000,4890000,0,0,4890000,Null,Null,252050032,4584257,53350
252050042,0.0,0.0,4890000,4890000,0,0,4890000,Null,Null,252050042,4584257,53350
252050054,0.0,0.0,4760000,4760000,0,0,4760000,Null,Null,252050054,4584257,53350
252050064,0.0,0.0,3600000,3600000,0,0,3600000,Null,Null,252050064,4584257,53350
252050067,0.0,0.0,4000000,3800000,200000,5,4000000,Null,Null,252050067,218061,8165
252050102,0.0,0.0,3560000,3560000,0,0,3560000,Null,Null,252050102,4584257,53350
252050138,0.0,0.0,7200000,7200000,0,0,7200000,Null,Null,252050138,4584257,53350
252053150,52.0,52.0,325000,325000,0,0,325000,Null,Null,252053150,193677,1883
252053230,12.0,12.0,102000,83000,19000,19,102000,Null,Null,252053230,111461,28574
252053408,7.0,7.0,630000,314000,316000,50,630000,Null,Null,252053408,111461,2340
252054558,7.0,7.0,104000,84000,20000,19,104000,Null,Null,252054558,111461,28574
252061962,2.0,2.0,6900,4485,2415,35,6900,Null,Null,252061962,111461,8202
252063162,951.0,951.0,484000,484000,0,0,484000,Null,Null,252063162,449693,1520
252066214,0.0,0.0,1500,1500,0,0,1500,Null,Null,252066214,111461,27214
252070529,0.0,0.0,1850,1850,0,0,1850,Null,Null,252070529,111461,23246
252072952,0.0,0.0,1520100,1474497,45603,3,1520100,Null,Null,252072952,19673,1796
252072957,0.0,0.0,2330100,2169000,161100,7,2330100,Null,Null,252072957,52232,1795
252072962,0.0,0.0,675000,675000,0,0,675000,Null,Null,252072962,112638,2
252072963,0.0,0.0,2990000,2590000,400000,13,2990000,Null,Null,252072963,25422,1795
252072977,0.0,0.0,899000,793000,106000,12,899000,Null,Null,252072977,19673,1796
252073000,0.0,0.0,1890000,1634000,256000,14,1890000,Null,Null,252073000,19673,1796
252073013,1.0,1.0,699000,591000,108000,15,699000,Null,Null,252073013,112638,2
252073020,0.0,0.0,699000,605000,94000,13,699000,Null,Null,252073020,112638,2
252073027,0.0,0.0,1990000,1755000,235000,12,1990000,Null,Null,252073027,19673,1795
252073036,3.0,3.0,2290000,1759000,531000,23,2290000,Null,Null,252073036,25422,1795
252073070,1.0,1.0,3999000,3490000,509000,13,3999000,Null,Null,252073070,52232,1795
252073075,0.0,0.0,499000,440000,59000,12,499000,Null,Null,252073075,112638,1796
252073087,3.0,3.0,1490000,1129000,361000,24,1490000,Null,Null,252073087,111684,1795
252073104,0.0,0.0,2590000,2284000,306000,12,2590000,Null,Null,252073104,25422,1795
252073151,1.0,1.0,1415500,1248000,167500,12,1415500,Null,Null,252073151,19673,1796
252073161,9.0,9.0,2590000,2290000,300000,12,2590000,Null,Null,252073161,19673,1795
252073167,0.0,0.0,3590000,2890000,700000,19,3590000,Null,Null,252073167,25422,1795
252073205,0.0,0.0,4990000,3790000,1200000,24,4990000,Null,Null,252073205,18802,1795
252073241,0.0,0.0,3599000,2890000,709000,20,3599000,Null,Null,252073241,18802,1794
252073258,4.0,4.0,599000,509000,90000,15,599000,Null,Null,252073258,111684,1796
252075315,5.0,5.0,560000,560000,0,0,560000,Null,Null,252075315,4228599,53350
252082970,5.0,5.0,500000,500000,0,0,500000,Null,Null,252082970,111461,2
252090320,5.0,5.0,69000,65550,3450,5,69000,Null,Null,252090320,111461,7064
252090399,0.0,0.0,7180000,7180000,0,0,7180000,Null,Null,252090399,405211,8511
252090401,0.0,0.0,7180000,7180000,0,0,7180000,Null,Null,252090401,405211,8511
252096985,11.0,11.0,79000,79000,0,0,79000,Null,Null,252096985,111461,1883
252106629,7.0,7.0,120000,95000,25000,21,120000,Null,Null,252106629,111461,28574
252106739,10.0,10.0,145000,118000,27000,19,145000,Null,Null,252106739,156043,11857
252106773,10.0,10.0,195000,150000,45000,23,195000,Null,Null,252106773,156043,11865
252125572,0.0,0.0,1700000,1700000,0,0,1700000,Null,Null,252125572,287013,12876
252125869,0.0,0.0,5900000,5900000,0,0,5900000,Null,Null,252125869,111461,15318
252125882,0.0,0.0,7900000,7900000,0,0,7900000,Null,Null,252125882,111461,15318
252130944,6.0,6.0,59000,58000,1000,2,59000,Null,Null,252130944,419129,28576
252130985,1810.0,1810.0,170000,115000,55000,32,170000,Null,Null,252130985,238407,1520
252132890,5.0,5.0,430000,430000,0,0,430000,Null,Null,252132890,726687,2
252133980,0.0,0.0,3750000,3750000,0,0,3750000,Null,Null,252133980,276799,11873
252136223,14.0,14.0,940000,789000,151000,16,940000,Null,Null,252136223,33203,8168
252136311,17.0,17.0,980000,980000,0,0,980000,Null,Null,252136311,33203,8168
252137815,7.0,7.0,1200000,1200000,0,0,1200000,Null,Null,252137815,5660745,2
252137817,5.0,5.0,1050000,1050000,0,0,1050000,Null,Null,252137817,4228599,2
252138482,0.0,0.0,9600000,9600000,0,0,9600000,Null,Null,252138482,48649,8165
252161619,0.0,0.0,9780000,9780000,0,0,9780000,Null,Null,252161619,111461,15318
252166409,4.0,4.0,123000,100000,23000,19,123000,Null,Null,252166409,185075,1583
252174695,0.0,0.0,5000,5000,0,0,5000,Null,Null,252174695,111461,11516
252226222,3.0,3.0,445000,445000,0,0,445000,Null,Null,252226222,22017,1795
252229816,0.0,0.0,1990000,1990000,0,0,1990000,Null,Null,252229816,22017,1794
252269040,8.0,8.0,79000,75000,4000,5,79000,Null,Null,252269040,111461,5531
252274187,0.0,0.0,2000,2000,0,0,2000,Null,Null,252274187,111461,2784
252290229,14.0,14.0,220000,145000,75000,34,220000,Null,Null,252290229,856589,11911
252292881,0.0,0.0,1600,1600,0,0,1600,Null,Null,252292881,111461,2
252292890,0.0,0.0,1095,1095,0,0,1095,Null,Null,252292890,111461,2
252341175,0.0,0.0,2000,2000,0,0,2000,Null,Null,252341175,111461,2225
252357460,0.0,0.0,9850000,9850000,0,0,9850000,Null,Null,252357460,48649,1634
252383287,82.0,82.0,20000,14000,6000,30,20000,Null,Null,252383287,111461,1815
252383643,130.0,130.0,25000,14000,11000,44,25000,Null,Null,252383643,111461,1815
252383844,14.0,14.0,60000,60000,0,0,60000,Null,Null,252383844,4664555,23554
252386592,1.0,1.0,149000,149000,0,0,149000,Null,Null,252386592,111461,49722
252388012,195.0,195.0,1900000,1900000,0,0,1900000,Null,Null,252388012,111461,2340
252389126,7.0,7.0,156000,156000,0,0,156000,Null,Null,252389126,111461,1883
252389161,0.0,0.0,23990000,23990000,0,0,23990000,Null,Null,252389161,5217953,7079
252390010,0.0,0.0,146999,146999,0,0,146999,Null,Null,252390010,111461,2
252390050,813.0,813.0,39000,29000,10000,26,39000,Null,Null,252390050,111461,1883
252390163,8.0,8.0,600000,398000,202000,34,600000,Null,Null,252390163,8094975,2324
252392905,0.0,0.0,11490000,8990000,2500000,22,11490000,Null,Null,252392905,18802,1795
252393410,13.0,13.0,35000,35000,0,0,35000,Null,Null,252393410,21274,8217
252398436,5.0,5.0,1350000,1350000,0,0,1350000,Null,Null,252398436,7400143,2
252400713,5.0,5.0,800000,665000,135000,17,800000,Null,Null,252400713,8094975,2324
252403221,0.0,0.0,2000,2000,0,0,2000,Null,Null,252403221,111461,23112
252406357,21.0,21.0,120000,120000,0,0,120000,Null,Null,252406357,470301,8305
252423003,4.0,4.0,3190000,2890000,300000,9,3190000,Null,Null,252423003,162007,1795
252427658,31.0,31.0,3990000,3540000,450000,11,3990000,Null,Null,252427658,162007,1795
252428990,8.0,8.0,4490000,4009000,481000,11,4490000,Null,Null,252428990,162007,1795
252429748,5.0,5.0,50000,37000,13000,26,50000,Null,Null,252429748,367597,1978
252543590,21.0,21.0,140000,65000,75000,54,140000,Null,Null,252543590,845973,5006
252550231,23.0,23.0,140000,98000,42000,30,140000,Null,Null,252550231,845973,28458
252556307,0.0,0.0,4000000,4000000,0,0,4000000,Null,Null,252556307,218061,2
252559290,0.0,0.0,3400000,3400000,0,0,3400000,Null,Null,252559290,4283997,2
252559347,0.0,0.0,3800000,3800000,0,0,3800000,Null,Null,252559347,4283997,2
252559377,0.0,0.0,7800000,7800000,0,0,7800000,Null,Null,252559377,4283997,2
252559379,0.0,0.0,3900000,3900000,0,0,3900000,Null,Null,252559379,4283997,2
252559381,0.0,0.0,3400000,3400000,0,0,3400000,Null,Null,252559381,4283997,2
252560115,0.0,0.0,3000,2000,1000,33,3000,Null,Null,252560115,838811,2
252561139,47.0,47.0,150000,79000,71000,47,150000,Null,Null,252561139,5010125,2
252561178,43.0,43.0,180000,92000,88000,49,180000,Null,Null,252561178,5010125,17170
252565008,0.0,0.0,6500,6500,0,0,6500,Null,Null,252565008,111461,1622
252570915,0.0,0.0,1500,1500,0,0,1500,Null,Null,252570915,111461,2
252574436,7.0,7.0,309000,301000,8000,3,309000,Null,Null,252574436,4691869,4880
252574772,30.0,30.0,499000,289000,210000,42,499000,Null,Null,252574772,5055635,5531
252576761,0.0,0.0,2000,2000,0,0,2000,Null,Null,252576761,111461,2
252576931,0.0,0.0,2000,2000,0,0,2000,Null,Null,252576931,111461,2
252578205,0.0,0.0,5000,5000,0,0,5000,Null,Null,252578205,5126697,28426
252578754,0.0,0.0,1000,1000,0,0,1000,Null,Null,252578754,111461,2
252584425,0.0,0.0,1200,1200,0,0,1200,Null,Null,252584425,111461,53074
252585689,0.0,0.0,11000,9900,1100,10,11000,Null,Null,252585689,111461,1622
252585968,0.0,0.0,4550000,4413500,136500,3,4550000,Null,Null,252585968,199801,11885
252586291,369.0,369.0,3990000,3550000,440000,11,3990000,Null,Null,252586291,147856,1789
252592781,0.0,0.0,8990,8990,0,0,8990,Null,Null,252592781,111461,2
252592801,0.0,0.0,8990,8990,0,0,8990,Null,Null,252592801,111461,2
252600167,26.0,26.0,499000,289000,210000,42,499000,Null,Null,252600167,5055635,5531
252601043,36.0,36.0,10000,10000,0,0,10000,Null,Null,252601043,520061,2
252601248,1.0,1.0,2990000,2990000,0,0,2990000,Null,Null,252601248,111461,49724
252601816,0.0,0.0,7800,7800,0,0,7800,Null,Null,252601816,111461,5566
252604000,0.0,0.0,1000,1000,0,0,1000,Null,Null,252604000,111461,2
252605959,0.0,0.0,1000,1000,0,0,1000,Null,Null,252605959,111461,2
252606238,0.0,0.0,1000,1000,0,0,1000,Null,Null,252606238,111461,2
252606277,0.0,0.0,1000,1000,0,0,1000,Null,Null,252606277,111461,2
252608995,2.0,2.0,140000,140000,0,0,140000,Null,Null,252608995,111461,49722
252609407,0.0,0.0,6000,6000,0,0,6000,Null,Null,252609407,111461,2
252612861,0.0,0.0,9900,9900,0,0,9900,Null,Null,252612861,111461,2
252624470,0.0,0.0,9900,9900,0,0,9900,Null,Null,252624470,111461,2
252626690,0.0,0.0,9900,9900,0,0,9900,Null,Null,252626690,111461,2
252629348,0.0,0.0,9000,9000,0,0,9000,Null,Null,252629348,111461,2
252632740,4.0,4.0,99000,99000,0,0,99000,Null,Null,252632740,111461,49722
252636134,374.0,374.0,396000,310000,86000,22,396000,Null,Null,252636134,185075,1583
252637329,3.0,3.0,115000,115000,0,0,115000,Null,Null,252637329,111461,2
252637418,1.0,1.0,115000,115000,0,0,115000,Null,Null,252637418,111461,2
252637444,0.0,0.0,110000,110000,0,0,110000,Null,Null,252637444,111461,2
252637738,2.0,2.0,115000,115000,0,0,115000,Null,Null,252637738,111461,2
252641097,0.0,0.0,1249000,1220000,29000,2,1249000,Null,Null,252641097,252755,20244
252651023,0.0,0.0,4200000,4200000,0,0,4200000,Null,Null,252651023,111461,2
252661615,0.0,0.0,10117000,7587750,2529250,25,10117000,Null,Null,252661615,26150,8513
252661687,0.0,0.0,6046000,4534500,1511500,25,6046000,Null,Null,252661687,26150,8513
252664374,0.0,0.0,1098000,1098000,0,0,1098000,Null,Null,252664374,369895,8227
252664383,0.0,0.0,32200000,32200000,0,0,32200000,Null,Null,252664383,111461,20174
252664425,0.0,0.0,20000000,20000000,0,0,20000000,Null,Null,252664425,111461,28458
252665826,0.0,0.0,2750,2750,0,0,2750,Null,Null,252665826,111461,1819
252666269,0.0,0.0,5000,5000,0,0,5000,Null,Null,252666269,111461,2
252666332,0.0,0.0,5000,5000,0,0,5000,Null,Null,252666332,111461,2
252673352,0.0,0.0,198000000,198000000,0,0,198000000,Null,Null,252673352,111461,1883
252673482,0.0,0.0,199000000,199000000,0,0,199000000,Null,Null,252673482,111461,23544
252673606,0.0,0.0,199000000,199000000,0,0,199000000,Null,Null,252673606,111461,23544
252673757,0.0,0.0,196000000,196000000,0,0,196000000,Null,Null,252673757,111461,23544
252674994,0.0,0.0,8000,8000,0,0,8000,Null,Null,252674994,111461,5566
252675353,27.0,27.0,8000,8000,0,0,8000,Null,Null,252675353,4452467,8305
252675757,0.0,0.0,8400,8400,0,0,8400,Null,Null,252675757,111461,8073
252675923,0.0,0.0,9600,9600,0,0,9600,Null,Null,252675923,111461,5566
252676812,14.0,14.0,249000,249000,0,0,249000,Null,Null,252676812,5706641,5995
252676884,3.0,3.0,3490000,2680000,810000,23,3490000,Null,Null,252676884,25422,1795
252678509,12.0,12.0,55000,55000,0,0,55000,Null,Null,252678509,111461,17162
252680117,37.0,37.0,189000,182000,7000,4,189000,Null,Null,252680117,111461,1815
252681068,0.0,0.0,690000,499000,191000,28,690000,Null,Null,252681068,111461,12908
252684572,0.0,0.0,65000,65000,0,0,65000,Null,Null,252684572,111461,53074
252684574,0.0,0.0,65000,65000,0,0,65000,Null,Null,252684574,111461,53074
252711716,0.0,0.0,990000,940000,50000,5,990000,Null,Null,252711716,153088,28444
252714024,0.0,0.0,37900000,37900000,0,0,37900000,Null,Null,252714024,3795327,2849
252714124,0.0,0.0,43900000,43900000,0,0,43900000,Null,Null,252714124,3795327,2849
252714467,5.0,5.0,550000,550000,0,0,550000,Null,Null,252714467,189445,28576
252720292,3.0,3.0,2520000,2520000,0,0,2520000,Null,Null,252720292,5181283,28480
252721273,0.0,0.0,1000,1000,0,0,1000,Null,Null,252721273,111461,2
252726942,8.0,8.0,199000,149000,50000,25,199000,Null,Null,252726942,25422,2018
252756809,0.0,0.0,7888,7888,0,0,7888,Null,Null,252756809,111461,2
252756833,0.0,0.0,4000,4000,0,0,4000,Null,Null,252756833,111461,2
252758630,0.0,0.0,1726,1726,0,0,1726,Null,Null,252758630,111461,2
252767877,2.0,2.0,139000,133000,6000,4,139000,Null,Null,252767877,21274,8217
252773340,0.0,0.0,2000,2000,0,0,2000,Null,Null,252773340,111461,23800
252778127,0.0,0.0,2000,2000,0,0,2000,Null,Null,252778127,111461,23800
252790646,0.0,0.0,15000,15000,0,0,15000,Null,Null,252790646,111461,2
252803334,0.0,0.0,4000,4000,0,0,4000,Null,Null,252803334,111461,1622
252830113,11.0,11.0,362000,260000,102000,28,362000,Null,Null,252830113,47663,1613
252850098,5.0,5.0,190000,180000,10000,5,190000,Null,Null,252850098,4973949,20244
252853668,84.0,84.0,20000,14000,6000,30,20000,Null,Null,252853668,111461,28484
252854345,0.0,0.0,9900000,9900000,0,0,9900000,Null,Null,252854345,111461,15318
252855020,0.0,0.0,105273916,105273916,0,0,105273916,Null,Null,252855020,111461,23544
252855091,0.0,0.0,9900000,9900000,0,0,9900000,Null,Null,252855091,243915,12876
252856735,1.0,1.0,399000,299000,100000,25,399000,Null,Null,252856735,183257,15318
252857698,1.0,1.0,419000,349000,70000,17,419000,Null,Null,252857698,111461,1796
252858324,5.0,5.0,299000,239000,60000,20,299000,Null,Null,252858324,111461,1796
252862664,131.0,131.0,140000,89000,51000,36,140000,Null,Null,252862664,111461,3177
252865847,0.0,0.0,599000,517000,82000,14,599000,Null,Null,252865847,150568,1796
252867390,23.0,23.0,181000,130000,51000,28,181000,Null,Null,252867390,47663,1613
252867601,19.0,19.0,181000,130000,51000,28,181000,Null,Null,252867601,47663,1613
252868488,0.0,0.0,24900000,21699000,3201000,13,24900000,Null,Null,252868488,20215,8067
252868567,0.0,0.0,12990000,12990000,0,0,12990000,Null,Null,252868567,215519,8066
252871953,10.0,10.0,350000,350000,0,0,350000,Null,Null,252871953,50629,3805
252872018,6.0,6.0,500000,500000,0,0,500000,Null,Null,252872018,50629,12908
252872462,3.0,3.0,1400000,1400000,0,0,1400000,Null,Null,252872462,50629,12908
252872762,0.0,0.0,15900000,15900000,0,0,15900000,Null,Null,252872762,111461,15318
252874681,0.0,0.0,4147200,4147200,0,0,4147200,Null,Null,252874681,111461,2
252874961,0.0,0.0,9790000,9790000,0,0,9790000,Null,Null,252874961,111461,15318
252880040,3.0,3.0,399000,299000,100000,25,399000,Null,Null,252880040,111461,1796
252881776,0.0,0.0,439000,339000,100000,23,439000,Null,Null,252881776,111461,1796
252882419,2436.0,2436.0,315000,255000,60000,19,315000,Null,Null,252882419,183013,1520
252882569,2.0,2.0,469000,369000,100000,21,469000,Null,Null,252882569,111461,1796
252882714,0.0,0.0,7289000,7289000,0,0,7289000,Null,Null,252882714,111461,1634
252883198,8.0,8.0,439000,339000,100000,23,439000,Null,Null,252883198,111461,1796
252883230,5.0,5.0,500000,500000,0,0,500000,Null,Null,252883230,111454,4428
252887687,0.0,0.0,2500,2500,0,0,2500,Null,Null,252887687,111461,2
252888553,0.0,0.0,1000,1000,0,0,1000,Null,Null,252888553,111461,2
252888910,0.0,0.0,1000,1000,0,0,1000,Null,Null,252888910,111461,2
252890654,0.0,0.0,9900,9900,0,0,9900,Null,Null,252890654,111461,2
252891177,0.0,0.0,1500,1500,0,0,1500,Null,Null,252891177,111461,2
252891459,0.0,0.0,2000,2000,0,0,2000,Null,Null,252891459,111461,2
252906013,1.0,1.0,122000,109800,12200,10,122000,Null,Null,252906013,111461,15320
252906668,144.0,144.0,85000,85000,0,0,85000,Null,Null,252906668,111461,1815
252912189,17.0,17.0,99000,79000,20000,20,99000,Null,Null,252912189,4995383,23022
252920220,0.0,0.0,9900,9900,0,0,9900,Null,Null,252920220,111461,8202
252939311,3.0,3.0,990000,525000,465000,47,990000,Null,Null,252939311,18802,28454
252952374,79.0,79.0,1000000,970000,30000,3,1000000,Null,Null,252952374,111461,23346
252960969,78.0,78.0,1200000,1200000,0,0,1200000,Null,Null,252960969,111461,23346
252961618,8.0,8.0,788000,436000,352000,45,788000,Null,Null,252961618,4878167,2340
252967395,4.0,4.0,1490000,1250000,240000,16,1490000,Null,Null,252967395,7845813,2
252970254,78.0,78.0,1300000,1300000,0,0,1300000,Null,Null,252970254,111461,23346
252979633,0.0,0.0,350000,350000,0,0,350000,Null,Null,252979633,111461,15250
252991136,0.0,0.0,15000,15000,0,0,15000,Null,Null,252991136,111461,2
252994360,0.0,0.0,50000000,50000000,0,0,50000000,Null,Null,252994360,111461,23430
253001835,7.0,7.0,169000,119000,50000,30,169000,Null,Null,253001835,700877,23362
253007610,7.0,7.0,39000,39000,0,0,39000,Null,Null,253007610,111461,28586
253007699,0.0,0.0,212000,106000,106000,50,212000,Null,Null,253007699,111461,15318
253044537,5.0,5.0,500000,349000,151000,30,500000,Null,Null,253044537,4244853,4593
253044694,0.0,0.0,5999000,5999000,0,0,5999000,Null,Null,253044694,48649,1634
253044791,0.0,0.0,18500000,16410000,2090000,11,18500000,Null,Null,253044791,114527,2657
253044827,0.0,0.0,7999000,7999000,0,0,7999000,Null,Null,253044827,48649,1634
253044850,0.0,0.0,8999000,8999000,0,0,8999000,Null,Null,253044850,48649,1634
253044866,0.0,0.0,5799000,5799000,0,0,5799000,Null,Null,253044866,48649,1634
253046639,6.0,6.0,3600,2000,1600,44,3600,Null,Null,253046639,111461,2
253046696,0.0,0.0,9900000,9900000,0,0,9900000,Null,Null,253046696,48649,1634
253046719,0.0,0.0,3366000,3366000,0,0,3366000,Null,Null,253046719,19018,1634
253047000,0.0,0.0,7999000,7999000,0,0,7999000,Null,Null,253047000,48649,1634
253047662,24.0,24.0,1000,1000,0,0,1000,Null,Null,253047662,111461,5566
253048252,0.0,0.0,3366000,3366000,0,0,3366000,Null,Null,253048252,19018,1634
253050286,0.0,0.0,1500,1500,0,0,1500,Null,Null,253050286,111461,2
253050554,0.0,0.0,7000,7000,0,0,7000,Null,Null,253050554,111461,2
253051288,0.0,0.0,2000,2000,0,0,2000,Null,Null,253051288,111461,2
253056056,0.0,0.0,4980000,4980000,0,0,4980000,Null,Null,253056056,884783,11845
253056660,2.0,2.0,25000,25000,0,0,25000,Null,Null,253056660,111461,28576
253056715,0.0,0.0,7400000,7400000,0,0,7400000,Null,Null,253056715,111461,8167
253059012,0.0,0.0,7790000,7790000,0,0,7790000,Null,Null,253059012,48649,1634
253069205,0.0,0.0,130000,130000,0,0,130000,Null,Null,253069205,111461,49722
253070177,8.0,8.0,658000,309000,349000,53,658000,Null,Null,253070177,111461,28644
253070325,4.0,4.0,50000,39000,11000,22,50000,Null,Null,253070325,4244853,4593
253071800,0.0,0.0,9000,9000,0,0,9000,Null,Null,253071800,111461,2
253072572,0.0,0.0,11000,7500,3500,32,11000,Null,Null,253072572,111461,2
253072954,2.0,2.0,14000,14000,0,0,14000,Null,Null,253072954,111461,2
253073519,0.0,0.0,6000,6000,0,0,6000,Null,Null,253073519,111461,2
253073875,0.0,0.0,9000,9000,0,0,9000,Null,Null,253073875,111461,2
253074503,0.0,0.0,5000,5000,0,0,5000,Null,Null,253074503,111461,2
253074588,0.0,0.0,6000,6000,0,0,6000,Null,Null,253074588,111461,2
253074649,0.0,0.0,6000,6000,0,0,6000,Null,Null,253074649,111461,2
253074809,0.0,0.0,8000,8000,0,0,8000,Null,Null,253074809,111461,2
253074961,0.0,0.0,9000,9000,0,0,9000,Null,Null,253074961,111461,2
253075218,0.0,0.0,6000,6000,0,0,6000,Null,Null,253075218,111461,2
253075285,0.0,0.0,4000,4000,0,0,4000,Null,Null,253075285,111461,2
253075301,0.0,0.0,9000,9000,0,0,9000,Null,Null,253075301,111461,2
253075569,0.0,0.0,9000,9000,0,0,9000,Null,Null,253075569,111461,2
253075619,0.0,0.0,9000,9000,0,0,9000,Null,Null,253075619,111461,8068
253075711,0.0,0.0,6000,6000,0,0,6000,Null,Null,253075711,111461,2
253075940,0.0,0.0,9000,9000,0,0,9000,Null,Null,253075940,111461,2
253076262,0.0,0.0,8000,8000,0,0,8000,Null,Null,253076262,111461,2
253076420,0.0,0.0,2000,2000,0,0,2000,Null,Null,253076420,111461,2
253076546,0.0,0.0,8000,8000,0,0,8000,Null,Null,253076546,111461,2
253076675,0.0,0.0,2000,2000,0,0,2000,Null,Null,253076675,111461,2
253076693,0.0,0.0,9000,9000,0,0,9000,Null,Null,253076693,111461,2
253076863,0.0,0.0,7000,7000,0,0,7000,Null,Null,253076863,111461,2
253077111,10.0,10.0,7000,7000,0,0,7000,Null,Null,253077111,111461,2
253077214,0.0,0.0,7000,7000,0,0,7000,Null,Null,253077214,111461,2
253077342,0.0,0.0,2500,2500,0,0,2500,Null,Null,253077342,111461,2
253077466,0.0,0.0,9000,9000,0,0,9000,Null,Null,253077466,111461,2
253077665,4.0,4.0,9000,9000,0,0,9000,Null,Null,253077665,111461,2
253077760,0.0,0.0,8000,8000,0,0,8000,Null,Null,253077760,111461,2
253078660,0.0,0.0,6000,6000,0,0,6000,Null,Null,253078660,111461,2
253078694,0.0,0.0,5000,5000,0,0,5000,Null,Null,253078694,111461,2
253086115,0.0,0.0,7000,7000,0,0,7000,Null,Null,253086115,111461,2
253092149,0.0,0.0,8835000,6998000,1837000,21,8835000,Null,Null,253092149,5719107,2
253093067,0.0,0.0,8455000,6697000,1758000,21,8455000,Null,Null,253093067,5719107,2
253093097,0.0,0.0,7410000,5870000,1540000,21,7410000,Null,Null,253093097,5719107,2
253093690,0.0,0.0,5100000,3489000,1611000,32,5100000,Null,Null,253093690,416127,8227
253095100,0.0,0.0,6800000,6800000,0,0,6800000,Null,Null,253095100,111461,1634
253095311,0.0,0.0,1600,1600,0,0,1600,Null,Null,253095311,111461,2
253097509,1.0,1.0,140000,140000,0,0,140000,Null,Null,253097509,111461,49722
253098960,0.0,0.0,5790000,5790000,0,0,5790000,Null,Null,253098960,111461,15318
253099548,0.0,0.0,3500000,3500000,0,0,3500000,Null,Null,253099548,111461,1634
253100007,0.0,0.0,10000,10000,0,0,10000,Null,Null,253100007,111461,7064
253102876,0.0,0.0,8400000,8400000,0,0,8400000,Null,Null,253102876,7835599,11935
253103732,0.0,0.0,3366000,3366000,0,0,3366000,Null,Null,253103732,19018,1634
253104692,71.0,71.0,1300,1010,290,22,1300,Null,Null,253104692,7247657,23416
253104837,1.0,1.0,78000,31000,47000,60,78000,Null,Null,253104837,111461,15236
253109908,4.0,4.0,900000,459000,441000,49,900000,Null,Null,253109908,4647777,8371
253112432,0.0,0.0,2500,2500,0,0,2500,Null,Null,253112432,111461,2
253116036,0.0,0.0,11640,11640,0,0,11640,Null,Null,253116036,111461,2
253118374,7.0,7.0,899000,899000,0,0,899000,Null,Null,253118374,111461,28576
253119329,4.0,4.0,799000,799000,0,0,799000,Null,Null,253119329,111461,28576
253123102,0.0,0.0,9000,8730,270,3,9000,Null,Null,253123102,111461,2
253131374,0.0,0.0,2500,2500,0,0,2500,Null,Null,253131374,111461,2
253131475,9.0,9.0,90000,90000,0,0,90000,Null,Null,253131475,111461,2
253133125,3.0,3.0,379500,360525,18975,5,379500,Null,Null,253133125,7506817,23246
253133906,12.0,12.0,95000,69000,26000,27,95000,Null,Null,253133906,4820811,6948
253133930,0.0,0.0,2140,1498,642,30,2140,Null,Null,253133930,111461,18876
253133966,16.0,16.0,150000,79200,70800,47,150000,Null,Null,253133966,111461,27128
253134885,95.0,95.0,1204001,1204001,0,0,1204001,Null,Null,253134885,2630119,2657
253150756,2.0,2.0,160000,160000,0,0,160000,Null,Null,253150756,111461,2
253152191,4.0,4.0,96000,80000,16000,17,96000,Null,Null,253152191,111461,28574
253152835,0.0,0.0,18877000,14157750,4719250,25,18877000,Null,Null,253152835,26150,8513
253152894,1.0,1.0,15000,15000,0,0,15000,Null,Null,253152894,111461,2
253160800,91.0,91.0,100000,85000,15000,15,100000,Null,Null,253160800,53195,1883
253161385,18.0,18.0,108000,90000,18000,17,108000,Null,Null,253161385,111461,28574
253162600,0.0,0.0,1000,1000,0,0,1000,Null,Null,253162600,111461,2
253162720,0.0,0.0,3000,3000,0,0,3000,Null,Null,253162720,111461,2
253163380,0.0,0.0,8000,8000,0,0,8000,Null,Null,253163380,111461,2
253164832,0.0,0.0,18000,18000,0,0,18000,Null,Null,253164832,111461,2
253165072,3.0,3.0,48000,39000,9000,19,48000,Null,Null,253165072,111461,28574
253169120,2.0,2.0,250000,178000,72000,29,250000,Null,Null,253169120,312329,6742
253172498,0.0,0.0,40000000,40000000,0,0,40000000,Null,Null,253172498,111461,2
253172528,0.0,0.0,39200000,39200000,0,0,39200000,Null,Null,253172528,111461,2
253172551,0.0,0.0,36000000,36000000,0,0,36000000,Null,Null,253172551,111461,2
253172558,0.0,0.0,44400000,44400000,0,0,44400000,Null,Null,253172558,111461,2
253172586,0.0,0.0,36720000,36720000,0,0,36720000,Null,Null,253172586,111461,2
253172652,0.0,0.0,38880000,38880000,0,0,38880000,Null,Null,253172652,111461,2
253172713,0.0,0.0,41000000,41000000,0,0,41000000,Null,Null,253172713,111461,2
253172775,0.0,0.0,108000000,108000000,0,0,108000000,Null,Null,253172775,111461,2
253172805,0.0,0.0,50000000,50000000,0,0,50000000,Null,Null,253172805,111461,2
253172821,0.0,0.0,52000000,52000000,0,0,52000000,Null,Null,253172821,111461,2
253173546,0.0,0.0,11152000,11152000,0,0,11152000,Null,Null,253173546,111461,2
253173645,0.0,0.0,63496000,63496000,0,0,63496000,Null,Null,253173645,111461,2
253173710,0.0,0.0,50600000,50600000,0,0,50600000,Null,Null,253173710,111461,2
253173900,0.0,0.0,40480000,40480000,0,0,40480000,Null,Null,253173900,111461,2
253173943,0.0,0.0,43336000,43336000,0,0,43336000,Null,Null,253173943,111461,2
253173962,0.0,0.0,60136000,60136000,0,0,60136000,Null,Null,253173962,111461,2
253174033,0.0,0.0,41320000,41320000,0,0,41320000,Null,Null,253174033,111461,2
253174160,0.0,0.0,36000000,36000000,0,0,36000000,Null,Null,253174160,111461,2
253174247,0.0,0.0,37960000,37960000,0,0,37960000,Null,Null,253174247,111461,2
253174290,0.0,0.0,51400000,51400000,0,0,51400000,Null,Null,253174290,111461,2
253174312,0.0,0.0,40200000,40200000,0,0,40200000,Null,Null,253174312,111461,2
253174590,0.0,0.0,41400000,41400000,0,0,41400000,Null,Null,253174590,111461,2
253174665,0.0,0.0,44136000,44136000,0,0,44136000,Null,Null,253174665,111461,2
253174692,0.0,0.0,49720000,49720000,0,0,49720000,Null,Null,253174692,111461,2
253174852,0.0,0.0,40320000,40320000,0,0,40320000,Null,Null,253174852,111461,2
253174887,0.0,0.0,6250240,6250240,0,0,6250240,Null,Null,253174887,111461,2
253174888,0.0,0.0,37800000,37800000,0,0,37800000,Null,Null,253174888,111461,2
253174922,0.0,0.0,98920000,98920000,0,0,98920000,Null,Null,253174922,111461,2
253174954,0.0,0.0,5568000,5568000,0,0,5568000,Null,Null,253174954,111461,2
253175007,0.0,0.0,41320000,41320000,0,0,41320000,Null,Null,253175007,111461,2
253175067,0.0,0.0,90000000,90000000,0,0,90000000,Null,Null,253175067,111461,2
253175117,0.0,0.0,36840000,36840000,0,0,36840000,Null,Null,253175117,111461,2
253175130,0.0,0.0,41051200,41051200,0,0,41051200,Null,Null,253175130,111461,2
253175221,0.0,0.0,53200000,53200000,0,0,53200000,Null,Null,253175221,111461,2
253175276,0.0,0.0,38800000,38800000,0,0,38800000,Null,Null,253175276,111461,2
253175426,0.0,0.0,40600000,40600000,0,0,40600000,Null,Null,253175426,111461,2
253175449,0.0,0.0,54536000,54536000,0,0,54536000,Null,Null,253175449,111461,2
253175460,0.0,0.0,37800000,37800000,0,0,37800000,Null,Null,253175460,111461,2
253175554,0.0,0.0,36712000,36712000,0,0,36712000,Null,Null,253175554,111461,2
253175576,0.0,0.0,36840000,36840000,0,0,36840000,Null,Null,253175576,111461,2
253175622,0.0,0.0,50600000,50600000,0,0,50600000,Null,Null,253175622,111461,2
253175826,0.0,0.0,399000,399000,0,0,399000,Null,Null,253175826,606305,8172
253175843,0.0,0.0,399000,399000,0,0,399000,Null,Null,253175843,606305,8172
253176290,117.0,117.0,750000,699000,51000,7,750000,Null,Null,253176290,167099,1883
253176818,0.0,0.0,3909000,3909000,0,0,3909000,Null,Null,253176818,256727,15318
253177079,0.0,0.0,11640,11640,0,0,11640,Null,Null,253177079,111461,2
253177086,0.0,0.0,13580,13580,0,0,13580,Null,Null,253177086,111461,2
253177093,0.0,0.0,11640,11640,0,0,11640,Null,Null,253177093,111461,2
253177098,0.0,0.0,11640,11640,0,0,11640,Null,Null,253177098,111461,2
253178501,1801.0,1801.0,300000,195000,105000,35,300000,Null,Null,253178501,205035,1520
253181634,3.0,3.0,60000,49000,11000,18,60000,Null,Null,253181634,111461,28574
253182057,0.0,0.0,9000,9000,0,0,9000,Null,Null,253182057,111461,7064
253183745,0.0,0.0,13600000,6800000,6800000,50,13600000,Null,Null,253183745,111461,15318
253184050,0.0,0.0,13600000,6800000,6800000,50,13600000,Null,Null,253184050,111461,15318
253185143,0.0,0.0,3500000,3500000,0,0,3500000,Null,Null,253185143,111461,8167
253188405,0.0,0.0,11690000,11339000,351000,3,11690000,Null,Null,253188405,114527,2657
253188425,88.0,88.0,1140001,1140001,0,0,1140001,Null,Null,253188425,2630119,2657
253188446,1.0,1.0,690000,390000,300000,43,690000,Null,Null,253188446,281769,49722
253190475,0.0,0.0,7400000,7400000,0,0,7400000,Null,Null,253190475,8178761,8165
253193731,1.0,1.0,690000,390000,300000,43,690000,Null,Null,253193731,281769,49722
253193806,0.0,0.0,13600000,6800000,6800000,50,13600000,Null,Null,253193806,111461,15318
253202841,0.0,0.0,2500,2500,0,0,2500,Null,Null,253202841,111461,2
253203316,0.0,0.0,1500,1500,0,0,1500,Null,Null,253203316,111461,2
253204266,0.0,0.0,7000,7000,0,0,7000,Null,Null,253204266,111461,2
253204781,0.0,0.0,2000,2000,0,0,2000,Null,Null,253204781,111461,2
253211376,61.0,61.0,1277001,1277001,0,0,1277001,Null,Null,253211376,2630119,2657
253211576,14.0,14.0,158144,158144,0,0,158144,Null,Null,253211576,111461,3428
253213549,2.0,2.0,300000,249000,51000,17,300000,Null,Null,253213549,4244853,3804
253227146,0.0,0.0,36000000,36000000,0,0,36000000,Null,Null,253227146,111461,2
253230274,0.0,0.0,8000,8000,0,0,8000,Null,Null,253230274,111461,1813
253235176,3.0,3.0,180000,99000,81000,45,180000,Null,Null,253235176,4244853,28722
253236631,341.0,341.0,34000,33000,1000,3,34000,Null,Null,253236631,111461,1883
253236921,0.0,0.0,43900000,43900000,0,0,43900000,Null,Null,253236921,7426417,2
253236976,0.0,0.0,43700000,43700000,0,0,43700000,Null,Null,253236976,7426417,2
253236980,0.0,0.0,44700000,44700000,0,0,44700000,Null,Null,253236980,7426417,2
253237034,0.0,0.0,49990000,49990000,0,0,49990000,Null,Null,253237034,7426417,2
253237083,0.0,0.0,37900000,37900000,0,0,37900000,Null,Null,253237083,7426417,2
253237096,0.0,0.0,43900000,43900000,0,0,43900000,Null,Null,253237096,7426417,2
253237180,0.0,0.0,42120000,42120000,0,0,42120000,Null,Null,253237180,7426417,2
253238302,0.0,0.0,58392000,58392000,0,0,58392000,Null,Null,253238302,111461,7079
253239713,0.0,0.0,40392000,40392000,0,0,40392000,Null,Null,253239713,111461,7079
253241715,2.0,2.0,145000,145000,0,0,145000,Null,Null,253241715,111461,2
253244720,0.0,0.0,9900,9900,0,0,9900,Null,Null,253244720,111461,2
253245640,0.0,0.0,7000,7000,0,0,7000,Null,Null,253245640,111461,2
253245812,0.0,0.0,2000,2000,0,0,2000,Null,Null,253245812,111461,2
253246120,0.0,0.0,1500,1500,0,0,1500,Null,Null,253246120,111461,2
253247714,0.0,0.0,6218000,3730000,2488000,40,6218000,Null,Null,253247714,366783,2
253262179,0.0,0.0,48000000,24480000,23520000,49,48000000,Null,Null,253262179,111461,2340
253262371,0.0,0.0,76000000,56240000,19760000,26,76000000,Null,Null,253262371,111461,2340
253264559,48.0,48.0,8990000,8990000,0,0,8990000,Null,Null,253264559,5222401,2
253265226,0.0,0.0,35500000,35500000,0,0,35500000,Null,Null,253265226,111461,11518
253265765,0.0,0.0,7600,7600,0,0,7600,Null,Null,253265765,111461,8167
253265921,0.0,0.0,1100,1100,0,0,1100,Null,Null,253265921,111461,8167
253265932,0.0,0.0,16490000,15690000,800000,5,16490000,Null,Null,253265932,114527,8043
253268938,0.0,0.0,2500,2500,0,0,2500,Null,Null,253268938,111461,8167
253269077,24.0,24.0,4490000,3290000,1200000,27,4490000,Null,Null,253269077,18802,1795
253271591,0.0,0.0,7750000,6587500,1162500,15,7750000,Null,Null,253271591,691055,8512
253274560,0.0,0.0,3800000,3800000,0,0,3800000,Null,Null,253274560,702699,3426
253276453,8.0,8.0,200000,119000,81000,41,200000,Null,Null,253276453,4244853,28458
253282135,0.0,0.0,76000000,76000000,0,0,76000000,Null,Null,253282135,111461,6653
253285023,0.0,0.0,36500000,36500000,0,0,36500000,Null,Null,253285023,111461,11518
253286289,0.0,0.0,26990000,24919000,2071000,8,26990000,Null,Null,253286289,20215,2324
253290699,0.0,0.0,82500000,78375000,4125000,5,82500000,Null,Null,253290699,111461,6653
253292379,0.0,0.0,8455,8455,0,0,8455,Null,Null,253292379,111461,2
253292542,0.0,0.0,5700,5700,0,0,5700,Null,Null,253292542,111461,2
253292684,0.0,0.0,2500,2500,0,0,2500,Null,Null,253292684,111461,2
253296905,0.0,0.0,9500,9500,0,0,9500,Null,Null,253296905,111461,2
253297857,0.0,0.0,98000,88200,9800,10,98000,Null,Null,253297857,111461,15320
253300044,0.0,0.0,3685000,3685000,0,0,3685000,Null,Null,253300044,702699,53350
253304710,0.0,0.0,3395000,3395000,0,0,3395000,Null,Null,253304710,702699,17170
253304941,0.0,0.0,3496000,3496000,0,0,3496000,Null,Null,253304941,702699,53350
253311179,0.0,0.0,3890000,3890000,0,0,3890000,Null,Null,253311179,722647,2
253311293,0.0,0.0,5818000,3490000,2328000,40,5818000,Null,Null,253311293,722647,2
253311742,0.0,0.0,65000,65000,0,0,65000,Null,Null,253311742,111461,53074
253311797,0.0,0.0,342000,342000,0,0,342000,Null,Null,253311797,111461,53074
253311798,0.0,0.0,377000,377000,0,0,377000,Null,Null,253311798,111461,11858
253311892,0.0,0.0,65000,65000,0,0,65000,Null,Null,253311892,111461,23052
253313407,0.0,0.0,13600000,6800000,6800000,50,13600000,Null,Null,253313407,111461,15318
253317075,0.0,0.0,4700000,4700000,0,0,4700000,Null,Null,253317075,111461,11933
253317174,0.0,0.0,4350000,4350000,0,0,4350000,Null,Null,253317174,111461,11933
253317270,0.0,0.0,4750000,4750000,0,0,4750000,Null,Null,253317270,111461,11933
253317469,0.0,0.0,6750000,6750000,0,0,6750000,Null,Null,253317469,111461,11933
253318522,0.0,0.0,10636000,6381000,4255000,40,10636000,Null,Null,253318522,366783,2
253319089,0.0,0.0,14800000,14800000,0,0,14800000,Null,Null,253319089,111461,8511
253319709,0.0,0.0,4800,4800,0,0,4800,Null,Null,253319709,111461,2
253320089,8.0,8.0,250000,250000,0,0,250000,Null,Null,253320089,111461,2
253320727,0.0,0.0,10000,10000,0,0,10000,Null,Null,253320727,111461,2
253322397,0.0,0.0,5000,5000,0,0,5000,Null,Null,253322397,111461,2
253322403,0.0,0.0,5000,5000,0,0,5000,Null,Null,253322403,111461,2
253326455,0.0,0.0,10400000,10400000,0,0,10400000,Null,Null,253326455,7400131,15318
253326814,0.0,0.0,20000000,20000000,0,0,20000000,Null,Null,253326814,7400131,15318
253327031,0.0,0.0,20000000,20000000,0,0,20000000,Null,Null,253327031,7400131,15318
253328784,24.0,24.0,174000,174000,0,0,174000,Null,Null,253328784,111461,2
253329804,0.0,0.0,2000,2000,0,0,2000,Null,Null,253329804,111461,2
253330610,0.0,0.0,2600000,2600000,0,0,2600000,Null,Null,253330610,111461,7081
253335910,10.0,10.0,5000,5000,0,0,5000,Null,Null,253335910,111461,2
253344104,0.0,0.0,2000,1000,1000,50,2000,Null,Null,253344104,111461,2363
253344494,69.0,69.0,850000,850000,0,0,850000,Null,Null,253344494,2630119,2657
253348585,0.0,0.0,9500,9500,0,0,9500,Null,Null,253348585,111461,2
253352709,0.0,0.0,7999000,6299000,1700000,21,7999000,Null,Null,253352709,8182681,1637
253356757,0.0,0.0,3366000,3366000,0,0,3366000,Null,Null,253356757,19018,1520
253358384,9.0,9.0,265000,225000,40000,15,265000,Null,Null,253358384,18845,1820
253358448,13.0,13.0,445000,445000,0,0,445000,Null,Null,253358448,18845,1820
253358703,7.0,7.0,845000,845000,0,0,845000,Null,Null,253358703,18845,1820
253358730,0.0,0.0,11650000,11650000,0,0,11650000,Null,Null,253358730,111461,11516
253358806,0.0,0.0,62800000,62800000,0,0,62800000,Null,Null,253358806,511769,23634
253358817,0.0,0.0,35000000,33250000,1750000,5,35000000,Null,Null,253358817,111461,28868
253363322,31.0,31.0,750000,750000,0,0,750000,Null,Null,253363322,143017,1520
253364070,0.0,0.0,11950000,11950000,0,0,11950000,Null,Null,253364070,111461,8064
253364192,0.0,0.0,30000000,28500000,1500000,5,30000000,Null,Null,253364192,111461,28868
253364256,13.0,13.0,13200,13200,0,0,13200,Null,Null,253364256,732689,3178
253364309,0.0,0.0,13250000,13250000,0,0,13250000,Null,Null,253364309,111461,8064
253364885,0.0,0.0,13550000,13550000,0,0,13550000,Null,Null,253364885,111461,8064
253364931,0.0,0.0,6810000,6810000,0,0,6810000,Null,Null,253364931,111643,8511
253364939,0.0,0.0,7270000,7270000,0,0,7270000,Null,Null,253364939,111643,8511
253364953,0.0,0.0,7270000,7270000,0,0,7270000,Null,Null,253364953,111643,8511
253364957,0.0,0.0,7270000,7270000,0,0,7270000,Null,Null,253364957,111643,8511
253364959,0.0,0.0,6810000,6810000,0,0,6810000,Null,Null,253364959,111643,8511
253364969,0.0,0.0,6810000,6810000,0,0,6810000,Null,Null,253364969,111643,8511
253364973,0.0,0.0,7270000,7270000,0,0,7270000,Null,Null,253364973,111643,8511
253364975,0.0,0.0,7270000,7270000,0,0,7270000,Null,Null,253364975,111643,8511
253365566,0.0,0.0,18500000,17575000,925000,5,18500000,Null,Null,253365566,111461,8064
253369258,0.0,0.0,6000,6000,0,0,6000,Null,Null,253369258,111461,8202
253376255,3.0,3.0,539000,539000,0,0,539000,Null,Null,253376255,21651,28616
253376519,0.0,0.0,790000,683000,107000,14,790000,Null,Null,253376519,19673,1796
253378315,0.0,0.0,18000,18000,0,0,18000,Null,Null,253378315,111461,15320
253379672,0.0,0.0,6250000,6250000,0,0,6250000,Null,Null,253379672,885749,5385
253379674,0.0,0.0,6250000,6250000,0,0,6250000,Null,Null,253379674,885749,5385
253380028,0.0,0.0,6000,6000,0,0,6000,Null,Null,253380028,111461,8167
253380146,0.0,0.0,590000,463000,127000,22,590000,Null,Null,253380146,150568,1796
253383032,0.0,0.0,15800000,15010000,790000,5,15800000,Null,Null,253383032,111461,8064
253385509,0.0,0.0,13190000,13190000,0,0,13190000,Null,Null,253385509,18776,7273
253387926,0.0,0.0,5800000,3480000,2320000,40,5800000,Null,Null,253387926,722647,2
253388543,0.0,0.0,5890000,3534000,2356000,40,5890000,Null,Null,253388543,366783,2
253389981,13.0,13.0,110000,55000,55000,50,110000,Null,Null,253389981,48077,2
253390017,8.0,8.0,59000,35000,24000,41,59000,Null,Null,253390017,48077,2
253390034,51.0,51.0,4000,2000,2000,50,4000,Null,Null,253390034,111461,2
253390283,0.0,0.0,7236000,4341000,2895000,40,7236000,Null,Null,253390283,204875,2
253390289,4.0,4.0,506000,269000,237000,47,506000,Null,Null,253390289,48077,2
253393681,0.0,0.0,98000,98000,0,0,98000,Null,Null,253393681,7516279,8602
253393951,0.0,0.0,35000000,33250000,1750000,5,35000000,Null,Null,253393951,111461,28868
253394365,380.0,380.0,569000,399000,170000,30,569000,Null,Null,253394365,886169,1520
253394406,0.0,0.0,30000000,28500000,1500000,5,30000000,Null,Null,253394406,111461,28868
253395356,0.0,0.0,6000000,5267000,733000,12,6000000,Null,Null,253395356,18802,1795
253395451,0.0,0.0,14800000,14800000,0,0,14800000,Null,Null,253395451,111461,8064
253395491,0.0,0.0,18500000,17575000,925000,5,18500000,Null,Null,253395491,111461,8064
253395684,0.0,0.0,14350000,14350000,0,0,14350000,Null,Null,253395684,111461,8064
253395908,5.0,5.0,2100000,1790000,310000,15,2100000,Null,Null,253395908,19246,9013
253395951,0.0,0.0,15200000,15200000,0,0,15200000,Null,Null,253395951,111461,8064
253396314,0.0,0.0,15800000,15010000,790000,5,15800000,Null,Null,253396314,111461,8064
253396330,0.0,0.0,14750000,14750000,0,0,14750000,Null,Null,253396330,111461,8064
253396518,0.0,0.0,15700000,15700000,0,0,15700000,Null,Null,253396518,111461,8064
253396667,0.0,0.0,15300000,15300000,0,0,15300000,Null,Null,253396667,111461,8064
253396689,4.0,4.0,390000,290000,100000,26,390000,Null,Null,253396689,8051609,53348
253396800,7010.0,7010.0,225000,195000,30000,13,225000,Null,Null,253396800,4293715,1520
253396983,0.0,0.0,18100000,18100000,0,0,18100000,Null,Null,253396983,111461,8064
253397129,0.0,0.0,17700000,17700000,0,0,17700000,Null,Null,253397129,111461,8064
253402581,1.0,1.0,590000,590000,0,0,590000,Null,Null,253402581,111461,2
253402583,0.0,0.0,7590000,7590000,0,0,7590000,Null,Null,253402583,111461,49724
253402585,0.0,0.0,9100000,9100000,0,0,9100000,Null,Null,253402585,111461,49724
253402587,0.0,0.0,6650000,6650000,0,0,6650000,Null,Null,253402587,111461,49724
253405741,16.0,16.0,650000,617500,32500,5,650000,Null,Null,253405741,423495,3177
253407100,1.0,1.0,4990000,4139000,851000,17,4990000,Null,Null,253407100,247549,1795
253409817,0.0,0.0,38000000,19900000,18100000,48,38000000,Null,Null,253409817,184543,2340
253409878,33.0,33.0,120000,60000,60000,50,120000,Null,Null,253409878,4524605,10228
253412333,0.0,0.0,88660000,88660000,0,0,88660000,Null,Null,253412333,718215,23446
253414698,0.0,0.0,6440000,5799000,641000,10,6440000,Null,Null,253414698,4647777,15318
253419723,40.0,40.0,560000,560000,0,0,560000,Null,Null,253419723,114328,2
253422819,0.0,0.0,2000,2000,0,0,2000,Null,Null,253422819,111461,2
253423822,0.0,0.0,2000,2000,0,0,2000,Null,Null,253423822,111461,2
253424680,0.0,0.0,1000,1000,0,0,1000,Null,Null,253424680,111461,2
253424783,0.0,0.0,1500,1500,0,0,1500,Null,Null,253424783,111461,2
253426788,13.0,13.0,217000,109000,108000,50,217000,Null,Null,253426788,48077,2
253443652,0.0,0.0,6000000,4766000,1234000,21,6000000,Null,Null,253443652,18802,1795
253443788,0.0,0.0,6000000,4766000,1234000,21,6000000,Null,Null,253443788,18802,1795
253443894,0.0,0.0,6000000,4922000,1078000,18,6000000,Null,Null,253443894,18802,1795
253443951,0.0,0.0,6000000,5267000,733000,12,6000000,Null,Null,253443951,18802,1795
253444038,64.0,64.0,15999,15999,0,0,15999,Null,Null,253444038,111461,23446
253482891,0.0,0.0,6500000,6500000,0,0,6500000,Null,Null,253482891,6484151,11871
253486786,55.0,55.0,59000,59000,0,0,59000,Null,Null,253486786,111461,28578
253489331,0.0,0.0,2790000,2790000,0,0,2790000,Null,Null,253489331,52232,1795
253492126,0.0,0.0,1400,1400,0,0,1400,Null,Null,253492126,111461,2
253492384,0.0,0.0,1600,1600,0,0,1600,Null,Null,253492384,111461,2
253492478,0.0,0.0,1900,1900,0,0,1900,Null,Null,253492478,111461,2
253492516,0.0,0.0,1485,1485,0,0,1485,Null,Null,253492516,111461,2
253492744,0.0,0.0,1100,1100,0,0,1100,Null,Null,253492744,111461,2
253492788,0.0,0.0,1485,1485,0,0,1485,Null,Null,253492788,111461,2
253495139,3.0,3.0,6990000,5990000,1000000,14,6990000,Null,Null,253495139,27468,1795
253498979,6.0,6.0,990000,525000,465000,47,990000,Null,Null,253498979,18802,28454
253526233,16.0,16.0,1359000,699000,660000,49,1359000,Null,Null,253526233,5246949,11935
253531741,0.0,0.0,3390000,3390000,0,0,3390000,Null,Null,253531741,52232,1795
253535353,0.0,0.0,14300000,14300000,0,0,14300000,Null,Null,253535353,111461,28860
253535420,0.0,0.0,8950000,7607500,1342500,15,8950000,Null,Null,253535420,691055,8511
253536168,0.0,0.0,13300000,13300000,0,0,13300000,Null,Null,253536168,111461,28860
253540064,0.0,0.0,7913000,4747800,3165200,40,7913000,Null,Null,253540064,722647,2
253543092,0.0,0.0,11750000,11750000,0,0,11750000,Null,Null,253543092,18802,8067
253543133,5.0,5.0,100000,52800,47200,47,100000,Null,Null,253543133,4647777,15318
253552825,0.0,0.0,19550000,19550000,0,0,19550000,Null,Null,253552825,18802,8067
253554604,0.0,0.0,12850000,10922500,1927500,15,12850000,Null,Null,253554604,691055,8512
253555970,0.0,0.0,32950000,32950000,0,0,32950000,Null,Null,253555970,18802,8067
253561944,0.0,0.0,11250000,9562500,1687500,15,11250000,Null,Null,253561944,691055,8512
253577564,3.0,3.0,2500,2500,0,0,2500,Null,Null,253577564,111461,8167
253581955,0.0,0.0,920000,920000,0,0,920000,Null,Null,253581955,111461,5566
253582661,0.0,0.0,3000,3000,0,0,3000,Null,Null,253582661,111461,8167
253585757,0.0,0.0,3000,3000,0,0,3000,Null,Null,253585757,111461,8167
253621688,0.0,0.0,4372000,4372000,0,0,4372000,Null,Null,253621688,256727,8371
253621907,0.0,0.0,160000,160000,0,0,160000,Null,Null,253621907,111461,15250
253622031,0.0,0.0,3265000,3265000,0,0,3265000,Null,Null,253622031,256727,8371
253622073,0.0,0.0,180000,180000,0,0,180000,Null,Null,253622073,111461,15250
253626150,0.0,0.0,250000,250000,0,0,250000,Null,Null,253626150,111461,15250
253626372,0.0,0.0,6000,6000,0,0,6000,Null,Null,253626372,111461,2
253626643,0.0,0.0,6000,6000,0,0,6000,Null,Null,253626643,111461,2
253626660,0.0,0.0,1750000,1575000,175000,10,1750000,Null,Null,253626660,704815,15250
253626677,0.0,0.0,250000,250000,0,0,250000,Null,Null,253626677,111461,15250
253626731,0.0,0.0,295000,295000,0,0,295000,Null,Null,253626731,111461,15318
253626910,0.0,0.0,459000,459000,0,0,459000,Null,Null,253626910,111461,15318
253627128,0.0,0.0,133000,119700,13300,10,133000,Null,Null,253627128,111461,15320
253627634,0.0,0.0,50000,50000,0,0,50000,Null,Null,253627634,111461,49726
253627643,0.0,0.0,239000,239000,0,0,239000,Null,Null,253627643,111461,15318
253627743,0.0,0.0,107000,96300,10700,10,107000,Null,Null,253627743,111461,15320
253628723,0.0,0.0,3364000,3364000,0,0,3364000,Null,Null,253628723,19018,1634
253628794,0.0,0.0,143000,128700,14300,10,143000,Null,Null,253628794,111461,15320
253629207,0.0,0.0,108000,97200,10800,10,108000,Null,Null,253629207,111461,15320
253630088,0.0,0.0,590000,590000,0,0,590000,Null,Null,253630088,111461,20172
253630089,0.0,0.0,850000,850000,0,0,850000,Null,Null,253630089,111461,20172
253630093,0.0,0.0,630000,630000,0,0,630000,Null,Null,253630093,111461,20172
253630127,0.0,0.0,790000,790000,0,0,790000,Null,Null,253630127,111461,20172
253630154,13.0,13.0,1900,1900,0,0,1900,Null,Null,253630154,111461,2
253630188,0.0,0.0,1900,1900,0,0,1900,Null,Null,253630188,111461,2
253630212,2.0,2.0,1900,1900,0,0,1900,Null,Null,253630212,111461,2
253631275,0.0,0.0,4950000,4207500,742500,15,4950000,Null,Null,253631275,691055,8512
253631594,0.0,0.0,7850000,6672500,1177500,15,7850000,Null,Null,253631594,691055,8512
253632082,0.0,0.0,3650000,3102500,547500,15,3650000,Null,Null,253632082,691055,8512
253633271,0.0,0.0,3850000,3272500,577500,15,3850000,Null,Null,253633271,691055,8512
253635636,0.0,0.0,4685000,3982250,702750,15,4685000,Null,Null,253635636,691055,5384
253640053,0.0,0.0,3950000,3357500,592500,15,3950000,Null,Null,253640053,691055,5384
253656300,0.0,0.0,1939000,1939000,0,0,1939000,Null,Null,253656300,7368403,2
253656305,0.0,0.0,207000,207000,0,0,207000,Null,Null,253656305,7368403,2
253656318,0.0,0.0,130000,130000,0,0,130000,Null,Null,253656318,7368403,2
253656327,0.0,0.0,189000,189000,0,0,189000,Null,Null,253656327,7368403,2
253656335,0.0,0.0,224000,224000,0,0,224000,Null,Null,253656335,7368403,2
253656339,0.0,0.0,195000,195000,0,0,195000,Null,Null,253656339,7368403,2
253656341,0.0,0.0,265000,265000,0,0,265000,Null,Null,253656341,7368403,2
253656343,0.0,0.0,165000,165000,0,0,165000,Null,Null,253656343,7368403,2
253656345,0.0,0.0,155000,155000,0,0,155000,Null,Null,253656345,7368403,2
253656358,0.0,0.0,89250,89250,0,0,89250,Null,Null,253656358,7368403,2
253656367,0.0,0.0,105400,105400,0,0,105400,Null,Null,253656367,7368403,2
253656465,0.0,0.0,239000,239000,0,0,239000,Null,Null,253656465,7368403,2
253656467,0.0,0.0,179000,179000,0,0,179000,Null,Null,253656467,7368403,2
253656478,0.0,0.0,209000,209000,0,0,209000,Null,Null,253656478,7368403,2
253665402,0.0,0.0,14300000,14300000,0,0,14300000,Null,Null,253665402,111461,28860
253665808,0.0,0.0,13300000,13300000,0,0,13300000,Null,Null,253665808,111461,28860
253671424,9.0,9.0,362000,260000,102000,28,362000,Null,Null,253671424,47663,1613
253676224,9.0,9.0,362000,260000,102000,28,362000,Null,Null,253676224,47663,1613
253680049,124.0,124.0,399000,290000,109000,27,399000,Null,Null,253680049,4250493,1883
253686655,2.0,2.0,150000,150000,0,0,150000,Null,Null,253686655,111461,2
253702481,0.0,0.0,55500000,55500000,0,0,55500000,Null,Null,253702481,111461,8064
253719675,0.0,0.0,1800,1800,0,0,1800,Null,Null,253719675,111461,2
253720430,0.0,0.0,12600,8000,4600,37,12600,Null,Null,253720430,145037,8305
253722642,0.0,0.0,752000,659000,93000,12,752000,Null,Null,253722642,26150,5384
253787885,0.0,0.0,599000,599000,0,0,599000,Null,Null,253787885,111461,15250
253891971,0.0,0.0,2500,2500,0,0,2500,Null,Null,253891971,111461,2
253891991,0.0,0.0,38000,38000,0,0,38000,Null,Null,253891991,111461,2
253891994,0.0,0.0,5000,5000,0,0,5000,Null,Null,253891994,111461,2
253892051,0.0,0.0,65000,65000,0,0,65000,Null,Null,253892051,111461,2
253892730,0.0,0.0,130000,130000,0,0,130000,Null,Null,253892730,111461,15250
253892758,0.0,0.0,160000,160000,0,0,160000,Null,Null,253892758,111461,15250
253892893,0.0,0.0,180000,180000,0,0,180000,Null,Null,253892893,111461,15250
253892923,0.0,0.0,250000,250000,0,0,250000,Null,Null,253892923,111461,15250
253892927,0.0,0.0,250000,250000,0,0,250000,Null,Null,253892927,111461,15250
253892937,0.0,0.0,130000,130000,0,0,130000,Null,Null,253892937,111461,15250
253900446,0.0,0.0,160000,160000,0,0,160000,Null,Null,253900446,111461,15250
253905543,0.0,0.0,180000,180000,0,0,180000,Null,Null,253905543,111461,15250
253946270,0.0,0.0,250000,250000,0,0,250000,Null,Null,253946270,111461,15250
254015637,0.0,0.0,250000,250000,0,0,250000,Null,Null,254015637,111461,15250
254020952,57.0,57.0,150000,120000,30000,20,150000,Null,Null,254020952,214421,1520
254021352,0.0,0.0,130000,130000,0,0,130000,Null,Null,254021352,111461,15250
254021823,0.0,0.0,160000,160000,0,0,160000,Null,Null,254021823,111461,15250
254022238,0.0,0.0,180000,180000,0,0,180000,Null,Null,254022238,111461,15250
254022735,0.0,0.0,19800000,19800000,0,0,19800000,Null,Null,254022735,111461,28860
254022785,0.0,0.0,14219700,14219700,0,0,14219700,Null,Null,254022785,8184181,20258
254023159,0.0,0.0,25800000,25800000,0,0,25800000,Null,Null,254023159,111461,28860
254023252,0.0,0.0,39990000,32990000,7000000,18,39990000,Null,Null,254023252,5740935,2324
254023505,0.0,0.0,23800000,23800000,0,0,23800000,Null,Null,254023505,111461,28860
254023513,8.0,8.0,720000,428000,292000,41,720000,Null,Null,254023513,48077,8170
254023897,0.0,0.0,7960000,3980000,3980000,50,7960000,Null,Null,254023897,111461,15318
254024251,18.0,18.0,35000,29000,6000,17,35000,Null,Null,254024251,111461,2
254024475,19.0,19.0,29000,19000,10000,34,29000,Null,Null,254024475,111461,2
254024529,7.0,7.0,30000,25000,5000,17,30000,Null,Null,254024529,111461,2
254024880,0.0,0.0,1650000,1599000,51000,3,1650000,Null,Null,254024880,46363,5385
254025316,0.0,0.0,1050000,959000,91000,9,1050000,Null,Null,254025316,46363,5384
254031373,0.0,0.0,15260300,15260300,0,0,15260300,Null,Null,254031373,8184181,20258
254037031,0.0,0.0,19819800,19819800,0,0,19819800,Null,Null,254037031,8184181,20258
254037638,0.0,0.0,31348900,31348900,0,0,31348900,Null,Null,254037638,8184181,20258
254038117,0.0,0.0,33628100,33628100,0,0,33628100,Null,Null,254038117,8184181,20258
254073902,0.0,0.0,2798000,2798000,0,0,2798000,Null,Null,254073902,7892089,15250
254073907,0.0,0.0,20300000,20300000,0,0,20300000,Null,Null,254073907,111461,8064
254074716,0.0,0.0,1698000,1698000,0,0,1698000,Null,Null,254074716,7892089,15250
254074717,0.0,0.0,1598000,1598000,0,0,1598000,Null,Null,254074717,7892089,15250
254074720,0.0,0.0,1998000,1998000,0,0,1998000,Null,Null,254074720,7892089,15250
254074722,0.0,0.0,1498000,1498000,0,0,1498000,Null,Null,254074722,7892089,15250
254074724,0.0,0.0,3398000,3398000,0,0,3398000,Null,Null,254074724,7892089,15250
254074726,0.0,0.0,2398000,2398000,0,0,2398000,Null,Null,254074726,7892089,15250
254074728,0.0,0.0,3298000,3298000,0,0,3298000,Null,Null,254074728,7892089,15250
254074732,0.0,0.0,2398000,2398000,0,0,2398000,Null,Null,254074732,7892089,15250
254074734,0.0,0.0,1598000,1598000,0,0,1598000,Null,Null,254074734,7892089,15250
254074736,0.0,0.0,3398000,3398000,0,0,3398000,Null,Null,254074736,7892089,15250
254074738,0.0,0.0,2598000,2598000,0,0,2598000,Null,Null,254074738,7892089,15250
254074740,0.0,0.0,2198000,2198000,0,0,2198000,Null,Null,254074740,7892089,15250
254074742,0.0,0.0,2598000,2598000,0,0,2598000,Null,Null,254074742,7892089,15250
254074744,0.0,0.0,1598000,1598000,0,0,1598000,Null,Null,254074744,7892089,15250
254074746,0.0,0.0,3698000,3698000,0,0,3698000,Null,Null,254074746,7892089,15250
254074748,0.0,0.0,1698000,1698000,0,0,1698000,Null,Null,254074748,7892089,15250
254074750,0.0,0.0,3298000,3298000,0,0,3298000,Null,Null,254074750,7892089,15250
254074752,0.0,0.0,1498000,1498000,0,0,1498000,Null,Null,254074752,7892089,15250
254074754,0.0,0.0,2498000,2498000,0,0,2498000,Null,Null,254074754,7892089,15250
254078984,0.0,0.0,250000,250000,0,0,250000,Null,Null,254078984,111461,15250
254080308,11.0,11.0,225000,220500,4500,2,225000,Null,Null,254080308,18802,4428
254080369,0.0,0.0,250000,250000,0,0,250000,Null,Null,254080369,111461,15250
254082283,0.0,0.0,130000,130000,0,0,130000,Null,Null,254082283,111461,15250
254084172,0.0,0.0,788000,788000,0,0,788000,Null,Null,254084172,111461,1636
254085779,0.0,0.0,56296000,42222000,14074000,25,56296000,Null,Null,254085779,183111,23376
254089697,0.0,0.0,499000,499000,0,0,499000,Null,Null,254089697,183257,15250
254093019,0.0,0.0,499000,499000,0,0,499000,Null,Null,254093019,183257,15250
254093118,0.0,0.0,5398000,5398000,0,0,5398000,Null,Null,254093118,7892089,15250
254093238,0.0,0.0,2798000,2798000,0,0,2798000,Null,Null,254093238,7892089,15250
254093262,0.0,0.0,499000,499000,0,0,499000,Null,Null,254093262,183257,15250
254093483,0.0,0.0,499000,499000,0,0,499000,Null,Null,254093483,183257,15250
254113755,24.0,24.0,1000000,1000000,0,0,1000000,Null,Null,254113755,27932,1936
254114668,0.0,0.0,11640000,11640000,0,0,11640000,Null,Null,254114668,111461,28860
254123256,40.0,40.0,212000,127200,84800,40,212000,Null,Null,254123256,111461,1883
254123776,0.0,0.0,1100000,550000,550000,50,1100000,Null,Null,254123776,111461,15318
254125039,0.0,0.0,1760000,880000,880000,50,1760000,Null,Null,254125039,111461,15318
254125720,0.0,0.0,5990000,5990000,0,0,5990000,Null,Null,254125720,112735,1795
254138365,0.0,0.0,160000,160000,0,0,160000,Null,Null,254138365,111461,15250
254138371,0.0,0.0,180000,180000,0,0,180000,Null,Null,254138371,111461,15250
254138374,0.0,0.0,250000,250000,0,0,250000,Null,Null,254138374,111461,15250
254138376,0.0,0.0,250000,250000,0,0,250000,Null,Null,254138376,111461,15250
254138389,0.0,0.0,130000,130000,0,0,130000,Null,Null,254138389,111461,15250
254138392,0.0,0.0,160000,160000,0,0,160000,Null,Null,254138392,111461,15250
254138397,0.0,0.0,180000,180000,0,0,180000,Null,Null,254138397,111461,15250
254138400,0.0,0.0,250000,250000,0,0,250000,Null,Null,254138400,111461,15250
254138403,0.0,0.0,250000,250000,0,0,250000,Null,Null,254138403,111461,15250
254138671,0.0,0.0,130000,130000,0,0,130000,Null,Null,254138671,111461,15250
254138734,0.0,0.0,160000,160000,0,0,160000,Null,Null,254138734,111461,15250
254138801,0.0,0.0,180000,180000,0,0,180000,Null,Null,254138801,111461,15250
254138817,0.0,0.0,250000,250000,0,0,250000,Null,Null,254138817,111461,15250
254139167,0.0,0.0,250000,250000,0,0,250000,Null,Null,254139167,111461,15250
254139174,0.0,0.0,13500000,13500000,0,0,13500000,Null,Null,254139174,893943,28870
254139307,0.0,0.0,130000,130000,0,0,130000,Null,Null,254139307,111461,15250
254139398,0.0,0.0,4350000,3697500,652500,15,4350000,Null,Null,254139398,691055,5384
254139477,0.0,0.0,180000,180000,0,0,180000,Null,Null,254139477,111461,15250
254139653,0.0,0.0,250000,250000,0,0,250000,Null,Null,254139653,111461,15250
254139742,0.0,0.0,250000,250000,0,0,250000,Null,Null,254139742,111461,15250
254139874,0.0,0.0,130000,130000,0,0,130000,Null,Null,254139874,111461,15250
254139881,0.0,0.0,19500000,16575000,2925000,15,19500000,Null,Null,254139881,691055,8512
254140392,10.0,10.0,1250000,699000,551000,44,1250000,Null,Null,254140392,5246949,2340
254147471,0.0,0.0,13100000,13100000,0,0,13100000,Null,Null,254147471,111461,8067
254147480,0.0,0.0,15312000,15312000,0,0,15312000,Null,Null,254147480,111461,8067
254147487,0.0,0.0,15312000,15312000,0,0,15312000,Null,Null,254147487,111461,8067
254147498,0.0,0.0,15312000,15312000,0,0,15312000,Null,Null,254147498,111461,8067
254180584,0.0,0.0,7700000,7700000,0,0,7700000,Null,Null,254180584,111461,1634
254180958,0.0,0.0,160000,160000,0,0,160000,Null,Null,254180958,111461,15250
254181051,0.0,0.0,12000000,12000000,0,0,12000000,Null,Null,254181051,111461,11518
254181117,0.0,0.0,180000,180000,0,0,180000,Null,Null,254181117,111461,15250
254181256,0.0,0.0,250000,250000,0,0,250000,Null,Null,254181256,111461,15250
254181375,0.0,0.0,55700000,55700000,0,0,55700000,Null,Null,254181375,111461,8064
254181530,0.0,0.0,250000,250000,0,0,250000,Null,Null,254181530,111461,15250
254184750,0.0,0.0,23892000,20547120,3344880,14,23892000,Null,Null,254184750,111461,8064
254184994,0.0,0.0,11640000,11640000,0,0,11640000,Null,Null,254184994,111461,28860
254186335,0.0,0.0,920000,920000,0,0,920000,Null,Null,254186335,111461,6653
254186442,0.0,0.0,15312000,13168320,2143680,14,15312000,Null,Null,254186442,111461,8067
254187881,0.0,0.0,130000,130000,0,0,130000,Null,Null,254187881,111461,15250
254188096,0.0,0.0,160000,160000,0,0,160000,Null,Null,254188096,111461,15250
254188215,0.0,0.0,180000,180000,0,0,180000,Null,Null,254188215,111461,15250
254188356,0.0,0.0,250000,250000,0,0,250000,Null,Null,254188356,111461,15250
254188441,0.0,0.0,250000,250000,0,0,250000,Null,Null,254188441,111461,15250
254188804,0.0,0.0,18200000,18200000,0,0,18200000,Null,Null,254188804,111461,6653
254189116,0.0,0.0,13860000,11919600,1940400,14,13860000,Null,Null,254189116,111461,11518
254206407,0.0,0.0,24000,11000,13000,54,24000,Null,Null,254206407,111461,15318
254206606,0.0,0.0,8060000,4880000,3180000,39,8060000,Null,Null,254206606,7982659,8512
254206711,0.0,0.0,99000,99000,0,0,99000,Null,Null,254206711,111461,15318
254206911,0.0,0.0,119000,119000,0,0,119000,Null,Null,254206911,111461,15318
254347283,0.0,0.0,560000,280000,280000,50,560000,Null,Null,254347283,111461,15318
254462070,0.0,0.0,165000,165000,0,0,165000,Null,Null,254462070,111461,15318
254462107,0.0,0.0,245000,245000,0,0,245000,Null,Null,254462107,111461,15318
254462124,0.0,0.0,259000,259000,0,0,259000,Null,Null,254462124,111461,15318
254462156,0.0,0.0,385000,385000,0,0,385000,Null,Null,254462156,111461,15318
254764509,0.0,0.0,199000,199000,0,0,199000,Null,Null,254764509,111461,15250
254896267,0.0,0.0,69000,69000,0,0,69000,Null,Null,254896267,111461,2
254896269,0.0,0.0,109000,109000,0,0,109000,Null,Null,254896269,111461,2
254896271,0.0,0.0,199000,199000,0,0,199000,Null,Null,254896271,111461,2
254896278,0.0,0.0,65000,65000,0,0,65000,Null,Null,254896278,111461,2
254896491,0.0,0.0,890000,890000,0,0,890000,Null,Null,254896491,111461,15936
254896766,0.0,0.0,179000,179000,0,0,179000,Null,Null,254896766,111461,15250
254898215,0.0,0.0,6000,6000,0,0,6000,Null,Null,254898215,111461,2
254898298,0.0,0.0,10216000,10216000,0,0,10216000,Null,Null,254898298,111461,2
254898591,0.0,0.0,63496000,63496000,0,0,63496000,Null,Null,254898591,111461,2
254898986,0.0,0.0,8000,8000,0,0,8000,Null,Null,254898986,111461,20254
254900065,0.0,0.0,50000000,50000000,0,0,50000000,Null,Null,254900065,111461,2
254900125,0.0,0.0,53000000,53000000,0,0,53000000,Null,Null,254900125,111461,2
254900169,0.0,0.0,50000000,50000000,0,0,50000000,Null,Null,254900169,111461,2
254900227,0.0,0.0,50000000,50000000,0,0,50000000,Null,Null,254900227,111461,2
254900505,0.0,0.0,50000000,50000000,0,0,50000000,Null,Null,254900505,111461,2
254900582,0.0,0.0,50000000,50000000,0,0,50000000,Null,Null,254900582,111461,2
254900773,0.0,0.0,55540000,55540000,0,0,55540000,Null,Null,254900773,111461,2
254900780,0.0,0.0,47600000,47600000,0,0,47600000,Null,Null,254900780,111461,2
254900804,0.0,0.0,42160000,42160000,0,0,42160000,Null,Null,254900804,111461,2
254900806,0.0,0.0,36186400,36186400,0,0,36186400,Null,Null,254900806,111461,2
254900857,0.0,0.0,46200000,46200000,0,0,46200000,Null,Null,254900857,111461,2
254900900,0.0,0.0,58120000,58120000,0,0,58120000,Null,Null,254900900,111461,2
254900951,0.0,0.0,37800000,37800000,0,0,37800000,Null,Null,254900951,111461,2
254900960,0.0,0.0,36520000,36520000,0,0,36520000,Null,Null,254900960,111461,2
254900986,0.0,0.0,40600000,40600000,0,0,40600000,Null,Null,254900986,111461,2
254900991,0.0,0.0,58800000,58800000,0,0,58800000,Null,Null,254900991,111461,2
254901013,0.0,0.0,47080000,47080000,0,0,47080000,Null,Null,254901013,111461,2
254901016,0.0,0.0,39400000,39400000,0,0,39400000,Null,Null,254901016,111461,2
254901021,0.0,0.0,58800000,58800000,0,0,58800000,Null,Null,254901021,111461,2
254901054,0.0,0.0,44800000,44800000,0,0,44800000,Null,Null,254901054,111461,2
254901077,0.0,0.0,39640000,39640000,0,0,39640000,Null,Null,254901077,111461,2
254901111,0.0,0.0,77000000,77000000,0,0,77000000,Null,Null,254901111,111461,2
254901152,0.0,0.0,59800000,59800000,0,0,59800000,Null,Null,254901152,111461,2
254901194,0.0,0.0,48040000,48040000,0,0,48040000,Null,Null,254901194,111461,2
254901227,0.0,0.0,46360000,46360000,0,0,46360000,Null,Null,254901227,111461,2
254901234,0.0,0.0,38363200,38363200,0,0,38363200,Null,Null,254901234,111461,2
254901276,0.0,0.0,50400000,50400000,0,0,50400000,Null,Null,254901276,111461,2
254901278,0.0,0.0,36712000,36712000,0,0,36712000,Null,Null,254901278,111461,2
254901282,0.0,0.0,36400000,36400000,0,0,36400000,Null,Null,254901282,111461,2
254901345,0.0,0.0,49000000,49000000,0,0,49000000,Null,Null,254901345,111461,2
254901411,0.0,0.0,39400000,39400000,0,0,39400000,Null,Null,254901411,111461,2
254901441,0.0,0.0,37800000,37800000,0,0,37800000,Null,Null,254901441,111461,2
254901491,0.0,0.0,53200000,53200000,0,0,53200000,Null,Null,254901491,111461,2
254901542,0.0,0.0,37480000,37480000,0,0,37480000,Null,Null,254901542,111461,2
254901552,0.0,0.0,5740800,5740800,0,0,5740800,Null,Null,254901552,111461,2
254901554,0.0,0.0,78280000,78280000,0,0,78280000,Null,Null,254901554,111461,2
254901559,0.0,0.0,67240000,67240000,0,0,67240000,Null,Null,254901559,111461,2
254901577,0.0,0.0,71560000,71560000,0,0,71560000,Null,Null,254901577,111461,2
254901603,0.0,0.0,36400000,36400000,0,0,36400000,Null,Null,254901603,111461,2
254902120,1.0,1.0,299000,270000,29000,10,299000,Null,Null,254902120,111461,1796
254903626,0.0,0.0,560000,280000,280000,50,560000,Null,Null,254903626,111461,15236
254904430,0.0,0.0,5000,5000,0,0,5000,Null,Null,254904430,111461,28732
255074899,0.0,0.0,15990000,15990000,0,0,15990000,Null,Null,255074899,690631,7079
255077235,0.0,0.0,169000,169000,0,0,169000,Null,Null,255077235,111461,15250
255078692,0.0,0.0,269000,269000,0,0,269000,Null,Null,255078692,111461,15318
255079674,0.0,0.0,239000,239000,0,0,239000,Null,Null,255079674,111461,15250
255109064,0.0,0.0,279000,279000,0,0,279000,Null,Null,255109064,111461,15318
255109096,0.0,0.0,189000,189000,0,0,189000,Null,Null,255109096,111461,15250
255115669,0.0,0.0,949000,949000,0,0,949000,Null,Null,255115669,111461,15936
255143784,0.0,0.0,949000,949000,0,0,949000,Null,Null,255143784,111461,15936
255153094,0.0,0.0,990000,990000,0,0,990000,Null,Null,255153094,111461,15936
255172993,0.0,0.0,269000,269000,0,0,269000,Null,Null,255172993,111461,15318
255173017,0.0,0.0,279000,279000,0,0,279000,Null,Null,255173017,111461,15250
255173068,0.0,0.0,219000,219000,0,0,219000,Null,Null,255173068,111461,15318
255174972,0.0,0.0,145000,145000,0,0,145000,Null,Null,255174972,111461,15250
255175618,0.0,0.0,65000,65000,0,0,65000,Null,Null,255175618,111461,15320
255176047,0.0,0.0,560000,280000,280000,50,560000,Null,Null,255176047,111461,15236
255256730,4.0,4.0,249999,249999,0,0,249999,Null,Null,255256730,111461,2
255294438,5.0,5.0,412000,320000,92000,22,412000,Null,Null,255294438,47663,1637
255294494,0.0,0.0,13600000,13600000,0,0,13600000,Null,Null,255294494,111461,28862
255295742,0.0,0.0,13900000,13900000,0,0,13900000,Null,Null,255295742,111461,28862
255299485,4.0,4.0,1099000,818000,281000,26,1099000,Null,Null,255299485,215231,1815
255299502,0.0,0.0,15400000,15400000,0,0,15400000,Null,Null,255299502,111461,28862
255299931,0.0,0.0,15000000,15000000,0,0,15000000,Null,Null,255299931,111461,28862
255316890,6.0,6.0,2050000,1678000,372000,18,2050000,Null,Null,255316890,147856,1789
255318103,0.0,0.0,450000,450000,0,0,450000,Null,Null,255318103,111461,2
255318144,0.0,0.0,147000,147000,0,0,147000,Null,Null,255318144,111461,2
255322714,0.0,0.0,147000,147000,0,0,147000,Null,Null,255322714,111461,2
255322825,0.0,0.0,84000,84000,0,0,84000,Null,Null,255322825,111461,2
255333013,0.0,0.0,97900,97900,0,0,97900,Null,Null,255333013,111461,2
255338287,0.0,0.0,140000,140000,0,0,140000,Null,Null,255338287,111461,15250
255338510,0.0,0.0,2000,2000,0,0,2000,Null,Null,255338510,111461,2
255371165,0.0,0.0,249000,249000,0,0,249000,Null,Null,255371165,111461,15936
255407007,0.0,0.0,249000,249000,0,0,249000,Null,Null,255407007,111461,2
255407009,0.0,0.0,249000,249000,0,0,249000,Null,Null,255407009,111461,2
255407011,0.0,0.0,249000,249000,0,0,249000,Null,Null,255407011,111461,2
255407013,0.0,0.0,249000,249000,0,0,249000,Null,Null,255407013,111461,2
255407015,0.0,0.0,249000,249000,0,0,249000,Null,Null,255407015,111461,2
255407017,0.0,0.0,249000,249000,0,0,249000,Null,Null,255407017,111461,2
255407019,0.0,0.0,249000,249000,0,0,249000,Null,Null,255407019,111461,2
255410145,0.0,0.0,799000,599900,199100,25,799000,Null,Null,255410145,183257,15318
255410238,0.0,0.0,349000,268000,81000,23,349000,Null,Null,255410238,183257,15318
255414132,0.0,0.0,249000,249000,0,0,249000,Null,Null,255414132,111461,15936
255426957,0.0,0.0,249000,249000,0,0,249000,Null,Null,255426957,111461,15936
255427311,0.0,0.0,249000,249000,0,0,249000,Null,Null,255427311,111461,15936
255427363,0.0,0.0,249000,249000,0,0,249000,Null,Null,255427363,111461,15936
255427431,0.0,0.0,1960000,980000,980000,50,1960000,Null,Null,255427431,111461,15318
255430458,0.0,0.0,200000,200000,0,0,200000,Null,Null,255430458,111461,49722
255455702,0.0,0.0,30000,12000,18000,60,30000,Null,Null,255455702,111461,15320
255457844,0.0,0.0,250000,230000,20000,8,250000,Null,Null,255457844,111461,49722
255598432,0.0,0.0,2000,2000,0,0,2000,Null,Null,255598432,111461,2
255640837,120.0,120.0,5000,5000,0,0,5000,Null,Null,255640837,111461,2685
255760070,1.0,1.0,4699000,4699000,0,0,4699000,Null,Null,255760070,222015,5905
255760258,0.0,0.0,3550000,3550000,0,0,3550000,Null,Null,255760258,222015,5905
255761327,0.0,0.0,2829000,2829000,0,0,2829000,Null,Null,255761327,26150,8516
255763238,0.0,0.0,55720000,55720000,0,0,55720000,Null,Null,255763238,111461,2
255763273,0.0,0.0,50600000,50600000,0,0,50600000,Null,Null,255763273,111461,2
255763358,0.0,0.0,50400000,50400000,0,0,50400000,Null,Null,255763358,111461,2
255763428,0.0,0.0,53000000,53000000,0,0,53000000,Null,Null,255763428,111461,2
255763630,0.0,0.0,59800000,59800000,0,0,59800000,Null,Null,255763630,111461,2
255763632,0.0,0.0,71400000,71400000,0,0,71400000,Null,Null,255763632,111461,2
255763650,0.0,0.0,37736000,37736000,0,0,37736000,Null,Null,255763650,111461,2
255763660,0.0,0.0,41800000,41800000,0,0,41800000,Null,Null,255763660,111461,2
255763678,0.0,0.0,93400000,93400000,0,0,93400000,Null,Null,255763678,111461,2
255763775,0.0,0.0,63400000,63400000,0,0,63400000,Null,Null,255763775,111461,2
255763803,0.0,0.0,51400000,51400000,0,0,51400000,Null,Null,255763803,111461,2
255763824,0.0,0.0,49000000,49000000,0,0,49000000,Null,Null,255763824,111461,2
255763858,0.0,0.0,44680000,44680000,0,0,44680000,Null,Null,255763858,111461,2
255763886,0.0,0.0,49720000,49720000,0,0,49720000,Null,Null,255763886,111461,2
255763890,0.0,0.0,55400000,55400000,0,0,55400000,Null,Null,255763890,111461,2
255763933,0.0,0.0,60200000,60200000,0,0,60200000,Null,Null,255763933,111461,2
255763962,0.0,0.0,37800000,37800000,0,0,37800000,Null,Null,255763962,111461,2
255763978,0.0,0.0,40600000,40600000,0,0,40600000,Null,Null,255763978,111461,2
255764031,0.0,0.0,44800000,44800000,0,0,44800000,Null,Null,255764031,111461,2
255764090,0.0,0.0,63160000,63160000,0,0,63160000,Null,Null,255764090,111461,2
255764094,0.0,0.0,51800000,51800000,0,0,51800000,Null,Null,255764094,111461,2
255764193,0.0,0.0,46200000,46200000,0,0,46200000,Null,Null,255764193,111461,2
255764227,0.0,0.0,56440000,56440000,0,0,56440000,Null,Null,255764227,111461,2
255764334,0.0,0.0,14440000,14440000,0,0,14440000,Null,Null,255764334,111461,2
255764355,0.0,0.0,61480000,61480000,0,0,61480000,Null,Null,255764355,111461,2
255764402,0.0,0.0,41248000,41248000,0,0,41248000,Null,Null,255764402,111461,2
255764416,0.0,0.0,48040000,48040000,0,0,48040000,Null,Null,255764416,111461,2
255764653,0.0,0.0,51800000,51800000,0,0,51800000,Null,Null,255764653,111461,2
255764667,0.0,0.0,39200000,39200000,0,0,39200000,Null,Null,255764667,111461,2
255764741,0.0,0.0,39640000,39640000,0,0,39640000,Null,Null,255764741,111461,2
255764762,0.0,0.0,46360000,46360000,0,0,46360000,Null,Null,255764762,111461,2
255764775,0.0,0.0,38296000,38296000,0,0,38296000,Null,Null,255764775,111461,2
255764860,0.0,0.0,39400000,39400000,0,0,39400000,Null,Null,255764860,111461,2
255764892,0.0,0.0,61000000,61000000,0,0,61000000,Null,Null,255764892,111461,2
256834851,0.0,0.0,145000,145000,0,0,145000,Null,Null,256834851,111461,15250
257291182,0.0,0.0,330000,297000,33000,10,330000,Null,Null,257291182,111461,15236
257317403,0.0,0.0,310000,310000,0,0,310000,Null,Null,257317403,256727,15320
257326794,0.0,0.0,443000,398700,44300,10,443000,Null,Null,257326794,111461,15236
257454443,0.0,0.0,662000,595800,66200,10,662000,Null,Null,257454443,111461,15250
257519588,0.0,0.0,12000000,12000000,0,0,12000000,Null,Null,257519588,111461,28862
257532160,39.0,39.0,87022,87022,0,0,87022,Null,Null,257532160,111461,1805
257532632,0.0,0.0,4600000,4600000,0,0,4600000,Null,Null,257532632,722647,2
257536610,0.0,0.0,6800000,6800000,0,0,6800000,Null,Null,257536610,722647,2
257537312,0.0,0.0,6800000,6800000,0,0,6800000,Null,Null,257537312,722647,2
257537629,0.0,0.0,12300000,12300000,0,0,12300000,Null,Null,257537629,111461,28862
257538212,0.0,0.0,13800000,13800000,0,0,13800000,Null,Null,257538212,111461,28862
257540664,0.0,0.0,38381857,38381857,0,0,38381857,Null,Null,257540664,111461,2
257541387,0.0,0.0,36111962,36111962,0,0,36111962,Null,Null,257541387,111461,2
257542042,0.0,0.0,36504035,36504035,0,0,36504035,Null,Null,257542042,111461,2
257543158,0.0,0.0,39619982,39619982,0,0,39619982,Null,Null,257543158,111461,2
257543417,0.0,0.0,47977322,47977322,0,0,47977322,Null,Null,257543417,111461,2
257543773,0.0,0.0,46429666,46429666,0,0,46429666,Null,Null,257543773,111461,2
257543831,0.0,0.0,36111962,36111962,0,0,36111962,Null,Null,257543831,111461,2
257544260,0.0,0.0,41270814,41270814,0,0,41270814,Null,Null,257544260,111461,2
257544291,0.0,0.0,40239043,40239043,0,0,40239043,Null,Null,257544291,111461,2
257544313,0.0,0.0,38691388,38691388,0,0,38691388,Null,Null,257544313,111461,2
257544484,0.0,0.0,38691388,38691388,0,0,38691388,Null,Null,257544484,111461,2
257551611,0.0,0.0,13400000,13400000,0,0,13400000,Null,Null,257551611,111461,28862
257587064,0.0,0.0,189000,189000,0,0,189000,Null,Null,257587064,183257,15250
257613618,0.0,0.0,310000,158000,152000,49,310000,Null,Null,257613618,183257,15320
257674731,0.0,0.0,530000,468000,62000,12,530000,Null,Null,257674731,183257,15318
257682820,0.0,0.0,520000,399000,121000,23,520000,Null,Null,257682820,183257,15318
257683118,0.0,0.0,179000,179000,0,0,179000,Null,Null,257683118,111461,27546
257683308,0.0,0.0,1095000,1095000,0,0,1095000,Null,Null,257683308,111461,27544
257699301,0.0,0.0,540000,540000,0,0,540000,Null,Null,257699301,183257,15318
257749645,0.0,0.0,490000,490000,0,0,490000,Null,Null,257749645,183257,15318
257757848,0.0,0.0,7400000,7400000,0,0,7400000,Null,Null,257757848,8178761,8165
257757851,0.0,0.0,7400000,7400000,0,0,7400000,Null,Null,257757851,8178761,8165
257759466,13.0,13.0,68000,56000,12000,18,68000,Null,Null,257759466,277519,6948
257760445,0.0,0.0,37125000,37125000,0,0,37125000,Null,Null,257760445,111461,2
257764555,8.0,8.0,45000,45000,0,0,45000,Null,Null,257764555,111461,12908
257766532,0.0,0.0,65000,65000,0,0,65000,Null,Null,257766532,111461,2
257766560,0.0,0.0,75000,75000,0,0,75000,Null,Null,257766560,111461,2
257766562,0.0,0.0,88000,88000,0,0,88000,Null,Null,257766562,111461,2
257766564,0.0,0.0,69000,69000,0,0,69000,Null,Null,257766564,111461,2
257766568,0.0,0.0,55000,55000,0,0,55000,Null,Null,257766568,111461,2
257766588,0.0,0.0,59000,59000,0,0,59000,Null,Null,257766588,111461,2
257766591,0.0,0.0,88000,88000,0,0,88000,Null,Null,257766591,111461,2
257767013,6.0,6.0,240149,149001,91148,38,240149,Null,Null,257767013,848485,1815
257768248,0.0,0.0,320000,239000,81000,25,320000,Null,Null,257768248,183257,15318
257768390,0.0,0.0,381650,381650,0,0,381650,Null,Null,257768390,7368403,2
257768517,0.0,0.0,114750,114750,0,0,114750,Null,Null,257768517,7368403,2
257768743,0.0,0.0,237150,237150,0,0,237150,Null,Null,257768743,7368403,2
257769158,0.0,0.0,210800,210800,0,0,210800,Null,Null,257769158,7368403,2
257769427,0.0,0.0,369550,369550,0,0,369550,Null,Null,257769427,7368403,2
257769980,0.0,0.0,90000,90000,0,0,90000,Null,Null,257769980,111461,2
257769981,0.0,0.0,90000,90000,0,0,90000,Null,Null,257769981,111461,49724
257769986,0.0,0.0,70000,70000,0,0,70000,Null,Null,257769986,111461,2
257770006,0.0,0.0,190000,190000,0,0,190000,Null,Null,257770006,111461,2
257770026,0.0,0.0,370000,370000,0,0,370000,Null,Null,257770026,111461,2
257770049,0.0,0.0,125000,125000,0,0,125000,Null,Null,257770049,111461,2
257770116,0.0,0.0,590000,468000,122000,21,590000,Null,Null,257770116,183257,15236
257770208,0.0,0.0,480000,480000,0,0,480000,Null,Null,257770208,111461,49724
257770274,1.0,1.0,7390000,7390000,0,0,7390000,Null,Null,257770274,111461,1634
257770299,0.0,0.0,480000,480000,0,0,480000,Null,Null,257770299,111461,49724
257770396,0.0,0.0,400000,400000,0,0,400000,Null,Null,257770396,111461,49724
257770470,0.0,0.0,450000,450000,0,0,450000,Null,Null,257770470,111461,49724
257770686,0.0,0.0,780000,780000,0,0,780000,Null,Null,257770686,111461,49724
257775783,0.0,0.0,25200,12600,12600,50,25200,Null,Null,257775783,111461,15318
257779316,0.0,0.0,7290000,7290000,0,0,7290000,Null,Null,257779316,111461,1634
257788593,0.0,0.0,182800000,182800000,0,0,182800000,Null,Null,257788593,153999,2340
257788878,0.0,0.0,180000,180000,0,0,180000,Null,Null,257788878,153088,49722
257788887,0.0,0.0,180000,180000,0,0,180000,Null,Null,257788887,153088,49722
257789598,0.0,0.0,250000,250000,0,0,250000,Null,Null,257789598,153088,49722
257789646,0.0,0.0,245000,245000,0,0,245000,Null,Null,257789646,111461,15318
257831992,0.0,0.0,2500,2500,0,0,2500,Null,Null,257831992,111461,2
257832380,0.0,0.0,2500,2500,0,0,2500,Null,Null,257832380,111461,2
257832506,0.0,0.0,1200,1200,0,0,1200,Null,Null,257832506,111461,2
257832956,0.0,0.0,2500,2500,0,0,2500,Null,Null,257832956,111461,2
257833000,0.0,0.0,1200,1200,0,0,1200,Null,Null,257833000,111461,2
257833203,0.0,0.0,1200,1200,0,0,1200,Null,Null,257833203,111461,2
257834138,0.0,0.0,15000,15000,0,0,15000,Null,Null,257834138,111461,15318
257835464,67.0,67.0,30000,30000,0,0,30000,Null,Null,257835464,111461,53048
257835948,21.0,21.0,199000,199000,0,0,199000,Null,Null,257835948,4973949,1815
257836309,0.0,0.0,6000,6000,0,0,6000,Null,Null,257836309,111461,2
257837295,0.0,0.0,1000,1000,0,0,1000,Null,Null,257837295,111461,2
257843667,0.0,0.0,880000,719000,161000,18,880000,Null,Null,257843667,21717,49722
257844026,5.0,5.0,150000,89000,61000,41,150000,Null,Null,257844026,4244853,20244
257844247,4.0,4.0,140000,140000,0,0,140000,Null,Null,257844247,218061,10228
257844324,8.0,8.0,140000,140000,0,0,140000,Null,Null,257844324,218061,10228
257844953,0.0,0.0,232000,208800,23200,10,232000,Null,Null,257844953,111461,15318
257845069,0.0,0.0,15200,7000,8200,54,15200,Null,Null,257845069,111461,15318
257857032,1248.0,1248.0,252000,130000,122000,48,252000,Null,Null,257857032,48077,11833
257861524,0.0,0.0,3500000,2880000,620000,18,3500000,Null,Null,257861524,111461,1789
257866509,0.0,0.0,808000,808000,0,0,808000,Null,Null,257866509,26150,8513
257866622,0.0,0.0,1475000,1475000,0,0,1475000,Null,Null,257866622,26150,5385
257866809,4.0,4.0,3950000,3950000,0,0,3950000,Null,Null,257866809,111461,1789
257867958,3.0,3.0,165000,165000,0,0,165000,Null,Null,257867958,4563837,27180
257914267,0.0,0.0,57000,51300,5700,10,57000,Null,Null,257914267,111461,15320
257915405,0.0,0.0,133000,119700,13300,10,133000,Null,Null,257915405,111461,15320
257915422,13.0,13.0,230000,230000,0,0,230000,Null,Null,257915422,628131,23052
257915531,0.0,0.0,730000,730000,0,0,730000,Null,Null,257915531,21717,49722
258090156,0.0,0.0,315000,315000,0,0,315000,Null,Null,258090156,111461,2
258090158,0.0,0.0,209000,209000,0,0,209000,Null,Null,258090158,111461,2
258090160,0.0,0.0,209000,209000,0,0,209000,Null,Null,258090160,111461,2
258090167,0.0,0.0,365000,365000,0,0,365000,Null,Null,258090167,111461,2
258090169,0.0,0.0,200000,200000,0,0,200000,Null,Null,258090169,111461,2
258090171,0.0,0.0,939000,939000,0,0,939000,Null,Null,258090171,111461,2
258090178,0.0,0.0,600000,600000,0,0,600000,Null,Null,258090178,111461,2
258090180,0.0,0.0,265000,265000,0,0,265000,Null,Null,258090180,111461,2
258090182,0.0,0.0,189000,189000,0,0,189000,Null,Null,258090182,111461,2
258090184,0.0,0.0,1065000,1065000,0,0,1065000,Null,Null,258090184,111461,2
258090186,0.0,0.0,350000,350000,0,0,350000,Null,Null,258090186,111461,2
258090222,0.0,0.0,2000000,2000000,0,0,2000000,Null,Null,258090222,111461,2
258090234,0.0,0.0,189000,189000,0,0,189000,Null,Null,258090234,111461,2
258090242,0.0,0.0,315000,315000,0,0,315000,Null,Null,258090242,111461,2
258090257,0.0,0.0,3500000,3500000,0,0,3500000,Null,Null,258090257,111461,2
258090281,0.0,0.0,439000,439000,0,0,439000,Null,Null,258090281,111461,2
258090283,0.0,0.0,189000,189000,0,0,189000,Null,Null,258090283,111461,2
258090317,0.0,0.0,350000,350000,0,0,350000,Null,Null,258090317,111461,2
258090318,0.0,0.0,315000,315000,0,0,315000,Null,Null,258090318,111461,2
258090326,0.0,0.0,275000,275000,0,0,275000,Null,Null,258090326,111461,2
258090329,0.0,0.0,1375000,1375000,0,0,1375000,Null,Null,258090329,111461,2
258090340,0.0,0.0,7500000,7500000,0,0,7500000,Null,Null,258090340,111461,2
258090342,0.0,0.0,189000,189000,0,0,189000,Null,Null,258090342,111461,2
258090343,0.0,0.0,350000,350000,0,0,350000,Null,Null,258090343,111461,2
258090369,0.0,0.0,750000,750000,0,0,750000,Null,Null,258090369,111461,2
258090378,0.0,0.0,209000,209000,0,0,209000,Null,Null,258090378,111461,2
258090380,0.0,0.0,850000,850000,0,0,850000,Null,Null,258090380,111461,2
258090385,0.0,0.0,200000,200000,0,0,200000,Null,Null,258090385,111461,2
258090391,0.0,0.0,200000,200000,0,0,200000,Null,Null,258090391,111461,2
258090392,0.0,0.0,6250000,6250000,0,0,6250000,Null,Null,258090392,111461,2
258090395,0.0,0.0,389000,389000,0,0,389000,Null,Null,258090395,111461,2
258090409,0.0,0.0,1375000,1375000,0,0,1375000,Null,Null,258090409,111461,2
258090410,0.0,0.0,750000,750000,0,0,750000,Null,Null,258090410,111461,2
258090416,0.0,0.0,225000,225000,0,0,225000,Null,Null,258090416,111461,2
258090422,0.0,0.0,6875000,6875000,0,0,6875000,Null,Null,258090422,111461,2
258090431,0.0,0.0,365000,365000,0,0,365000,Null,Null,258090431,111461,2
258090440,0.0,0.0,315000,315000,0,0,315000,Null,Null,258090440,111461,2
258090449,0.0,0.0,225000,225000,0,0,225000,Null,Null,258090449,111461,2
258090451,0.0,0.0,209000,209000,0,0,209000,Null,Null,258090451,111461,2
258090452,0.0,0.0,565000,565000,0,0,565000,Null,Null,258090452,111461,2
258090467,0.0,0.0,975000,975000,0,0,975000,Null,Null,258090467,111461,2
258090483,0.0,0.0,450000,450000,0,0,450000,Null,Null,258090483,111461,2
258090517,0.0,0.0,4125000,4125000,0,0,4125000,Null,Null,258090517,111461,2
258090523,0.0,0.0,565000,565000,0,0,565000,Null,Null,258090523,111461,2
258090524,0.0,0.0,1819000,1819000,0,0,1819000,Null,Null,258090524,111461,15250
258090557,0.0,0.0,1879000,1879000,0,0,1879000,Null,Null,258090557,111461,2
258091774,0.0,0.0,149000,149000,0,0,149000,Null,Null,258091774,111461,2
258091794,0.0,0.0,489000,489000,0,0,489000,Null,Null,258091794,111461,2
258091798,0.0,0.0,439000,439000,0,0,439000,Null,Null,258091798,111461,2
258091800,0.0,0.0,489000,489000,0,0,489000,Null,Null,258091800,111461,2
258091802,0.0,0.0,439000,439000,0,0,439000,Null,Null,258091802,111461,2
258091804,0.0,0.0,439000,439000,0,0,439000,Null,Null,258091804,111461,2
258091806,0.0,0.0,250000,250000,0,0,250000,Null,Null,258091806,111461,2
258091817,0.0,0.0,565000,565000,0,0,565000,Null,Null,258091817,111461,2
258091824,0.0,0.0,200000,200000,0,0,200000,Null,Null,258091824,111461,2
258091826,0.0,0.0,600000,600000,0,0,600000,Null,Null,258091826,111461,2
258091828,0.0,0.0,1500000,1500000,0,0,1500000,Null,Null,258091828,111461,2
258091829,0.0,0.0,175000,175000,0,0,175000,Null,Null,258091829,111461,2
258091835,0.0,0.0,350000,350000,0,0,350000,Null,Null,258091835,111461,2
258091837,0.0,0.0,1625000,1625000,0,0,1625000,Null,Null,258091837,111461,2
258091854,0.0,0.0,369000,369000,0,0,369000,Null,Null,258091854,111461,2
258091863,0.0,0.0,315000,315000,0,0,315000,Null,Null,258091863,111461,2
258184282,0.0,0.0,188000,188000,0,0,188000,Null,Null,258184282,111461,7449
258184587,0.0,0.0,2100000,1050000,1050000,50,2100000,Null,Null,258184587,111461,15250
258209206,0.0,0.0,1099000,989100,109900,10,1099000,Null,Null,258209206,704815,15250
258274375,0.0,0.0,2000,2000,0,0,2000,Null,Null,258274375,111461,2
258274815,0.0,0.0,2000,2000,0,0,2000,Null,Null,258274815,111461,2
258330471,1.0,1.0,3200000,2960000,240000,8,3200000,Null,Null,258330471,111461,1789
258373871,8.0,8.0,3490000,2990000,500000,14,3490000,Null,Null,258373871,111684,1795
258496468,0.0,0.0,135000,121500,13500,10,135000,Null,Null,258496468,111461,15320
258497473,0.0,0.0,1899000,1709100,189900,10,1899000,Null,Null,258497473,704815,15236
258497478,0.0,0.0,368000,331200,36800,10,368000,Null,Null,258497478,111461,15318
258507244,0.0,0.0,1350000,1215000,135000,10,1350000,Null,Null,258507244,704815,15250
258509151,0.0,0.0,699000,629100,69900,10,699000,Null,Null,258509151,704815,15250
258509179,0.0,0.0,1099000,989100,109900,10,1099000,Null,Null,258509179,704815,15250
258514404,0.0,0.0,1500,1500,0,0,1500,Null,Null,258514404,111461,2
258525956,0.0,0.0,11056,11056,0,0,11056,Null,Null,258525956,111461,2
258567507,0.0,0.0,20000,9000,11000,55,20000,Null,Null,258567507,111461,15318
258667842,0.0,0.0,7990000,6750000,1240000,16,7990000,Null,Null,258667842,25422,1795
258668285,0.0,0.0,469000,459000,10000,2,469000,Null,Null,258668285,18804,8061
258670012,0.0,0.0,1693000,1693000,0,0,1693000,Null,Null,258670012,256727,15320
258670160,0.0,0.0,1790000,1790000,0,0,1790000,Null,Null,258670160,256727,15320
258670239,0.0,0.0,1989000,1989000,0,0,1989000,Null,Null,258670239,256727,15320
258673229,0.0,0.0,2807000,2807000,0,0,2807000,Null,Null,258673229,256727,15320
258692676,0.0,0.0,0,3312000,0,0,3312000,Null,Null,258692676,256727,0
258739366,0.0,0.0,3329000,3329000,0,0,3329000,Null,Null,258739366,256727,15318
258752335,0.0,0.0,2668000,2668000,0,0,2668000,Null,Null,258752335,256727,15318
258766780,0.0,0.0,25000,25000,0,0,25000,Null,Null,258766780,111461,2
258766852,0.0,0.0,35000,35000,0,0,35000,Null,Null,258766852,111461,2
258766897,0.0,0.0,468000,468000,0,0,468000,Null,Null,258766897,112638,1796
258766933,0.0,0.0,10990000,7990000,3000000,27,10990000,Null,Null,258766933,18802,1794
258787119,0.0,0.0,8990000,8990000,0,0,8990000,Null,Null,258787119,112735,1794
258848656,0.0,0.0,890000,890000,0,0,890000,Null,Null,258848656,111461,12928
258857637,0.0,0.0,1999,1999,0,0,1999,Null,Null,258857637,111461,2
258857826,0.0,0.0,16490000,16490000,0,0,16490000,Null,Null,258857826,114527,8043
258862420,0.0,0.0,1800,1800,0,0,1800,Null,Null,258862420,111461,2
258897488,0.0,0.0,159000,159000,0,0,159000,Null,Null,258897488,111461,15318
258928734,0.0,0.0,16490000,16490000,0,0,16490000,Null,Null,258928734,114527,2657
259317613,0.0,0.0,45000,45000,0,0,45000,Null,Null,259317613,111461,49722
259320195,0.0,0.0,1000,1000,0,0,1000,Null,Null,259320195,111461,2
259417214,3.0,3.0,9000,7500,1500,17,9000,Null,Null,259417214,712223,11869
259458889,2.0,2.0,10000,8500,1500,15,10000,Null,Null,259458889,712223,11869
259477758,0.0,0.0,57000,57000,0,0,57000,Null,Null,259477758,8187003,11899
259514222,1.0,1.0,7400000,7400000,0,0,7400000,Null,Null,259514222,111461,8165
259514693,1781.0,1781.0,245000,159000,86000,35,245000,Null,Null,259514693,4259821,1883
259515191,3.0,3.0,1500000,1399000,101000,7,1500000,Null,Null,259515191,885047,28482
259520307,0.0,0.0,6000,6000,0,0,6000,Null,Null,259520307,111461,7064
259520372,0.0,0.0,7400000,7400000,0,0,7400000,Null,Null,259520372,111461,8165
259520401,0.0,0.0,6500,6500,0,0,6500,Null,Null,259520401,111461,7064
259520690,0.0,0.0,5500,5500,0,0,5500,Null,Null,259520690,111461,7064
259535232,0.0,0.0,30000,28800,1200,4,30000,Null,Null,259535232,111461,49728
259535233,0.0,0.0,55000,55000,0,0,55000,Null,Null,259535233,111461,49728
259535239,0.0,0.0,28000,28000,0,0,28000,Null,Null,259535239,111461,49728
259535244,0.0,0.0,58000,55680,2320,4,58000,Null,Null,259535244,111461,49728
259535258,0.0,0.0,55000,55000,0,0,55000,Null,Null,259535258,111461,49728
259535259,0.0,0.0,28000,26880,1120,4,28000,Null,Null,259535259,111461,49728
259535273,0.0,0.0,58000,58000,0,0,58000,Null,Null,259535273,111461,49728
259535297,0.0,0.0,30000,28800,1200,4,30000,Null,Null,259535297,111461,49728
259535303,0.0,0.0,45000,43200,1800,4,45000,Null,Null,259535303,111461,49728
259535306,0.0,0.0,65000,65000,0,0,65000,Null,Null,259535306,111461,49728
259535321,0.0,0.0,55000,55000,0,0,55000,Null,Null,259535321,111461,49728
259535336,0.0,0.0,65000,62400,2600,4,65000,Null,Null,259535336,111461,49728
259535342,1.0,1.0,65000,62400,2600,4,65000,Null,Null,259535342,111461,49728
259535356,0.0,0.0,65000,65000,0,0,65000,Null,Null,259535356,111461,49728
259535377,0.0,0.0,65000,65000,0,0,65000,Null,Null,259535377,111461,49728
259535396,0.0,0.0,65000,62400,2600,4,65000,Null,Null,259535396,111461,49728
259535406,0.0,0.0,25000,24000,1000,4,25000,Null,Null,259535406,111461,49728
259536049,0.0,0.0,115000,115000,0,0,115000,Null,Null,259536049,111461,49722
259536733,0.0,0.0,7500000,7500000,0,0,7500000,Null,Null,259536733,111461,15318
259537360,0.0,0.0,238000,212000,26000,11,238000,Null,Null,259537360,111461,15320
259537475,0.0,0.0,6900000,6900000,0,0,6900000,Null,Null,259537475,111461,15318
259539741,0.0,0.0,4000,4000,0,0,4000,Null,Null,259539741,111461,2
259540340,0.0,0.0,28000,28000,0,0,28000,Null,Null,259540340,111461,2
259541719,0.0,0.0,45000,45000,0,0,45000,Null,Null,259541719,111461,2
259542122,0.0,0.0,9900000,9900000,0,0,9900000,Null,Null,259542122,111461,15318
259542510,0.0,0.0,1299000,1299000,0,0,1299000,Null,Null,259542510,111461,15318
259542697,2.0,2.0,6690000,5590000,1100000,16,6690000,Null,Null,259542697,25422,1795
259542896,0.0,0.0,2160000,1080000,1080000,50,2160000,Null,Null,259542896,111461,15250
259562105,0.0,0.0,25000,25000,0,0,25000,Null,Null,259562105,111461,2
259562630,0.0,0.0,2000,2000,0,0,2000,Null,Null,259562630,111461,2
259562788,0.0,0.0,1500,1500,0,0,1500,Null,Null,259562788,111461,2
259563972,1.0,1.0,18000,18000,0,0,18000,Null,Null,259563972,111461,2
259564020,1.0,1.0,6000,6000,0,0,6000,Null,Null,259564020,111461,2
259567940,15.0,15.0,159000,155000,4000,3,159000,Null,Null,259567940,7288833,27180
259695046,1.0,1.0,10000,9000,1000,10,10000,Null,Null,259695046,111461,2
259767983,0.0,0.0,15200,7000,8200,54,15200,Null,Null,259767983,111461,15318
259770562,1.0,1.0,250000,199000,51000,20,250000,Null,Null,259770562,111461,49722
259770666,0.0,0.0,250000,199000,51000,20,250000,Null,Null,259770666,111461,15318
259771416,0.0,0.0,250000,250000,0,0,250000,Null,Null,259771416,153088,49722
259779598,0.0,0.0,9000,9000,0,0,9000,Null,Null,259779598,111461,2
259793781,0.0,0.0,250000,250000,0,0,250000,Null,Null,259793781,153088,49722
259802669,0.0,0.0,250000,250000,0,0,250000,Null,Null,259802669,153088,49722
259821304,0.0,0.0,250000,250000,0,0,250000,Null,Null,259821304,111461,49722
259834928,0.0,0.0,250000,250000,0,0,250000,Null,Null,259834928,111461,49722
260103048,0.0,0.0,17900000,17900000,0,0,17900000,Null,Null,260103048,111461,28862
260108221,13.0,13.0,60000,58800,1200,2,60000,Null,Null,260108221,21653,28426
260110712,0.0,0.0,2750000,2475000,275000,10,2750000,Null,Null,260110712,704815,15320
260202512,0.0,0.0,115000,110400,4600,4,115000,Null,Null,260202512,111461,5384
260222222,0.0,0.0,115000,110400,4600,4,115000,Null,Null,260222222,111461,49722
260222427,0.0,0.0,11690000,11398000,292000,2,11690000,Null,Null,260222427,114527,8043
260222679,0.0,0.0,1780000,890000,890000,50,1780000,Null,Null,260222679,111461,15250
260231310,0.0,0.0,249000,249000,0,0,249000,Null,Null,260231310,111461,15318
260234429,0.0,0.0,11690000,11339000,351000,3,11690000,Null,Null,260234429,114527,2657
260269910,0.0,0.0,20319000,20319000,0,0,20319000,Null,Null,260269910,111461,2657
260300875,0.0,0.0,350000,350000,0,0,350000,Null,Null,260300875,7506817,15318
260406257,0.0,0.0,3990000,3990000,0,0,3990000,Null,Null,260406257,112735,1795
260407211,0.0,0.0,159000,159000,0,0,159000,Null,Null,260407211,111461,15318
260536310,4.0,4.0,180000,110000,70000,39,180000,Null,Null,260536310,111461,9013
260640664,0.0,0.0,650000,650000,0,0,650000,Null,Null,260640664,5653553,49724
260669051,0.0,0.0,5000000,4450000,550000,11,5000000,Null,Null,260669051,111461,15250
260684914,0.0,0.0,159000,159000,0,0,159000,Null,Null,260684914,111461,15318
260685387,0.0,0.0,159000,159000,0,0,159000,Null,Null,260685387,111461,15318
260685597,1.0,1.0,650000,650000,0,0,650000,Null,Null,260685597,7506817,15318
260685604,0.0,0.0,488888,435000,53888,11,488888,Null,Null,260685604,111461,15318
260685631,0.0,0.0,466666,415000,51666,11,466666,Null,Null,260685631,111461,15318
260685661,12.0,12.0,250000,190000,60000,24,250000,Null,Null,260685661,8137481,9013
260701783,0.0,0.0,15000,9000,6000,40,15000,Null,Null,260701783,150215,17186
260739386,0.0,0.0,6500,6500,0,0,6500,Null,Null,260739386,111461,8197
260795606,0.0,0.0,2952000,2952000,0,0,2952000,Null,Null,260795606,256727,15318
260795718,0.0,0.0,2877000,2877000,0,0,2877000,Null,Null,260795718,256727,15318
260797475,0.0,0.0,81000,72900,8100,10,81000,Null,Null,260797475,111461,15320
260798129,0.0,0.0,2999000,2999000,0,0,2999000,Null,Null,260798129,256727,15318
260798189,0.0,0.0,4199000,4199000,0,0,4199000,Null,Null,260798189,256727,15318
260801386,0.0,0.0,4999000,4999000,0,0,4999000,Null,Null,260801386,256727,15318
260801538,0.0,0.0,65500,52400,13100,20,65500,Null,Null,260801538,8195091,17186
260801540,0.0,0.0,82500,66000,16500,20,82500,Null,Null,260801540,8194961,17186
260801545,0.0,0.0,181500,145200,36300,20,181500,Null,Null,260801545,8194961,17186
260801547,0.0,0.0,151500,121200,30300,20,151500,Null,Null,260801547,8195091,17186
260801562,0.0,0.0,182000,145600,36400,20,182000,Null,Null,260801562,331811,17186
260801563,0.0,0.0,324000,259200,64800,20,324000,Null,Null,260801563,8194961,17186
260801574,0.0,0.0,42500,34000,8500,20,42500,Null,Null,260801574,8195091,17186
260801577,0.0,0.0,23000,18400,4600,20,23000,Null,Null,260801577,8194965,17186
260804874,0.0,0.0,1926000,1926000,0,0,1926000,Null,Null,260804874,256727,15320
260804921,0.0,0.0,2999000,2999000,0,0,2999000,Null,Null,260804921,256727,15320
260805033,0.0,0.0,1860000,1860000,0,0,1860000,Null,Null,260805033,256727,15320
260805144,0.0,0.0,1390000,1390000,0,0,1390000,Null,Null,260805144,256727,15320
260805181,0.0,0.0,1590000,1590000,0,0,1590000,Null,Null,260805181,256727,15320
260805667,1289.0,1289.0,132000,109000,23000,17,132000,Null,Null,260805667,49242,8300
260806503,0.0,0.0,3990000,3390000,600000,15,3990000,Null,Null,260806503,208841,2340
260807230,0.0,0.0,15200,7000,8200,54,15200,Null,Null,260807230,111461,15318
260807340,0.0,0.0,59000,59000,0,0,59000,Null,Null,260807340,111461,2
260807342,0.0,0.0,55000,55000,0,0,55000,Null,Null,260807342,111461,2
260807343,0.0,0.0,69000,69000,0,0,69000,Null,Null,260807343,111461,2
260807347,0.0,0.0,75000,75000,0,0,75000,Null,Null,260807347,111461,2
260807349,0.0,0.0,75000,75000,0,0,75000,Null,Null,260807349,111461,2
260807352,0.0,0.0,39000,39000,0,0,39000,Null,Null,260807352,111461,2
260807355,0.0,0.0,85000,85000,0,0,85000,Null,Null,260807355,111461,2
260807358,0.0,0.0,59000,59000,0,0,59000,Null,Null,260807358,111461,2
260807359,0.0,0.0,55000,55000,0,0,55000,Null,Null,260807359,111461,2
260807360,0.0,0.0,58000,58000,0,0,58000,Null,Null,260807360,111461,2
260807361,0.0,0.0,55000,55000,0,0,55000,Null,Null,260807361,111461,2
260807366,0.0,0.0,79000,79000,0,0,79000,Null,Null,260807366,111461,2
260807375,0.0,0.0,75000,75000,0,0,75000,Null,Null,260807375,111461,2
260807376,0.0,0.0,55000,55000,0,0,55000,Null,Null,260807376,111461,2
260807377,0.0,0.0,59000,59000,0,0,59000,Null,Null,260807377,111461,2
260807382,0.0,0.0,55000,55000,0,0,55000,Null,Null,260807382,111461,2
260807383,0.0,0.0,85000,85000,0,0,85000,Null,Null,260807383,111461,2
260807386,0.0,0.0,75000,75000,0,0,75000,Null,Null,260807386,111461,2
260807387,0.0,0.0,55000,55000,0,0,55000,Null,Null,260807387,111461,2
260807389,0.0,0.0,57000,57000,0,0,57000,Null,Null,260807389,111461,2
260807391,0.0,0.0,59000,59000,0,0,59000,Null,Null,260807391,111461,2
260807393,0.0,0.0,80962,80962,0,0,80962,Null,Null,260807393,111461,2
260807399,0.0,0.0,85000,85000,0,0,85000,Null,Null,260807399,111461,2
260807410,0.0,0.0,59000,59000,0,0,59000,Null,Null,260807410,111461,2
260807412,0.0,0.0,79000,79000,0,0,79000,Null,Null,260807412,111461,2
260807425,0.0,0.0,75000,75000,0,0,75000,Null,Null,260807425,111461,2
260807428,0.0,0.0,45000,45000,0,0,45000,Null,Null,260807428,111461,2
260807430,0.0,0.0,83160,83160,0,0,83160,Null,Null,260807430,111461,2
260807431,0.0,0.0,59000,59000,0,0,59000,Null,Null,260807431,111461,2
260807432,0.0,0.0,75000,75000,0,0,75000,Null,Null,260807432,111461,2
260807440,0.0,0.0,32000,32000,0,0,32000,Null,Null,260807440,111461,2
260807441,0.0,0.0,69000,69000,0,0,69000,Null,Null,260807441,111461,2
260807442,0.0,0.0,52000,52000,0,0,52000,Null,Null,260807442,111461,2
260807445,0.0,0.0,65000,65000,0,0,65000,Null,Null,260807445,111461,2
260807450,0.0,0.0,57000,57000,0,0,57000,Null,Null,260807450,111461,2
260807452,0.0,0.0,189000,189000,0,0,189000,Null,Null,260807452,111461,2
260807456,0.0,0.0,85000,85000,0,0,85000,Null,Null,260807456,111461,2
260807477,0.0,0.0,69000,69000,0,0,69000,Null,Null,260807477,111461,2
260807480,0.0,0.0,79000,79000,0,0,79000,Null,Null,260807480,111461,2
260807487,0.0,0.0,65000,65000,0,0,65000,Null,Null,260807487,111461,2
260807488,0.0,0.0,85000,85000,0,0,85000,Null,Null,260807488,111461,2
260807495,0.0,0.0,69000,69000,0,0,69000,Null,Null,260807495,111461,2
260807497,0.0,0.0,75000,75000,0,0,75000,Null,Null,260807497,111461,2
260807499,0.0,0.0,75000,75000,0,0,75000,Null,Null,260807499,111461,2
260807502,0.0,0.0,69000,69000,0,0,69000,Null,Null,260807502,111461,2
260807503,0.0,0.0,75000,75000,0,0,75000,Null,Null,260807503,111461,2
260807504,0.0,0.0,89000,89000,0,0,89000,Null,Null,260807504,111461,2
260807509,0.0,0.0,85000,85000,0,0,85000,Null,Null,260807509,111461,2
260807511,0.0,0.0,75000,75000,0,0,75000,Null,Null,260807511,111461,2
260807512,0.0,0.0,75000,75000,0,0,75000,Null,Null,260807512,111461,2
260807515,0.0,0.0,55000,55000,0,0,55000,Null,Null,260807515,111461,2
260807517,0.0,0.0,79000,79000,0,0,79000,Null,Null,260807517,111461,2
260807518,0.0,0.0,99000,99000,0,0,99000,Null,Null,260807518,111461,2
260807530,0.0,0.0,65000,65000,0,0,65000,Null,Null,260807530,111461,2
260807532,0.0,0.0,59000,59000,0,0,59000,Null,Null,260807532,111461,2
260807534,0.0,0.0,45000,45000,0,0,45000,Null,Null,260807534,111461,2
260807535,0.0,0.0,63000,63000,0,0,63000,Null,Null,260807535,111461,2
260807537,0.0,0.0,55000,55000,0,0,55000,Null,Null,260807537,111461,2
260807564,0.0,0.0,69000,69000,0,0,69000,Null,Null,260807564,111461,2
260807569,0.0,0.0,65000,65000,0,0,65000,Null,Null,260807569,111461,2
260807574,0.0,0.0,85000,85000,0,0,85000,Null,Null,260807574,111461,2
260807575,0.0,0.0,85000,85000,0,0,85000,Null,Null,260807575,111461,2
260807583,0.0,0.0,55000,55000,0,0,55000,Null,Null,260807583,111461,2
260807588,0.0,0.0,85000,85000,0,0,85000,Null,Null,260807588,111461,2
260807589,0.0,0.0,39000,39000,0,0,39000,Null,Null,260807589,111461,2
260807593,0.0,0.0,65000,65000,0,0,65000,Null,Null,260807593,111461,2
260807596,0.0,0.0,75000,75000,0,0,75000,Null,Null,260807596,111461,2
260807601,0.0,0.0,55000,55000,0,0,55000,Null,Null,260807601,111461,2
260811854,0.0,0.0,752000,601600,150400,20,752000,Null,Null,260811854,26150,8516
260811856,0.0,0.0,2542000,2033600,508400,20,2542000,Null,Null,260811856,26150,8516
260811860,0.0,0.0,3628000,2902400,725600,20,3628000,Null,Null,260811860,26150,8516
260811862,0.0,0.0,5182000,4145600,1036400,20,5182000,Null,Null,260811862,26150,8513
260811866,0.0,0.0,3529000,2823200,705800,20,3529000,Null,Null,260811866,26150,8513
260811870,0.0,0.0,3529000,2823200,705800,20,3529000,Null,Null,260811870,26150,8513
260811874,0.0,0.0,691000,552800,138200,20,691000,Null,Null,260811874,26150,8513
260811876,0.0,0.0,3529000,2823200,705800,20,3529000,Null,Null,260811876,26150,8513
260811878,0.0,0.0,3628000,2902400,725600,20,3628000,Null,Null,260811878,26150,8516
260811881,0.0,0.0,6490000,5192000,1298000,20,6490000,Null,Null,260811881,26150,8513
260811884,0.0,0.0,3628000,2902400,725600,20,3628000,Null,Null,260811884,26150,8516
260811886,0.0,0.0,15545000,12436000,3109000,20,15545000,Null,Null,260811886,26150,8513
260811888,0.0,0.0,3628000,2902400,725600,20,3628000,Null,Null,260811888,26150,8516
260811890,0.0,0.0,815000,652000,163000,20,815000,Null,Null,260811890,26150,8513
260812108,0.0,0.0,3529000,2823200,705800,20,3529000,Null,Null,260812108,26150,8513
260813303,7.0,7.0,499000,283000,216000,43,499000,Null,Null,260813303,18984,1838
260814453,0.0,0.0,188000,180480,7520,4,188000,Null,Null,260814453,111461,49722
260815021,0.0,0.0,115000,110400,4600,4,115000,Null,Null,260815021,111461,49722
260817041,0.0,0.0,165000,158400,6600,4,165000,Null,Null,260817041,111461,5384
260817186,0.0,0.0,950000,950000,0,0,950000,Null,Null,260817186,183257,15318
260817900,0.0,0.0,348000,218000,130000,37,348000,Null,Null,260817900,183257,15318
260818295,0.0,0.0,17500000,17500000,0,0,17500000,Null,Null,260818295,111461,28862
260819122,0.0,0.0,5000,5000,0,0,5000,Null,Null,260819122,111461,2
260826362,0.0,0.0,94000,84600,9400,10,94000,Null,Null,260826362,111461,15250
260827759,0.0,0.0,134000,120600,13400,10,134000,Null,Null,260827759,111461,15250
260828212,0.0,0.0,3300000,3300000,0,0,3300000,Null,Null,260828212,720887,8512
260830088,0.0,0.0,209000,209000,0,0,209000,Null,Null,260830088,111461,49726
260830204,0.0,0.0,219000,219000,0,0,219000,Null,Null,260830204,111461,49726
260844985,9252.0,9252.0,400000,290000,110000,28,400000,Null,Null,260844985,569135,3426
260845089,0.0,0.0,3500000,3500000,0,0,3500000,Null,Null,260845089,720887,8512
260847275,1763.0,1763.0,450000,375000,75000,17,450000,Null,Null,260847275,569135,3426
260858200,0.0,0.0,2250000,2250000,0,0,2250000,Null,Null,260858200,720887,5384
260860868,0.0,0.0,2150000,2150000,0,0,2150000,Null,Null,260860868,720887,5385
260881549,0.0,0.0,1950000,1950000,0,0,1950000,Null,Null,260881549,720887,5385
260918654,0.0,0.0,9200000,9200000,0,0,9200000,Null,Null,260918654,223635,1636
260918919,0.0,0.0,9200000,9200000,0,0,9200000,Null,Null,260918919,223635,1636
260919356,0.0,0.0,9200000,9200000,0,0,9200000,Null,Null,260919356,223635,1636
260919650,0.0,0.0,9200000,9200000,0,0,9200000,Null,Null,260919650,223635,1636
260919718,0.0,0.0,9200000,9200000,0,0,9200000,Null,Null,260919718,223635,1636
260920244,0.0,0.0,960000,480000,480000,50,960000,Null,Null,260920244,111461,15318
260922159,5.0,5.0,150000,150000,0,0,150000,Null,Null,260922159,857381,5531
260923003,0.0,0.0,84000,42000,42000,50,84000,Null,Null,260923003,111461,15318
260924223,0.0,0.0,750500,595000,155500,21,750500,Null,Null,260924223,5719107,2
260924236,0.0,0.0,750500,595000,155500,21,750500,Null,Null,260924236,5719107,2
260924242,0.0,0.0,1244500,986000,258500,21,1244500,Null,Null,260924242,5719107,2
260924244,0.0,0.0,750500,595000,155500,21,750500,Null,Null,260924244,5719107,2
260924285,0.0,0.0,769500,610000,159500,21,769500,Null,Null,260924285,5719107,2
260924289,0.0,0.0,982394,778000,204394,21,982394,Null,Null,260924289,5719107,2
260924302,0.0,0.0,636500,504000,132500,21,636500,Null,Null,260924302,5719107,2
260924317,0.0,0.0,579500,459000,120500,21,579500,Null,Null,260924317,5719107,2
260924351,0.0,0.0,741000,587000,154000,21,741000,Null,Null,260924351,5719107,2
260924354,0.0,0.0,2142900,2142900,0,0,2142900,Null,Null,260924354,5719107,2
260924359,0.0,0.0,1083000,1083000,0,0,1083000,Null,Null,260924359,5719107,2
260924366,0.0,0.0,807500,640000,167500,21,807500,Null,Null,260924366,5719107,2
260924389,0.0,0.0,2999000,2999000,0,0,2999000,Null,Null,260924389,256727,15236
260924513,1.0,1.0,1796000,1796000,0,0,1796000,Null,Null,260924513,256727,15236
260924536,0.0,0.0,1646000,1646000,0,0,1646000,Null,Null,260924536,256727,15236
260924559,0.0,0.0,3199000,3199000,0,0,3199000,Null,Null,260924559,256727,15236
260924584,0.0,0.0,18335000,18335000,0,0,18335000,Null,Null,260924584,256727,15236
260924636,0.0,0.0,18915000,18915000,0,0,18915000,Null,Null,260924636,256727,15236
260924668,0.0,0.0,19901000,19901000,0,0,19901000,Null,Null,260924668,256727,15236
260930564,0.0,0.0,225000,216000,9000,4,225000,Null,Null,260930564,111461,49722
260931843,0.0,0.0,7610000,4490000,3120000,41,7610000,Null,Null,260931843,7982659,8512
260931894,0.0,0.0,215000,215000,0,0,215000,Null,Null,260931894,111461,49722
260932829,0.0,0.0,225000,225000,0,0,225000,Null,Null,260932829,111461,49722
260933001,0.0,0.0,7610000,4490000,3120000,41,7610000,Null,Null,260933001,7982659,8513
260934021,0.0,0.0,3950000,3950000,0,0,3950000,Null,Null,260934021,47424,8172
260934178,0.0,0.0,7310000,4950000,2360000,32,7310000,Null,Null,260934178,7982659,7449
260939025,0.0,0.0,235000,235000,0,0,235000,Null,Null,260939025,111461,49722
260939556,0.0,0.0,15000,15000,0,0,15000,Null,Null,260939556,111461,2
260939911,0.0,0.0,30000,30000,0,0,30000,Null,Null,260939911,111461,49728
260940937,0.0,0.0,1125000,1125000,0,0,1125000,Null,Null,260940937,111461,2
260940942,0.0,0.0,189000,189000,0,0,189000,Null,Null,260940942,111461,2
260940943,0.0,0.0,475000,475000,0,0,475000,Null,Null,260940943,111461,2
260940945,0.0,0.0,190000,190000,0,0,190000,Null,Null,260940945,111461,2
260940948,0.0,0.0,2250000,2250000,0,0,2250000,Null,Null,260940948,111461,2
260940949,0.0,0.0,189000,189000,0,0,189000,Null,Null,260940949,111461,2
260940951,0.0,0.0,400000,400000,0,0,400000,Null,Null,260940951,111461,2
260940954,0.0,0.0,400000,400000,0,0,400000,Null,Null,260940954,111461,2
260940955,0.0,0.0,189000,189000,0,0,189000,Null,Null,260940955,111461,2
260940957,0.0,0.0,815000,815000,0,0,815000,Null,Null,260940957,111461,2
260940961,0.0,0.0,315000,315000,0,0,315000,Null,Null,260940961,111461,2
260940964,0.0,0.0,850000,850000,0,0,850000,Null,Null,260940964,111461,2
260940967,0.0,0.0,209000,209000,0,0,209000,Null,Null,260940967,111461,2
260940968,0.0,0.0,265000,265000,0,0,265000,Null,Null,260940968,111461,2
260940971,0.0,0.0,315000,315000,0,0,315000,Null,Null,260940971,111461,2
260940972,0.0,0.0,189000,189000,0,0,189000,Null,Null,260940972,111461,2
260940974,0.0,0.0,850000,850000,0,0,850000,Null,Null,260940974,111461,2
260940975,0.0,0.0,139000,139000,0,0,139000,Null,Null,260940975,111461,2
260940981,0.0,0.0,189000,189000,0,0,189000,Null,Null,260940981,111461,2
260940987,0.0,0.0,850000,850000,0,0,850000,Null,Null,260940987,111461,2
260940989,0.0,0.0,200000,200000,0,0,200000,Null,Null,260940989,111461,2
260940991,0.0,0.0,350000,350000,0,0,350000,Null,Null,260940991,111461,2
260941000,0.0,0.0,369000,369000,0,0,369000,Null,Null,260941000,111461,2
260941001,0.0,0.0,815000,815000,0,0,815000,Null,Null,260941001,111461,2
260941004,0.0,0.0,200000,200000,0,0,200000,Null,Null,260941004,111461,2
260941005,0.0,0.0,350000,350000,0,0,350000,Null,Null,260941005,111461,2
260941008,0.0,0.0,439000,439000,0,0,439000,Null,Null,260941008,111461,2
260941017,0.0,0.0,1000000,1000000,0,0,1000000,Null,Null,260941017,111461,2
260941024,0.0,0.0,119000,119000,0,0,119000,Null,Null,260941024,111461,2
260941026,0.0,0.0,625000,625000,0,0,625000,Null,Null,260941026,111461,2
260941034,0.0,0.0,565000,565000,0,0,565000,Null,Null,260941034,111461,2
260941036,0.0,0.0,439000,439000,0,0,439000,Null,Null,260941036,111461,2
260941040,0.0,0.0,189000,189000,0,0,189000,Null,Null,260941040,111461,2
260941044,0.0,0.0,689000,689000,0,0,689000,Null,Null,260941044,111461,2
260941049,0.0,0.0,565000,565000,0,0,565000,Null,Null,260941049,111461,2
260941062,0.0,0.0,500000,500000,0,0,500000,Null,Null,260941062,111461,2
260941067,0.0,0.0,475000,475000,0,0,475000,Null,Null,260941067,111461,2
260941068,0.0,0.0,265000,265000,0,0,265000,Null,Null,260941068,111461,2
260941073,0.0,0.0,1000000,1000000,0,0,1000000,Null,Null,260941073,111461,2
260941074,0.0,0.0,225000,225000,0,0,225000,Null,Null,260941074,111461,2
260941082,0.0,0.0,1000000,1000000,0,0,1000000,Null,Null,260941082,111461,2
260941083,0.0,0.0,850000,850000,0,0,850000,Null,Null,260941083,111461,2
260941085,0.0,0.0,200000,200000,0,0,200000,Null,Null,260941085,111461,2
260941086,0.0,0.0,975000,975000,0,0,975000,Null,Null,260941086,111461,2
260941096,0.0,0.0,315000,315000,0,0,315000,Null,Null,260941096,111461,2
260941100,0.0,0.0,215000,215000,0,0,215000,Null,Null,260941100,111461,2
260941103,0.0,0.0,1250000,1250000,0,0,1250000,Null,Null,260941103,111461,2
260941107,0.0,0.0,190000,190000,0,0,190000,Null,Null,260941107,111461,2
260941116,0.0,0.0,275000,275000,0,0,275000,Null,Null,260941116,111461,2
260941118,0.0,0.0,565000,565000,0,0,565000,Null,Null,260941118,111461,2
260941120,0.0,0.0,850000,850000,0,0,850000,Null,Null,260941120,111461,2
260941126,0.0,0.0,350000,350000,0,0,350000,Null,Null,260941126,111461,2
260941143,0.0,0.0,350000,350000,0,0,350000,Null,Null,260941143,111461,2
260941145,0.0,0.0,750000,750000,0,0,750000,Null,Null,260941145,111461,2
260942425,0.0,0.0,159000,159000,0,0,159000,Null,Null,260942425,111461,15318
260986508,3.0,3.0,5990000,4650000,1340000,22,5990000,Null,Null,260986508,183637,28856
261023670,0.0,0.0,2825000,2825000,0,0,2825000,Null,Null,261023670,111644,8512
261023675,0.0,0.0,4400000,4400000,0,0,4400000,Null,Null,261023675,111644,8512
261023695,0.0,0.0,4975000,4975000,0,0,4975000,Null,Null,261023695,111644,8512
261023745,0.0,0.0,2325000,2325000,0,0,2325000,Null,Null,261023745,111644,8512
261023785,0.0,0.0,3625000,3625000,0,0,3625000,Null,Null,261023785,111644,8512
261023787,0.0,0.0,3475000,3475000,0,0,3475000,Null,Null,261023787,111644,8512
261023794,0.0,0.0,3825000,3825000,0,0,3825000,Null,Null,261023794,111644,8512
261023958,0.0,0.0,2325000,2325000,0,0,2325000,Null,Null,261023958,111644,8512
261023961,0.0,0.0,3475000,3475000,0,0,3475000,Null,Null,261023961,111644,8512
261023964,0.0,0.0,3125000,3125000,0,0,3125000,Null,Null,261023964,111644,8512
261023975,0.0,0.0,4225000,4225000,0,0,4225000,Null,Null,261023975,111644,8512
261023978,0.0,0.0,6650000,6650000,0,0,6650000,Null,Null,261023978,111644,8512
261023982,0.0,0.0,2475000,2475000,0,0,2475000,Null,Null,261023982,111644,8512
261024083,0.0,0.0,2475000,2475000,0,0,2475000,Null,Null,261024083,111644,8512
261024125,0.0,0.0,2625000,2625000,0,0,2625000,Null,Null,261024125,111644,8512
261024141,0.0,0.0,2350000,2350000,0,0,2350000,Null,Null,261024141,111644,8512
261024182,0.0,0.0,2825000,2825000,0,0,2825000,Null,Null,261024182,111644,8512
261024247,0.0,0.0,2975000,2975000,0,0,2975000,Null,Null,261024247,111644,8512
261024286,0.0,0.0,2475000,2475000,0,0,2475000,Null,Null,261024286,111644,8512
261024576,0.0,0.0,35600,16000,19600,55,35600,Null,Null,261024576,111461,15318
261025255,1.0,1.0,115000,115000,0,0,115000,Null,Null,261025255,111461,49722
261025268,0.0,0.0,2000,2000,0,0,2000,Null,Null,261025268,111461,2
261025280,0.0,0.0,1000,1000,0,0,1000,Null,Null,261025280,111461,2
261025289,0.0,0.0,2000,2000,0,0,2000,Null,Null,261025289,111461,2
261025538,0.0,0.0,11500000,11500000,0,0,11500000,Null,Null,261025538,27398,2340
261025665,0.0,0.0,155000,155000,0,0,155000,Null,Null,261025665,111461,49722
261026069,0.0,0.0,45000,45000,0,0,45000,Null,Null,261026069,111461,8371
261027940,0.0,0.0,265000,265000,0,0,265000,Null,Null,261027940,111461,49722
261028278,0.0,0.0,32000,32000,0,0,32000,Null,Null,261028278,111461,15318
261028833,0.0,0.0,32000,32000,0,0,32000,Null,Null,261028833,111461,15318
261036293,0.0,0.0,18000,18000,0,0,18000,Null,Null,261036293,111461,15318
261037635,0.0,0.0,32000,32000,0,0,32000,Null,Null,261037635,111461,15318
261037878,0.0,0.0,22000,22000,0,0,22000,Null,Null,261037878,111461,15318
261037973,0.0,0.0,9490000,7190000,2300000,24,9490000,Null,Null,261037973,18802,1795
261075499,1.0,1.0,19900,19900,0,0,19900,Null,Null,261075499,111461,15320
261094027,0.0,0.0,9000,9000,0,0,9000,Null,Null,261094027,111461,8193
261113163,0.0,0.0,5000,5000,0,0,5000,Null,Null,261113163,111461,8194
261113497,0.0,0.0,890000,890000,0,0,890000,Null,Null,261113497,46363,2
261113499,0.0,0.0,980000,980000,0,0,980000,Null,Null,261113499,46363,2
261113500,0.0,0.0,1355000,1355000,0,0,1355000,Null,Null,261113500,46363,2
261113503,0.0,0.0,997000,997000,0,0,997000,Null,Null,261113503,46363,2
261113504,0.0,0.0,960000,960000,0,0,960000,Null,Null,261113504,46363,2
261113512,0.0,0.0,997000,997000,0,0,997000,Null,Null,261113512,46363,2
261113513,0.0,0.0,980000,980000,0,0,980000,Null,Null,261113513,46363,2
261113516,0.0,0.0,1079000,1079000,0,0,1079000,Null,Null,261113516,46363,2
261113518,0.0,0.0,1199000,1199000,0,0,1199000,Null,Null,261113518,46363,2
261113520,0.0,0.0,1768002,1768002,0,0,1768002,Null,Null,261113520,46363,2
261113522,0.0,0.0,1089000,1089000,0,0,1089000,Null,Null,261113522,46363,2
261113524,0.0,0.0,980000,980000,0,0,980000,Null,Null,261113524,46363,2
261113526,0.0,0.0,1199000,1199000,0,0,1199000,Null,Null,261113526,46363,2
261113528,0.0,0.0,1200000,1200000,0,0,1200000,Null,Null,261113528,46363,2
261113530,0.0,0.0,1355000,1355000,0,0,1355000,Null,Null,261113530,46363,2
261113532,0.0,0.0,1299000,1299000,0,0,1299000,Null,Null,261113532,46363,2
261113534,0.0,0.0,2990000,2990000,0,0,2990000,Null,Null,261113534,46363,2
261113536,0.0,0.0,980000,980000,0,0,980000,Null,Null,261113536,46363,2
261113538,0.0,0.0,1200000,1200000,0,0,1200000,Null,Null,261113538,46363,2
261113540,0.0,0.0,2690000,2690000,0,0,2690000,Null,Null,261113540,46363,2
261113542,0.0,0.0,1199000,1199000,0,0,1199000,Null,Null,261113542,46363,2
261113544,0.0,0.0,989000,989000,0,0,989000,Null,Null,261113544,46363,2
261113546,0.0,0.0,1990000,1990000,0,0,1990000,Null,Null,261113546,46363,2
261113548,0.0,0.0,1090000,1090000,0,0,1090000,Null,Null,261113548,46363,2
261113550,0.0,0.0,1079000,1079000,0,0,1079000,Null,Null,261113550,46363,2
261113552,0.0,0.0,997000,997000,0,0,997000,Null,Null,261113552,46363,2
261113554,0.0,0.0,890000,890000,0,0,890000,Null,Null,261113554,46363,2
261113555,0.0,0.0,1190000,1190000,0,0,1190000,Null,Null,261113555,46363,2
261113558,0.0,0.0,980000,980000,0,0,980000,Null,Null,261113558,46363,2
261113560,0.0,0.0,1199000,1199000,0,0,1199000,Null,Null,261113560,46363,2
261113562,0.0,0.0,1355000,1355000,0,0,1355000,Null,Null,261113562,46363,2
261113564,0.0,0.0,1169000,1169000,0,0,1169000,Null,Null,261113564,46363,2
261113566,0.0,0.0,1190000,1190000,0,0,1190000,Null,Null,261113566,46363,2
261113568,0.0,0.0,980000,980000,0,0,980000,Null,Null,261113568,46363,2
261113570,0.0,0.0,1049000,1049000,0,0,1049000,Null,Null,261113570,46363,2
261113572,0.0,0.0,980000,980000,0,0,980000,Null,Null,261113572,46363,2
261113574,0.0,0.0,1990000,1990000,0,0,1990000,Null,Null,261113574,46363,2
261113576,0.0,0.0,980000,980000,0,0,980000,Null,Null,261113576,46363,2
261113578,0.0,0.0,2969000,2969000,0,0,2969000,Null,Null,261113578,46363,2
261113580,0.0,0.0,960000,960000,0,0,960000,Null,Null,261113580,46363,2
261113587,0.0,0.0,1199000,1199000,0,0,1199000,Null,Null,261113587,46363,2
261113589,0.0,0.0,997000,997000,0,0,997000,Null,Null,261113589,46363,2
261113591,0.0,0.0,1200000,1200000,0,0,1200000,Null,Null,261113591,46363,2
261113593,0.0,0.0,1355000,1355000,0,0,1355000,Null,Null,261113593,46363,2
261113595,0.0,0.0,980000,980000,0,0,980000,Null,Null,261113595,46363,2
261113601,0.0,0.0,143000,128700,14300,10,143000,Null,Null,261113601,111461,15236
261114021,0.0,0.0,598000,299000,299000,50,598000,Null,Null,261114021,111461,15318
261114062,0.0,0.0,159000,159000,0,0,159000,Null,Null,261114062,111461,15318
261114161,0.0,0.0,3550000,3550000,0,0,3550000,Null,Null,261114161,27398,2340
261114247,0.0,0.0,159000,159000,0,0,159000,Null,Null,261114247,111461,15318
261114438,0.0,0.0,159000,159000,0,0,159000,Null,Null,261114438,111461,15318
261115083,0.0,0.0,4450000,4450000,0,0,4450000,Null,Null,261115083,27398,2342
261734966,0.0,0.0,96000,96000,0,0,96000,Null,Null,261734966,111461,2
261799412,0.0,0.0,320000,320000,0,0,320000,Null,Null,261799412,4534177,15250
261799574,3.0,3.0,570000,570000,0,0,570000,Null,Null,261799574,423495,3177
261799581,17.0,17.0,700000,700000,0,0,700000,Null,Null,261799581,423495,3177
261799585,12.0,12.0,700000,700000,0,0,700000,Null,Null,261799585,423495,3177
261799594,5.0,5.0,650000,650000,0,0,650000,Null,Null,261799594,423495,3177
261799891,0.0,0.0,4596000,4596000,0,0,4596000,Null,Null,261799891,111461,2
261808759,10.0,10.0,449000,449000,0,0,449000,Null,Null,261808759,111461,27170
261808927,0.0,0.0,232000,206000,26000,11,232000,Null,Null,261808927,111461,15250
261809745,0.0,0.0,895000,797000,98000,11,895000,Null,Null,261809745,111461,15250
261815655,0.0,0.0,32000000,25600000,6400000,20,32000000,Null,Null,261815655,111461,2324
261816300,0.0,0.0,1900,1900,0,0,1900,Null,Null,261816300,111461,2
261817252,0.0,0.0,4000,4000,0,0,4000,Null,Null,261817252,111461,2
261817454,0.0,0.0,12000,12000,0,0,12000,Null,Null,261817454,111461,2
261817979,0.0,0.0,4000,4000,0,0,4000,Null,Null,261817979,111461,2
261819682,0.0,0.0,2000,2000,0,0,2000,Null,Null,261819682,111461,2
261820553,10.0,10.0,449000,449000,0,0,449000,Null,Null,261820553,111461,27172
261822945,0.0,0.0,1990,995,995,50,1990,Null,Null,261822945,154455,23446
261822969,0.0,0.0,4800000,2829000,1971000,41,4800000,Null,Null,261822969,112638,1794
261823361,0.0,0.0,14800000,14356000,444000,3,14800000,Null,Null,261823361,111461,2657
261823870,0.0,0.0,13600000,13192000,408000,3,13600000,Null,Null,261823870,111461,2657
261824759,0.0,0.0,13600000,13192000,408000,3,13600000,Null,Null,261824759,111461,2657
261824893,0.0,0.0,15290000,15290000,0,0,15290000,Null,Null,261824893,114527,28444
261828428,0.0,0.0,15290000,14831000,459000,3,15290000,Null,Null,261828428,114527,28444
261832746,0.0,0.0,8391000,8391000,0,0,8391000,Null,Null,261832746,111461,2
261832770,0.0,0.0,27990000,27990000,0,0,27990000,Null,Null,261832770,111461,2
261834984,0.0,0.0,2925000,2925000,0,0,2925000,Null,Null,261834984,111644,5385
261834985,0.0,0.0,2625000,2625000,0,0,2625000,Null,Null,261834985,111644,5385
261834987,0.0,0.0,1975000,1975000,0,0,1975000,Null,Null,261834987,111644,5385
261834988,0.0,0.0,2200000,2200000,0,0,2200000,Null,Null,261834988,111644,5385
261834990,0.0,0.0,2475000,2475000,0,0,2475000,Null,Null,261834990,111644,5385
261834991,0.0,0.0,1975000,1975000,0,0,1975000,Null,Null,261834991,111644,5384
261834995,0.0,0.0,2325000,2325000,0,0,2325000,Null,Null,261834995,111644,5384
261834996,0.0,0.0,1975000,1975000,0,0,1975000,Null,Null,261834996,111644,5384
261835000,0.0,0.0,2475000,2475000,0,0,2475000,Null,Null,261835000,111644,5384
261835001,0.0,0.0,2625000,2625000,0,0,2625000,Null,Null,261835001,111644,5385
261835004,0.0,0.0,2825000,2825000,0,0,2825000,Null,Null,261835004,111644,5385
261835006,0.0,0.0,2825000,2825000,0,0,2825000,Null,Null,261835006,111644,5385
261835008,0.0,0.0,2075000,2075000,0,0,2075000,Null,Null,261835008,111644,5385
261835009,0.0,0.0,2675000,2675000,0,0,2675000,Null,Null,261835009,111644,5384
261835012,0.0,0.0,3125000,3125000,0,0,3125000,Null,Null,261835012,111644,5385
261835013,0.0,0.0,3475000,3475000,0,0,3475000,Null,Null,261835013,111644,5384
261835016,0.0,0.0,3175000,3175000,0,0,3175000,Null,Null,261835016,111644,5385
261835018,0.0,0.0,3375000,3375000,0,0,3375000,Null,Null,261835018,111644,5385
261835020,0.0,0.0,2325000,2325000,0,0,2325000,Null,Null,261835020,111644,5384
261837074,0.0,0.0,2975000,2975000,0,0,2975000,Null,Null,261837074,111644,5385
261839663,0.0,0.0,500000,500000,0,0,500000,Null,Null,261839663,659879,4428
261840175,0.0,0.0,960000,480000,480000,50,960000,Null,Null,261840175,111461,15318
261840224,0.0,0.0,75000,75000,0,0,75000,Null,Null,261840224,810913,28720
261841523,0.0,0.0,5440000,5440000,0,0,5440000,Null,Null,261841523,111461,2
261841606,0.0,0.0,40600000,40600000,0,0,40600000,Null,Null,261841606,111461,2
261841698,0.0,0.0,43400000,43400000,0,0,43400000,Null,Null,261841698,111461,2
261841961,0.0,0.0,54600000,54600000,0,0,54600000,Null,Null,261841961,111461,2
261841985,0.0,0.0,37800000,37800000,0,0,37800000,Null,Null,261841985,111461,2
261842596,0.0,0.0,50400000,50400000,0,0,50400000,Null,Null,261842596,111461,2
261842721,0.0,0.0,51840000,51840000,0,0,51840000,Null,Null,261842721,111461,2
261842790,0.0,0.0,50400000,50400000,0,0,50400000,Null,Null,261842790,111461,2
261842838,0.0,0.0,41800000,41800000,0,0,41800000,Null,Null,261842838,111461,2
261842860,0.0,0.0,72800000,72800000,0,0,72800000,Null,Null,261842860,111461,2
261843047,0.0,0.0,39200000,39200000,0,0,39200000,Null,Null,261843047,111461,2
261843089,0.0,0.0,37950000,37950000,0,0,37950000,Null,Null,261843089,111461,2
261843413,0.0,0.0,96600000,96600000,0,0,96600000,Null,Null,261843413,111461,2
261843595,0.0,0.0,72800000,72800000,0,0,72800000,Null,Null,261843595,111461,2
261843688,0.0,0.0,46200000,46200000,0,0,46200000,Null,Null,261843688,111461,2
261844031,0.0,0.0,82800000,82800000,0,0,82800000,Null,Null,261844031,111461,2
261844051,0.0,0.0,100800000,100800000,0,0,100800000,Null,Null,261844051,111461,2
261844289,0.0,0.0,37800000,37800000,0,0,37800000,Null,Null,261844289,111461,2
261844321,0.0,0.0,1000,1000,0,0,1000,Null,Null,261844321,111461,2
261844344,0.0,0.0,5800000,5800000,0,0,5800000,Null,Null,261844344,111461,2
261844912,0.0,0.0,47600000,47600000,0,0,47600000,Null,Null,261844912,111461,2
261845124,0.0,0.0,58800000,58800000,0,0,58800000,Null,Null,261845124,111461,2
261845207,0.0,0.0,5790000,5790000,0,0,5790000,Null,Null,261845207,111461,2
261845221,0.0,0.0,51800000,51800000,0,0,51800000,Null,Null,261845221,111461,2
261845251,0.0,0.0,50400000,50400000,0,0,50400000,Null,Null,261845251,111461,2
261845288,0.0,0.0,5800000,5800000,0,0,5800000,Null,Null,261845288,111461,2
261845316,0.0,0.0,37200000,37200000,0,0,37200000,Null,Null,261845316,111461,2
261845317,0.0,0.0,49000000,49000000,0,0,49000000,Null,Null,261845317,111461,2
261845573,0.0,0.0,50400000,50400000,0,0,50400000,Null,Null,261845573,111461,2
261845618,0.0,0.0,49000000,49000000,0,0,49000000,Null,Null,261845618,111461,2
261845654,0.0,0.0,39600000,39600000,0,0,39600000,Null,Null,261845654,111461,2
261845710,0.0,0.0,42000000,42000000,0,0,42000000,Null,Null,261845710,111461,2
261846139,0.0,0.0,16100000,16100000,0,0,16100000,Null,Null,261846139,111461,2
261846147,0.0,0.0,64400000,64400000,0,0,64400000,Null,Null,261846147,111461,2
261846286,0.0,0.0,82600000,82600000,0,0,82600000,Null,Null,261846286,111461,2
261846299,0.0,0.0,40600000,40600000,0,0,40600000,Null,Null,261846299,111461,2
261846665,0.0,0.0,39380000,39380000,0,0,39380000,Null,Null,261846665,111461,2
261846914,0.0,0.0,40600000,40600000,0,0,40600000,Null,Null,261846914,111461,2
261847017,0.0,0.0,37100000,37100000,0,0,37100000,Null,Null,261847017,111461,2
261847059,0.0,0.0,67200000,67200000,0,0,67200000,Null,Null,261847059,111461,2
261847083,0.0,0.0,57400000,57400000,0,0,57400000,Null,Null,261847083,111461,2
261847142,0.0,0.0,57600000,57600000,0,0,57600000,Null,Null,261847142,111461,2
261847264,0.0,0.0,40600000,40600000,0,0,40600000,Null,Null,261847264,111461,2
261847282,0.0,0.0,39200000,39200000,0,0,39200000,Null,Null,261847282,111461,2
261847304,0.0,0.0,53700000,53700000,0,0,53700000,Null,Null,261847304,111461,2
261847525,0.0,0.0,60200000,60200000,0,0,60200000,Null,Null,261847525,111461,2
261847526,0.0,0.0,54000000,54000000,0,0,54000000,Null,Null,261847526,111461,2
261847638,0.0,0.0,36400000,36400000,0,0,36400000,Null,Null,261847638,111461,2
261847813,0.0,0.0,37800000,37800000,0,0,37800000,Null,Null,261847813,111461,2
261847866,0.0,0.0,89600000,89600000,0,0,89600000,Null,Null,261847866,111461,2
261848683,0.0,0.0,51800000,51800000,0,0,51800000,Null,Null,261848683,111461,2
261848710,0.0,0.0,88800000,88800000,0,0,88800000,Null,Null,261848710,111461,2
261848740,0.0,0.0,45605000,45605000,0,0,45605000,Null,Null,261848740,111461,2
261848831,0.0,0.0,38400000,38400000,0,0,38400000,Null,Null,261848831,111461,2
261848974,0.0,0.0,45100000,45100000,0,0,45100000,Null,Null,261848974,111461,2
261849009,0.0,0.0,64400000,64400000,0,0,64400000,Null,Null,261849009,111461,2
261849702,0.0,0.0,48000000,48000000,0,0,48000000,Null,Null,261849702,111461,2
261849793,0.0,0.0,55000000,55000000,0,0,55000000,Null,Null,261849793,111461,2
261849975,0.0,0.0,40600000,40600000,0,0,40600000,Null,Null,261849975,111461,2
261849981,0.0,0.0,37000000,37000000,0,0,37000000,Null,Null,261849981,111461,2
261850119,0.0,0.0,36500000,36500000,0,0,36500000,Null,Null,261850119,111461,2
261850226,0.0,0.0,60200000,60200000,0,0,60200000,Null,Null,261850226,111461,2
261850418,0.0,0.0,47600000,47600000,0,0,47600000,Null,Null,261850418,111461,2
261851374,0.0,0.0,42000000,42000000,0,0,42000000,Null,Null,261851374,111461,2
261851384,0.0,0.0,44800000,44800000,0,0,44800000,Null,Null,261851384,111461,2
261851677,0.0,0.0,99000000,99000000,0,0,99000000,Null,Null,261851677,111461,2
261851870,0.0,0.0,39000000,39000000,0,0,39000000,Null,Null,261851870,111461,2
261852233,0.0,0.0,42000000,42000000,0,0,42000000,Null,Null,261852233,111461,2
261852324,0.0,0.0,37800000,37800000,0,0,37800000,Null,Null,261852324,111461,2
261852475,0.0,0.0,64200000,64200000,0,0,64200000,Null,Null,261852475,111461,2
261852661,0.0,0.0,16100000,16100000,0,0,16100000,Null,Null,261852661,111461,2
261852745,0.0,0.0,43400000,43400000,0,0,43400000,Null,Null,261852745,111461,2
261852833,0.0,0.0,39200000,39200000,0,0,39200000,Null,Null,261852833,111461,2
261853321,0.0,0.0,52800000,52800000,0,0,52800000,Null,Null,261853321,111461,2
261853339,0.0,0.0,40600000,40600000,0,0,40600000,Null,Null,261853339,111461,2
261853353,0.0,0.0,38920000,38920000,0,0,38920000,Null,Null,261853353,111461,2
261853428,0.0,0.0,37800000,37800000,0,0,37800000,Null,Null,261853428,111461,2
261853432,0.0,0.0,14000000,14000000,0,0,14000000,Null,Null,261853432,111461,2
261853484,0.0,0.0,37800000,37800000,0,0,37800000,Null,Null,261853484,111461,2
261853562,0.0,0.0,40800000,40800000,0,0,40800000,Null,Null,261853562,111461,2
261853607,0.0,0.0,38920000,38920000,0,0,38920000,Null,Null,261853607,111461,2
261853699,0.0,0.0,77000000,77000000,0,0,77000000,Null,Null,261853699,111461,2
261853729,0.0,0.0,5450000,5450000,0,0,5450000,Null,Null,261853729,111461,2
261853768,0.0,0.0,40320000,40320000,0,0,40320000,Null,Null,261853768,111461,2
261853813,0.0,0.0,36400000,36400000,0,0,36400000,Null,Null,261853813,111461,2
261853894,0.0,0.0,43400000,43400000,0,0,43400000,Null,Null,261853894,111461,2
261853914,0.0,0.0,75850000,75850000,0,0,75850000,Null,Null,261853914,111461,2
261854084,0.0,0.0,50400000,50400000,0,0,50400000,Null,Null,261854084,111461,2
261854254,0.0,0.0,36400000,36400000,0,0,36400000,Null,Null,261854254,111461,2
261854294,0.0,0.0,86400000,86400000,0,0,86400000,Null,Null,261854294,111461,2
261854319,0.0,0.0,42000000,42000000,0,0,42000000,Null,Null,261854319,111461,2
261854333,0.0,0.0,42000000,42000000,0,0,42000000,Null,Null,261854333,111461,2
261854460,0.0,0.0,36400000,36400000,0,0,36400000,Null,Null,261854460,111461,2
261854600,0.0,0.0,62000000,62000000,0,0,62000000,Null,Null,261854600,111461,2
261854602,0.0,0.0,46200000,46200000,0,0,46200000,Null,Null,261854602,111461,2
261854693,0.0,0.0,60780000,60780000,0,0,60780000,Null,Null,261854693,111461,2
261854726,0.0,0.0,53200000,53200000,0,0,53200000,Null,Null,261854726,111461,2
261854777,0.0,0.0,61077206,61077206,0,0,61077206,Null,Null,261854777,111461,2
261854795,0.0,0.0,36400000,36400000,0,0,36400000,Null,Null,261854795,111461,2
261854797,0.0,0.0,63496000,63496000,0,0,63496000,Null,Null,261854797,111461,2
261854863,0.0,0.0,78120000,78120000,0,0,78120000,Null,Null,261854863,111461,2
261854881,0.0,0.0,42000000,42000000,0,0,42000000,Null,Null,261854881,111461,2
261854915,0.0,0.0,38500000,38500000,0,0,38500000,Null,Null,261854915,111461,2
261854938,0.0,0.0,41300000,41300000,0,0,41300000,Null,Null,261854938,111461,2
261855055,0.0,0.0,39200000,39200000,0,0,39200000,Null,Null,261855055,111461,2
261855060,0.0,0.0,37800000,37800000,0,0,37800000,Null,Null,261855060,111461,2
261855165,0.0,0.0,47600000,47600000,0,0,47600000,Null,Null,261855165,111461,2
261855184,0.0,0.0,39000000,39000000,0,0,39000000,Null,Null,261855184,111461,2
261855425,0.0,0.0,40600000,40600000,0,0,40600000,Null,Null,261855425,111461,2
261855472,0.0,0.0,62000000,62000000,0,0,62000000,Null,Null,261855472,111461,2
261855538,0.0,0.0,39200000,39200000,0,0,39200000,Null,Null,261855538,111461,2
261855576,0.0,0.0,39200000,39200000,0,0,39200000,Null,Null,261855576,111461,2
261855593,0.0,0.0,42000000,42000000,0,0,42000000,Null,Null,261855593,111461,2
261855646,0.0,0.0,39200000,39200000,0,0,39200000,Null,Null,261855646,111461,2
261855659,0.0,0.0,42000000,42000000,0,0,42000000,Null,Null,261855659,111461,2
261855719,0.0,0.0,44800000,44800000,0,0,44800000,Null,Null,261855719,111461,2
261855726,0.0,0.0,48300000,48300000,0,0,48300000,Null,Null,261855726,111461,2
261855869,0.0,0.0,46200000,46200000,0,0,46200000,Null,Null,261855869,111461,2
261855878,0.0,0.0,47600000,47600000,0,0,47600000,Null,Null,261855878,111461,2
261855895,0.0,0.0,44800000,44800000,0,0,44800000,Null,Null,261855895,111461,2
261855898,0.0,0.0,51800000,51800000,0,0,51800000,Null,Null,261855898,111461,2
261855939,0.0,0.0,39200000,39200000,0,0,39200000,Null,Null,261855939,111461,2
261855957,0.0,0.0,37800000,37800000,0,0,37800000,Null,Null,261855957,111461,2
261855958,0.0,0.0,40500000,40500000,0,0,40500000,Null,Null,261855958,111461,2
261856055,0.0,0.0,40320000,40320000,0,0,40320000,Null,Null,261856055,111461,2
261856056,0.0,0.0,40600000,40600000,0,0,40600000,Null,Null,261856056,111461,2
261856078,0.0,0.0,39200000,39200000,0,0,39200000,Null,Null,261856078,111461,2
261856092,0.0,0.0,36400000,36400000,0,0,36400000,Null,Null,261856092,111461,2
261856181,0.0,0.0,39200000,39200000,0,0,39200000,Null,Null,261856181,111461,2
261856190,0.0,0.0,37100000,37100000,0,0,37100000,Null,Null,261856190,111461,2
261856391,0.0,0.0,42880000,42880000,0,0,42880000,Null,Null,261856391,111461,2
261856465,0.0,0.0,42420000,42420000,0,0,42420000,Null,Null,261856465,111461,2
261856488,0.0,0.0,51800000,51800000,0,0,51800000,Null,Null,261856488,111461,2
261856575,0.0,0.0,58800000,58800000,0,0,58800000,Null,Null,261856575,111461,2
261856588,0.0,0.0,45240000,45240000,0,0,45240000,Null,Null,261856588,111461,2
261856605,0.0,0.0,46200000,46200000,0,0,46200000,Null,Null,261856605,111461,2
261856645,0.0,0.0,36400000,36400000,0,0,36400000,Null,Null,261856645,111461,2
261856722,0.0,0.0,39200000,39200000,0,0,39200000,Null,Null,261856722,111461,2
261856791,0.0,0.0,39200000,39200000,0,0,39200000,Null,Null,261856791,111461,2
261856802,0.0,0.0,51800000,51800000,0,0,51800000,Null,Null,261856802,111461,2
261856843,0.0,0.0,44640000,44640000,0,0,44640000,Null,Null,261856843,111461,2
261856940,0.0,0.0,36400000,36400000,0,0,36400000,Null,Null,261856940,111461,2
261856952,0.0,0.0,43400000,43400000,0,0,43400000,Null,Null,261856952,111461,2
261856994,0.0,0.0,49000000,49000000,0,0,49000000,Null,Null,261856994,111461,2
261857044,0.0,0.0,44800000,44800000,0,0,44800000,Null,Null,261857044,111461,2
261857075,0.0,0.0,40286400,40286400,0,0,40286400,Null,Null,261857075,111461,2
261857152,0.0,0.0,4676000,4676000,0,0,4676000,Null,Null,261857152,111461,2
261857229,0.0,0.0,36400000,36400000,0,0,36400000,Null,Null,261857229,111461,2
261857314,0.0,0.0,47000000,47000000,0,0,47000000,Null,Null,261857314,111461,2
261857328,0.0,0.0,50400000,50400000,0,0,50400000,Null,Null,261857328,111461,2
261857371,0.0,0.0,4460000,4460000,0,0,4460000,Null,Null,261857371,111461,2
261857403,0.0,0.0,43400000,43400000,0,0,43400000,Null,Null,261857403,111461,2
261857448,0.0,0.0,44800000,44800000,0,0,44800000,Null,Null,261857448,111461,2
261857541,0.0,0.0,36400000,36400000,0,0,36400000,Null,Null,261857541,111461,2
261857547,0.0,0.0,43400000,43400000,0,0,43400000,Null,Null,261857547,111461,2
261857567,0.0,0.0,37800000,37800000,0,0,37800000,Null,Null,261857567,111461,2
261857599,0.0,0.0,38000000,38000000,0,0,38000000,Null,Null,261857599,111461,2
261857615,0.0,0.0,36850000,36850000,0,0,36850000,Null,Null,261857615,111461,2
261857625,0.0,0.0,40000000,40000000,0,0,40000000,Null,Null,261857625,111461,2
261857668,0.0,0.0,39200000,39200000,0,0,39200000,Null,Null,261857668,111461,2
261857715,0.0,0.0,38000000,38000000,0,0,38000000,Null,Null,261857715,111461,2
261857738,0.0,0.0,47600000,47600000,0,0,47600000,Null,Null,261857738,111461,2
261857754,0.0,0.0,36400000,36400000,0,0,36400000,Null,Null,261857754,111461,2
261857880,0.0,0.0,39200000,39200000,0,0,39200000,Null,Null,261857880,111461,2
261857907,0.0,0.0,40000000,40000000,0,0,40000000,Null,Null,261857907,111461,2
261857935,0.0,0.0,37800000,37800000,0,0,37800000,Null,Null,261857935,111461,2
261857946,0.0,0.0,10216000,10216000,0,0,10216000,Null,Null,261857946,111461,2
261857964,0.0,0.0,43000000,43000000,0,0,43000000,Null,Null,261857964,111461,2
261857995,0.0,0.0,46800000,46800000,0,0,46800000,Null,Null,261857995,111461,2
261858012,0.0,0.0,43200000,43200000,0,0,43200000,Null,Null,261858012,111461,2
261858041,0.0,0.0,43400000,43400000,0,0,43400000,Null,Null,261858041,111461,2
261858067,0.0,0.0,51840000,51840000,0,0,51840000,Null,Null,261858067,111461,2
261858093,0.0,0.0,47520000,47520000,0,0,47520000,Null,Null,261858093,111461,2
261858111,0.0,0.0,82800000,82800000,0,0,82800000,Null,Null,261858111,111461,2
261858132,0.0,0.0,45600000,45600000,0,0,45600000,Null,Null,261858132,111461,2
261858225,0.0,0.0,53000000,53000000,0,0,53000000,Null,Null,261858225,111461,2
261858231,0.0,0.0,36400000,36400000,0,0,36400000,Null,Null,261858231,111461,2
261858310,0.0,0.0,36894000,36894000,0,0,36894000,Null,Null,261858310,111461,2
261858320,0.0,0.0,64400000,64400000,0,0,64400000,Null,Null,261858320,111461,2
261858322,0.0,0.0,50120000,50120000,0,0,50120000,Null,Null,261858322,111461,2
261858455,0.0,0.0,39984000,39984000,0,0,39984000,Null,Null,261858455,111461,2
261858501,0.0,0.0,48000000,48000000,0,0,48000000,Null,Null,261858501,111461,2
261858535,0.0,0.0,37440000,37440000,0,0,37440000,Null,Null,261858535,111461,2
261858635,0.0,0.0,36400000,36400000,0,0,36400000,Null,Null,261858635,111461,2
261858646,0.0,0.0,78000000,78000000,0,0,78000000,Null,Null,261858646,111461,2
261858703,0.0,0.0,58800000,58800000,0,0,58800000,Null,Null,261858703,111461,2
261858740,0.0,0.0,40600000,40600000,0,0,40600000,Null,Null,261858740,111461,2
261858780,0.0,0.0,39200000,39200000,0,0,39200000,Null,Null,261858780,111461,2
261858792,0.0,0.0,37520000,37520000,0,0,37520000,Null,Null,261858792,111461,2
261858852,0.0,0.0,40320000,40320000,0,0,40320000,Null,Null,261858852,111461,2
261858925,0.0,0.0,37800000,37800000,0,0,37800000,Null,Null,261858925,111461,2
261858926,0.0,0.0,50400000,50400000,0,0,50400000,Null,Null,261858926,111461,2
261858941,0.0,0.0,54000000,54000000,0,0,54000000,Null,Null,261858941,111461,2
261858958,0.0,0.0,40600000,40600000,0,0,40600000,Null,Null,261858958,111461,2
261858969,0.0,0.0,45000000,45000000,0,0,45000000,Null,Null,261858969,111461,2
261858974,0.0,0.0,36800000,36800000,0,0,36800000,Null,Null,261858974,111461,2
261858994,0.0,0.0,37000000,37000000,0,0,37000000,Null,Null,261858994,111461,2
261858997,0.0,0.0,36800000,36800000,0,0,36800000,Null,Null,261858997,111461,2
261859067,0.0,0.0,37380000,37380000,0,0,37380000,Null,Null,261859067,111461,2
261859214,0.0,0.0,53200000,53200000,0,0,53200000,Null,Null,261859214,111461,2
261859219,0.0,0.0,50000000,50000000,0,0,50000000,Null,Null,261859219,111461,2
261859269,0.0,0.0,40000000,40000000,0,0,40000000,Null,Null,261859269,111461,2
261859289,0.0,0.0,93600000,93600000,0,0,93600000,Null,Null,261859289,111461,2
261859309,0.0,0.0,50000000,50000000,0,0,50000000,Null,Null,261859309,111461,2
261859313,0.0,0.0,38800000,38800000,0,0,38800000,Null,Null,261859313,111461,2
261859364,0.0,0.0,36400000,36400000,0,0,36400000,Null,Null,261859364,111461,2
261859428,0.0,0.0,65000000,65000000,0,0,65000000,Null,Null,261859428,111461,2
261859431,0.0,0.0,40320000,40320000,0,0,40320000,Null,Null,261859431,111461,2
261859585,0.0,0.0,38400000,38400000,0,0,38400000,Null,Null,261859585,111461,2
261859655,0.0,0.0,45500000,45500000,0,0,45500000,Null,Null,261859655,111461,2
261859669,0.0,0.0,52500000,52500000,0,0,52500000,Null,Null,261859669,111461,2
261859783,0.0,0.0,44800000,44800000,0,0,44800000,Null,Null,261859783,111461,2
261859823,0.0,0.0,49000000,49000000,0,0,49000000,Null,Null,261859823,111461,2
261859889,0.0,0.0,36000000,36000000,0,0,36000000,Null,Null,261859889,111461,2
261859909,0.0,0.0,51000000,51000000,0,0,51000000,Null,Null,261859909,111461,2
261859926,0.0,0.0,50000000,50000000,0,0,50000000,Null,Null,261859926,111461,2
261859936,0.0,0.0,39900000,39900000,0,0,39900000,Null,Null,261859936,111461,2
261859998,0.0,0.0,53200000,53200000,0,0,53200000,Null,Null,261859998,111461,2
261860030,0.0,0.0,77000000,77000000,0,0,77000000,Null,Null,261860030,111461,2
261860063,0.0,0.0,38976000,38976000,0,0,38976000,Null,Null,261860063,111461,2
261860099,0.0,0.0,60200000,60200000,0,0,60200000,Null,Null,261860099,111461,2
261860103,0.0,0.0,41000000,41000000,0,0,41000000,Null,Null,261860103,111461,2
261860238,0.0,0.0,47600000,47600000,0,0,47600000,Null,Null,261860238,111461,2
261860260,0.0,0.0,50000000,50000000,0,0,50000000,Null,Null,261860260,111461,2
261860274,0.0,0.0,78000000,78000000,0,0,78000000,Null,Null,261860274,111461,2
261860286,0.0,0.0,41760000,41760000,0,0,41760000,Null,Null,261860286,111461,2
261860299,0.0,0.0,52000000,52000000,0,0,52000000,Null,Null,261860299,111461,2
261860304,0.0,0.0,40600000,40600000,0,0,40600000,Null,Null,261860304,111461,2
261860305,0.0,0.0,40320000,40320000,0,0,40320000,Null,Null,261860305,111461,2
261860346,0.0,0.0,46000000,46000000,0,0,46000000,Null,Null,261860346,111461,2
261860385,0.0,0.0,40600000,40600000,0,0,40600000,Null,Null,261860385,111461,2
261860395,0.0,0.0,48000000,48000000,0,0,48000000,Null,Null,261860395,111461,2
261860510,0.0,0.0,46400000,46400000,0,0,46400000,Null,Null,261860510,111461,2
261860513,0.0,0.0,36120000,36120000,0,0,36120000,Null,Null,261860513,111461,2
261860549,0.0,0.0,40600000,40600000,0,0,40600000,Null,Null,261860549,111461,2
261860646,0.0,0.0,37800000,37800000,0,0,37800000,Null,Null,261860646,111461,2
261860815,0.0,0.0,42000000,42000000,0,0,42000000,Null,Null,261860815,111461,2
261860819,0.0,0.0,75000000,75000000,0,0,75000000,Null,Null,261860819,111461,2
261860828,0.0,0.0,14100000,14100000,0,0,14100000,Null,Null,261860828,111461,2
261860845,0.0,0.0,41720000,41720000,0,0,41720000,Null,Null,261860845,111461,2
261860973,0.0,0.0,43000000,43000000,0,0,43000000,Null,Null,261860973,111461,2
261860982,0.0,0.0,39200000,39200000,0,0,39200000,Null,Null,261860982,111461,2
261860983,0.0,0.0,42000000,42000000,0,0,42000000,Null,Null,261860983,111461,2
261861003,0.0,0.0,43116274,43116274,0,0,43116274,Null,Null,261861003,111461,2
261861109,0.0,0.0,50400000,50400000,0,0,50400000,Null,Null,261861109,111461,2
261861120,0.0,0.0,49000000,49000000,0,0,49000000,Null,Null,261861120,111461,2
261861126,0.0,0.0,38304000,38304000,0,0,38304000,Null,Null,261861126,111461,2
261861128,0.0,0.0,37800000,37800000,0,0,37800000,Null,Null,261861128,111461,2
261861173,0.0,0.0,37000000,37000000,0,0,37000000,Null,Null,261861173,111461,2
261861217,0.0,0.0,38250000,38250000,0,0,38250000,Null,Null,261861217,111461,2
261861235,0.0,0.0,45000000,45000000,0,0,45000000,Null,Null,261861235,111461,2
261861238,0.0,0.0,77000000,77000000,0,0,77000000,Null,Null,261861238,111461,2
261861289,0.0,0.0,56850000,56850000,0,0,56850000,Null,Null,261861289,111461,2
261861330,0.0,0.0,50000000,50000000,0,0,50000000,Null,Null,261861330,111461,2
261861447,0.0,0.0,65000000,65000000,0,0,65000000,Null,Null,261861447,111461,2
261861464,0.0,0.0,49000000,49000000,0,0,49000000,Null,Null,261861464,111461,2
261861498,0.0,0.0,40000000,40000000,0,0,40000000,Null,Null,261861498,111461,2
261861570,0.0,0.0,60136000,60136000,0,0,60136000,Null,Null,261861570,111461,2
261861640,0.0,0.0,38400000,38400000,0,0,38400000,Null,Null,261861640,111461,2
261861647,0.0,0.0,57600000,57600000,0,0,57600000,Null,Null,261861647,111461,2
261861651,0.0,0.0,42000000,42000000,0,0,42000000,Null,Null,261861651,111461,2
261861683,0.0,0.0,54000000,54000000,0,0,54000000,Null,Null,261861683,111461,2
261861904,0.0,0.0,42900000,42900000,0,0,42900000,Null,Null,261861904,111461,2
261861920,0.0,0.0,36400000,36400000,0,0,36400000,Null,Null,261861920,111461,2
261861922,0.0,0.0,47000000,47000000,0,0,47000000,Null,Null,261861922,111461,2
261862007,0.0,0.0,11200000,11200000,0,0,11200000,Null,Null,261862007,111461,2
261862056,0.0,0.0,81600000,81600000,0,0,81600000,Null,Null,261862056,111461,2
261862063,0.0,0.0,51000000,51000000,0,0,51000000,Null,Null,261862063,111461,2
261862084,0.0,0.0,50400000,50400000,0,0,50400000,Null,Null,261862084,111461,2
261862125,0.0,0.0,43200000,43200000,0,0,43200000,Null,Null,261862125,111461,2
261862175,0.0,0.0,47400000,47400000,0,0,47400000,Null,Null,261862175,111461,2
261862188,0.0,0.0,45000000,45000000,0,0,45000000,Null,Null,261862188,111461,2
261862222,0.0,0.0,36400000,36400000,0,0,36400000,Null,Null,261862222,111461,2
261862263,0.0,0.0,54400000,54400000,0,0,54400000,Null,Null,261862263,111461,2
261862369,0.0,0.0,39200000,39200000,0,0,39200000,Null,Null,261862369,111461,2
261862413,0.0,0.0,45920000,45920000,0,0,45920000,Null,Null,261862413,111461,2
261862446,0.0,0.0,41760000,41760000,0,0,41760000,Null,Null,261862446,111461,2
261862462,0.0,0.0,46200000,46200000,0,0,46200000,Null,Null,261862462,111461,2
261862654,0.0,0.0,37000000,37000000,0,0,37000000,Null,Null,261862654,111461,2
261862662,0.0,0.0,39000000,39000000,0,0,39000000,Null,Null,261862662,111461,2
261862689,0.0,0.0,79200000,79200000,0,0,79200000,Null,Null,261862689,111461,2
261862708,0.0,0.0,79200000,79200000,0,0,79200000,Null,Null,261862708,111461,2
261862717,0.0,0.0,60000000,60000000,0,0,60000000,Null,Null,261862717,111461,2
261862732,0.0,0.0,74392500,74392500,0,0,74392500,Null,Null,261862732,111461,2
261862744,0.0,0.0,66000000,66000000,0,0,66000000,Null,Null,261862744,111461,2
261862835,0.0,0.0,41420000,41420000,0,0,41420000,Null,Null,261862835,111461,2
261862920,0.0,0.0,48160000,48160000,0,0,48160000,Null,Null,261862920,111461,2
261863008,0.0,0.0,81600000,81600000,0,0,81600000,Null,Null,261863008,111461,2
261863034,0.0,0.0,112320000,112320000,0,0,112320000,Null,Null,261863034,111461,2
261863072,0.0,0.0,61920000,61920000,0,0,61920000,Null,Null,261863072,111461,2
261863115,0.0,0.0,37200000,37200000,0,0,37200000,Null,Null,261863115,111461,2
261863200,0.0,0.0,44000000,44000000,0,0,44000000,Null,Null,261863200,111461,2
261863277,0.0,0.0,40600000,40600000,0,0,40600000,Null,Null,261863277,111461,2
261863280,0.0,0.0,46000000,46000000,0,0,46000000,Null,Null,261863280,111461,2
261863339,0.0,0.0,67500000,67500000,0,0,67500000,Null,Null,261863339,111461,2
261863461,0.0,0.0,48000000,48000000,0,0,48000000,Null,Null,261863461,111461,2
261863483,0.0,0.0,43000000,43000000,0,0,43000000,Null,Null,261863483,111461,2
261863499,0.0,0.0,108000000,108000000,0,0,108000000,Null,Null,261863499,111461,2
261863519,0.0,0.0,37000000,37000000,0,0,37000000,Null,Null,261863519,111461,2
261863631,0.0,0.0,57600000,57600000,0,0,57600000,Null,Null,261863631,111461,2
261863640,0.0,0.0,58000000,58000000,0,0,58000000,Null,Null,261863640,111461,2
261863674,0.0,0.0,47520000,47520000,0,0,47520000,Null,Null,261863674,111461,2
261863702,0.0,0.0,42560000,42560000,0,0,42560000,Null,Null,261863702,111461,2
261863722,0.0,0.0,38880000,38880000,0,0,38880000,Null,Null,261863722,111461,2
261863730,0.0,0.0,83520000,83520000,0,0,83520000,Null,Null,261863730,111461,2
261863857,0.0,0.0,64400000,64400000,0,0,64400000,Null,Null,261863857,111461,2
261863959,0.0,0.0,50400000,50400000,0,0,50400000,Null,Null,261863959,111461,2
261864069,0.0,0.0,42000000,42000000,0,0,42000000,Null,Null,261864069,111461,2
261864087,0.0,0.0,53920000,53920000,0,0,53920000,Null,Null,261864087,111461,2
261864157,0.0,0.0,40000000,40000000,0,0,40000000,Null,Null,261864157,111461,2
261864291,0.0,0.0,46900000,46900000,0,0,46900000,Null,Null,261864291,111461,2
261864305,0.0,0.0,79200000,79200000,0,0,79200000,Null,Null,261864305,111461,2
261864323,0.0,0.0,50000000,50000000,0,0,50000000,Null,Null,261864323,111461,2
261864459,0.0,0.0,36000000,36000000,0,0,36000000,Null,Null,261864459,111461,2
261864469,0.0,0.0,42000000,42000000,0,0,42000000,Null,Null,261864469,111461,2
261864510,0.0,0.0,38500000,38500000,0,0,38500000,Null,Null,261864510,111461,2
261864571,0.0,0.0,59950000,59950000,0,0,59950000,Null,Null,261864571,111461,2
261864578,0.0,0.0,36540000,36540000,0,0,36540000,Null,Null,261864578,111461,2
261864585,0.0,0.0,39000000,39000000,0,0,39000000,Null,Null,261864585,111461,2
261864672,0.0,0.0,40000000,40000000,0,0,40000000,Null,Null,261864672,111461,2
261864713,0.0,0.0,120000000,120000000,0,0,120000000,Null,Null,261864713,111461,2
261864739,0.0,0.0,39676000,39676000,0,0,39676000,Null,Null,261864739,111461,2
261864790,0.0,0.0,47800000,47800000,0,0,47800000,Null,Null,261864790,111461,2
261864877,0.0,0.0,37000000,37000000,0,0,37000000,Null,Null,261864877,111461,2
261864934,0.0,0.0,66920000,66920000,0,0,66920000,Null,Null,261864934,111461,2
261864998,0.0,0.0,37600000,37600000,0,0,37600000,Null,Null,261864998,111461,2
261865007,0.0,0.0,36000000,36000000,0,0,36000000,Null,Null,261865007,111461,2
261865011,0.0,0.0,62400000,62400000,0,0,62400000,Null,Null,261865011,111461,2
261865027,0.0,0.0,90000000,90000000,0,0,90000000,Null,Null,261865027,111461,2
261865040,0.0,0.0,49200000,49200000,0,0,49200000,Null,Null,261865040,111461,2
261865094,0.0,0.0,99999999,99999999,0,0,99999999,Null,Null,261865094,111461,2
261865097,0.0,0.0,54720000,54720000,0,0,54720000,Null,Null,261865097,111461,2
261865129,0.0,0.0,39200000,39200000,0,0,39200000,Null,Null,261865129,111461,2
261865195,0.0,0.0,50000000,50000000,0,0,50000000,Null,Null,261865195,111461,2
261865206,0.0,0.0,56160000,56160000,0,0,56160000,Null,Null,261865206,111461,2
261865212,0.0,0.0,70000000,70000000,0,0,70000000,Null,Null,261865212,111461,2
261865285,0.0,0.0,50000000,50000000,0,0,50000000,Null,Null,261865285,111461,2
261865333,0.0,0.0,58800000,58800000,0,0,58800000,Null,Null,261865333,111461,2
261865341,0.0,0.0,40600000,40600000,0,0,40600000,Null,Null,261865341,111461,2
261865415,0.0,0.0,47039040,47039040,0,0,47039040,Null,Null,261865415,111461,2
261865509,0.0,0.0,45000000,45000000,0,0,45000000,Null,Null,261865509,111461,2
261865629,0.0,0.0,43200000,43200000,0,0,43200000,Null,Null,261865629,111461,2
261865645,0.0,0.0,43600000,43600000,0,0,43600000,Null,Null,261865645,111461,2
261865655,0.0,0.0,54252000,54252000,0,0,54252000,Null,Null,261865655,111461,2
261865793,0.0,0.0,36400000,36400000,0,0,36400000,Null,Null,261865793,111461,2
261865903,0.0,0.0,39840000,39840000,0,0,39840000,Null,Null,261865903,111461,2
261865979,0.0,0.0,40000000,40000000,0,0,40000000,Null,Null,261865979,111461,2
261866146,0.0,0.0,36960000,36960000,0,0,36960000,Null,Null,261866146,111461,2
261866185,0.0,0.0,39200000,39200000,0,0,39200000,Null,Null,261866185,111461,2
261866345,0.0,0.0,7292000,7292000,0,0,7292000,Null,Null,261866345,111461,2
261866348,0.0,0.0,55200000,55200000,0,0,55200000,Null,Null,261866348,111461,2
261866361,0.0,0.0,50064000,50064000,0,0,50064000,Null,Null,261866361,111461,2
261866383,0.0,0.0,59514000,59514000,0,0,59514000,Null,Null,261866383,111461,2
261866400,0.0,0.0,50400000,50400000,0,0,50400000,Null,Null,261866400,111461,2
261866459,0.0,0.0,38390400,38390400,0,0,38390400,Null,Null,261866459,111461,2
261866476,0.0,0.0,43000000,43000000,0,0,43000000,Null,Null,261866476,111461,2
261866506,0.0,0.0,38240000,38240000,0,0,38240000,Null,Null,261866506,111461,2
261866557,0.0,0.0,50000000,50000000,0,0,50000000,Null,Null,261866557,111461,2
261866623,0.0,0.0,62000000,62000000,0,0,62000000,Null,Null,261866623,111461,2
261866631,0.0,0.0,46870000,46870000,0,0,46870000,Null,Null,261866631,111461,2
261866705,0.0,0.0,38400000,38400000,0,0,38400000,Null,Null,261866705,111461,2
261866775,0.0,0.0,38400000,38400000,0,0,38400000,Null,Null,261866775,111461,2
261866789,0.0,0.0,50000000,50000000,0,0,50000000,Null,Null,261866789,111461,2
261866842,0.0,0.0,50000000,50000000,0,0,50000000,Null,Null,261866842,111461,2
261866845,0.0,0.0,50000000,50000000,0,0,50000000,Null,Null,261866845,111461,2
261866930,0.0,0.0,52800000,52800000,0,0,52800000,Null,Null,261866930,111461,2
261867046,0.0,0.0,41420000,41420000,0,0,41420000,Null,Null,261867046,111461,2
261867048,0.0,0.0,39200000,39200000,0,0,39200000,Null,Null,261867048,111461,2
261867056,0.0,0.0,38800000,38800000,0,0,38800000,Null,Null,261867056,111461,2
261867156,0.0,0.0,50400000,50400000,0,0,50400000,Null,Null,261867156,111461,2
261867169,0.0,0.0,37000000,37000000,0,0,37000000,Null,Null,261867169,111461,2
261867173,0.0,0.0,37520000,37520000,0,0,37520000,Null,Null,261867173,111461,2
261867198,0.0,0.0,42510000,42510000,0,0,42510000,Null,Null,261867198,111461,2
261867206,0.0,0.0,43120000,43120000,0,0,43120000,Null,Null,261867206,111461,2
261867218,0.0,0.0,1920,1920,0,0,1920,Null,Null,261867218,111461,2
261867246,0.0,0.0,39200000,39200000,0,0,39200000,Null,Null,261867246,111461,2
261867359,0.0,0.0,60000000,60000000,0,0,60000000,Null,Null,261867359,111461,2
261867473,0.0,0.0,86400000,86400000,0,0,86400000,Null,Null,261867473,111461,2
261867565,0.0,0.0,52784000,52784000,0,0,52784000,Null,Null,261867565,111461,2
261867589,0.0,0.0,66000000,66000000,0,0,66000000,Null,Null,261867589,111461,2
261867643,0.0,0.0,47984000,47984000,0,0,47984000,Null,Null,261867643,111461,2
261867644,0.0,0.0,48800000,48800000,0,0,48800000,Null,Null,261867644,111461,2
261867652,0.0,0.0,74392500,74392500,0,0,74392500,Null,Null,261867652,111461,2
261867661,0.0,0.0,90720000,90720000,0,0,90720000,Null,Null,261867661,111461,2
261867685,0.0,0.0,42510000,42510000,0,0,42510000,Null,Null,261867685,111461,2
261867703,0.0,0.0,119000000,119000000,0,0,119000000,Null,Null,261867703,111461,2
261867738,0.0,0.0,48000000,48000000,0,0,48000000,Null,Null,261867738,111461,2
261867822,0.0,0.0,38000000,38000000,0,0,38000000,Null,Null,261867822,111461,2
261867869,0.0,0.0,39500000,39500000,0,0,39500000,Null,Null,261867869,111461,2
261867886,0.0,0.0,51660000,51660000,0,0,51660000,Null,Null,261867886,111461,2
261867918,0.0,0.0,44800000,44800000,0,0,44800000,Null,Null,261867918,111461,2
261867920,0.0,0.0,40600000,40600000,0,0,40600000,Null,Null,261867920,111461,2
261867934,0.0,0.0,41440000,41440000,0,0,41440000,Null,Null,261867934,111461,2
261867990,0.0,0.0,41400000,41400000,0,0,41400000,Null,Null,261867990,111461,2
261868022,0.0,0.0,53000000,53000000,0,0,53000000,Null,Null,261868022,111461,2
261868141,0.0,0.0,36000000,36000000,0,0,36000000,Null,Null,261868141,111461,2
261868169,0.0,0.0,47400000,47400000,0,0,47400000,Null,Null,261868169,111461,2
261868173,0.0,0.0,49000000,49000000,0,0,49000000,Null,Null,261868173,111461,2
261868242,0.0,0.0,51000000,51000000,0,0,51000000,Null,Null,261868242,111461,2
261868328,0.0,0.0,50000000,50000000,0,0,50000000,Null,Null,261868328,111461,2
261868335,0.0,0.0,38000000,38000000,0,0,38000000,Null,Null,261868335,111461,2
261868345,0.0,0.0,58800000,58800000,0,0,58800000,Null,Null,261868345,111461,2
261868413,0.0,0.0,50400000,50400000,0,0,50400000,Null,Null,261868413,111461,2
261868568,0.0,0.0,53000000,53000000,0,0,53000000,Null,Null,261868568,111461,2
261868584,0.0,0.0,49000000,49000000,0,0,49000000,Null,Null,261868584,111461,2
261868909,0.0,0.0,78000000,78000000,0,0,78000000,Null,Null,261868909,111461,2
261868933,0.0,0.0,49050000,49050000,0,0,49050000,Null,Null,261868933,111461,2
261868998,0.0,0.0,73920000,73920000,0,0,73920000,Null,Null,261868998,111461,2
261869000,0.0,0.0,12880000,12880000,0,0,12880000,Null,Null,261869000,111461,2
261869046,0.0,0.0,41000000,41000000,0,0,41000000,Null,Null,261869046,111461,2
261869070,0.0,0.0,68000000,68000000,0,0,68000000,Null,Null,261869070,111461,2
261869090,0.0,0.0,44640000,44640000,0,0,44640000,Null,Null,261869090,111461,2
261869181,0.0,0.0,38080000,38080000,0,0,38080000,Null,Null,261869181,111461,2
261869195,0.0,0.0,53000000,53000000,0,0,53000000,Null,Null,261869195,111461,2
261869268,0.0,0.0,44800000,44800000,0,0,44800000,Null,Null,261869268,111461,2
261869297,0.0,0.0,77280000,77280000,0,0,77280000,Null,Null,261869297,111461,2
261869324,0.0,0.0,43400000,43400000,0,0,43400000,Null,Null,261869324,111461,2
261869410,0.0,0.0,37800000,37800000,0,0,37800000,Null,Null,261869410,111461,2
261869487,0.0,0.0,37000000,37000000,0,0,37000000,Null,Null,261869487,111461,2
261869543,0.0,0.0,50000000,50000000,0,0,50000000,Null,Null,261869543,111461,2
261869943,0.0,0.0,45600000,45600000,0,0,45600000,Null,Null,261869943,111461,2
261869952,0.0,0.0,36400000,36400000,0,0,36400000,Null,Null,261869952,111461,2
261870153,0.0,0.0,40320000,40320000,0,0,40320000,Null,Null,261870153,111461,2
261870161,0.0,0.0,49000000,49000000,0,0,49000000,Null,Null,261870161,111461,2
261870289,0.0,0.0,42000000,42000000,0,0,42000000,Null,Null,261870289,111461,2
261870296,0.0,0.0,37800000,37800000,0,0,37800000,Null,Null,261870296,111461,2
261870311,0.0,0.0,71400000,71400000,0,0,71400000,Null,Null,261870311,111461,2
261870332,0.0,0.0,64473500,64473500,0,0,64473500,Null,Null,261870332,111461,2
261870546,0.0,0.0,46200000,46200000,0,0,46200000,Null,Null,261870546,111461,2
261870634,0.0,0.0,36000000,36000000,0,0,36000000,Null,Null,261870634,111461,2
261870677,0.0,0.0,47412820,47412820,0,0,47412820,Null,Null,261870677,111461,2
261870685,0.0,0.0,37800000,37800000,0,0,37800000,Null,Null,261870685,111461,2
261870697,0.0,0.0,56160000,56160000,0,0,56160000,Null,Null,261870697,111461,2
261870774,0.0,0.0,68000000,68000000,0,0,68000000,Null,Null,261870774,111461,2
261870860,0.0,0.0,55720000,55720000,0,0,55720000,Null,Null,261870860,111461,2
261870963,0.0,0.0,40600000,40600000,0,0,40600000,Null,Null,261870963,111461,2
261871079,0.0,0.0,67449200,67449200,0,0,67449200,Null,Null,261871079,111461,2
261871182,0.0,0.0,61920000,61920000,0,0,61920000,Null,Null,261871182,111461,2
261871358,0.0,0.0,58642000,58642000,0,0,58642000,Null,Null,261871358,111461,2
261871394,0.0,0.0,54000000,54000000,0,0,54000000,Null,Null,261871394,111461,2
261871397,0.0,0.0,40320000,40320000,0,0,40320000,Null,Null,261871397,111461,2
261871398,0.0,0.0,39200000,39200000,0,0,39200000,Null,Null,261871398,111461,2
261871402,0.0,0.0,37800000,37800000,0,0,37800000,Null,Null,261871402,111461,2
261871477,0.0,0.0,38000000,38000000,0,0,38000000,Null,Null,261871477,111461,2
261871489,0.0,0.0,36400000,36400000,0,0,36400000,Null,Null,261871489,111461,2
261871573,0.0,0.0,64560000,64560000,0,0,64560000,Null,Null,261871573,111461,2
261871600,0.0,0.0,70000000,70000000,0,0,70000000,Null,Null,261871600,111461,2
261871670,0.0,0.0,41440000,41440000,0,0,41440000,Null,Null,261871670,111461,2
261871684,0.0,0.0,40800000,40800000,0,0,40800000,Null,Null,261871684,111461,2
261871703,0.0,0.0,43400000,43400000,0,0,43400000,Null,Null,261871703,111461,2
261871823,0.0,0.0,45024000,45024000,0,0,45024000,Null,Null,261871823,111461,2
261871878,0.0,0.0,39200000,39200000,0,0,39200000,Null,Null,261871878,111461,2
261871886,0.0,0.0,49000000,49000000,0,0,49000000,Null,Null,261871886,111461,2
261871933,0.0,0.0,36000000,36000000,0,0,36000000,Null,Null,261871933,111461,2
261871960,0.0,0.0,37000000,37000000,0,0,37000000,Null,Null,261871960,111461,2
261872012,0.0,0.0,71680000,71680000,0,0,71680000,Null,Null,261872012,111461,2
261872126,0.0,0.0,49000000,49000000,0,0,49000000,Null,Null,261872126,111461,2
261872162,0.0,0.0,40320000,40320000,0,0,40320000,Null,Null,261872162,111461,2
261872182,0.0,0.0,41300000,41300000,0,0,41300000,Null,Null,261872182,111461,2
261872224,0.0,0.0,42000000,42000000,0,0,42000000,Null,Null,261872224,111461,2
261872235,0.0,0.0,47400000,47400000,0,0,47400000,Null,Null,261872235,111461,2
261872288,0.0,0.0,51520000,51520000,0,0,51520000,Null,Null,261872288,111461,2
261872347,0.0,0.0,43400000,43400000,0,0,43400000,Null,Null,261872347,111461,2
261872474,0.0,0.0,49000000,49000000,0,0,49000000,Null,Null,261872474,111461,2
261872529,0.0,0.0,45600000,45600000,0,0,45600000,Null,Null,261872529,111461,2
261872536,0.0,0.0,44640000,44640000,0,0,44640000,Null,Null,261872536,111461,2
261872576,0.0,0.0,42000000,42000000,0,0,42000000,Null,Null,261872576,111461,2
261872611,0.0,0.0,49000000,49000000,0,0,49000000,Null,Null,261872611,111461,2
261872654,0.0,0.0,43200000,43200000,0,0,43200000,Null,Null,261872654,111461,2
261872660,0.0,0.0,42000000,42000000,0,0,42000000,Null,Null,261872660,111461,2
261872686,0.0,0.0,78000000,78000000,0,0,78000000,Null,Null,261872686,111461,2
261872702,0.0,0.0,46032000,46032000,0,0,46032000,Null,Null,261872702,111461,2
261872726,0.0,0.0,50400000,50400000,0,0,50400000,Null,Null,261872726,111461,2
261872805,0.0,0.0,42000000,42000000,0,0,42000000,Null,Null,261872805,111461,2
261872817,0.0,0.0,38320000,38320000,0,0,38320000,Null,Null,261872817,111461,2
261872821,0.0,0.0,42000000,42000000,0,0,42000000,Null,Null,261872821,111461,2
261872843,0.0,0.0,42000000,42000000,0,0,42000000,Null,Null,261872843,111461,2
261872885,0.0,0.0,42000000,42000000,0,0,42000000,Null,Null,261872885,111461,2
261872933,0.0,0.0,50000000,50000000,0,0,50000000,Null,Null,261872933,111461,2
261872975,0.0,0.0,41300000,41300000,0,0,41300000,Null,Null,261872975,111461,2
261872984,0.0,0.0,39168000,39168000,0,0,39168000,Null,Null,261872984,111461,2
261873006,0.0,0.0,44800000,44800000,0,0,44800000,Null,Null,261873006,111461,2
261873107,0.0,0.0,58800000,58800000,0,0,58800000,Null,Null,261873107,111461,2
261873261,0.0,0.0,41000000,41000000,0,0,41000000,Null,Null,261873261,111461,2
261873290,0.0,0.0,72000000,72000000,0,0,72000000,Null,Null,261873290,111461,2
261873359,0.0,0.0,37000000,37000000,0,0,37000000,Null,Null,261873359,111461,2
261873442,0.0,0.0,40000000,40000000,0,0,40000000,Null,Null,261873442,111461,2
261873444,0.0,0.0,38080000,38080000,0,0,38080000,Null,Null,261873444,111461,2
261873458,0.0,0.0,42000000,42000000,0,0,42000000,Null,Null,261873458,111461,2
261873460,0.0,0.0,60000000,60000000,0,0,60000000,Null,Null,261873460,111461,2
261873503,0.0,0.0,48040000,48040000,0,0,48040000,Null,Null,261873503,111461,2
261873525,0.0,0.0,38400000,38400000,0,0,38400000,Null,Null,261873525,111461,2
261873535,0.0,0.0,120000000,120000000,0,0,120000000,Null,Null,261873535,111461,2
261873705,0.0,0.0,77000000,77000000,0,0,77000000,Null,Null,261873705,111461,2
261873737,0.0,0.0,97920000,97920000,0,0,97920000,Null,Null,261873737,111461,2
261873875,0.0,0.0,45920000,45920000,0,0,45920000,Null,Null,261873875,111461,2
261873895,0.0,0.0,63360000,63360000,0,0,63360000,Null,Null,261873895,111461,2
261873956,0.0,0.0,50000000,50000000,0,0,50000000,Null,Null,261873956,111461,2
261874026,0.0,0.0,36000000,36000000,0,0,36000000,Null,Null,261874026,111461,2
261874069,0.0,0.0,40000000,40000000,0,0,40000000,Null,Null,261874069,111461,2
261874094,0.0,0.0,48000000,48000000,0,0,48000000,Null,Null,261874094,111461,2
261874128,0.0,0.0,40600000,40600000,0,0,40600000,Null,Null,261874128,111461,2
261874148,0.0,0.0,108000000,108000000,0,0,108000000,Null,Null,261874148,111461,2
261874173,0.0,0.0,36400000,36400000,0,0,36400000,Null,Null,261874173,111461,2
261874179,0.0,0.0,66000000,66000000,0,0,66000000,Null,Null,261874179,111461,2
261874199,0.0,0.0,36800000,36800000,0,0,36800000,Null,Null,261874199,111461,2
261874212,0.0,0.0,43400000,43400000,0,0,43400000,Null,Null,261874212,111461,2
261874215,0.0,0.0,47040000,47040000,0,0,47040000,Null,Null,261874215,111461,2
261874231,0.0,0.0,68000000,68000000,0,0,68000000,Null,Null,261874231,111461,2
261874240,0.0,0.0,42400000,42400000,0,0,42400000,Null,Null,261874240,111461,2
261874287,0.0,0.0,46870000,46870000,0,0,46870000,Null,Null,261874287,111461,2
261874303,0.0,0.0,38150000,38150000,0,0,38150000,Null,Null,261874303,111461,2
261874335,0.0,0.0,40800000,40800000,0,0,40800000,Null,Null,261874335,111461,2
261874348,0.0,0.0,43198400,43198400,0,0,43198400,Null,Null,261874348,111461,2
261874397,0.0,0.0,41300000,41300000,0,0,41300000,Null,Null,261874397,111461,2
261874408,0.0,0.0,39600000,39600000,0,0,39600000,Null,Null,261874408,111461,2
261874442,0.0,0.0,44400000,44400000,0,0,44400000,Null,Null,261874442,111461,2
261874498,0.0,0.0,36720000,36720000,0,0,36720000,Null,Null,261874498,111461,2
261874563,0.0,0.0,54600000,54600000,0,0,54600000,Null,Null,261874563,111461,2
261874569,0.0,0.0,39378430,39378430,0,0,39378430,Null,Null,261874569,111461,2
261874587,0.0,0.0,50000000,50000000,0,0,50000000,Null,Null,261874587,111461,2
261874623,0.0,0.0,78000000,78000000,0,0,78000000,Null,Null,261874623,111461,2
261874669,0.0,0.0,40600000,40600000,0,0,40600000,Null,Null,261874669,111461,2
261874891,0.0,0.0,46400000,46400000,0,0,46400000,Null,Null,261874891,111461,2
261874896,0.0,0.0,36000000,36000000,0,0,36000000,Null,Null,261874896,111461,2
261875034,0.0,0.0,41600000,41600000,0,0,41600000,Null,Null,261875034,111461,2
261875148,0.0,0.0,45000000,45000000,0,0,45000000,Null,Null,261875148,111461,2
261875221,0.0,0.0,51719200,51719200,0,0,51719200,Null,Null,261875221,111461,2
261875247,0.0,0.0,37578173,37578173,0,0,37578173,Null,Null,261875247,111461,2
261875310,0.0,0.0,49000000,49000000,0,0,49000000,Null,Null,261875310,111461,2
261875324,0.0,0.0,95040000,95040000,0,0,95040000,Null,Null,261875324,111461,2
261875513,0.0,0.0,51100000,51100000,0,0,51100000,Null,Null,261875513,111461,2
261875557,0.0,0.0,58240000,58240000,0,0,58240000,Null,Null,261875557,111461,2
261875673,0.0,0.0,48960000,48960000,0,0,48960000,Null,Null,261875673,111461,2
261875702,0.0,0.0,44800000,44800000,0,0,44800000,Null,Null,261875702,111461,2
261875712,0.0,0.0,63264000,63264000,0,0,63264000,Null,Null,261875712,111461,2
261875717,0.0,0.0,40000000,40000000,0,0,40000000,Null,Null,261875717,111461,2
261875851,0.0,0.0,63000000,63000000,0,0,63000000,Null,Null,261875851,111461,2
261875856,0.0,0.0,36400000,36400000,0,0,36400000,Null,Null,261875856,111461,2
261875981,0.0,0.0,50000000,50000000,0,0,50000000,Null,Null,261875981,111461,2
261876013,0.0,0.0,60000000,60000000,0,0,60000000,Null,Null,261876013,111461,2
261876038,0.0,0.0,59040000,59040000,0,0,59040000,Null,Null,261876038,111461,2
261876076,0.0,0.0,54000000,54000000,0,0,54000000,Null,Null,261876076,111461,2
261876093,0.0,0.0,40800000,40800000,0,0,40800000,Null,Null,261876093,111461,2
261876098,0.0,0.0,38500000,38500000,0,0,38500000,Null,Null,261876098,111461,2
261876218,0.0,0.0,36000000,36000000,0,0,36000000,Null,Null,261876218,111461,2
261876220,0.0,0.0,48000000,48000000,0,0,48000000,Null,Null,261876220,111461,2
261876225,0.0,0.0,38150000,38150000,0,0,38150000,Null,Null,261876225,111461,2
261876382,0.0,0.0,40000000,40000000,0,0,40000000,Null,Null,261876382,111461,2
261876430,0.0,0.0,53760000,53760000,0,0,53760000,Null,Null,261876430,111461,2
261876611,0.0,0.0,49000000,49000000,0,0,49000000,Null,Null,261876611,111461,2
261876647,0.0,0.0,51520000,51520000,0,0,51520000,Null,Null,261876647,111461,2
261876652,0.0,0.0,55200000,55200000,0,0,55200000,Null,Null,261876652,111461,2
261876655,0.0,0.0,57530200,57530200,0,0,57530200,Null,Null,261876655,111461,2
261876699,0.0,0.0,47640000,47640000,0,0,47640000,Null,Null,261876699,111461,2
261876705,0.0,0.0,39200000,39200000,0,0,39200000,Null,Null,261876705,111461,2
261876722,0.0,0.0,50000000,50000000,0,0,50000000,Null,Null,261876722,111461,2
261876768,0.0,0.0,37200000,37200000,0,0,37200000,Null,Null,261876768,111461,2
261876782,0.0,0.0,50000000,50000000,0,0,50000000,Null,Null,261876782,111461,2
261876807,0.0,0.0,50000000,50000000,0,0,50000000,Null,Null,261876807,111461,2
261876841,0.0,0.0,40800000,40800000,0,0,40800000,Null,Null,261876841,111461,2
261876854,0.0,0.0,48160000,48160000,0,0,48160000,Null,Null,261876854,111461,2
261876905,0.0,0.0,63296240,63296240,0,0,63296240,Null,Null,261876905,111461,2
261876927,0.0,0.0,43680000,43680000,0,0,43680000,Null,Null,261876927,111461,2
261876999,0.0,0.0,38000000,38000000,0,0,38000000,Null,Null,261876999,111461,2
261877195,0.0,0.0,39200000,39200000,0,0,39200000,Null,Null,261877195,111461,2
261877222,0.0,0.0,66080000,66080000,0,0,66080000,Null,Null,261877222,111461,2
261877274,0.0,0.0,39200000,39200000,0,0,39200000,Null,Null,261877274,111461,2
261877360,0.0,0.0,40320000,40320000,0,0,40320000,Null,Null,261877360,111461,2
261877365,0.0,0.0,39744000,39744000,0,0,39744000,Null,Null,261877365,111461,2
261877366,0.0,0.0,65465400,65465400,0,0,65465400,Null,Null,261877366,111461,2
261877481,0.0,0.0,38684100,38684100,0,0,38684100,Null,Null,261877481,111461,2
261877579,0.0,0.0,58240000,58240000,0,0,58240000,Null,Null,261877579,111461,2
261877598,0.0,0.0,46000000,46000000,0,0,46000000,Null,Null,261877598,111461,2
261877688,0.0,0.0,40600000,40600000,0,0,40600000,Null,Null,261877688,111461,2
261877714,0.0,0.0,41000000,41000000,0,0,41000000,Null,Null,261877714,111461,2
261877719,0.0,0.0,36400000,36400000,0,0,36400000,Null,Null,261877719,111461,2
261877723,0.0,0.0,74400000,74400000,0,0,74400000,Null,Null,261877723,111461,2
261877819,0.0,0.0,43400000,43400000,0,0,43400000,Null,Null,261877819,111461,2
261877829,0.0,0.0,37800000,37800000,0,0,37800000,Null,Null,261877829,111461,2
261877897,0.0,0.0,50000000,50000000,0,0,50000000,Null,Null,261877897,111461,2
261878028,0.0,0.0,43198400,43198400,0,0,43198400,Null,Null,261878028,111461,2
261878042,0.0,0.0,40320000,40320000,0,0,40320000,Null,Null,261878042,111461,2
261878047,0.0,0.0,44800000,44800000,0,0,44800000,Null,Null,261878047,111461,2
261878292,0.0,0.0,41320000,41320000,0,0,41320000,Null,Null,261878292,111461,2
261878298,0.0,0.0,43336000,43336000,0,0,43336000,Null,Null,261878298,111461,2
261878305,0.0,0.0,60136000,60136000,0,0,60136000,Null,Null,261878305,111461,2
261878306,0.0,0.0,51400000,51400000,0,0,51400000,Null,Null,261878306,111461,2
261878370,0.0,0.0,63496000,63496000,0,0,63496000,Null,Null,261878370,111461,2
261878565,0.0,0.0,41400000,41400000,0,0,41400000,Null,Null,261878565,111461,2
261878716,0.0,0.0,36186400,36186400,0,0,36186400,Null,Null,261878716,111461,2
261878866,0.0,0.0,49000000,49000000,0,0,49000000,Null,Null,261878866,111461,2
261878941,0.0,0.0,51800000,51800000,0,0,51800000,Null,Null,261878941,111461,2
261878965,0.0,0.0,39200000,39200000,0,0,39200000,Null,Null,261878965,111461,2
261879005,0.0,0.0,49000000,49000000,0,0,49000000,Null,Null,261879005,111461,2
261879077,0.0,0.0,44136000,44136000,0,0,44136000,Null,Null,261879077,111461,2
261879154,0.0,0.0,98950000,98950000,0,0,98950000,Null,Null,261879154,111461,2
261879186,0.0,0.0,37800000,37800000,0,0,37800000,Null,Null,261879186,111461,2
261879261,0.0,0.0,55540000,55540000,0,0,55540000,Null,Null,261879261,111461,2
261879512,0.0,0.0,50400000,50400000,0,0,50400000,Null,Null,261879512,111461,2
261879614,0.0,0.0,93400000,93400000,0,0,93400000,Null,Null,261879614,111461,2
261879762,0.0,0.0,44800000,44800000,0,0,44800000,Null,Null,261879762,111461,2
261879853,0.0,0.0,46000000,46000000,0,0,46000000,Null,Null,261879853,111461,2
261880098,0.0,0.0,51800000,51800000,0,0,51800000,Null,Null,261880098,111461,2
261880151,0.0,0.0,40480000,40480000,0,0,40480000,Null,Null,261880151,111461,2
261880208,0.0,0.0,55720000,55720000,0,0,55720000,Null,Null,261880208,111461,2
261880259,0.0,0.0,39400000,39400000,0,0,39400000,Null,Null,261880259,111461,2
261880337,0.0,0.0,48040000,48040000,0,0,48040000,Null,Null,261880337,111461,2
261880347,0.0,0.0,46200000,46200000,0,0,46200000,Null,Null,261880347,111461,2
261880368,0.0,0.0,60200000,60200000,0,0,60200000,Null,Null,261880368,111461,2
261880411,0.0,0.0,55400000,55400000,0,0,55400000,Null,Null,261880411,111461,2
261880412,0.0,0.0,40600000,40600000,0,0,40600000,Null,Null,261880412,111461,2
261880463,0.0,0.0,59800000,59800000,0,0,59800000,Null,Null,261880463,111461,2
261880578,0.0,0.0,44800000,44800000,0,0,44800000,Null,Null,261880578,111461,2
261880590,0.0,0.0,40000000,40000000,0,0,40000000,Null,Null,261880590,111461,2
261880636,0.0,0.0,39400000,39400000,0,0,39400000,Null,Null,261880636,111461,2
261880670,0.0,0.0,38950000,38950000,0,0,38950000,Null,Null,261880670,111461,2
261880767,0.0,0.0,50600000,50600000,0,0,50600000,Null,Null,261880767,111461,2
261880824,0.0,0.0,51400000,51400000,0,0,51400000,Null,Null,261880824,111461,2
261880848,0.0,0.0,50600000,50600000,0,0,50600000,Null,Null,261880848,111461,2
261880850,0.0,0.0,37800000,37800000,0,0,37800000,Null,Null,261880850,111461,2
261881097,0.0,0.0,53200000,53200000,0,0,53200000,Null,Null,261881097,111461,2
261881136,0.0,0.0,44680000,44680000,0,0,44680000,Null,Null,261881136,111461,2
261881325,0.0,0.0,36520000,36520000,0,0,36520000,Null,Null,261881325,111461,2
261881394,0.0,0.0,48000000,48000000,0,0,48000000,Null,Null,261881394,111461,2
261881535,0.0,0.0,90000000,90000000,0,0,90000000,Null,Null,261881535,111461,2
261881588,0.0,0.0,48040000,48040000,0,0,48040000,Null,Null,261881588,111461,2
261881618,0.0,0.0,71400000,71400000,0,0,71400000,Null,Null,261881618,111461,2
261881625,0.0,0.0,40600000,40600000,0,0,40600000,Null,Null,261881625,111461,2
261881756,0.0,0.0,58800000,58800000,0,0,58800000,Null,Null,261881756,111461,2
261881792,0.0,0.0,37800000,37800000,0,0,37800000,Null,Null,261881792,111461,2
261881835,0.0,0.0,41320000,41320000,0,0,41320000,Null,Null,261881835,111461,2
261881959,0.0,0.0,78280000,78280000,0,0,78280000,Null,Null,261881959,111461,2
261882024,0.0,0.0,67240000,67240000,0,0,67240000,Null,Null,261882024,111461,2
261882031,0.0,0.0,46200000,46200000,0,0,46200000,Null,Null,261882031,111461,2
261882050,0.0,0.0,14440000,14440000,0,0,14440000,Null,Null,261882050,111461,2
261882056,0.0,0.0,11152000,11152000,0,0,11152000,Null,Null,261882056,111461,2
261882097,0.0,0.0,39400000,39400000,0,0,39400000,Null,Null,261882097,111461,2
261882238,0.0,0.0,49720000,49720000,0,0,49720000,Null,Null,261882238,111461,2
261882434,0.0,0.0,49720000,49720000,0,0,49720000,Null,Null,261882434,111461,2
261882583,0.0,0.0,5568000,5568000,0,0,5568000,Null,Null,261882583,111461,2
261882639,0.0,0.0,38800000,38800000,0,0,38800000,Null,Null,261882639,111461,2
261882765,0.0,0.0,47080000,47080000,0,0,47080000,Null,Null,261882765,111461,2
261883004,0.0,0.0,61000000,61000000,0,0,61000000,Null,Null,261883004,111461,2
261883115,0.0,0.0,58800000,58800000,0,0,58800000,Null,Null,261883115,111461,2
261883226,0.0,0.0,42160000,42160000,0,0,42160000,Null,Null,261883226,111461,2
261883309,0.0,0.0,56440000,56440000,0,0,56440000,Null,Null,261883309,111461,2
261883357,0.0,0.0,54536000,54536000,0,0,54536000,Null,Null,261883357,111461,2
261883373,0.0,0.0,46360000,46360000,0,0,46360000,Null,Null,261883373,111461,2
261883374,0.0,0.0,41800000,41800000,0,0,41800000,Null,Null,261883374,111461,2
261883377,0.0,0.0,6250240,6250240,0,0,6250240,Null,Null,261883377,111461,2
261883382,0.0,0.0,77000000,77000000,0,0,77000000,Null,Null,261883382,111461,2
261883396,0.0,0.0,38363200,38363200,0,0,38363200,Null,Null,261883396,111461,2
261883504,0.0,0.0,41248000,41248000,0,0,41248000,Null,Null,261883504,111461,2
261883520,0.0,0.0,37800000,37800000,0,0,37800000,Null,Null,261883520,111461,2
261883588,0.0,0.0,39000000,39000000,0,0,39000000,Null,Null,261883588,111461,2
261883614,0.0,0.0,36400000,36400000,0,0,36400000,Null,Null,261883614,111461,2
261883676,0.0,0.0,41051200,41051200,0,0,41051200,Null,Null,261883676,111461,2
261883736,0.0,0.0,36840000,36840000,0,0,36840000,Null,Null,261883736,111461,2
261883807,0.0,0.0,40320000,40320000,0,0,40320000,Null,Null,261883807,111461,2
261883828,0.0,0.0,40600000,40600000,0,0,40600000,Null,Null,261883828,111461,2
261883913,0.0,0.0,36000000,36000000,0,0,36000000,Null,Null,261883913,111461,2
261883936,0.0,0.0,59800000,59800000,0,0,59800000,Null,Null,261883936,111461,2
261884111,0.0,0.0,46360000,46360000,0,0,46360000,Null,Null,261884111,111461,2
261884291,0.0,0.0,36840000,36840000,0,0,36840000,Null,Null,261884291,111461,2
261884409,0.0,0.0,50600000,50600000,0,0,50600000,Null,Null,261884409,111461,2
261884512,0.0,0.0,53000000,53000000,0,0,53000000,Null,Null,261884512,111461,2
261884558,0.0,0.0,46000000,46000000,0,0,46000000,Null,Null,261884558,111461,2
261884588,0.0,0.0,36400000,36400000,0,0,36400000,Null,Null,261884588,111461,2
261884616,0.0,0.0,63160000,63160000,0,0,63160000,Null,Null,261884616,111461,2
261884641,0.0,0.0,36400000,36400000,0,0,36400000,Null,Null,261884641,111461,2
261884644,0.0,0.0,39640000,39640000,0,0,39640000,Null,Null,261884644,111461,2
261884658,0.0,0.0,58120000,58120000,0,0,58120000,Null,Null,261884658,111461,2
261884754,0.0,0.0,40200000,40200000,0,0,40200000,Null,Null,261884754,111461,2
261884813,0.0,0.0,71560000,71560000,0,0,71560000,Null,Null,261884813,111461,2
261884955,0.0,0.0,37800000,37800000,0,0,37800000,Null,Null,261884955,111461,2
261884986,0.0,0.0,5740800,5740800,0,0,5740800,Null,Null,261884986,111461,2
261885180,0.0,0.0,39640000,39640000,0,0,39640000,Null,Null,261885180,111461,2
261885231,0.0,0.0,37736000,37736000,0,0,37736000,Null,Null,261885231,111461,2
261885406,0.0,0.0,36712000,36712000,0,0,36712000,Null,Null,261885406,111461,2
261885541,0.0,0.0,38296000,38296000,0,0,38296000,Null,Null,261885541,111461,2
261885544,0.0,0.0,36712000,36712000,0,0,36712000,Null,Null,261885544,111461,2
261885622,0.0,0.0,98920000,98920000,0,0,98920000,Null,Null,261885622,111461,2
261885779,0.0,0.0,53200000,53200000,0,0,53200000,Null,Null,261885779,111461,2
261885794,0.0,0.0,63400000,63400000,0,0,63400000,Null,Null,261885794,111461,2
261942659,0.0,0.0,199000,199000,0,0,199000,Null,Null,261942659,111461,2
261943097,0.0,0.0,116000,104400,11600,10,116000,Null,Null,261943097,111461,15320
261943658,0.0,0.0,72000,64800,7200,10,72000,Null,Null,261943658,111461,15320
261943885,74.0,74.0,15000,15000,0,0,15000,Null,Null,261943885,111461,23210
261945138,0.0,0.0,159000,159000,0,0,159000,Null,Null,261945138,111461,2
261945153,0.0,0.0,109000,109000,0,0,109000,Null,Null,261945153,111461,2
261945160,0.0,0.0,149000,149000,0,0,149000,Null,Null,261945160,111461,2
261945165,0.0,0.0,135000,135000,0,0,135000,Null,Null,261945165,111461,2
261945662,0.0,0.0,370000,370000,0,0,370000,Null,Null,261945662,717061,11859
261945711,0.0,0.0,78000,78000,0,0,78000,Null,Null,261945711,111461,2
261945941,0.0,0.0,130000,130000,0,0,130000,Null,Null,261945941,111461,2
261945956,0.0,0.0,83000,83000,0,0,83000,Null,Null,261945956,111461,2
261945989,0.0,0.0,110000,110000,0,0,110000,Null,Null,261945989,111461,2
261946013,0.0,0.0,89000,89000,0,0,89000,Null,Null,261946013,111461,2
261946060,0.0,0.0,80000,80000,0,0,80000,Null,Null,261946060,111461,2
261946061,0.0,0.0,92000,92000,0,0,92000,Null,Null,261946061,111461,2
261946204,0.0,0.0,97000,97000,0,0,97000,Null,Null,261946204,111461,2
261946671,0.0,0.0,358000,358000,0,0,358000,Null,Null,261946671,254399,2347
261946792,0.0,0.0,120000,120000,0,0,120000,Null,Null,261946792,111461,2
261946829,0.0,0.0,130000,130000,0,0,130000,Null,Null,261946829,111461,2
261946899,1.0,1.0,4990000,4289000,701000,14,4990000,Null,Null,261946899,18802,1795
261947548,0.0,0.0,87000,87000,0,0,87000,Null,Null,261947548,111461,2
261947549,0.0,0.0,99000,99000,0,0,99000,Null,Null,261947549,111461,2
261947593,0.0,0.0,99000,99000,0,0,99000,Null,Null,261947593,111461,2
261948231,0.0,0.0,293000,261000,32000,11,293000,Null,Null,261948231,111461,15318
261949728,0.0,0.0,6900000,6900000,0,0,6900000,Null,Null,261949728,111461,15318
261951805,0.0,0.0,18300000,18300000,0,0,18300000,Null,Null,261951805,111461,28862
261957139,0.0,0.0,39734000,39734000,0,0,39734000,Null,Null,261957139,111461,2
261961035,0.0,0.0,15000000,15000000,0,0,15000000,Null,Null,261961035,111461,28862
261961284,0.0,0.0,10000,6500,3500,35,10000,Null,Null,261961284,477953,8305
261962079,0.0,0.0,10000,6500,3500,35,10000,Null,Null,261962079,477953,8305
261962220,0.0,0.0,6490000,5899000,591000,9,6490000,Null,Null,261962220,18802,1795
261963264,0.0,0.0,2200000,2200000,0,0,2200000,Null,Null,261963264,579445,15320
261963624,1.0,1.0,18990000,16770000,2220000,12,18990000,Null,Null,261963624,183637,28856
261964062,0.0,0.0,2934550,2612000,322550,11,2934550,Null,Null,261964062,5719107,2
261964853,0.0,0.0,3990000,3990000,0,0,3990000,Null,Null,261964853,169013,1795
261965186,0.0,0.0,6132000,5876000,256000,4,6132000,Null,Null,261965186,25422,1795
261965750,0.0,0.0,1500,1500,0,0,1500,Null,Null,261965750,111461,2
261965948,0.0,0.0,2400,2400,0,0,2400,Null,Null,261965948,111461,2
261966235,0.0,0.0,22730000,22730000,0,0,22730000,Null,Null,261966235,111461,6653
261967566,0.0,0.0,34531000,34531000,0,0,34531000,Null,Null,261967566,111461,7079
261973441,0.0,0.0,5000,5000,0,0,5000,Null,Null,261973441,111461,28484
261973452,0.0,0.0,5000,5000,0,0,5000,Null,Null,261973452,111461,28484
261973777,0.0,0.0,5000,5000,0,0,5000,Null,Null,261973777,111461,28484
261973812,0.0,0.0,5000,5000,0,0,5000,Null,Null,261973812,111461,28484
261973894,0.0,0.0,550000,459000,91000,17,550000,Null,Null,261973894,704815,15250
261973934,0.0,0.0,1450000,1305000,145000,10,1450000,Null,Null,261973934,704815,15250
261974046,0.0,0.0,130000,130000,0,0,130000,Null,Null,261974046,111461,53074
261974072,0.0,0.0,418000,418000,0,0,418000,Null,Null,261974072,111461,53074
261978291,0.0,0.0,450000,450000,0,0,450000,Null,Null,261978291,4251649,11859
261980005,0.0,0.0,2865000,2865000,0,0,2865000,Null,Null,261980005,111461,5566
261980118,0.0,0.0,4290000,4290000,0,0,4290000,Null,Null,261980118,113119,8066
261980550,0.0,0.0,38104000,38104000,0,0,38104000,Null,Null,261980550,111461,7079
261980552,0.0,0.0,4590000,3890000,700000,15,4590000,Null,Null,261980552,208841,2340
261981469,0.0,0.0,5990000,5270000,720000,12,5990000,Null,Null,261981469,208841,2340
261982749,0.0,0.0,3990000,3510000,480000,12,3990000,Null,Null,261982749,208841,2340
261983263,0.0,0.0,4990000,4490000,500000,10,4990000,Null,Null,261983263,208841,2340
261983742,0.0,0.0,13262000,13262000,0,0,13262000,Null,Null,261983742,111461,28860
261983773,0.0,0.0,280000,240000,40000,14,280000,Null,Null,261983773,173547,2
261983778,0.0,0.0,520000,480000,40000,8,520000,Null,Null,261983778,173547,2
261983779,0.0,0.0,490000,300000,190000,39,490000,Null,Null,261983779,173547,2
261983829,0.0,0.0,370000,370000,0,0,370000,Null,Null,261983829,173547,2
261983841,0.0,0.0,450000,360000,90000,20,450000,Null,Null,261983841,173547,2
261983845,0.0,0.0,350000,310000,40000,11,350000,Null,Null,261983845,173547,2
261983852,0.0,0.0,360000,280000,80000,22,360000,Null,Null,261983852,173547,2
261984683,12.0,12.0,69000,59000,10000,14,69000,Null,Null,261984683,111461,5531
261984820,0.0,0.0,15000,8500,6500,43,15000,Null,Null,261984820,477953,8305
261988192,0.0,0.0,239000,239000,0,0,239000,Null,Null,261988192,111461,15250
261989501,0.0,0.0,249000,249000,0,0,249000,Null,Null,261989501,111461,15250
261990231,0.0,0.0,1000,1000,0,0,1000,Null,Null,261990231,111461,2
261990595,0.0,0.0,2400,2400,0,0,2400,Null,Null,261990595,111461,2
261990849,0.0,0.0,10000,10000,0,0,10000,Null,Null,261990849,111461,2
261991610,0.0,0.0,4800,4800,0,0,4800,Null,Null,261991610,111461,2
261992488,0.0,0.0,1200,1200,0,0,1200,Null,Null,261992488,111461,2
261992564,0.0,0.0,1200,1200,0,0,1200,Null,Null,261992564,111461,2
261992923,0.0,0.0,239000,239000,0,0,239000,Null,Null,261992923,111461,15250
261992983,0.0,0.0,24900,24900,0,0,24900,Null,Null,261992983,111461,15250
261993536,0.0,0.0,160650,160650,0,0,160650,Null,Null,261993536,7368403,2
261993603,0.0,0.0,160650,160650,0,0,160650,Null,Null,261993603,7368403,2
261993832,0.0,0.0,240550,240550,0,0,240550,Null,Null,261993832,7368403,2
261993914,0.0,0.0,157250,157250,0,0,157250,Null,Null,261993914,7368403,2
261994081,0.0,0.0,168300,168300,0,0,168300,Null,Null,261994081,7368403,2
261994542,0.0,0.0,145350,145350,0,0,145350,Null,Null,261994542,7368403,2
261997689,0.0,0.0,15743000,15743000,0,0,15743000,Null,Null,261997689,111461,8067
262005234,0.0,0.0,75000000,68000000,7000000,9,75000000,Null,Null,262005234,601737,2340
262017473,0.0,0.0,6500000,6500000,0,0,6500000,Null,Null,262017473,27398,2340
262017492,0.0,0.0,1750,1750,0,0,1750,Null,Null,262017492,111461,2
262018858,0.0,0.0,13966000,13966000,0,0,13966000,Null,Null,262018858,111461,11518
262029750,0.0,0.0,38104000,38104000,0,0,38104000,Null,Null,262029750,111461,28860
262030648,0.0,0.0,27958000,27958000,0,0,27958000,Null,Null,262030648,111461,11518
262030801,0.0,0.0,13499000,13499000,0,0,13499000,Null,Null,262030801,111461,8064
262031242,0.0,0.0,4436000,3548800,887200,20,4436000,Null,Null,262031242,5156071,17174
262031323,0.0,0.0,250000,250000,0,0,250000,Null,Null,262031323,111461,15318
262031506,6.0,6.0,319000,156000,163000,51,319000,Null,Null,262031506,361359,4593
262034792,9.0,9.0,319000,156000,163000,51,319000,Null,Null,262034792,361359,8519
262034844,0.0,0.0,159000,159000,0,0,159000,Null,Null,262034844,111461,15318
262036373,0.0,0.0,2950000,2950000,0,0,2950000,Null,Null,262036373,579445,15320
262037039,0.0,0.0,8250000,8250000,0,0,8250000,Null,Null,262037039,27398,2340
262044367,0.0,0.0,169000,169000,0,0,169000,Null,Null,262044367,111461,2
262044374,0.0,0.0,330000,330000,0,0,330000,Null,Null,262044374,111461,2
262044375,0.0,0.0,169000,169000,0,0,169000,Null,Null,262044375,111461,2
262044386,0.0,0.0,115000,115000,0,0,115000,Null,Null,262044386,111461,2
262044395,0.0,0.0,650000,650000,0,0,650000,Null,Null,262044395,111461,2
262044401,0.0,0.0,390000,390000,0,0,390000,Null,Null,262044401,111461,2
262044407,0.0,0.0,380000,380000,0,0,380000,Null,Null,262044407,111461,2
262044410,0.0,0.0,7000,7000,0,0,7000,Null,Null,262044410,111461,2
262044414,0.0,0.0,245000,245000,0,0,245000,Null,Null,262044414,111461,2
262044417,0.0,0.0,169000,169000,0,0,169000,Null,Null,262044417,111461,2
262044425,0.0,0.0,169000,169000,0,0,169000,Null,Null,262044425,111461,2
262044426,0.0,0.0,360000,360000,0,0,360000,Null,Null,262044426,111461,2
262044427,0.0,0.0,235000,235000,0,0,235000,Null,Null,262044427,111461,2
262044428,0.0,0.0,169000,169000,0,0,169000,Null,Null,262044428,111461,2
262044437,0.0,0.0,235000,235000,0,0,235000,Null,Null,262044437,111461,2
262044452,0.0,0.0,39000,39000,0,0,39000,Null,Null,262044452,111461,2
262044454,0.0,0.0,360000,360000,0,0,360000,Null,Null,262044454,111461,2
262044455,0.0,0.0,510000,510000,0,0,510000,Null,Null,262044455,111461,2
262044457,0.0,0.0,420000,420000,0,0,420000,Null,Null,262044457,111461,2
262044459,0.0,0.0,169000,169000,0,0,169000,Null,Null,262044459,111461,2
262044467,0.0,0.0,330000,330000,0,0,330000,Null,Null,262044467,111461,2
262044468,0.0,0.0,65000,65000,0,0,65000,Null,Null,262044468,111461,2
262044473,0.0,0.0,249000,249000,0,0,249000,Null,Null,262044473,111461,2
262044488,0.0,0.0,45000,45000,0,0,45000,Null,Null,262044488,111461,2
262044492,0.0,0.0,25000,25000,0,0,25000,Null,Null,262044492,111461,2
262044497,0.0,0.0,45000,45000,0,0,45000,Null,Null,262044497,111461,2
262044498,0.0,0.0,119000,119000,0,0,119000,Null,Null,262044498,111461,2
262044501,0.0,0.0,29900,29900,0,0,29900,Null,Null,262044501,111461,2
262044503,0.0,0.0,380000,380000,0,0,380000,Null,Null,262044503,111461,2
262044510,0.0,0.0,245000,245000,0,0,245000,Null,Null,262044510,111461,2
262044513,0.0,0.0,240000,240000,0,0,240000,Null,Null,262044513,111461,2
262044529,0.0,0.0,39000,39000,0,0,39000,Null,Null,262044529,111461,2
262044534,0.0,0.0,270000,270000,0,0,270000,Null,Null,262044534,111461,2
262044535,0.0,0.0,235000,235000,0,0,235000,Null,Null,262044535,111461,2
262044538,0.0,0.0,39000,39000,0,0,39000,Null,Null,262044538,111461,2
262044541,0.0,0.0,225000,225000,0,0,225000,Null,Null,262044541,111461,2
262044542,0.0,0.0,129000,129000,0,0,129000,Null,Null,262044542,111461,2
262044544,0.0,0.0,49000,49000,0,0,49000,Null,Null,262044544,111461,2
262044553,0.0,0.0,65000,65000,0,0,65000,Null,Null,262044553,111461,2
262044555,0.0,0.0,380000,380000,0,0,380000,Null,Null,262044555,111461,2
262044561,0.0,0.0,330000,330000,0,0,330000,Null,Null,262044561,111461,2
262044562,0.0,0.0,380000,380000,0,0,380000,Null,Null,262044562,111461,2
262044574,0.0,0.0,115000,115000,0,0,115000,Null,Null,262044574,111461,2
262044577,0.0,0.0,330000,330000,0,0,330000,Null,Null,262044577,111461,2
262044580,0.0,0.0,380000,380000,0,0,380000,Null,Null,262044580,111461,2
262044600,0.0,0.0,29900,29900,0,0,29900,Null,Null,262044600,111461,2
262044601,0.0,0.0,39000,39000,0,0,39000,Null,Null,262044601,111461,2
262044622,0.0,0.0,245000,245000,0,0,245000,Null,Null,262044622,111461,2
262044623,0.0,0.0,9000,9000,0,0,9000,Null,Null,262044623,111461,2
262044624,0.0,0.0,65000,65000,0,0,65000,Null,Null,262044624,111461,2
262044628,0.0,0.0,55000,55000,0,0,55000,Null,Null,262044628,111461,2
262044629,0.0,0.0,270000,270000,0,0,270000,Null,Null,262044629,111461,2
262044630,0.0,0.0,225000,225000,0,0,225000,Null,Null,262044630,111461,2
262044637,0.0,0.0,360000,360000,0,0,360000,Null,Null,262044637,111461,2
262044642,0.0,0.0,55000,55000,0,0,55000,Null,Null,262044642,111461,2
262044643,0.0,0.0,39000,39000,0,0,39000,Null,Null,262044643,111461,2
262044646,0.0,0.0,240000,240000,0,0,240000,Null,Null,262044646,111461,2
262044653,0.0,0.0,390000,390000,0,0,390000,Null,Null,262044653,111461,2
262044655,0.0,0.0,49000,49000,0,0,49000,Null,Null,262044655,111461,2
262044656,0.0,0.0,390000,390000,0,0,390000,Null,Null,262044656,111461,2
262044661,0.0,0.0,49000,49000,0,0,49000,Null,Null,262044661,111461,2
262044667,0.0,0.0,240000,240000,0,0,240000,Null,Null,262044667,111461,2
262044676,0.0,0.0,380000,380000,0,0,380000,Null,Null,262044676,111461,2
262044687,0.0,0.0,330000,330000,0,0,330000,Null,Null,262044687,111461,2
262044696,0.0,0.0,330000,330000,0,0,330000,Null,Null,262044696,111461,2
262044721,0.0,0.0,380000,380000,0,0,380000,Null,Null,262044721,111461,2
262044728,0.0,0.0,460000,460000,0,0,460000,Null,Null,262044728,111461,2
262045509,0.0,0.0,10000,7000,3000,30,10000,Null,Null,262045509,477953,8305
262048995,0.0,0.0,9000,8000,1000,11,9000,Null,Null,262048995,31581,2
262049001,0.0,0.0,9000,8000,1000,11,9000,Null,Null,262049001,31581,2
262049007,0.0,0.0,12000,8000,4000,33,12000,Null,Null,262049007,31581,2
262049011,0.0,0.0,12000,8000,4000,33,12000,Null,Null,262049011,31581,2
262049015,0.0,0.0,9000,8000,1000,11,9000,Null,Null,262049015,31581,2
262049019,0.0,0.0,8500,8000,500,6,8500,Null,Null,262049019,31581,2
262049023,0.0,0.0,12000,8000,4000,33,12000,Null,Null,262049023,31581,2
262049025,0.0,0.0,9000,8000,1000,11,9000,Null,Null,262049025,31581,2
262049513,0.0,0.0,14999000,14999000,0,0,14999000,Null,Null,262049513,181329,8066
262049888,0.0,0.0,55924000,55924000,0,0,55924000,Null,Null,262049888,111461,6653
262051450,0.0,0.0,20962000,20962000,0,0,20962000,Null,Null,262051450,111461,11518
262051540,0.0,0.0,159000,159000,0,0,159000,Null,Null,262051540,111461,15318
262053915,17.0,17.0,115000,115000,0,0,115000,Null,Null,262053915,111461,1520
262053969,0.0,0.0,8000,8000,0,0,8000,Null,Null,262053969,273633,2
262054005,0.0,0.0,9000,8000,1000,11,9000,Null,Null,262054005,31581,2
262054013,0.0,0.0,9000,8000,1000,11,9000,Null,Null,262054013,31581,2
262054207,0.0,0.0,93236000,93236000,0,0,93236000,Null,Null,262054207,111461,6653
262055825,0.0,0.0,11900000,11900000,0,0,11900000,Null,Null,262055825,8190385,28860
262055875,0.0,0.0,3990000,2859000,1131000,28,3990000,Null,Null,262055875,25422,1795
262055982,0.0,0.0,150000,150000,0,0,150000,Null,Null,262055982,111461,15318
262055994,0.0,0.0,14490000,14490000,0,0,14490000,Null,Null,262055994,8190385,28860
262055996,0.0,0.0,8300000,8300000,0,0,8300000,Null,Null,262055996,27398,2340
262056034,0.0,0.0,180000,180000,0,0,180000,Null,Null,262056034,111461,15318
262056547,0.0,0.0,3588000,3588000,0,0,3588000,Null,Null,262056547,254939,2342
262056661,0.0,0.0,150000,150000,0,0,150000,Null,Null,262056661,111461,15250
262056840,0.0,0.0,15136000,15136000,0,0,15136000,Null,Null,262056840,111461,8067
262056961,0.0,0.0,4790000,2998000,1792000,37,4790000,Null,Null,262056961,25422,1795
262056970,0.0,0.0,230000,230000,0,0,230000,Null,Null,262056970,111461,15318
262057571,0.0,0.0,230000,230000,0,0,230000,Null,Null,262057571,111461,15318
262058019,0.0,0.0,22352000,22352000,0,0,22352000,Null,Null,262058019,111461,8064
262058304,0.0,0.0,150000,150000,0,0,150000,Null,Null,262058304,111461,15250
262058495,0.0,0.0,3599000,3599000,0,0,3599000,Null,Null,262058495,254939,2342
262058587,0.0,0.0,180000,180000,0,0,180000,Null,Null,262058587,111461,15318
262058677,0.0,0.0,170000,170000,0,0,170000,Null,Null,262058677,111461,15318
262059199,0.0,0.0,598000,299000,299000,50,598000,Null,Null,262059199,111461,15318
262059273,0.0,0.0,16931000,16931000,0,0,16931000,Null,Null,262059273,111461,6653
262060134,0.0,0.0,13262000,13262000,0,0,13262000,Null,Null,262060134,111461,11518
262060477,0.0,0.0,1650000,1248000,402000,24,1650000,Null,Null,262060477,8130109,5385
262065763,0.0,0.0,64990000,63365000,1625000,3,64990000,Null,Null,262065763,114527,2657
262067485,0.0,0.0,64990000,64990000,0,0,64990000,Null,Null,262067485,114527,2657
262068246,0.0,0.0,3800000,3500000,300000,8,3800000,Null,Null,262068246,18804,1626
262074225,0.0,0.0,65000,55000,10000,15,65000,Null,Null,262074225,111461,8371
262074516,0.0,0.0,329000,269000,60000,18,329000,Null,Null,262074516,111461,8371
262074611,0.0,0.0,69000,56000,13000,19,69000,Null,Null,262074611,111461,8371
262074980,0.0,0.0,180000,180000,0,0,180000,Null,Null,262074980,111461,15936
262075320,0.0,0.0,3190000,2699000,491000,15,3190000,Null,Null,262075320,162007,1795
262075507,0.0,0.0,99800000,50898000,48902000,49,99800000,Null,Null,262075507,201253,23576
262075538,0.0,0.0,3000,3000,0,0,3000,Null,Null,262075538,111461,8205
262076091,0.0,0.0,99800000,50898000,48902000,49,99800000,Null,Null,262076091,201253,23576
262076098,0.0,0.0,99800000,50898000,48902000,49,99800000,Null,Null,262076098,201253,23576
262076377,0.0,0.0,99800000,50898000,48902000,49,99800000,Null,Null,262076377,201253,23576
262076395,0.0,0.0,99800000,50898000,48902000,49,99800000,Null,Null,262076395,201253,23576
262076416,0.0,0.0,79800000,40698000,39102000,49,79800000,Null,Null,262076416,201253,23576
262076420,0.0,0.0,79800000,40698000,39102000,49,79800000,Null,Null,262076420,201253,23576
262078632,0.0,0.0,69000,58000,11000,16,69000,Null,Null,262078632,111461,8371
262082287,0.0,0.0,4698000,4698000,0,0,4698000,Null,Null,262082287,256727,15320
262082322,1.0,1.0,3532000,3532000,0,0,3532000,Null,Null,262082322,256727,15320
262082487,0.0,0.0,2349000,2349000,0,0,2349000,Null,Null,262082487,256727,15320
262082630,0.0,0.0,1755000,1755000,0,0,1755000,Null,Null,262082630,256727,15320
262082695,0.0,0.0,2407000,2407000,0,0,2407000,Null,Null,262082695,256727,8371
262083126,0.0,0.0,1009000,1009000,0,0,1009000,Null,Null,262083126,256727,15320
262083757,0.0,0.0,501400,250700,250700,50,501400,Null,Null,262083757,111461,15250
262085828,0.0,0.0,79800000,40698000,39102000,49,79800000,Null,Null,262085828,201253,23576
262087026,0.0,0.0,79800000,40698000,39102000,49,79800000,Null,Null,262087026,201253,23576
262087166,0.0,0.0,79800000,40698000,39102000,49,79800000,Null,Null,262087166,201253,23576
262087713,0.0,0.0,99800000,50898000,48902000,49,99800000,Null,Null,262087713,201253,23576
262089930,0.0,0.0,22730000,22730000,0,0,22730000,Null,Null,262089930,111461,6653
262117053,0.0,0.0,854000,854000,0,0,854000,Null,Null,262117053,111461,2
262127838,0.0,0.0,615000,615000,0,0,615000,Null,Null,262127838,111461,2
262131892,0.0,0.0,665000,665000,0,0,665000,Null,Null,262131892,111461,2
262131917,0.0,0.0,665900,665900,0,0,665900,Null,Null,262131917,111461,2
262131996,0.0,0.0,688000,688000,0,0,688000,Null,Null,262131996,111461,2
262132036,0.0,0.0,672000,672000,0,0,672000,Null,Null,262132036,111461,2
262141745,0.0,0.0,662000,662000,0,0,662000,Null,Null,262141745,111461,2
262148685,0.0,0.0,5500000,5500000,0,0,5500000,Null,Null,262148685,111461,2
262183595,0.0,0.0,460000,460000,0,0,460000,Null,Null,262183595,111461,2
262244713,0.0,0.0,5500000,5500000,0,0,5500000,Null,Null,262244713,111461,2
262250246,0.0,0.0,1200000,1200000,0,0,1200000,Null,Null,262250246,111461,2
262251153,0.0,0.0,676000,676000,0,0,676000,Null,Null,262251153,111461,2
262260900,0.0,0.0,676000,676000,0,0,676000,Null,Null,262260900,111461,2
262262467,0.0,0.0,676000,676000,0,0,676000,Null,Null,262262467,111461,2
262272802,0.0,0.0,676000,676000,0,0,676000,Null,Null,262272802,111461,2
262278084,0.0,0.0,540800,540800,0,0,540800,Null,Null,262278084,111461,2
262279800,0.0,0.0,5500000,5500000,0,0,5500000,Null,Null,262279800,111461,2
262292461,0.0,0.0,149000,149000,0,0,149000,Null,Null,262292461,149308,28484
262293250,0.0,0.0,34531000,34531000,0,0,34531000,Null,Null,262293250,111461,7079
262293593,1.0,1.0,3103000,3103000,0,0,3103000,Null,Null,262293593,256727,15320
262294219,0.0,0.0,1636000,1636000,0,0,1636000,Null,Null,262294219,256727,15320
262294269,0.0,0.0,2755000,2755000,0,0,2755000,Null,Null,262294269,256727,15320
262294401,0.0,0.0,2558000,2558000,0,0,2558000,Null,Null,262294401,256727,15320
262294430,0.0,0.0,2703000,2703000,0,0,2703000,Null,Null,262294430,256727,15320
262294562,0.0,0.0,2616000,2616000,0,0,2616000,Null,Null,262294562,256727,15320
262294726,0.0,0.0,1926000,1926000,0,0,1926000,Null,Null,262294726,256727,15320
262294804,0.0,0.0,2697000,2697000,0,0,2697000,Null,Null,262294804,256727,15320
262294942,0.0,0.0,2819000,2819000,0,0,2819000,Null,Null,262294942,256727,15318
262294982,0.0,0.0,127000,127000,0,0,127000,Null,Null,262294982,111684,28450
262294983,0.0,0.0,176000,176000,0,0,176000,Null,Null,262294983,111684,28450
262294984,0.0,0.0,127000,127000,0,0,127000,Null,Null,262294984,111684,28450
262295023,0.0,0.0,127000,127000,0,0,127000,Null,Null,262295023,111684,28450
262295044,0.0,0.0,127000,127000,0,0,127000,Null,Null,262295044,111684,28450
262295088,0.0,0.0,127000,127000,0,0,127000,Null,Null,262295088,111684,28450
262295136,0.0,0.0,176000,176000,0,0,176000,Null,Null,262295136,111684,28450
262295149,0.0,0.0,50000,50000,0,0,50000,Null,Null,262295149,111684,28450
262295180,0.0,0.0,226000,226000,0,0,226000,Null,Null,262295180,111684,28450
262295190,0.0,0.0,127000,127000,0,0,127000,Null,Null,262295190,111684,28450
262295202,0.0,0.0,50000,50000,0,0,50000,Null,Null,262295202,111684,28450
262295270,0.0,0.0,13262000,13262000,0,0,13262000,Null,Null,262295270,111461,28860
262295333,0.0,0.0,2869000,2869000,0,0,2869000,Null,Null,262295333,256727,15936
262295373,0.0,0.0,2348000,2348000,0,0,2348000,Null,Null,262295373,256727,15936
262295463,0.0,0.0,2261000,2261000,0,0,2261000,Null,Null,262295463,256727,15936
262295554,0.0,0.0,4041000,4041000,0,0,4041000,Null,Null,262295554,256727,15250
262295725,0.0,0.0,4969000,4969000,0,0,4969000,Null,Null,262295725,256727,15250
262299611,0.0,0.0,38104000,38104000,0,0,38104000,Null,Null,262299611,111461,7079
262299827,0.0,0.0,6183000,6183000,0,0,6183000,Null,Null,262299827,256727,15250
262299954,0.0,0.0,3805000,3805000,0,0,3805000,Null,Null,262299954,256727,15250
262300577,52.0,52.0,630000,387000,243000,39,630000,Null,Null,262300577,48077,1936
262301449,0.0,0.0,2633000,2633000,0,0,2633000,Null,Null,262301449,256727,15250
262301508,0.0,0.0,16931000,16931000,0,0,16931000,Null,Null,262301508,111461,6653
262301953,0.0,0.0,3254000,3254000,0,0,3254000,Null,Null,262301953,256727,15250
262301982,0.0,0.0,3068000,3068000,0,0,3068000,Null,Null,262301982,256727,15250
262302306,0.0,0.0,99000,99000,0,0,99000,Null,Null,262302306,111461,15320
262303117,0.0,0.0,15743000,15743000,0,0,15743000,Null,Null,262303117,111461,8067
262303122,0.0,0.0,3468000,3468000,0,0,3468000,Null,Null,262303122,256727,15250
262304237,0.0,0.0,38104000,38104000,0,0,38104000,Null,Null,262304237,111461,28860
262304292,0.0,0.0,950000,950000,0,0,950000,Null,Null,262304292,579445,15320
262304454,0.0,0.0,720000,720000,0,0,720000,Null,Null,262304454,579445,15320
262304581,0.0,0.0,2400000,2400000,0,0,2400000,Null,Null,262304581,579445,15320
262304780,0.0,0.0,13966000,13966000,0,0,13966000,Null,Null,262304780,111461,11518
262305058,0.0,0.0,27958000,27958000,0,0,27958000,Null,Null,262305058,111461,11518
262305103,0.0,0.0,229000,229000,0,0,229000,Null,Null,262305103,111461,4429
262305115,0.0,0.0,379000,379000,0,0,379000,Null,Null,262305115,20683,28454
262305439,0.0,0.0,13499000,13499000,0,0,13499000,Null,Null,262305439,111461,8064
262328632,0.0,0.0,239000,239000,0,0,239000,Null,Null,262328632,111461,15250
262333433,0.0,0.0,239000,239000,0,0,239000,Null,Null,262333433,111461,15250
262336015,0.0,0.0,199000,199000,0,0,199000,Null,Null,262336015,111461,15250
262336095,0.0,0.0,139000,139000,0,0,139000,Null,Null,262336095,111461,15250
262336127,0.0,0.0,2150000,1935000,215000,10,2150000,Null,Null,262336127,704815,15320
262336132,0.0,0.0,199000,199000,0,0,199000,Null,Null,262336132,111461,15250
262336212,0.0,0.0,2050000,1845000,205000,10,2050000,Null,Null,262336212,704815,15320
262336222,0.0,0.0,2150000,1935000,215000,10,2150000,Null,Null,262336222,704815,15320
262336245,0.0,0.0,2150000,1935000,215000,10,2150000,Null,Null,262336245,704815,15320
262336254,0.0,0.0,239000,239000,0,0,239000,Null,Null,262336254,111461,15250
262336290,0.0,0.0,1650000,1485000,165000,10,1650000,Null,Null,262336290,704815,15236
262336302,0.0,0.0,1450000,1305000,145000,10,1450000,Null,Null,262336302,704815,15236
262336497,0.0,0.0,239000,239000,0,0,239000,Null,Null,262336497,111461,15250
262336647,0.0,0.0,299000,299000,0,0,299000,Null,Null,262336647,111461,15250
262337649,0.0,0.0,56990000,55565000,1425000,3,56990000,Null,Null,262337649,114527,2657
262337815,0.0,0.0,5300000,5300000,0,0,5300000,Null,Null,262337815,111461,2
262338509,57.0,57.0,3590000,3590000,0,0,3590000,Null,Null,262338509,111461,1789
262345125,0.0,0.0,760000,676000,84000,11,760000,Null,Null,262345125,5719107,2
262345130,0.0,0.0,788500,702000,86500,11,788500,Null,Null,262345130,5719107,2
262345132,0.0,0.0,345000,307000,38000,11,345000,Null,Null,262345132,5719107,2
262345135,0.0,0.0,427500,380000,47500,11,427500,Null,Null,262345135,5719107,2
262345138,0.0,0.0,1297500,1155000,142500,11,1297500,Null,Null,262345138,5719107,2
262345141,0.0,0.0,390000,347000,43000,11,390000,Null,Null,262345141,5719107,2
262345146,0.0,0.0,2302500,2049000,253500,11,2302500,Null,Null,262345146,5719107,2
262345147,0.0,0.0,389500,347000,42500,11,389500,Null,Null,262345147,5719107,2
262345153,0.0,0.0,1372500,1222000,150500,11,1372500,Null,Null,262345153,5719107,2
262345158,0.0,0.0,1710000,1522000,188000,11,1710000,Null,Null,262345158,5719107,2
262345160,0.0,0.0,456000,406000,50000,11,456000,Null,Null,262345160,5719107,2
262345162,0.0,0.0,630000,561000,69000,11,630000,Null,Null,262345162,5719107,2
262345163,0.0,0.0,408500,364000,44500,11,408500,Null,Null,262345163,5719107,2
262345169,0.0,0.0,300000,267000,33000,11,300000,Null,Null,262345169,5719107,2
262345175,0.0,0.0,3697500,3291000,406500,11,3697500,Null,Null,262345175,5719107,2
262345184,0.0,0.0,427500,380000,47500,11,427500,Null,Null,262345184,5719107,2
262345186,0.0,0.0,617500,550000,67500,11,617500,Null,Null,262345186,5719107,2
262345190,0.0,0.0,1463000,1302000,161000,11,1463000,Null,Null,262345190,5719107,2
262345194,0.0,0.0,345000,307000,38000,11,345000,Null,Null,262345194,5719107,2
262345201,0.0,0.0,480000,427000,53000,11,480000,Null,Null,262345201,5719107,2
262345203,0.0,0.0,350000,312000,38000,11,350000,Null,Null,262345203,5719107,2
262345208,0.0,0.0,315000,280000,35000,11,315000,Null,Null,262345208,5719107,2
262345209,0.0,0.0,446500,397000,49500,11,446500,Null,Null,262345209,5719107,2
262345218,0.0,0.0,607500,541000,66500,11,607500,Null,Null,262345218,5719107,2
262345227,0.0,0.0,590000,525000,65000,11,590000,Null,Null,262345227,5719107,2
262345228,0.0,0.0,440000,392000,48000,11,440000,Null,Null,262345228,5719107,2
262345234,0.0,0.0,2156500,1919000,237500,11,2156500,Null,Null,262345234,5719107,2
262345239,0.0,0.0,360000,320000,40000,11,360000,Null,Null,262345239,5719107,2
262345240,0.0,0.0,608000,541000,67000,11,608000,Null,Null,262345240,5719107,2
262345241,0.0,0.0,1845000,1642000,203000,11,1845000,Null,Null,262345241,5719107,2
262345248,0.0,0.0,300000,267000,33000,11,300000,Null,Null,262345248,5719107,2
262345253,0.0,0.0,1470000,1308000,162000,11,1470000,Null,Null,262345253,5719107,2
262345255,0.0,0.0,510000,454000,56000,11,510000,Null,Null,262345255,5719107,2
262345257,0.0,0.0,285000,254000,31000,11,285000,Null,Null,262345257,5719107,2
262345262,0.0,0.0,360000,320000,40000,11,360000,Null,Null,262345262,5719107,2
262345267,0.0,0.0,2137500,1902000,235500,11,2137500,Null,Null,262345267,5719107,2
262345269,0.0,0.0,390000,347000,43000,11,390000,Null,Null,262345269,5719107,2
262345271,0.0,0.0,6269000,5579000,690000,11,6269000,Null,Null,262345271,5719107,2
262345272,0.0,0.0,1207500,1075000,132500,11,1207500,Null,Null,262345272,5719107,2
262345280,0.0,0.0,307500,274000,33500,11,307500,Null,Null,262345280,5719107,2
262345285,0.0,0.0,840000,748000,92000,11,840000,Null,Null,262345285,5719107,2
262345287,0.0,0.0,503500,448000,55500,11,503500,Null,Null,262345287,5719107,2
262345296,0.0,0.0,1905000,1695000,210000,11,1905000,Null,Null,262345296,5719107,2
262345940,0.0,0.0,438000,438000,0,0,438000,Null,Null,262345940,111461,2
262345942,0.0,0.0,12100000,12100000,0,0,12100000,Null,Null,262345942,111461,2
262345945,0.0,0.0,1125000,1125000,0,0,1125000,Null,Null,262345945,111461,2
262345957,0.0,0.0,155000,155000,0,0,155000,Null,Null,262345957,111461,2
262345960,0.0,0.0,145000,145000,0,0,145000,Null,Null,262345960,111461,2
262345961,0.0,0.0,149000,149000,0,0,149000,Null,Null,262345961,111461,2
262345962,0.0,0.0,149000,149000,0,0,149000,Null,Null,262345962,111461,2
262345963,0.0,0.0,439000,439000,0,0,439000,Null,Null,262345963,111461,2
262345970,0.0,0.0,5125000,5125000,0,0,5125000,Null,Null,262345970,111461,2
262345971,0.0,0.0,1000000,1000000,0,0,1000000,Null,Null,262345971,111461,2
262345974,0.0,0.0,2000000,2000000,0,0,2000000,Null,Null,262345974,111461,2
262345977,0.0,0.0,10000000,10000000,0,0,10000000,Null,Null,262345977,111461,2
262345978,0.0,0.0,190000,190000,0,0,190000,Null,Null,262345978,111461,2
262345979,0.0,0.0,275000,275000,0,0,275000,Null,Null,262345979,111461,2
262345983,0.0,0.0,1000000,1000000,0,0,1000000,Null,Null,262345983,111461,2
262345984,0.0,0.0,600000,600000,0,0,600000,Null,Null,262345984,111461,2
262345992,0.0,0.0,439000,439000,0,0,439000,Null,Null,262345992,111461,2
262345994,0.0,0.0,1000000,1000000,0,0,1000000,Null,Null,262345994,111461,2
262345996,0.0,0.0,225000,225000,0,0,225000,Null,Null,262345996,111461,2
262345999,0.0,0.0,1000000,1000000,0,0,1000000,Null,Null,262345999,111461,2
262346001,0.0,0.0,3500000,3500000,0,0,3500000,Null,Null,262346001,111461,2
262346002,0.0,0.0,4750000,4750000,0,0,4750000,Null,Null,262346002,111461,2
262346003,0.0,0.0,413000,413000,0,0,413000,Null,Null,262346003,111461,2
262346007,0.0,0.0,2000000,2000000,0,0,2000000,Null,Null,262346007,111461,2
262346011,0.0,0.0,1000000,1000000,0,0,1000000,Null,Null,262346011,111461,2
262346018,0.0,0.0,689000,689000,0,0,689000,Null,Null,262346018,111461,2
262346019,0.0,0.0,2500000,2500000,0,0,2500000,Null,Null,262346019,111461,2
262346022,0.0,0.0,179000,179000,0,0,179000,Null,Null,262346022,111461,2
262346023,0.0,0.0,725000,725000,0,0,725000,Null,Null,262346023,111461,2
262346025,0.0,0.0,595000,595000,0,0,595000,Null,Null,262346025,111461,2
262346027,0.0,0.0,704000,704000,0,0,704000,Null,Null,262346027,111461,2
262346028,0.0,0.0,1000000,1000000,0,0,1000000,Null,Null,262346028,111461,2
262346032,0.0,0.0,500000,500000,0,0,500000,Null,Null,262346032,111461,2
262346033,0.0,0.0,190000,190000,0,0,190000,Null,Null,262346033,111461,2
262346035,0.0,0.0,850000,850000,0,0,850000,Null,Null,262346035,111461,2
262346038,0.0,0.0,189000,189000,0,0,189000,Null,Null,262346038,111461,2
262346048,0.0,0.0,1100000,1100000,0,0,1100000,Null,Null,262346048,111461,2
262346063,0.0,0.0,475000,475000,0,0,475000,Null,Null,262346063,111461,2
262346064,0.0,0.0,1875000,1875000,0,0,1875000,Null,Null,262346064,111461,2
262346070,0.0,0.0,2250000,2250000,0,0,2250000,Null,Null,262346070,111461,2
262346083,0.0,0.0,230000,230000,0,0,230000,Null,Null,262346083,111461,2
262346084,0.0,0.0,1125000,1125000,0,0,1125000,Null,Null,262346084,111461,2
262346098,0.0,0.0,190000,190000,0,0,190000,Null,Null,262346098,111461,2
262346100,0.0,0.0,2250000,2250000,0,0,2250000,Null,Null,262346100,111461,2
262346102,0.0,0.0,214000,214000,0,0,214000,Null,Null,262346102,111461,2
262346105,0.0,0.0,1000000,1000000,0,0,1000000,Null,Null,262346105,111461,2
262346106,0.0,0.0,1000000,1000000,0,0,1000000,Null,Null,262346106,111461,2
262346112,0.0,0.0,215000,215000,0,0,215000,Null,Null,262346112,111461,2
262346115,0.0,0.0,1000000,1000000,0,0,1000000,Null,Null,262346115,111461,2
262346117,0.0,0.0,275000,275000,0,0,275000,Null,Null,262346117,111461,2
262346119,0.0,0.0,689000,689000,0,0,689000,Null,Null,262346119,111461,2
262346120,0.0,0.0,275000,275000,0,0,275000,Null,Null,262346120,111461,2
262346128,0.0,0.0,1250000,1250000,0,0,1250000,Null,Null,262346128,111461,2
262346137,3.0,3.0,29000,29000,0,0,29000,Null,Null,262346137,111461,15318
262346475,0.0,0.0,445000,445000,0,0,445000,Null,Null,262346475,111461,8516
262362970,51.0,51.0,540000,332000,208000,39,540000,Null,Null,262362970,48077,1936
262362981,0.0,0.0,195000,195000,0,0,195000,Null,Null,262362981,111461,7449
262366920,0.0,0.0,198000,198000,0,0,198000,Null,Null,262366920,111461,7449
262382407,0.0,0.0,239000,239000,0,0,239000,Null,Null,262382407,111461,8511
262382491,0.0,0.0,56990000,56990000,0,0,56990000,Null,Null,262382491,114527,2657
262382772,0.0,0.0,32604000,32604000,0,0,32604000,Null,Null,262382772,111461,6653
262382797,0.0,0.0,236000,236000,0,0,236000,Null,Null,262382797,111461,7449
262382976,0.0,0.0,219000,219000,0,0,219000,Null,Null,262382976,111461,7449
262383227,0.0,0.0,279000,279000,0,0,279000,Null,Null,262383227,111461,7449
262383566,0.0,0.0,20962000,20962000,0,0,20962000,Null,Null,262383566,111461,11518
262383677,0.0,0.0,159000,159000,0,0,159000,Null,Null,262383677,111461,7449
262384684,6.0,6.0,1999000,1412000,587000,29,1999000,Null,Null,262384684,18984,1838
262385763,0.0,0.0,209000,209000,0,0,209000,Null,Null,262385763,111461,8511
262385958,0.0,0.0,55294000,55294000,0,0,55294000,Null,Null,262385958,111461,6653
262386095,0.0,0.0,249000,249000,0,0,249000,Null,Null,262386095,111461,8513
262386266,0.0,0.0,235000,235000,0,0,235000,Null,Null,262386266,111461,7449
262386722,0.0,0.0,93236000,93236000,0,0,93236000,Null,Null,262386722,111461,6653
262387130,0.0,0.0,800000,800000,0,0,800000,Null,Null,262387130,579445,15320
262387152,0.0,0.0,10490000,7690000,2800000,27,10490000,Null,Null,262387152,18802,1795
262387289,0.0,0.0,3750000,3400000,350000,9,3750000,Null,Null,262387289,8186835,11863
262387291,0.0,0.0,850000,850000,0,0,850000,Null,Null,262387291,579445,15320
262387521,0.0,0.0,890000,890000,0,0,890000,Null,Null,262387521,579445,15320
262388130,0.0,0.0,900000,900000,0,0,900000,Null,Null,262388130,579445,15320
262388205,0.0,0.0,15136000,15136000,0,0,15136000,Null,Null,262388205,111461,8067
262388390,0.0,0.0,16931000,16931000,0,0,16931000,Null,Null,262388390,111461,6653
262388393,0.0,0.0,3490000,3078000,412000,12,3490000,Null,Null,262388393,162007,1795
262388489,0.0,0.0,900000,900000,0,0,900000,Null,Null,262388489,579445,15320
262388543,0.0,0.0,990000,990000,0,0,990000,Null,Null,262388543,579445,15320
262389024,0.0,0.0,3200000,3200000,0,0,3200000,Null,Null,262389024,579445,15320
262389362,0.0,0.0,650000,650000,0,0,650000,Null,Null,262389362,579445,15320
262389445,13.0,13.0,599000,399000,200000,33,599000,Null,Null,262389445,5527787,11833
262389486,0.0,0.0,235000,235000,0,0,235000,Null,Null,262389486,111461,7449
262389646,0.0,0.0,22352000,22352000,0,0,22352000,Null,Null,262389646,111461,8064
262390843,0.0,0.0,198000,198000,0,0,198000,Null,Null,262390843,111461,7449
262392312,0.0,0.0,229000,229000,0,0,229000,Null,Null,262392312,111461,8511
262392469,0.0,0.0,195000,195000,0,0,195000,Null,Null,262392469,111461,7449
262392548,0.0,0.0,13262000,13262000,0,0,13262000,Null,Null,262392548,111461,11518
262393313,0.0,0.0,3850000,3272500,577500,15,3850000,Null,Null,262393313,691055,5385
262394266,0.0,0.0,1200000,1200000,0,0,1200000,Null,Null,262394266,579445,15320
262394979,0.0,0.0,990000,990000,0,0,990000,Null,Null,262394979,579445,15320
262395200,0.0,0.0,800000,800000,0,0,800000,Null,Null,262395200,579445,15320
262404612,0.0,0.0,2200,2200,0,0,2200,Null,Null,262404612,8189595,27214
262404700,0.0,0.0,600000,600000,0,0,600000,Null,Null,262404700,579445,15320
262406205,0.0,0.0,789000,789000,0,0,789000,Null,Null,262406205,26150,8516
262414714,14.0,14.0,299000,179000,120000,40,299000,Null,Null,262414714,5527787,11833
262415785,13.0,13.0,249000,129000,120000,48,249000,Null,Null,262415785,5527787,2334
262423919,0.0,0.0,1550000,1550000,0,0,1550000,Null,Null,262423919,111461,49724
262427249,0.0,0.0,4890000,4890000,0,0,4890000,Null,Null,262427249,111461,11935
262434056,0.0,0.0,1100000,550000,550000,50,1100000,Null,Null,262434056,111461,15318
262447386,3.0,3.0,45000,45000,0,0,45000,Null,Null,262447386,111461,28576
262450118,0.0,0.0,2195000,2195000,0,0,2195000,Null,Null,262450118,111461,2
262450120,0.0,0.0,1875000,1875000,0,0,1875000,Null,Null,262450120,111461,2
262450122,0.0,0.0,1100000,1100000,0,0,1100000,Null,Null,262450122,111461,2
262450124,0.0,0.0,1875000,1875000,0,0,1875000,Null,Null,262450124,111461,2
262450131,0.0,0.0,1125000,1125000,0,0,1125000,Null,Null,262450131,111461,2
262450132,0.0,0.0,1125000,1125000,0,0,1125000,Null,Null,262450132,111461,2
262450145,0.0,0.0,1125000,1125000,0,0,1125000,Null,Null,262450145,111461,2
262450152,0.0,0.0,215000,215000,0,0,215000,Null,Null,262450152,111461,2
262450157,0.0,0.0,1625000,1625000,0,0,1625000,Null,Null,262450157,111461,2
262450170,0.0,0.0,750000,750000,0,0,750000,Null,Null,262450170,111461,2
262450181,0.0,0.0,1125000,1125000,0,0,1125000,Null,Null,262450181,111461,2
262450186,0.0,0.0,400000,400000,0,0,400000,Null,Null,262450186,111461,2
262450309,0.0,0.0,6100000,6100000,0,0,6100000,Null,Null,262450309,111461,11935
262451299,0.0,0.0,1250000,1125000,125000,10,1250000,Null,Null,262451299,704815,15250
262451633,0.0,0.0,3690000,3690000,0,0,3690000,Null,Null,262451633,111461,8165
262451659,0.0,0.0,7200000,7200000,0,0,7200000,Null,Null,262451659,111461,8165
262451831,0.0,0.0,7190000,7190000,0,0,7190000,Null,Null,262451831,111461,8165
262453407,0.0,0.0,1670000,1670000,0,0,1670000,Null,Null,262453407,256727,15250
262453468,0.0,0.0,2098000,2098000,0,0,2098000,Null,Null,262453468,256727,15236
262453517,0.0,0.0,2139000,2139000,0,0,2139000,Null,Null,262453517,256727,15236
262454645,0.0,0.0,149000,149000,0,0,149000,Null,Null,262454645,111461,49722
262461927,0.0,0.0,1356000,1356000,0,0,1356000,Null,Null,262461927,256727,15236
262461976,0.0,0.0,1622000,1622000,0,0,1622000,Null,Null,262461976,256727,15236
262462005,0.0,0.0,1689000,1689000,0,0,1689000,Null,Null,262462005,256727,15236
262462127,0.0,0.0,1849000,1849000,0,0,1849000,Null,Null,262462127,256727,15236
262463239,1.0,1.0,1489000,1489000,0,0,1489000,Null,Null,262463239,18984,1838
262464058,0.0,0.0,950000,950000,0,0,950000,Null,Null,262464058,579445,15320
262464293,0.0,0.0,800000,800000,0,0,800000,Null,Null,262464293,579445,15320
262464476,0.0,0.0,950000,950000,0,0,950000,Null,Null,262464476,579445,15320
262464679,0.0,0.0,980000,980000,0,0,980000,Null,Null,262464679,579445,15320
262465131,0.0,0.0,2200000,2200000,0,0,2200000,Null,Null,262465131,579445,15320
262465432,0.0,0.0,3200000,3200000,0,0,3200000,Null,Null,262465432,579445,15320
262465571,0.0,0.0,40000,40000,0,0,40000,Null,Null,262465571,111461,28596
262467980,0.0,0.0,199000,189050,9950,5,199000,Null,Null,262467980,21653,28460
262469691,0.0,0.0,390000,390000,0,0,390000,Null,Null,262469691,4977209,5566
262469822,0.0,0.0,59000,59000,0,0,59000,Null,Null,262469822,614727,3179
262469894,0.0,0.0,1250000,750000,500000,40,1250000,Null,Null,262469894,8183299,2
262469895,0.0,0.0,1250000,1250000,0,0,1250000,Null,Null,262469895,8183299,2
262469933,0.0,0.0,1150000,1150000,0,0,1150000,Null,Null,262469933,8183299,2
262469934,0.0,0.0,985000,985000,0,0,985000,Null,Null,262469934,8183299,2
262470536,0.0,0.0,950000,950000,0,0,950000,Null,Null,262470536,4977209,5566
262473151,0.0,0.0,2459000,2459000,0,0,2459000,Null,Null,262473151,256727,15320
262477218,0.0,0.0,750000,750000,0,0,750000,Null,Null,262477218,4977209,5566
262478001,0.0,0.0,4990000,4090000,900000,18,4990000,Null,Null,262478001,18802,1795
262478537,0.0,0.0,33900000,33900000,0,0,33900000,Null,Null,262478537,111461,2
262478590,0.0,0.0,1400,1400,0,0,1400,Null,Null,262478590,111461,2
262479554,0.0,0.0,2000,2000,0,0,2000,Null,Null,262479554,111461,2
262479661,0.0,0.0,5000,5000,0,0,5000,Null,Null,262479661,111461,2
262479987,0.0,0.0,1500,1500,0,0,1500,Null,Null,262479987,111461,2
262480079,0.0,0.0,2000,2000,0,0,2000,Null,Null,262480079,111461,2
262480822,0.0,0.0,3000,3000,0,0,3000,Null,Null,262480822,111461,2
262480961,0.0,0.0,9000,9000,0,0,9000,Null,Null,262480961,111461,2
262481236,0.0,0.0,5000,5000,0,0,5000,Null,Null,262481236,111461,2
262483023,0.0,0.0,2500,2500,0,0,2500,Null,Null,262483023,111461,2
262483755,0.0,0.0,5000,5000,0,0,5000,Null,Null,262483755,111461,2
262485045,0.0,0.0,608000,608000,0,0,608000,Null,Null,262485045,111461,2
262485498,0.0,0.0,1500,1500,0,0,1500,Null,Null,262485498,111461,2
262485702,0.0,0.0,41000,41000,0,0,41000,Null,Null,262485702,111461,2
262485708,0.0,0.0,2000,2000,0,0,2000,Null,Null,262485708,111461,2
262486182,0.0,0.0,3000,3000,0,0,3000,Null,Null,262486182,111461,2
262487265,0.0,0.0,38000,38000,0,0,38000,Null,Null,262487265,111461,2
262487279,0.0,0.0,10000,10000,0,0,10000,Null,Null,262487279,111461,2
262488031,0.0,0.0,149000,149000,0,0,149000,Null,Null,262488031,111461,2
262488296,0.0,0.0,5000,5000,0,0,5000,Null,Null,262488296,111461,2
262489191,0.0,0.0,2500,2500,0,0,2500,Null,Null,262489191,111461,2
262489653,0.0,0.0,2000,2000,0,0,2000,Null,Null,262489653,111461,2
262489666,0.0,0.0,1400,1400,0,0,1400,Null,Null,262489666,111461,2
262490436,0.0,0.0,9000,9000,0,0,9000,Null,Null,262490436,111461,2
262494745,0.0,0.0,149000,149000,0,0,149000,Null,Null,262494745,111461,2
262495612,0.0,0.0,2000,2000,0,0,2000,Null,Null,262495612,111461,2
262495949,0.0,0.0,5000,5000,0,0,5000,Null,Null,262495949,111461,2
262496794,0.0,0.0,608000,608000,0,0,608000,Null,Null,262496794,111461,2
262497160,0.0,0.0,33900000,33900000,0,0,33900000,Null,Null,262497160,111461,2
262497318,0.0,0.0,9000,9000,0,0,9000,Null,Null,262497318,111461,2
262497392,0.0,0.0,790000,790000,0,0,790000,Null,Null,262497392,111461,2
262497477,0.0,0.0,41000,41000,0,0,41000,Null,Null,262497477,111461,2
262497931,0.0,0.0,2000,2000,0,0,2000,Null,Null,262497931,111461,2
262497989,0.0,0.0,3000,3000,0,0,3000,Null,Null,262497989,111461,2
262498019,0.0,0.0,1400,1400,0,0,1400,Null,Null,262498019,111461,2
262498090,0.0,0.0,995000,995000,0,0,995000,Null,Null,262498090,111461,2
262498341,0.0,0.0,1500,1500,0,0,1500,Null,Null,262498341,111461,2
262498682,0.0,0.0,2500,2500,0,0,2500,Null,Null,262498682,111461,2
262498911,0.0,0.0,33900000,33900000,0,0,33900000,Null,Null,262498911,111461,2
262499031,0.0,0.0,739000,688000,51000,7,739000,Null,Null,262499031,111461,5531
262499074,0.0,0.0,15000,15000,0,0,15000,Null,Null,262499074,111461,2
262499649,0.0,0.0,3000,3000,0,0,3000,Null,Null,262499649,111461,2
262501792,5.0,5.0,265000,130000,135000,51,265000,Null,Null,262501792,361359,1831
262503238,0.0,0.0,38000,38000,0,0,38000,Null,Null,262503238,111461,2
262503458,0.0,0.0,1300000,1300000,0,0,1300000,Null,Null,262503458,111461,7079
262503712,1.0,1.0,1950000,1950000,0,0,1950000,Null,Null,262503712,111461,49724
262503722,0.0,0.0,120000,120000,0,0,120000,Null,Null,262503722,111461,28484
262504030,0.0,0.0,1650000,1650000,0,0,1650000,Null,Null,262504030,659879,4428
262504433,0.0,0.0,299000,299000,0,0,299000,Null,Null,262504433,18984,1838
262504490,0.0,0.0,129000,129000,0,0,129000,Null,Null,262504490,111461,28696
262505412,0.0,0.0,155000,149000,6000,4,155000,Null,Null,262505412,111461,1813
262505513,0.0,0.0,1700000,1700000,0,0,1700000,Null,Null,262505513,111461,7079
262505567,0.0,0.0,1400000,1400000,0,0,1400000,Null,Null,262505567,111461,7079
262505605,0.0,0.0,1300000,1300000,0,0,1300000,Null,Null,262505605,111461,7079
262505627,0.0,0.0,150000,144000,6000,4,150000,Null,Null,262505627,111461,1813
262505637,0.0,0.0,65000,65000,0,0,65000,Null,Null,262505637,111461,28484
262505640,0.0,0.0,1300000,1300000,0,0,1300000,Null,Null,262505640,111461,7079
262505644,0.0,0.0,65000,65000,0,0,65000,Null,Null,262505644,111461,28484
262505662,0.0,0.0,1600000,1600000,0,0,1600000,Null,Null,262505662,111461,7079
262505698,0.0,0.0,1000000,1000000,0,0,1000000,Null,Null,262505698,111461,8073
262505894,0.0,0.0,65000,65000,0,0,65000,Null,Null,262505894,111461,28484
262505908,0.0,0.0,15000,15000,0,0,15000,Null,Null,262505908,111461,2
262506130,0.0,0.0,59000,59000,0,0,59000,Null,Null,262506130,111461,28576
262506236,0.0,0.0,59000,59000,0,0,59000,Null,Null,262506236,111461,28576
262506255,0.0,0.0,859000,859000,0,0,859000,Null,Null,262506255,362757,4428
262506459,0.0,0.0,115000,115000,0,0,115000,Null,Null,262506459,111461,15250
262506872,0.0,0.0,449000,449000,0,0,449000,Null,Null,262506872,8191753,8400
262506939,0.0,0.0,45000,45000,0,0,45000,Null,Null,262506939,111461,15250
262509260,0.0,0.0,39000,39000,0,0,39000,Null,Null,262509260,111461,2
262509262,0.0,0.0,39000,39000,0,0,39000,Null,Null,262509262,111461,2
262509264,0.0,0.0,39000,39000,0,0,39000,Null,Null,262509264,111461,2
262509266,0.0,0.0,39000,39000,0,0,39000,Null,Null,262509266,111461,2
262509273,0.0,0.0,39000,39000,0,0,39000,Null,Null,262509273,111461,2
262509287,0.0,0.0,115000,115000,0,0,115000,Null,Null,262509287,111461,15250
262512894,0.0,0.0,79000,79000,0,0,79000,Null,Null,262512894,111461,1815
262513213,0.0,0.0,246000,219000,27000,11,246000,Null,Null,262513213,111461,15250
262513327,0.0,0.0,150000,150000,0,0,150000,Null,Null,262513327,111461,8371
262514203,0.0,0.0,174000,167000,7000,4,174000,Null,Null,262514203,111461,1813
262514210,0.0,0.0,149000,149000,0,0,149000,Null,Null,262514210,272933,28576
262514258,0.0,0.0,2250000,2250000,0,0,2250000,Null,Null,262514258,4977209,5566
262514431,0.0,0.0,16400000,16400000,0,0,16400000,Null,Null,262514431,111461,8165
262514434,0.0,0.0,54000,54000,0,0,54000,Null,Null,262514434,111461,15320
262514470,0.0,0.0,162000,156000,6000,4,162000,Null,Null,262514470,111461,1813
262514630,0.0,0.0,1790000,1790000,0,0,1790000,Null,Null,262514630,231689,3428
262514678,0.0,0.0,1995000,1995000,0,0,1995000,Null,Null,262514678,413603,8073
262515364,0.0,0.0,3490000,3490000,0,0,3490000,Null,Null,262515364,48649,1634
262515366,0.0,0.0,50000000,50000000,0,0,50000000,Null,Null,262515366,111461,2
262515370,0.0,0.0,148400,142000,6400,4,148400,Null,Null,262515370,111461,1813
262515412,0.0,0.0,1650000,1650000,0,0,1650000,Null,Null,262515412,413603,8073
262515498,0.0,0.0,448000,399000,49000,11,448000,Null,Null,262515498,111461,15250
262515764,0.0,0.0,40000,40000,0,0,40000,Null,Null,262515764,111461,28598
262515833,0.0,0.0,145000,139000,6000,4,145000,Null,Null,262515833,111461,1813
262515912,0.0,0.0,5349000,5349000,0,0,5349000,Null,Null,262515912,19018,1634
262516014,0.0,0.0,7853000,7164000,689000,9,7853000,Null,Null,262516014,18802,1795
262516120,0.0,0.0,25000,21000,4000,16,25000,Null,Null,262516120,111461,12294
262516231,0.0,0.0,9490000,7417000,2073000,22,9490000,Null,Null,262516231,18802,1795
262516257,0.0,0.0,99856,99856,0,0,99856,Null,Null,262516257,111461,28598
262516433,0.0,0.0,129000,129000,0,0,129000,Null,Null,262516433,111461,2971
262516558,0.0,0.0,26900,26900,0,0,26900,Null,Null,262516558,111461,3428
262516855,0.0,0.0,2990000,2990000,0,0,2990000,Null,Null,262516855,18882,2971
262516933,0.0,0.0,9860000,8190000,1670000,17,9860000,Null,Null,262516933,18802,1795
262517069,0.0,0.0,142000,136000,6000,4,142000,Null,Null,262517069,111461,1813
262517076,0.0,0.0,3750000,3750000,0,0,3750000,Null,Null,262517076,227957,11885
262517256,0.0,0.0,149000,149000,0,0,149000,Null,Null,262517256,111461,2659
262517583,0.0,0.0,30000,30000,0,0,30000,Null,Null,262517583,111461,2
262517632,0.0,0.0,30000,30000,0,0,30000,Null,Null,262517632,111461,2
262518038,0.0,0.0,292500,285000,7500,3,292500,Null,Null,262518038,111461,1813
262518743,0.0,0.0,488000,434000,54000,11,488000,Null,Null,262518743,111461,15250
262522048,0.0,0.0,142000,136000,6000,4,142000,Null,Null,262522048,111461,1813
262522127,0.0,0.0,1250000,1250000,0,0,1250000,Null,Null,262522127,8131421,2324
262522224,0.0,0.0,140500,137000,3500,2,140500,Null,Null,262522224,111461,1813
262522706,0.0,0.0,150000,144000,6000,4,150000,Null,Null,262522706,111461,1813
262522873,0.0,0.0,2900000,2900000,0,0,2900000,Null,Null,262522873,579445,15320
262522956,0.0,0.0,1150000,1150000,0,0,1150000,Null,Null,262522956,579445,15320
262522986,0.0,0.0,6500,6500,0,0,6500,Null,Null,262522986,5206871,8305
262523031,0.0,0.0,59000,59000,0,0,59000,Null,Null,262523031,111461,5007
262523036,0.0,0.0,600000,600000,0,0,600000,Null,Null,262523036,579445,15320
262523155,0.0,0.0,680000,680000,0,0,680000,Null,Null,262523155,579445,15320
262523167,0.0,0.0,3366000,3366000,0,0,3366000,Null,Null,262523167,19018,1634
262523191,0.0,0.0,130000,125000,5000,4,130000,Null,Null,262523191,111461,1813
262523274,0.0,0.0,320000,320000,0,0,320000,Null,Null,262523274,111461,26652
262523281,0.0,0.0,129000,126000,3000,2,129000,Null,Null,262523281,111461,1813
262523316,0.0,0.0,2000,1980,20,1,2000,Null,Null,262523316,5307993,53074
262523369,0.0,0.0,165000,165000,0,0,165000,Null,Null,262523369,114328,13878
262523639,0.0,0.0,100000,100000,0,0,100000,Null,Null,262523639,8166207,28484
262523657,0.0,0.0,205000,197000,8000,4,205000,Null,Null,262523657,111461,1813
262524183,0.0,0.0,89000,89000,0,0,89000,Null,Null,262524183,111461,12294
262525374,0.0,0.0,49000,49000,0,0,49000,Null,Null,262525374,111461,5007
262525499,1.0,1.0,139000,139000,0,0,139000,Null,Null,262525499,111461,28460
262525732,0.0,0.0,35000,35000,0,0,35000,Null,Null,262525732,111461,12294
262526316,0.0,0.0,140000,140000,0,0,140000,Null,Null,262526316,111461,27544
262526884,0.0,0.0,140000,140000,0,0,140000,Null,Null,262526884,111461,27544
262526949,0.0,0.0,2158000,2158000,0,0,2158000,Null,Null,262526949,111461,2324
262527073,0.0,0.0,128000,125000,3000,2,128000,Null,Null,262527073,111461,1813
262527118,0.0,0.0,59000,59000,0,0,59000,Null,Null,262527118,111461,5006
262527127,0.0,0.0,10234000,10234000,0,0,10234000,Null,Null,262527127,111461,8064
262527251,0.0,0.0,150000,144000,6000,4,150000,Null,Null,262527251,111461,1813
262527269,0.0,0.0,3500000,3500000,0,0,3500000,Null,Null,262527269,663447,5893
262530476,0.0,0.0,2450000,2450000,0,0,2450000,Null,Null,262530476,111461,11516
262530482,0.0,0.0,900000,900000,0,0,900000,Null,Null,262530482,579445,15320
262530659,0.0,0.0,1900000,1900000,0,0,1900000,Null,Null,262530659,579445,15320
262530726,0.0,0.0,2900000,2900000,0,0,2900000,Null,Null,262530726,579445,15320
262530765,0.0,0.0,449000,449000,0,0,449000,Null,Null,262530765,111461,2324
262550364,0.0,0.0,720000,720000,0,0,720000,Null,Null,262550364,579445,15320
262550632,0.0,0.0,179000,179000,0,0,179000,Null,Null,262550632,111461,1813
262550670,7.0,7.0,250000,198000,52000,21,250000,Null,Null,262550670,198555,1613
262550846,0.0,0.0,49000,49000,0,0,49000,Null,Null,262550846,111461,5007
262551729,0.0,0.0,129000,129000,0,0,129000,Null,Null,262551729,111461,5263
262551819,0.0,0.0,110000,106000,4000,4,110000,Null,Null,262551819,111461,1813
262566466,0.0,0.0,20610000,20610000,0,0,20610000,Null,Null,262566466,111461,11518
262567638,0.0,0.0,750000,750000,0,0,750000,Null,Null,262567638,111461,2324
262567926,0.0,0.0,35000,35000,0,0,35000,Null,Null,262567926,111461,20174
262568022,0.0,0.0,150000,146000,4000,3,150000,Null,Null,262568022,111461,5531
262568177,0.0,0.0,289000,282000,7000,2,289000,Null,Null,262568177,8189829,28428
262569859,0.0,0.0,12848000,12848000,0,0,12848000,Null,Null,262569859,111461,11518
262570574,0.0,0.0,72000,69000,3000,4,72000,Null,Null,262570574,111461,28722
262570619,0.0,0.0,6590000,6590000,0,0,6590000,Null,Null,262570619,113119,11516
262570639,0.0,0.0,6590000,6590000,0,0,6590000,Null,Null,262570639,113119,11516
262570739,2.0,2.0,800000,639000,161000,20,800000,Null,Null,262570739,414669,6742
262581719,0.0,0.0,4500000,4500000,0,0,4500000,Null,Null,262581719,227957,11873
262581721,0.0,0.0,50000,50000,0,0,50000,Null,Null,262581721,111461,28484
262581952,0.0,0.0,7880000,6225200,1654800,21,7880000,Null,Null,262581952,4232883,11849
262581989,0.0,0.0,60000,60000,0,0,60000,Null,Null,262581989,111461,28428
262582028,0.0,0.0,699000,699000,0,0,699000,Null,Null,262582028,111461,2324
262582041,0.0,0.0,276000,276000,0,0,276000,Null,Null,262582041,111684,28450
262582150,0.0,0.0,1300000,845000,455000,35,1300000,Null,Null,262582150,148196,11847
262584417,0.0,0.0,276000,276000,0,0,276000,Null,Null,262584417,111684,28450
262587454,0.0,0.0,8298000,8298000,0,0,8298000,Null,Null,262587454,111461,11518
262587464,0.0,0.0,127000,127000,0,0,127000,Null,Null,262587464,111684,28450
262589289,0.0,0.0,3012000,3012000,0,0,3012000,Null,Null,262589289,25643,1795
262589734,0.0,0.0,127000,127000,0,0,127000,Null,Null,262589734,111684,28450
262589802,0.0,0.0,269000,262000,7000,3,269000,Null,Null,262589802,8189829,28428
262589811,0.0,0.0,6490000,5590000,900000,14,6490000,Null,Null,262589811,18802,1795
262589819,0.0,0.0,226000,226000,0,0,226000,Null,Null,262589819,111684,28450
262590176,8.0,8.0,350000,319000,31000,9,350000,Null,Null,262590176,22013,8227
262590868,0.0,0.0,39000,39000,0,0,39000,Null,Null,262590868,111461,15250
262590882,0.0,0.0,55000,55000,0,0,55000,Null,Null,262590882,111461,15250
262590897,0.0,0.0,2139990,1619000,520990,24,2139990,Null,Null,262590897,18984,1838
262590903,0.0,0.0,45000,45000,0,0,45000,Null,Null,262590903,111461,15250
262590918,0.0,0.0,100000,100000,0,0,100000,Null,Null,262590918,8166207,28484
262590927,0.0,0.0,38000,38000,0,0,38000,Null,Null,262590927,111461,15250
262593143,0.0,0.0,25000,25000,0,0,25000,Null,Null,262593143,111461,15250
262593157,0.0,0.0,49000,49000,0,0,49000,Null,Null,262593157,111461,15250
262593180,0.0,0.0,35500,35500,0,0,35500,Null,Null,262593180,111461,15250
262593184,0.0,0.0,32500,32500,0,0,32500,Null,Null,262593184,111461,15320
262593190,0.0,0.0,38000,38000,0,0,38000,Null,Null,262593190,111461,15320
262593196,0.0,0.0,38000,38000,0,0,38000,Null,Null,262593196,111461,15320
262595404,0.0,0.0,24288000,24288000,0,0,24288000,Null,Null,262595404,111461,6653
262597859,0.0,0.0,2200000,2200000,0,0,2200000,Null,Null,262597859,579445,15320
262600389,0.0,0.0,8910,8910,0,0,8910,Null,Null,262600389,111461,2
262600602,0.0,0.0,2950000,2655000,295000,10,2950000,Null,Null,262600602,704815,15250
262600635,0.0,0.0,159000,159000,0,0,159000,Null,Null,262600635,111461,2977
262601362,0.0,0.0,8910,8910,0,0,8910,Null,Null,262601362,111461,2
262605182,0.0,0.0,55000,55000,0,0,55000,Null,Null,262605182,111461,2
262605974,0.0,0.0,59490000,59490000,0,0,59490000,Null,Null,262605974,114527,2657
262636358,0.0,0.0,45500,45500,0,0,45500,Null,Null,262636358,111461,28576
262636408,0.0,0.0,119000,119000,0,0,119000,Null,Null,262636408,111461,15318
262636421,0.0,0.0,65500,65500,0,0,65500,Null,Null,262636421,111461,28584
262636423,0.0,0.0,359000,359000,0,0,359000,Null,Null,262636423,111461,15318
262636679,0.0,0.0,59490000,59490000,0,0,59490000,Null,Null,262636679,114527,2657
262636698,0.0,0.0,90000,90000,0,0,90000,Null,Null,262636698,461155,8519
262637341,0.0,0.0,309000,309000,0,0,309000,Null,Null,262637341,111461,15318
262637497,0.0,0.0,169000,169000,0,0,169000,Null,Null,262637497,111461,15318
262637505,0.0,0.0,2150000,1850000,300000,14,2150000,Null,Null,262637505,111461,3428
262637550,0.0,0.0,199000,99000,100000,50,199000,Null,Null,262637550,312329,8519
262637602,0.0,0.0,152000,152000,0,0,152000,Null,Null,262637602,111461,15250
262637733,0.0,0.0,250000,250000,0,0,250000,Null,Null,262637733,111461,28460
262637735,0.0,0.0,195000,195000,0,0,195000,Null,Null,262637735,111461,15318
262637912,0.0,0.0,265000,265000,0,0,265000,Null,Null,262637912,111461,15318
262637943,0.0,0.0,74000,71000,3000,4,74000,Null,Null,262637943,111461,28722
262640759,0.0,0.0,231000,231000,0,0,231000,Null,Null,262640759,7843291,28698
262641338,0.0,0.0,279000,279000,0,0,279000,Null,Null,262641338,111461,15236
262641877,0.0,0.0,79000,79000,0,0,79000,Null,Null,262641877,111461,12908
262643381,0.0,0.0,62000,62000,0,0,62000,Null,Null,262643381,20683,12294
262643917,0.0,0.0,170000,162000,8000,5,170000,Null,Null,262643917,166419,28576
262644476,0.0,0.0,125000,120000,5000,4,125000,Null,Null,262644476,111461,28722
262645855,0.0,0.0,6900000,4692000,2208000,32,6900000,Null,Null,262645855,4232883,11849
262645907,0.0,0.0,300000,300000,0,0,300000,Null,Null,262645907,111461,28454
262645981,0.0,0.0,2200000,2200000,0,0,2200000,Null,Null,262645981,579445,15320
262646073,0.0,0.0,720000,720000,0,0,720000,Null,Null,262646073,579445,15320
262646145,0.0,0.0,3990000,3152100,837900,21,3990000,Null,Null,262646145,4232883,11849
262646270,0.0,0.0,600000,600000,0,0,600000,Null,Null,262646270,579445,15320
262646287,0.0,0.0,310000,289000,21000,7,310000,Null,Null,262646287,494489,28576
262646317,0.0,0.0,600000,600000,0,0,600000,Null,Null,262646317,579445,15320
262646320,0.0,0.0,220000,199000,21000,10,220000,Null,Null,262646320,166419,28576
262646412,0.0,0.0,2990000,2182700,807300,27,2990000,Null,Null,262646412,148196,11845
262646446,0.0,0.0,160000,147000,13000,8,160000,Null,Null,262646446,425477,28576
262648306,1.0,1.0,93000,93000,0,0,93000,Null,Null,262648306,20683,5006
262648698,0.0,0.0,3220000,2350600,869400,27,3220000,Null,Null,262648698,4232883,11849
262648728,0.0,0.0,179000,179000,0,0,179000,Null,Null,262648728,111461,12908
262648738,0.0,0.0,219000,219000,0,0,219000,Null,Null,262648738,111461,15318
262648776,0.0,0.0,186000,179000,7000,4,186000,Null,Null,262648776,111461,3805
262648788,0.0,0.0,2660000,1888600,771400,29,2660000,Null,Null,262648788,148196,11845
262648831,0.0,0.0,250000,235000,15000,6,250000,Null,Null,262648831,166419,28576
262649140,0.0,0.0,170000,159000,11000,6,170000,Null,Null,262649140,166419,28576
262651065,0.0,0.0,129000,129000,0,0,129000,Null,Null,262651065,111461,28460
262651225,0.0,0.0,350000,335000,15000,4,350000,Null,Null,262651225,111461,28576
262651412,0.0,0.0,350000,337000,13000,4,350000,Null,Null,262651412,149308,28576
262651537,0.0,0.0,279000,268000,11000,4,279000,Null,Null,262651537,111461,3805
262651717,0.0,0.0,250000,237000,13000,5,250000,Null,Null,262651717,4548129,28576
262651809,0.0,0.0,49000,49000,0,0,49000,Null,Null,262651809,111461,28484
262652390,0.0,0.0,35000,35000,0,0,35000,Null,Null,262652390,111461,28480
262652569,0.0,0.0,140000,140000,0,0,140000,Null,Null,262652569,149308,28578
262652642,0.0,0.0,193000,185000,8000,4,193000,Null,Null,262652642,111461,28722
262652647,0.0,0.0,900000,549000,351000,39,900000,Null,Null,262652647,5147565,28480
262652658,0.0,0.0,275000,275000,0,0,275000,Null,Null,262652658,142818,2971
262652732,2.0,2.0,99000,99000,0,0,99000,Null,Null,262652732,111461,28722
262652958,0.0,0.0,370000,370000,0,0,370000,Null,Null,262652958,48051,1838
262652980,0.0,0.0,19000,19000,0,0,19000,Null,Null,262652980,111461,12294
262653465,0.0,0.0,35500,35500,0,0,35500,Null,Null,262653465,111461,28574
262653499,0.0,0.0,139000,139000,0,0,139000,Null,Null,262653499,111461,2
262653522,0.0,0.0,2200000,2200000,0,0,2200000,Null,Null,262653522,579445,15320
262653535,0.0,0.0,119000,119000,0,0,119000,Null,Null,262653535,425477,28574
262653740,0.0,0.0,2200000,2200000,0,0,2200000,Null,Null,262653740,579445,15320
262653767,0.0,0.0,2200000,2200000,0,0,2200000,Null,Null,262653767,579445,15320
262653814,0.0,0.0,350000,188000,162000,46,350000,Null,Null,262653814,111461,28430
262653949,0.0,0.0,979000,979000,0,0,979000,Null,Null,262653949,19788,8043
262654825,0.0,0.0,6350000,6000000,350000,6,6350000,Null,Null,262654825,111461,8066
262654838,0.0,0.0,218000,209000,9000,4,218000,Null,Null,262654838,111461,3805
262655011,0.0,0.0,415000,390000,25000,6,415000,Null,Null,262655011,111461,7081
262656931,0.0,0.0,40000,40000,0,0,40000,Null,Null,262656931,111461,28596
262657041,5.0,5.0,69000,67000,2000,3,69000,Null,Null,262657041,4973949,28428
262657746,0.0,0.0,105600000,105600000,0,0,105600000,Null,Null,262657746,153999,2340
262657757,0.0,0.0,360000,268000,92000,26,360000,Null,Null,262657757,183257,15250
262658725,0.0,0.0,52999000,52999000,0,0,52999000,Null,Null,262658725,111461,27196
262658906,0.0,0.0,98000,94000,4000,4,98000,Null,Null,262658906,111461,3804
262659765,0.0,0.0,250000,250000,0,0,250000,Null,Null,262659765,212267,5006
262660017,0.0,0.0,6490000,5650000,840000,13,6490000,Null,Null,262660017,18802,1795
262660092,0.0,0.0,350000,350000,0,0,350000,Null,Null,262660092,212267,5006
262660636,0.0,0.0,149000,149000,0,0,149000,Null,Null,262660636,243693,28726
262660698,0.0,0.0,420000,420000,0,0,420000,Null,Null,262660698,111461,1813
262661013,0.0,0.0,680000,680000,0,0,680000,Null,Null,262661013,111461,1813
262661733,0.0,0.0,430000,430000,0,0,430000,Null,Null,262661733,111461,12882
262662981,0.0,0.0,88200,49000,39200,44,88200,Null,Null,262662981,46703,12908
262663015,0.0,0.0,850000,850000,0,0,850000,Null,Null,262663015,111461,1813
262663283,0.0,0.0,1150000,1150000,0,0,1150000,Null,Null,262663283,111461,12882
262663563,0.0,0.0,580000,290000,290000,50,580000,Null,Null,262663563,579233,1831
262663773,0.0,0.0,800000,800000,0,0,800000,Null,Null,262663773,111461,12882
262663866,0.0,0.0,3640000,2550000,1090000,30,3640000,Null,Null,262663866,4649279,7079
262664090,0.0,0.0,325000,255000,70000,22,325000,Null,Null,262664090,183257,15250
262664636,0.0,0.0,300000,218000,82000,27,300000,Null,Null,262664636,183257,15318
262665701,0.0,0.0,48990000,48990000,0,0,48990000,Null,Null,262665701,891099,23376
262665848,0.0,0.0,68990000,68990000,0,0,68990000,Null,Null,262665848,891099,23376
262667057,0.0,0.0,9999000,9999000,0,0,9999000,Null,Null,262667057,111461,2971
262667352,0.0,0.0,24900,24900,0,0,24900,Null,Null,262667352,111461,1831
262667354,0.0,0.0,94990000,94990000,0,0,94990000,Null,Null,262667354,891099,23376
262667505,0.0,0.0,193990000,193990000,0,0,193990000,Null,Null,262667505,891099,23376
262670520,0.0,0.0,20000,20000,0,0,20000,Null,Null,262670520,111461,28484
262671825,0.0,0.0,485000,485000,0,0,485000,Null,Null,262671825,111461,28682
262671829,0.0,0.0,380000,380000,0,0,380000,Null,Null,262671829,111461,1813
262671894,0.0,0.0,1950000,1950000,0,0,1950000,Null,Null,262671894,704815,15236
262672102,0.0,0.0,2000000,2000000,0,0,2000000,Null,Null,262672102,111461,1813
262672106,0.0,0.0,1200000,1200000,0,0,1200000,Null,Null,262672106,111461,12882
262672267,0.0,0.0,680000,680000,0,0,680000,Null,Null,262672267,111461,12882
262672286,0.0,0.0,650000,650000,0,0,650000,Null,Null,262672286,111461,1813
262672378,0.0,0.0,390000,380000,10000,3,390000,Null,Null,262672378,189445,20244
262672389,0.0,0.0,900000,565000,335000,37,900000,Null,Null,262672389,165897,28480
262672724,0.0,0.0,275000,275000,0,0,275000,Null,Null,262672724,243693,12294
262673254,0.0,0.0,320000,320000,0,0,320000,Null,Null,262673254,243693,3804
262673320,0.0,0.0,205000,205000,0,0,205000,Null,Null,262673320,111461,15318
262673546,0.0,0.0,282000,251000,31000,11,282000,Null,Null,262673546,111461,15318
262673683,0.0,0.0,139000,139000,0,0,139000,Null,Null,262673683,272933,28576
262673861,0.0,0.0,285000,254000,31000,11,285000,Null,Null,262673861,111461,15318
262675487,0.0,0.0,750000,750000,0,0,750000,Null,Null,262675487,111461,20172
262676893,0.0,0.0,345000,345000,0,0,345000,Null,Null,262676893,111461,2971
262677342,2866.0,2866.0,67000,67000,0,0,67000,Null,Null,262677342,145037,1520
262677358,0.0,0.0,389000,389000,0,0,389000,Null,Null,262677358,189445,20244
262677591,0.0,0.0,249000,249000,0,0,249000,Null,Null,262677591,111461,2971
262677893,0.0,0.0,15000,15000,0,0,15000,Null,Null,262677893,111461,2
262678070,0.0,0.0,80000,80000,0,0,80000,Null,Null,262678070,111461,2
262687077,0.0,0.0,90000,66000,24000,27,90000,Null,Null,262687077,111461,2340
262687319,0.0,0.0,358200,199000,159200,44,358200,Null,Null,262687319,46703,12908
262687647,0.0,0.0,399000,399000,0,0,399000,Null,Null,262687647,111461,28682
262687877,0.0,0.0,520200,289000,231200,44,520200,Null,Null,262687877,46703,12908
262687983,0.0,0.0,600000,585000,15000,3,600000,Null,Null,262687983,111461,5267
262688103,13.0,13.0,18000,18000,0,0,18000,Null,Null,262688103,111461,12908
262688183,0.0,0.0,560000,560000,0,0,560000,Null,Null,262688183,112638,1796
262688299,0.0,0.0,2500000,2500000,0,0,2500000,Null,Null,262688299,579445,15320
262688318,0.0,0.0,600000,585000,15000,3,600000,Null,Null,262688318,111461,5267
262688393,0.0,0.0,2200000,2200000,0,0,2200000,Null,Null,262688393,579445,15320
262688420,0.0,0.0,2800000,2800000,0,0,2800000,Null,Null,262688420,579445,15320
262688515,0.0,0.0,2200000,2200000,0,0,2200000,Null,Null,262688515,579445,15320
262688552,0.0,0.0,2700000,2700000,0,0,2700000,Null,Null,262688552,579445,15320
262688651,0.0,0.0,869000,869000,0,0,869000,Null,Null,262688651,469505,8371
262689113,0.0,0.0,286000,286000,0,0,286000,Null,Null,262689113,469505,15236
262689186,0.0,0.0,70000,70000,0,0,70000,Null,Null,262689186,111461,1831
262689341,12.0,12.0,1049,1049,0,0,1049,Null,Null,262689341,111457,1803
262689402,0.0,0.0,599000,420000,179000,30,599000,Null,Null,262689402,18802,1815
262689545,0.0,0.0,179000,179000,0,0,179000,Null,Null,262689545,463899,28596
262689558,0.0,0.0,198000,198000,0,0,198000,Null,Null,262689558,469505,15318
262689743,0.0,0.0,819000,819000,0,0,819000,Null,Null,262689743,21651,28454
262689746,0.0,0.0,195000,187000,8000,4,195000,Null,Null,262689746,111461,28480
262689765,0.0,0.0,2950000,2950000,0,0,2950000,Null,Null,262689765,579445,15320
262689777,0.0,0.0,2200000,2200000,0,0,2200000,Null,Null,262689777,579445,15320
262689809,0.0,0.0,100000,100000,0,0,100000,Null,Null,262689809,463899,28574
262689983,0.0,0.0,688000,610000,78000,11,688000,Null,Null,262689983,111461,2324
262690149,0.0,0.0,715000,670000,45000,6,715000,Null,Null,262690149,111461,20170
262690193,0.0,0.0,550000,550000,0,0,550000,Null,Null,262690193,579445,15236
262690199,0.0,0.0,850000,850000,0,0,850000,Null,Null,262690199,579445,15236
262690273,0.0,0.0,24000,24000,0,0,24000,Null,Null,262690273,111461,1831
262690333,0.0,0.0,231000,231000,0,0,231000,Null,Null,262690333,7843291,1815
262691545,0.0,0.0,187000,187000,0,0,187000,Null,Null,262691545,166419,28574
262691611,0.0,0.0,286200,159000,127200,44,286200,Null,Null,262691611,46703,12908
262691613,0.0,0.0,231000,231000,0,0,231000,Null,Null,262691613,7843291,1815
262691744,0.0,0.0,304200,169000,135200,44,304200,Null,Null,262691744,46703,12908
262691906,0.0,0.0,231000,231000,0,0,231000,Null,Null,262691906,7843291,28698
262692176,0.0,0.0,231000,231000,0,0,231000,Null,Null,262692176,7843291,1815
262692182,0.0,0.0,40000,40000,0,0,40000,Null,Null,262692182,111461,28576
262692201,0.0,0.0,358200,199000,159200,44,358200,Null,Null,262692201,46703,12908
262692247,0.0,0.0,40000,40000,0,0,40000,Null,Null,262692247,111461,28598
262692290,0.0,0.0,725000,725000,0,0,725000,Null,Null,262692290,111461,5566
262692323,0.0,0.0,60000,60000,0,0,60000,Null,Null,262692323,111461,28596
262692389,0.0,0.0,214200,119000,95200,44,214200,Null,Null,262692389,46703,12908
262692524,0.0,0.0,198000,198000,0,0,198000,Null,Null,262692524,469505,15318
262692735,4.0,4.0,231000,231000,0,0,231000,Null,Null,262692735,7843291,1815
262693001,1.0,1.0,231000,231000,0,0,231000,Null,Null,262693001,7843291,1815
262693063,0.0,0.0,299000,299000,0,0,299000,Null,Null,262693063,111461,5566
262693075,0.0,0.0,2090000,2090000,0,0,2090000,Null,Null,262693075,469505,15318
262693154,0.0,0.0,749000,690000,59000,8,749000,Null,Null,262693154,243693,3804
262693189,1.0,1.0,27000,15000,12000,44,27000,Null,Null,262693189,46703,12294
262693216,0.0,0.0,8310000,8310000,0,0,8310000,Null,Null,262693216,469505,15318
262693563,0.0,0.0,829000,829000,0,0,829000,Null,Null,262693563,111461,5566
262693577,0.0,0.0,231000,231000,0,0,231000,Null,Null,262693577,7843291,1815
262694250,0.0,0.0,1899000,1599000,300000,16,1899000,Null,Null,262694250,233859,5267
262694311,0.0,0.0,231000,231000,0,0,231000,Null,Null,262694311,7843291,1815
262694380,0.0,0.0,649000,649000,0,0,649000,Null,Null,262694380,111461,5566
262694490,0.0,0.0,231000,231000,0,0,231000,Null,Null,262694490,7843291,1815
262694665,0.0,0.0,1899000,1559000,340000,18,1899000,Null,Null,262694665,233859,5267
262694893,0.0,0.0,909000,909000,0,0,909000,Null,Null,262694893,111461,5566
262694919,1.0,1.0,1899000,1559000,340000,18,1899000,Null,Null,262694919,233859,5267
262694962,0.0,0.0,231000,231000,0,0,231000,Null,Null,262694962,7843291,1815
262695019,2.0,2.0,231000,231000,0,0,231000,Null,Null,262695019,7843291,1815
262695080,0.0,0.0,2299000,1900000,399000,17,2299000,Null,Null,262695080,233859,5267
262695100,2.0,2.0,231000,231000,0,0,231000,Null,Null,262695100,7843291,1815
262695137,0.0,0.0,924000,924000,0,0,924000,Null,Null,262695137,111461,5566
262695201,0.0,0.0,1299000,1013000,286000,22,1299000,Null,Null,262695201,233859,5267
262695304,0.0,0.0,820000,670000,150000,18,820000,Null,Null,262695304,111461,20170
262695346,0.0,0.0,231000,231000,0,0,231000,Null,Null,262695346,7843291,1815
262695372,0.0,0.0,1299000,1013000,286000,22,1299000,Null,Null,262695372,233859,5267
262695399,0.0,0.0,231000,231000,0,0,231000,Null,Null,262695399,7843291,1815
262695445,0.0,0.0,1299000,1013000,286000,22,1299000,Null,Null,262695445,233859,5267
262695530,2.0,2.0,1299000,1013000,286000,22,1299000,Null,Null,262695530,233859,5267
262695602,1.0,1.0,231000,231000,0,0,231000,Null,Null,262695602,7843291,1815
262695611,0.0,0.0,25000,25000,0,0,25000,Null,Null,262695611,111461,28576
262695621,0.0,0.0,14000,14000,0,0,14000,Null,Null,262695621,111461,20254
262695640,2.0,2.0,231000,231000,0,0,231000,Null,Null,262695640,7843291,1815
262695695,5.0,5.0,231000,231000,0,0,231000,Null,Null,262695695,7843291,1815
262695789,2.0,2.0,231000,231000,0,0,231000,Null,Null,262695789,7843291,1815
262695949,1.0,1.0,231000,231000,0,0,231000,Null,Null,262695949,7843291,1815
262695975,0.0,0.0,231000,231000,0,0,231000,Null,Null,262695975,7843291,1815
262696016,0.0,0.0,231000,231000,0,0,231000,Null,Null,262696016,7843291,1815
262696696,0.0,0.0,9000,9000,0,0,9000,Null,Null,262696696,111461,20258
262696724,0.0,0.0,549000,549000,0,0,549000,Null,Null,262696724,19072,1831
262698004,0.0,0.0,40500,40500,0,0,40500,Null,Null,262698004,111461,28574
262698843,0.0,0.0,40500,40500,0,0,40500,Null,Null,262698843,111461,28594
262699237,0.0,0.0,35500,35500,0,0,35500,Null,Null,262699237,111461,28574
262699454,0.0,0.0,199000,199000,0,0,199000,Null,Null,262699454,26151,1837
262699465,15.0,15.0,78000,78000,0,0,78000,Null,Null,262699465,111461,12908
262699855,0.0,0.0,2499000,2424000,75000,3,2499000,Null,Null,262699855,18802,8400
262699880,0.0,0.0,1350000,1350000,0,0,1350000,Null,Null,262699880,18802,8400
262699889,0.0,0.0,45000,45000,0,0,45000,Null,Null,262699889,111461,15250
262699909,0.0,0.0,115000,115000,0,0,115000,Null,Null,262699909,111461,15250
262699932,0.0,0.0,45000,45000,0,0,45000,Null,Null,262699932,111461,15250
262699951,0.0,0.0,115000,115000,0,0,115000,Null,Null,262699951,111461,15250
262699984,0.0,0.0,45000,45000,0,0,45000,Null,Null,262699984,111461,15250
262700003,0.0,0.0,115000,115000,0,0,115000,Null,Null,262700003,111461,15250
262700267,9.0,9.0,690000,389000,301000,44,690000,Null,Null,262700267,198345,8400
262700346,0.0,0.0,95000,95000,0,0,95000,Null,Null,262700346,185083,1815
262700436,0.0,0.0,88000,88000,0,0,88000,Null,Null,262700436,111461,15236
262700590,0.0,0.0,267000,267000,0,0,267000,Null,Null,262700590,111461,15318
262700611,0.0,0.0,85000,85000,0,0,85000,Null,Null,262700611,166419,1815
262700676,0.0,0.0,31000,31000,0,0,31000,Null,Null,262700676,111461,1831
262700914,0.0,0.0,450000,450000,0,0,450000,Null,Null,262700914,112638,1796
262700925,0.0,0.0,249000,249000,0,0,249000,Null,Null,262700925,111461,20174
262701121,0.0,0.0,750000,750000,0,0,750000,Null,Null,262701121,579445,15236
262701126,0.0,0.0,85000,85000,0,0,85000,Null,Null,262701126,166419,28576
262701128,0.0,0.0,750000,750000,0,0,750000,Null,Null,262701128,579445,15236
262701138,0.0,0.0,650000,650000,0,0,650000,Null,Null,262701138,579445,15236
262701148,0.0,0.0,650000,650000,0,0,650000,Null,Null,262701148,579445,15236
262701154,0.0,0.0,600000,600000,0,0,600000,Null,Null,262701154,579445,15236
262701169,0.0,0.0,4100000,4100000,0,0,4100000,Null,Null,262701169,579445,15236
262701173,0.0,0.0,850000,850000,0,0,850000,Null,Null,262701173,25697,28452
262701397,0.0,0.0,950000,950000,0,0,950000,Null,Null,262701397,25697,28450
262701479,0.0,0.0,1990000,1990000,0,0,1990000,Null,Null,262701479,111461,28398
262701530,0.0,0.0,6890000,6325000,565000,8,6890000,Null,Null,262701530,111461,8066
262701551,0.0,0.0,6890000,6325000,565000,8,6890000,Null,Null,262701551,111461,8066
262701564,0.0,0.0,6890000,6325000,565000,8,6890000,Null,Null,262701564,111461,8066
262701602,0.0,0.0,950000,950000,0,0,950000,Null,Null,262701602,25697,28450
262705048,0.0,0.0,85000,85000,0,0,85000,Null,Null,262705048,166419,1815
262705394,12.0,12.0,145000,145000,0,0,145000,Null,Null,262705394,111461,1815
262705414,0.0,0.0,690000,389000,301000,44,690000,Null,Null,262705414,204385,8400
262705682,0.0,0.0,39000,39000,0,0,39000,Null,Null,262705682,111461,28486
262705733,0.0,0.0,259000,259000,0,0,259000,Null,Null,262705733,111461,28684
262705779,0.0,0.0,223000,223000,0,0,223000,Null,Null,262705779,111461,15318
262705785,0.0,0.0,420000,420000,0,0,420000,Null,Null,262705785,111461,1813
262705933,0.0,0.0,196000,196000,0,0,196000,Null,Null,262705933,111461,15318
262706167,0.0,0.0,10500000,8895000,1605000,15,10500000,Null,Null,262706167,114527,2657
262706182,13.0,13.0,132610,132610,0,0,132610,Null,Null,262706182,111461,1815
262706212,0.0,0.0,140000,140000,0,0,140000,Null,Null,262706212,111461,15236
262706645,0.0,0.0,2690000,2690000,0,0,2690000,Null,Null,262706645,147856,28856
262706921,0.0,0.0,1000,990,10,1,1000,Null,Null,262706921,111461,23162
262706932,0.0,0.0,45990000,45990000,0,0,45990000,Null,Null,262706932,488701,2340
262706946,0.0,0.0,38000000,19000000,19000000,50,38000000,Null,Null,262706946,488701,2340
262707184,0.0,0.0,470000,470000,0,0,470000,Null,Null,262707184,111461,5566
262707464,0.0,0.0,13990000,13990000,0,0,13990000,Null,Null,262707464,488701,2340
262707468,0.0,0.0,35360000,35360000,0,0,35360000,Null,Null,262707468,488701,2340
262707612,0.0,0.0,19760000,19760000,0,0,19760000,Null,Null,262707612,488701,2340
262707954,0.0,0.0,250000,250000,0,0,250000,Null,Null,262707954,26274,2324
262708179,0.0,0.0,132000,132000,0,0,132000,Null,Null,262708179,111461,5566
262708334,0.0,0.0,255000,255000,0,0,255000,Null,Null,262708334,111461,5566
262708431,0.0,0.0,379000,379000,0,0,379000,Null,Null,262708431,111461,5566
262708482,0.0,0.0,107800,107800,0,0,107800,Null,Null,262708482,111461,2
262708507,0.0,0.0,375000,375000,0,0,375000,Null,Null,262708507,111461,8073
262708511,0.0,0.0,714000,714000,0,0,714000,Null,Null,262708511,111461,8073
262708533,0.0,0.0,349000,349000,0,0,349000,Null,Null,262708533,111461,5566
262709047,0.0,0.0,656000,656000,0,0,656000,Null,Null,262709047,111461,5566
262709266,0.0,0.0,149000,149000,0,0,149000,Null,Null,262709266,111461,5566
262709276,0.0,0.0,0,279000,0,0,279000,Null,Null,262709276,111461,0
262709334,0.0,0.0,0,522000,0,0,522000,Null,Null,262709334,111461,0
262709342,0.0,0.0,0,278000,0,0,278000,Null,Null,262709342,111461,0
262718313,0.0,0.0,2650000,2385000,265000,10,2650000,Null,Null,262718313,704815,15936
262718318,0.0,0.0,35500,35500,0,0,35500,Null,Null,262718318,111461,28580
262718367,0.0,0.0,35500,35500,0,0,35500,Null,Null,262718367,111461,28576
262719197,0.0,0.0,10000,10000,0,0,10000,Null,Null,262719197,111461,2
262719759,0.0,0.0,30000,30000,0,0,30000,Null,Null,262719759,111461,2
262719888,0.0,0.0,19600,19600,0,0,19600,Null,Null,262719888,111461,2
262720616,0.0,0.0,50000,50000,0,0,50000,Null,Null,262720616,111461,2
262720898,0.0,0.0,70000,70000,0,0,70000,Null,Null,262720898,111461,2
262721009,0.0,0.0,760000,760000,0,0,760000,Null,Null,262721009,111461,2657
262724215,0.0,0.0,10000,10000,0,0,10000,Null,Null,262724215,111461,20254
262724276,0.0,0.0,14000,14000,0,0,14000,Null,Null,262724276,111461,20254
262724442,0.0,0.0,290000,290000,0,0,290000,Null,Null,262724442,149308,28484
262724721,0.0,0.0,10670,10670,0,0,10670,Null,Null,262724721,111461,2
262725079,0.0,0.0,76000,76000,0,0,76000,Null,Null,262725079,111461,2
262725868,0.0,0.0,3000000,3000000,0,0,3000000,Null,Null,262725868,25697,28450
262725932,0.0,0.0,1800000,1800000,0,0,1800000,Null,Null,262725932,25697,28450
262726210,0.0,0.0,1800000,1800000,0,0,1800000,Null,Null,262726210,25697,28450
262726214,0.0,0.0,4000,4000,0,0,4000,Null,Null,262726214,111461,8167
262726223,0.0,0.0,2800000,2800000,0,0,2800000,Null,Null,262726223,25697,28450
262726253,0.0,0.0,1300000,1300000,0,0,1300000,Null,Null,262726253,25697,28450
262726286,0.0,0.0,7000,7000,0,0,7000,Null,Null,262726286,111461,8197
262726344,0.0,0.0,1900,1900,0,0,1900,Null,Null,262726344,111461,2
262726349,0.0,0.0,151050,151050,0,0,151050,Null,Null,262726349,111461,2
262726378,0.0,0.0,8000,8000,0,0,8000,Null,Null,262726378,111461,2
262726408,0.0,0.0,1900,1900,0,0,1900,Null,Null,262726408,111461,2
262726420,0.0,0.0,1000,1000,0,0,1000,Null,Null,262726420,111461,2
262726498,0.0,0.0,4750,4750,0,0,4750,Null,Null,262726498,111461,2
262726537,5.0,5.0,1960,1960,0,0,1960,Null,Null,262726537,111461,2
262726538,11.0,11.0,5700,5700,0,0,5700,Null,Null,262726538,111461,2
262726560,0.0,0.0,12740,12740,0,0,12740,Null,Null,262726560,111461,2
262726564,0.0,0.0,10000,10000,0,0,10000,Null,Null,262726564,111461,2
262726581,0.0,0.0,1900,1900,0,0,1900,Null,Null,262726581,111461,2
262726599,0.0,0.0,13000,13000,0,0,13000,Null,Null,262726599,111461,2
262726607,0.0,0.0,31900,31900,0,0,31900,Null,Null,262726607,111461,2
262726618,0.0,0.0,2850,2850,0,0,2850,Null,Null,262726618,111461,2
262726643,0.0,0.0,14250,14250,0,0,14250,Null,Null,262726643,111461,2
262726681,0.0,0.0,160550,160550,0,0,160550,Null,Null,262726681,111461,2
262726682,0.0,0.0,1425,1425,0,0,1425,Null,Null,262726682,111461,2
262726754,0.0,0.0,3920,3920,0,0,3920,Null,Null,262726754,111461,2
262726758,0.0,0.0,189050,189050,0,0,189050,Null,Null,262726758,111461,2
262726760,0.0,0.0,6851,6851,0,0,6851,Null,Null,262726760,111461,2
262726761,0.0,0.0,5691,5691,0,0,5691,Null,Null,262726761,111461,2
262726821,0.0,0.0,1900,1900,0,0,1900,Null,Null,262726821,111461,2
262726848,0.0,0.0,3000,3000,0,0,3000,Null,Null,262726848,111461,2
262726866,0.0,0.0,63700,63700,0,0,63700,Null,Null,262726866,111461,2
262726885,0.0,0.0,25000,25000,0,0,25000,Null,Null,262726885,111461,2
262726907,0.0,0.0,1750000,1750000,0,0,1750000,Null,Null,262726907,111461,5566
262727324,1.0,1.0,590000,590000,0,0,590000,Null,Null,262727324,5073869,1815
262727335,0.0,0.0,5000,5000,0,0,5000,Null,Null,262727335,111461,8198
262727362,0.0,0.0,3500000,3500000,0,0,3500000,Null,Null,262727362,25697,28450
262727437,0.0,0.0,27160,27160,0,0,27160,Null,Null,262727437,111461,2
262727438,0.0,0.0,14250,14250,0,0,14250,Null,Null,262727438,111461,2
262727441,0.0,0.0,15000,15000,0,0,15000,Null,Null,262727441,111461,2
262727442,0.0,0.0,639000,639000,0,0,639000,Null,Null,262727442,111461,2
262727446,0.0,0.0,36900,36900,0,0,36900,Null,Null,262727446,111461,2
262727469,0.0,0.0,27550,27550,0,0,27550,Null,Null,262727469,111461,2
262727470,0.0,0.0,1500,1500,0,0,1500,Null,Null,262727470,111461,2
262727477,0.0,0.0,14550,14550,0,0,14550,Null,Null,262727477,111461,2
262727480,0.0,0.0,21000,21000,0,0,21000,Null,Null,262727480,111461,2
262727481,0.0,0.0,1066030,1066030,0,0,1066030,Null,Null,262727481,111461,2
262727482,0.0,0.0,23750,23750,0,0,23750,Null,Null,262727482,111461,2
262727486,0.0,0.0,72750,72750,0,0,72750,Null,Null,262727486,111461,2
262727506,0.0,0.0,5820,5820,0,0,5820,Null,Null,262727506,111461,2
262727515,0.0,0.0,14250,14250,0,0,14250,Null,Null,262727515,111461,2
262727519,0.0,0.0,125000,125000,0,0,125000,Null,Null,262727519,111461,2
262727534,0.0,0.0,23750,23750,0,0,23750,Null,Null,262727534,111461,2
262727536,0.0,0.0,8000,8000,0,0,8000,Null,Null,262727536,111461,2
262727547,0.0,0.0,208050,208050,0,0,208050,Null,Null,262727547,111461,2
262727600,0.0,0.0,27900,27900,0,0,27900,Null,Null,262727600,111461,2
262727619,0.0,0.0,86330,86330,0,0,86330,Null,Null,262727619,111461,2
262727652,0.0,0.0,185250,185250,0,0,185250,Null,Null,262727652,111461,2
262727660,0.0,0.0,246050,246050,0,0,246050,Null,Null,262727660,111461,2
262727671,0.0,0.0,14250,14250,0,0,14250,Null,Null,262727671,111461,2
262727674,0.0,0.0,1900,1900,0,0,1900,Null,Null,262727674,111461,2
262727680,0.0,0.0,2910,2910,0,0,2910,Null,Null,262727680,111461,2
262727681,0.0,0.0,29000,29000,0,0,29000,Null,Null,262727681,111461,2
262727686,0.0,0.0,11500,11500,0,0,11500,Null,Null,262727686,111461,2
262727737,0.0,0.0,18000,18000,0,0,18000,Null,Null,262727737,111461,2
262727742,0.0,0.0,41000,41000,0,0,41000,Null,Null,262727742,111461,2
262727743,0.0,0.0,43650,43650,0,0,43650,Null,Null,262727743,111461,2
262727744,0.0,0.0,939550,939550,0,0,939550,Null,Null,262727744,111461,2
262727748,0.0,0.0,189050,189050,0,0,189050,Null,Null,262727748,111461,2
262727749,0.0,0.0,4500,4500,0,0,4500,Null,Null,262727749,111461,2
262727787,0.0,0.0,23750,23750,0,0,23750,Null,Null,262727787,111461,2
262727790,0.0,0.0,159000,159000,0,0,159000,Null,Null,262727790,111461,2
262727821,0.0,0.0,569000,569000,0,0,569000,Null,Null,262727821,111461,2
262727829,0.0,0.0,20900,20900,0,0,20900,Null,Null,262727829,111461,2
262727835,0.0,0.0,9000,9000,0,0,9000,Null,Null,262727835,111461,2
262727847,10.0,10.0,1900,1900,0,0,1900,Null,Null,262727847,111461,2
262727851,0.0,0.0,7600,7600,0,0,7600,Null,Null,262727851,111461,2
262727864,0.0,0.0,1000,1000,0,0,1000,Null,Null,262727864,111461,2
262727929,0.0,0.0,4850,4850,0,0,4850,Null,Null,262727929,111461,2
262727977,0.0,0.0,7000,7000,0,0,7000,Null,Null,262727977,111461,2
262727981,0.0,0.0,170050,170050,0,0,170050,Null,Null,262727981,111461,2
262727993,0.0,0.0,122550,122550,0,0,122550,Null,Null,262727993,111461,2
262727994,0.0,0.0,4850,4850,0,0,4850,Null,Null,262727994,111461,2
262728000,0.0,0.0,315250,315250,0,0,315250,Null,Null,262728000,111461,2
262728010,0.0,0.0,75050,75050,0,0,75050,Null,Null,262728010,111461,2
262728033,0.0,0.0,11391,11391,0,0,11391,Null,Null,262728033,111461,2
262728038,0.0,0.0,8550,8550,0,0,8550,Null,Null,262728038,111461,2
262728039,0.0,0.0,1900,1900,0,0,1900,Null,Null,262728039,111461,2
262728041,0.0,0.0,5820,5820,0,0,5820,Null,Null,262728041,111461,2
262728113,0.0,0.0,62000,62000,0,0,62000,Null,Null,262728113,111461,2
262728114,0.0,0.0,4850,4850,0,0,4850,Null,Null,262728114,111461,2
262728116,0.0,0.0,1990,1990,0,0,1990,Null,Null,262728116,111461,2
262728126,0.0,0.0,2910,2910,0,0,2910,Null,Null,262728126,111461,2
262728138,0.0,0.0,274550,274550,0,0,274550,Null,Null,262728138,111461,2
262728139,0.0,0.0,23750,23750,0,0,23750,Null,Null,262728139,111461,2
262728156,0.0,0.0,23750,23750,0,0,23750,Null,Null,262728156,111461,2
262728175,0.0,0.0,4364030,4364030,0,0,4364030,Null,Null,262728175,111461,2
262728184,0.0,0.0,25641,25641,0,0,25641,Null,Null,262728184,111461,2
262728202,0.0,0.0,14000,14000,0,0,14000,Null,Null,262728202,111461,2
262728208,0.0,0.0,227050,227050,0,0,227050,Null,Null,262728208,111461,2
262728230,1.0,1.0,40740,40740,0,0,40740,Null,Null,262728230,111461,2
262728233,0.0,0.0,4850,4850,0,0,4850,Null,Null,262728233,111461,2
262728237,0.0,0.0,27550,27550,0,0,27550,Null,Null,262728237,111461,2
262728268,0.0,0.0,113050,113050,0,0,113050,Null,Null,262728268,111461,2
262728278,0.0,0.0,19000,19000,0,0,19000,Null,Null,262728278,111461,2
262728302,0.0,0.0,1940,1940,0,0,1940,Null,Null,262728302,111461,2
262728364,0.0,0.0,1500,1500,0,0,1500,Null,Null,262728364,111461,2
262728370,0.0,0.0,3900,3900,0,0,3900,Null,Null,262728370,111461,2
262728374,0.0,0.0,270630,270630,0,0,270630,Null,Null,262728374,111461,2
262728377,0.0,0.0,89000,89000,0,0,89000,Null,Null,262728377,111461,2
262728383,0.0,0.0,20900,20900,0,0,20900,Null,Null,262728383,111461,2
262728447,0.0,0.0,17100,17100,0,0,17100,Null,Null,262728447,111461,2
262728449,1.0,1.0,580000,580000,0,0,580000,Null,Null,262728449,111461,1815
262728453,0.0,0.0,23750,23750,0,0,23750,Null,Null,262728453,111461,2
262728457,0.0,0.0,219000,219000,0,0,219000,Null,Null,262728457,111461,2
262728600,0.0,0.0,750000,750000,0,0,750000,Null,Null,262728600,111461,5566
262728668,0.0,0.0,55000,55000,0,0,55000,Null,Null,262728668,111461,28480
262729327,0.0,0.0,299000,299000,0,0,299000,Null,Null,262729327,111461,3428
262729368,0.0,0.0,412000,412000,0,0,412000,Null,Null,262729368,111461,2324
262729389,0.0,0.0,249000,234000,15000,6,249000,Null,Null,262729389,111461,28594
262729410,0.0,0.0,412000,412000,0,0,412000,Null,Null,262729410,111461,2324
262730529,0.0,0.0,1798000,1690000,108000,6,1798000,Null,Null,262730529,111461,2324
262730964,0.0,0.0,25000,25000,0,0,25000,Null,Null,262730964,111461,28480
262731096,7.0,7.0,60000,60000,0,0,60000,Null,Null,262731096,185875,8223
262732099,0.0,0.0,209000,209000,0,0,209000,Null,Null,262732099,111461,5566
262732127,0.0,0.0,25000,25000,0,0,25000,Null,Null,262732127,111461,28480
262732137,0.0,0.0,210000,210000,0,0,210000,Null,Null,262732137,111461,5566
262732212,0.0,0.0,720000,720000,0,0,720000,Null,Null,262732212,579445,15236
262732251,0.0,0.0,5150000,5150000,0,0,5150000,Null,Null,262732251,579445,15236
262732253,0.0,0.0,155000,155000,0,0,155000,Null,Null,262732253,111461,8073
262732265,0.0,0.0,156000,156000,0,0,156000,Null,Null,262732265,111461,8073
262732315,0.0,0.0,284000,284000,0,0,284000,Null,Null,262732315,111461,5566
262732360,0.0,0.0,39000,39000,0,0,39000,Null,Null,262732360,111461,28682
262732586,0.0,0.0,99000,99000,0,0,99000,Null,Null,262732586,111461,49722
262732680,0.0,0.0,1900000,1900000,0,0,1900000,Null,Null,262732680,579445,15236
262732730,0.0,0.0,2950000,2950000,0,0,2950000,Null,Null,262732730,579445,15236
262732732,0.0,0.0,59000,59000,0,0,59000,Null,Null,262732732,111461,49722
262732763,0.0,0.0,850000,850000,0,0,850000,Null,Null,262732763,579445,15236
262732783,1.0,1.0,130000,130000,0,0,130000,Null,Null,262732783,111461,49722
262732846,0.0,0.0,389000,389000,0,0,389000,Null,Null,262732846,111461,28618
262732856,0.0,0.0,119000,119000,0,0,119000,Null,Null,262732856,111461,49728
262732861,0.0,0.0,269000,262000,7000,3,269000,Null,Null,262732861,8189829,28428
262732964,0.0,0.0,99000,99000,0,0,99000,Null,Null,262732964,111461,49728
262733056,2891.0,2891.0,776000,400000,376000,48,776000,Null,Null,262733056,48077,2334
262733067,1.0,1.0,199000,199000,0,0,199000,Null,Null,262733067,8189829,28428
262733082,0.0,0.0,120000,120000,0,0,120000,Null,Null,262733082,111461,49728
262733131,0.0,0.0,120000,120000,0,0,120000,Null,Null,262733131,111461,49724
262733148,0.0,0.0,49000,48000,1000,2,49000,Null,Null,262733148,8189829,1831
262733242,0.0,0.0,79000,79000,0,0,79000,Null,Null,262733242,111461,49722
262733331,0.0,0.0,249000,243000,6000,2,249000,Null,Null,262733331,8189829,28428
262733935,0.0,0.0,2490000,1969000,521000,21,2490000,Null,Null,262733935,247549,1795
262734191,0.0,0.0,55000,55000,0,0,55000,Null,Null,262734191,111461,8205
262734629,0.0,0.0,29000,29000,0,0,29000,Null,Null,262734629,111461,28576
262734794,0.0,0.0,6000,6000,0,0,6000,Null,Null,262734794,111461,11803
262734854,0.0,0.0,39600,22000,17600,44,39600,Null,Null,262734854,46703,12908
262736533,0.0,0.0,29000,29000,0,0,29000,Null,Null,262736533,111461,28576
262736660,0.0,0.0,441000,245000,196000,44,441000,Null,Null,262736660,46703,8519
262736707,0.0,0.0,269000,253000,16000,6,269000,Null,Null,262736707,111461,28594
262741303,0.0,0.0,35000,35000,0,0,35000,Null,Null,262741303,111461,28484
262741549,0.0,0.0,149000,149000,0,0,149000,Null,Null,262741549,111461,5566
262744950,0.0,0.0,148000,148000,0,0,148000,Null,Null,262744950,111461,8073
262745011,0.0,0.0,275000,275000,0,0,275000,Null,Null,262745011,111461,2324
262745038,0.0,0.0,284000,284000,0,0,284000,Null,Null,262745038,111461,5566
262745053,0.0,0.0,29000,29000,0,0,29000,Null,Null,262745053,111461,28576
262746019,0.0,0.0,58000,58000,0,0,58000,Null,Null,262746019,111461,28576
262746115,0.0,0.0,312000,156000,156000,50,312000,Null,Null,262746115,111461,15318
262746479,0.0,0.0,58659,58659,0,0,58659,Null,Null,262746479,111461,28576
262746549,0.0,0.0,165985,165985,0,0,165985,Null,Null,262746549,272933,28576
262746807,0.0,0.0,1090000,1090000,0,0,1090000,Null,Null,262746807,18641,12676
262746847,0.0,0.0,148000,148000,0,0,148000,Null,Null,262746847,272933,28576
262746856,0.0,0.0,140000,140000,0,0,140000,Null,Null,262746856,272933,28576
262747017,0.0,0.0,650000,650000,0,0,650000,Null,Null,262747017,156929,8225
262747031,0.0,0.0,240000,240000,0,0,240000,Null,Null,262747031,111461,15318
262747912,0.0,0.0,64000,64000,0,0,64000,Null,Null,262747912,111461,28484
262747980,0.0,0.0,35680000,35680000,0,0,35680000,Null,Null,262747980,7480987,6653
262748171,0.0,0.0,53898,48999,4899,9,53898,Null,Null,262748171,191669,28576
262748184,0.0,0.0,2150000,2150000,0,0,2150000,Null,Null,262748184,111461,8073
262748194,0.0,0.0,53898,48999,4899,9,53898,Null,Null,262748194,191669,28580
262748222,0.0,0.0,53898,48999,4899,9,53898,Null,Null,262748222,191669,28580
262748264,0.0,0.0,49000,49000,0,0,49000,Null,Null,262748264,191669,28578
262748346,0.0,0.0,49000,49000,0,0,49000,Null,Null,262748346,191669,28578
262748391,0.0,0.0,53898,48999,4899,9,53898,Null,Null,262748391,191669,28578
262749093,0.0,0.0,258000,258000,0,0,258000,Null,Null,262749093,111461,15318
262749177,0.0,0.0,3000000,3000000,0,0,3000000,Null,Null,262749177,111461,8073
262749230,0.0,0.0,99000,99000,0,0,99000,Null,Null,262749230,111461,28484
262749341,0.0,0.0,285000,285000,0,0,285000,Null,Null,262749341,111461,15318
262749644,0.0,0.0,3290000,3290000,0,0,3290000,Null,Null,262749644,111461,8073
262749726,0.0,0.0,290000,290000,0,0,290000,Null,Null,262749726,7376725,28428
262749924,0.0,0.0,205000,205000,0,0,205000,Null,Null,262749924,111461,15318
262750036,0.0,0.0,214000,214000,0,0,214000,Null,Null,262750036,111461,15250
262750057,0.0,0.0,3860000,3860000,0,0,3860000,Null,Null,262750057,111461,8073
262750090,0.0,0.0,990000,990000,0,0,990000,Null,Null,262750090,25422,12918
262750141,0.0,0.0,142000,136000,6000,4,142000,Null,Null,262750141,111461,1813
262755007,0.0,0.0,64000,64000,0,0,64000,Null,Null,262755007,114568,20258
262755109,0.0,0.0,2490000,2490000,0,0,2490000,Null,Null,262755109,810913,20170
262756013,1.0,1.0,89000,89000,0,0,89000,Null,Null,262756013,111461,1831
262756138,0.0,0.0,3490000,3490000,0,0,3490000,Null,Null,262756138,111461,8400
262756160,0.0,0.0,245000,245000,0,0,245000,Null,Null,262756160,111461,1831
262756202,0.0,0.0,4990000,4990000,0,0,4990000,Null,Null,262756202,111461,28640
262756280,0.0,0.0,3990000,3990000,0,0,3990000,Null,Null,262756280,111461,8400
262758194,0.0,0.0,449000,449000,0,0,449000,Null,Null,262758194,8191753,8400
262758374,0.0,0.0,19000,19000,0,0,19000,Null,Null,262758374,111461,49728
262758677,0.0,0.0,100000,100000,0,0,100000,Null,Null,262758677,8166207,28484
262759098,0.0,0.0,51999000,51999000,0,0,51999000,Null,Null,262759098,111461,27196
262759101,0.0,0.0,25000,25000,0,0,25000,Null,Null,262759101,111461,20254
262759184,0.0,0.0,40999000,40999000,0,0,40999000,Null,Null,262759184,111461,27196
262759269,0.0,0.0,2249000,2249000,0,0,2249000,Null,Null,262759269,26065,1811
262762326,0.0,0.0,0,70000,0,0,70000,Null,Null,262762326,111461,0
262765962,0.0,0.0,100000,100000,0,0,100000,Null,Null,262765962,8166207,28484
262766188,0.0,0.0,12000,12000,0,0,12000,Null,Null,262766188,111461,20254
262766225,0.0,0.0,3000000,3000000,0,0,3000000,Null,Null,262766225,111461,8073
262766449,0.0,0.0,3810000,3810000,0,0,3810000,Null,Null,262766449,111461,8073
262766727,0.0,0.0,649000,649000,0,0,649000,Null,Null,262766727,8175811,12908
262766821,0.0,0.0,899000,589000,310000,34,899000,Null,Null,262766821,314675,5267
262766951,0.0,0.0,199000,194000,5000,3,199000,Null,Null,262766951,4973949,28430
262767031,0.0,0.0,11000,11000,0,0,11000,Null,Null,262767031,111461,20254
262767139,1.0,1.0,179000,179000,0,0,179000,Null,Null,262767139,4973949,28430
262767180,0.0,0.0,47470000,47470000,0,0,47470000,Null,Null,262767180,111461,27196
262767326,0.0,0.0,830000,830000,0,0,830000,Null,Null,262767326,702761,7078
262767481,0.0,0.0,25000,25000,0,0,25000,Null,Null,262767481,111461,20254
262772594,0.0,0.0,12000,12000,0,0,12000,Null,Null,262772594,111461,20254
262772660,0.0,0.0,33999000,19999000,14000000,41,33999000,Null,Null,262772660,204665,2340
262772672,0.0,0.0,6900000,6900000,0,0,6900000,Null,Null,262772672,243915,12876
262772933,0.0,0.0,125000,125000,0,0,125000,Null,Null,262772933,111461,49726
262773301,0.0,0.0,115000,115000,0,0,115000,Null,Null,262773301,111461,49726
262773506,0.0,0.0,156000,156000,0,0,156000,Null,Null,262773506,111461,1836
262774953,0.0,0.0,500000,500000,0,0,500000,Null,Null,262774953,579445,15236
262775830,0.0,0.0,16900000,11499000,5401000,32,16900000,Null,Null,262775830,47424,8172
262775843,0.0,0.0,3950000,3950000,0,0,3950000,Null,Null,262775843,579445,15236
262778191,0.0,0.0,720000,720000,0,0,720000,Null,Null,262778191,579445,15236
262778240,0.0,0.0,231000,231000,0,0,231000,Null,Null,262778240,7843291,1815
262778246,0.0,0.0,129000,129000,0,0,129000,Null,Null,262778246,111461,1836
262778864,0.0,0.0,4400000,4400000,0,0,4400000,Null,Null,262778864,579445,15236
262779660,0.0,0.0,550000,550000,0,0,550000,Null,Null,262779660,579445,15236
262779740,0.0,0.0,3950000,3950000,0,0,3950000,Null,Null,262779740,579445,15236
262779863,0.0,0.0,231000,231000,0,0,231000,Null,Null,262779863,7843291,1815
262779932,0.0,0.0,231000,231000,0,0,231000,Null,Null,262779932,7843291,1815
262780015,0.0,0.0,1125000,1125000,0,0,1125000,Null,Null,262780015,111461,2
262780020,0.0,0.0,275000,275000,0,0,275000,Null,Null,262780020,111461,2
262780022,0.0,0.0,565000,565000,0,0,565000,Null,Null,262780022,111461,2
262780027,0.0,0.0,1750000,1750000,0,0,1750000,Null,Null,262780027,111461,2
262780029,0.0,0.0,475000,475000,0,0,475000,Null,Null,262780029,111461,2
262780031,0.0,0.0,839000,839000,0,0,839000,Null,Null,262780031,111461,2
262780032,0.0,0.0,199000,199000,0,0,199000,Null,Null,262780032,111461,2
262780033,0.0,0.0,1125000,1125000,0,0,1125000,Null,Null,262780033,111461,2
262780036,0.0,0.0,190000,190000,0,0,190000,Null,Null,262780036,111461,2
262780051,0.0,0.0,439000,439000,0,0,439000,Null,Null,262780051,111461,2
262780058,0.0,0.0,815000,815000,0,0,815000,Null,Null,262780058,111461,2
262780066,0.0,0.0,815000,815000,0,0,815000,Null,Null,262780066,111461,2
262780072,0.0,0.0,500000,500000,0,0,500000,Null,Null,262780072,111461,2
262780078,0.0,0.0,565000,565000,0,0,565000,Null,Null,262780078,111461,2
262780080,0.0,0.0,375000,375000,0,0,375000,Null,Null,262780080,111461,2
262780099,0.0,0.0,350000,350000,0,0,350000,Null,Null,262780099,111461,2
262780102,0.0,0.0,500000,500000,0,0,500000,Null,Null,262780102,111461,2
262780123,0.0,0.0,975000,975000,0,0,975000,Null,Null,262780123,111461,2
262780129,0.0,0.0,169000,169000,0,0,169000,Null,Null,262780129,111461,2
262780133,0.0,0.0,275000,275000,0,0,275000,Null,Null,262780133,111461,2
262780141,0.0,0.0,179000,179000,0,0,179000,Null,Null,262780141,111461,2
262780144,0.0,0.0,500000,500000,0,0,500000,Null,Null,262780144,111461,2
262780146,0.0,0.0,1100000,1100000,0,0,1100000,Null,Null,262780146,111461,2
262780152,0.0,0.0,155000,155000,0,0,155000,Null,Null,262780152,111461,2
262780157,0.0,0.0,225000,225000,0,0,225000,Null,Null,262780157,111461,2
262780159,0.0,0.0,179000,179000,0,0,179000,Null,Null,262780159,111461,2
262780161,0.0,0.0,189000,189000,0,0,189000,Null,Null,262780161,111461,2
262780162,0.0,0.0,850000,850000,0,0,850000,Null,Null,262780162,111461,2
262780173,0.0,0.0,179000,179000,0,0,179000,Null,Null,262780173,111461,2
262780174,0.0,0.0,489000,489000,0,0,489000,Null,Null,262780174,111461,2
262780181,0.0,0.0,439000,439000,0,0,439000,Null,Null,262780181,111461,2
262780333,0.0,0.0,40599000,40599000,0,0,40599000,Null,Null,262780333,111461,27196
262780496,0.0,0.0,225000,225000,0,0,225000,Null,Null,262780496,111461,2
262780524,0.0,0.0,98800,95000,3800,4,98800,Null,Null,262780524,111461,28480
262780830,0.0,0.0,278000,139000,139000,50,278000,Null,Null,262780830,111461,15318
262781214,1.0,1.0,231000,231000,0,0,231000,Null,Null,262781214,7843291,1815
262781223,1.0,1.0,80000,76000,4000,5,80000,Null,Null,262781223,111461,12864
262781841,2.0,2.0,1750,1750,0,0,1750,Null,Null,262781841,111461,53054
262781909,0.0,0.0,95000,95000,0,0,95000,Null,Null,262781909,111461,5531
262782108,0.0,0.0,13000,13000,0,0,13000,Null,Null,262782108,111461,20254
262782118,0.0,0.0,100000,100000,0,0,100000,Null,Null,262782118,8113141,5900
262782126,0.0,0.0,4850000,4850000,0,0,4850000,Null,Null,262782126,111461,28644
262782185,0.0,0.0,700000,616000,84000,12,700000,Null,Null,262782185,258483,20248
262782263,0.0,0.0,48000,48000,0,0,48000,Null,Null,262782263,111461,20254
262782356,1.0,1.0,231000,231000,0,0,231000,Null,Null,262782356,7843291,1815
262782464,0.0,0.0,2895000,2450000,445000,15,2895000,Null,Null,262782464,111461,5566
262782549,0.0,0.0,2890000,2069000,821000,28,2890000,Null,Null,262782549,111461,7079
262782730,0.0,0.0,231000,231000,0,0,231000,Null,Null,262782730,7843291,1815
262782781,0.0,0.0,230000,230000,0,0,230000,Null,Null,262782781,149256,28578
262782905,0.0,0.0,231000,231000,0,0,231000,Null,Null,262782905,7843291,1815
262783285,0.0,0.0,4390000,4280000,110000,3,4390000,Null,Null,262783285,18776,1838
262783287,0.0,0.0,162000,162000,0,0,162000,Null,Null,262783287,111461,1836
262783289,0.0,0.0,260000,260000,0,0,260000,Null,Null,262783289,149308,28484
262783314,0.0,0.0,231000,231000,0,0,231000,Null,Null,262783314,7843291,1815
262783371,28.0,28.0,20000,20000,0,0,20000,Null,Null,262783371,839837,3177
262783381,0.0,0.0,220000,220000,0,0,220000,Null,Null,262783381,111461,28578
262783397,0.0,0.0,1747000,1747000,0,0,1747000,Null,Null,262783397,111461,6653
262783515,0.0,0.0,231000,231000,0,0,231000,Null,Null,262783515,7843291,1815
262783520,0.0,0.0,15000,15000,0,0,15000,Null,Null,262783520,111461,20254
262783665,0.0,0.0,209000,209000,0,0,209000,Null,Null,262783665,111461,28696
262783841,0.0,0.0,350000,248000,102000,29,350000,Null,Null,262783841,183257,15936
262783991,0.0,0.0,899000,744000,155000,17,899000,Null,Null,262783991,19072,28454
262784059,0.0,0.0,231000,231000,0,0,231000,Null,Null,262784059,7843291,1815
262784175,0.0,0.0,231000,231000,0,0,231000,Null,Null,262784175,7843291,1815
262784205,0.0,0.0,18000,18000,0,0,18000,Null,Null,262784205,111461,20254
262784354,0.0,0.0,7590000,7590000,0,0,7590000,Null,Null,262784354,479021,1811
262784385,0.0,0.0,231000,231000,0,0,231000,Null,Null,262784385,7843291,1815
262784428,0.0,0.0,40990000,40990000,0,0,40990000,Null,Null,262784428,111461,6653
262784433,0.0,0.0,231000,231000,0,0,231000,Null,Null,262784433,7843291,1815
262784500,0.0,0.0,1859000,1859000,0,0,1859000,Null,Null,262784500,479021,1811
262784708,0.0,0.0,2849000,2849000,0,0,2849000,Null,Null,262784708,479021,1811
262784877,0.0,0.0,4290000,4290000,0,0,4290000,Null,Null,262784877,479021,1811
262784890,0.0,0.0,423000,423000,0,0,423000,Null,Null,262784890,111461,28696
262785230,0.0,0.0,231000,231000,0,0,231000,Null,Null,262785230,7843291,1815
262785279,0.0,0.0,750000,750000,0,0,750000,Null,Null,262785279,479021,1811
262785348,60.0,60.0,105000,105000,0,0,105000,Null,Null,262785348,111461,1815
262785352,0.0,0.0,580000,580000,0,0,580000,Null,Null,262785352,479021,1811
262785408,0.0,0.0,70000,70000,0,0,70000,Null,Null,262785408,111461,28592
262785640,0.0,0.0,231000,231000,0,0,231000,Null,Null,262785640,7843291,1815
262785642,0.0,0.0,4389000,4389000,0,0,4389000,Null,Null,262785642,479021,1811
262786533,0.0,0.0,18000,18000,0,0,18000,Null,Null,262786533,111461,20254
262786691,0.0,0.0,231000,231000,0,0,231000,Null,Null,262786691,7843291,1815
262787030,0.0,0.0,187000,187000,0,0,187000,Null,Null,262787030,111461,5267
262787464,3.0,3.0,231000,231000,0,0,231000,Null,Null,262787464,7843291,1815
262787485,0.0,0.0,30290000,30290000,0,0,30290000,Null,Null,262787485,111461,11518
262787528,0.0,0.0,950000,950000,0,0,950000,Null,Null,262787528,579445,15236
262787530,0.0,0.0,209000,209000,0,0,209000,Null,Null,262787530,111461,5263
262787543,0.0,0.0,4390000,4258000,132000,3,4390000,Null,Null,262787543,18776,3428
262787562,0.0,0.0,550000,550000,0,0,550000,Null,Null,262787562,579445,15236
262787602,0.0,0.0,81576000,81576000,0,0,81576000,Null,Null,262787602,111461,6653
262789478,0.0,0.0,231000,231000,0,0,231000,Null,Null,262789478,7843291,1815
262789552,0.0,0.0,11704000,11704000,0,0,11704000,Null,Null,262789552,111461,11518
262789797,0.0,0.0,31500,31500,0,0,31500,Null,Null,262789797,111461,2
262790037,0.0,0.0,59400,59400,0,0,59400,Null,Null,262790037,111461,2
262790347,0.0,0.0,4390000,4390000,0,0,4390000,Null,Null,262790347,18776,3428
262790667,0.0,0.0,299000,299000,0,0,299000,Null,Null,262790667,810913,20170
262790922,0.0,0.0,199000,199000,0,0,199000,Null,Null,262790922,810913,20170
262791148,0.0,0.0,265000,265000,0,0,265000,Null,Null,262791148,810913,20170
262792539,5.0,5.0,811000,738010,72990,9,811000,Null,Null,262792539,111461,11923
262792561,5.0,5.0,693000,589050,103950,15,693000,Null,Null,262792561,111461,11923
262792593,0.0,0.0,35000,35000,0,0,35000,Null,Null,262792593,111461,28594
262792652,0.0,0.0,999000,999000,0,0,999000,Null,Null,262792652,215231,5267
262792808,0.0,0.0,999000,999000,0,0,999000,Null,Null,262792808,215231,5267
262792906,0.0,0.0,59000,59000,0,0,59000,Null,Null,262792906,111461,12908
262793062,0.0,0.0,168000,168000,0,0,168000,Null,Null,262793062,111461,11516
262793076,0.0,0.0,138000,138000,0,0,138000,Null,Null,262793076,111461,5566
262793103,0.0,0.0,139000,139000,0,0,139000,Null,Null,262793103,111461,5566
262793134,0.0,0.0,280000,280000,0,0,280000,Null,Null,262793134,149308,28484
262793158,0.0,0.0,208000,208000,0,0,208000,Null,Null,262793158,111461,5566
262793193,0.0,0.0,209000,209000,0,0,209000,Null,Null,262793193,111461,5566
262793201,0.0,0.0,109900,109900,0,0,109900,Null,Null,262793201,111461,5566
262793250,0.0,0.0,18000,18000,0,0,18000,Null,Null,262793250,111461,20254
262793271,0.0,0.0,850000,550000,300000,35,850000,Null,Null,262793271,576515,5263
262793378,0.0,0.0,97000,97000,0,0,97000,Null,Null,262793378,111461,5566
262793460,0.0,0.0,11000,11000,0,0,11000,Null,Null,262793460,111461,20254
262793634,0.0,0.0,65500,65500,0,0,65500,Null,Null,262793634,111461,28576
262793639,0.0,0.0,152000,152000,0,0,152000,Null,Null,262793639,111461,15250
262794631,0.0,0.0,196000,196000,0,0,196000,Null,Null,262794631,111461,15318
262794674,0.0,0.0,46121000,46121000,0,0,46121000,Null,Null,262794674,111461,6653
262795245,0.0,0.0,480000,480000,0,0,480000,Null,Null,262795245,111461,6653
262795505,0.0,0.0,98000,98000,0,0,98000,Null,Null,262795505,111461,5566
262795543,0.0,0.0,5473000,5473000,0,0,5473000,Null,Null,262795543,111461,8067
262795548,0.0,0.0,175000,175000,0,0,175000,Null,Null,262795548,111461,5566
262795602,0.0,0.0,929000,929000,0,0,929000,Null,Null,262795602,111461,6653
262795666,0.0,0.0,98000,98000,0,0,98000,Null,Null,262795666,111461,5566
262795706,0.0,0.0,98000,98000,0,0,98000,Null,Null,262795706,111461,8073
262795708,0.0,0.0,59000,59000,0,0,59000,Null,Null,262795708,111461,12918
262795735,0.0,0.0,185000,185000,0,0,185000,Null,Null,262795735,111461,5566
262796058,0.0,0.0,79000,79000,0,0,79000,Null,Null,262796058,111461,12294
262796076,0.0,0.0,94000,94000,0,0,94000,Null,Null,262796076,111461,5566
262796174,0.0,0.0,94000,94000,0,0,94000,Null,Null,262796174,111461,5566
262796202,0.0,0.0,0,169000,0,0,169000,Null,Null,262796202,111461,0
262796307,0.0,0.0,85000,85000,0,0,85000,Null,Null,262796307,111461,8073
262796331,0.0,0.0,220000,220000,0,0,220000,Null,Null,262796331,8189465,26652
262796355,0.0,0.0,7022000,7022000,0,0,7022000,Null,Null,262796355,111461,8067
262796454,0.0,0.0,60500,60500,0,0,60500,Null,Null,262796454,111461,28576
262796465,0.0,0.0,84500,84500,0,0,84500,Null,Null,262796465,111461,5566
262796477,0.0,0.0,995000,995000,0,0,995000,Null,Null,262796477,8189465,26652
262796559,0.0,0.0,3165000,3165000,0,0,3165000,Null,Null,262796559,8189465,5566
262796574,0.0,0.0,160000,160000,0,0,160000,Null,Null,262796574,111461,5566
262797274,0.0,0.0,600000,600000,0,0,600000,Null,Null,262797274,579445,15236
262797277,0.0,0.0,3150000,3150000,0,0,3150000,Null,Null,262797277,6264871,5566
262797362,0.0,0.0,990000,990000,0,0,990000,Null,Null,262797362,6264871,26652
262797377,0.0,0.0,4950000,4950000,0,0,4950000,Null,Null,262797377,579445,15236
262797390,0.0,0.0,230000,230000,0,0,230000,Null,Null,262797390,6264871,26652
262797393,0.0,0.0,750000,750000,0,0,750000,Null,Null,262797393,579445,15236
262797421,0.0,0.0,60500,60500,0,0,60500,Null,Null,262797421,111461,28576
262797610,0.0,0.0,21000,21000,0,0,21000,Null,Null,262797610,111461,20254
262797618,0.0,0.0,3690000,3690000,0,0,3690000,Null,Null,262797618,21673,1813
262797680,0.0,0.0,169000,169000,0,0,169000,Null,Null,262797680,111461,12294
262797745,0.0,0.0,110000,110000,0,0,110000,Null,Null,262797745,111461,28594
262797911,0.0,0.0,159000,159000,0,0,159000,Null,Null,262797911,111461,28482
262798028,0.0,0.0,1358000,1130000,228000,17,1358000,Null,Null,262798028,111461,2324
262798063,0.0,0.0,299000,299000,0,0,299000,Null,Null,262798063,20271,1813
262798076,0.0,0.0,1389000,1150000,239000,17,1389000,Null,Null,262798076,111461,7079
262798094,0.0,0.0,65500,65500,0,0,65500,Null,Null,262798094,111461,28576
262798112,0.0,0.0,430000,430000,0,0,430000,Null,Null,262798112,52207,53350
262798834,0.0,0.0,290000,290000,0,0,290000,Null,Null,262798834,111461,28482
262798846,0.0,0.0,110000,110000,0,0,110000,Null,Null,262798846,111461,28594
262799059,0.0,0.0,139000,139000,0,0,139000,Null,Null,262799059,111461,2
262799069,0.0,0.0,225625,225625,0,0,225625,Null,Null,262799069,111461,2
262799097,0.0,0.0,108000,108000,0,0,108000,Null,Null,262799097,111461,2
262799216,0.0,0.0,219000,219000,0,0,219000,Null,Null,262799216,111461,8073
262799296,0.0,0.0,15620000,15620000,0,0,15620000,Null,Null,262799296,111461,28860
262799712,0.0,0.0,1980000,1620000,360000,18,1980000,Null,Null,262799712,7825443,11933
262799786,0.0,0.0,890000,780000,110000,12,890000,Null,Null,262799786,111461,2324
262799789,0.0,0.0,2065000,1725000,340000,16,2065000,Null,Null,262799789,7825443,11933
262799870,0.0,0.0,796000,559000,237000,30,796000,Null,Null,262799870,7825443,11933
262799980,0.0,0.0,19800000,19800000,0,0,19800000,Null,Null,262799980,111461,8067
262800051,0.0,0.0,600000,600000,0,0,600000,Null,Null,262800051,579445,15236
262800148,0.0,0.0,1119000,799000,320000,29,1119000,Null,Null,262800148,7825443,2340
262800195,0.0,0.0,20610000,20610000,0,0,20610000,Null,Null,262800195,111461,11518
262800202,0.0,0.0,600000,600000,0,0,600000,Null,Null,262800202,579445,15236
262800265,0.0,0.0,600000,600000,0,0,600000,Null,Null,262800265,579445,15236
262800314,0.0,0.0,600000,600000,0,0,600000,Null,Null,262800314,579445,15236
262800417,0.0,0.0,10234000,10234000,0,0,10234000,Null,Null,262800417,111461,8064
262800714,0.0,0.0,12848000,12848000,0,0,12848000,Null,Null,262800714,111461,11518
262800834,0.0,0.0,1290000,1290000,0,0,1290000,Null,Null,262800834,20271,3428
262800847,0.0,0.0,599000,399000,200000,33,599000,Null,Null,262800847,7825443,8043
262800968,0.0,0.0,125000,125000,0,0,125000,Null,Null,262800968,111461,5566
262801097,0.0,0.0,8298000,8298000,0,0,8298000,Null,Null,262801097,111461,11518
262801793,0.0,0.0,239000,169000,70000,29,239000,Null,Null,262801793,25422,12908
262801929,0.0,0.0,24288000,24288000,0,0,24288000,Null,Null,262801929,111461,6653
262802100,0.0,0.0,69000,69000,0,0,69000,Null,Null,262802100,111461,5566
262802110,0.0,0.0,85000,85000,0,0,85000,Null,Null,262802110,166419,28578
262802119,0.0,0.0,25000,25000,0,0,25000,Null,Null,262802119,172643,13878
262802132,0.0,0.0,349000,349000,0,0,349000,Null,Null,262802132,111461,2971
262802880,0.0,0.0,40990000,40990000,0,0,40990000,Null,Null,262802880,111461,6653
262802894,0.0,0.0,69000,69000,0,0,69000,Null,Null,262802894,111461,5566
262802992,0.0,0.0,129000,129000,0,0,129000,Null,Null,262802992,111461,5566
262803037,0.0,0.0,1990000,1890000,100000,5,1990000,Null,Null,262803037,368955,28644
262803097,0.0,0.0,80000,80000,0,0,80000,Null,Null,262803097,111461,28582
262803335,0.0,0.0,4620000,4620000,0,0,4620000,Null,Null,262803335,111461,11933
262803683,0.0,0.0,75000,75000,0,0,75000,Null,Null,262803683,111461,5566
262803707,0.0,0.0,30290000,30290000,0,0,30290000,Null,Null,262803707,111461,11518
262803773,0.0,0.0,249000,249000,0,0,249000,Null,Null,262803773,111461,2971
262803894,0.0,0.0,74500,74500,0,0,74500,Null,Null,262803894,111461,5566
262803954,0.0,0.0,140500,140500,0,0,140500,Null,Null,262803954,111461,5566
262803982,0.0,0.0,109000,109000,0,0,109000,Null,Null,262803982,162313,28484
262803998,0.0,0.0,85000,85000,0,0,85000,Null,Null,262803998,111461,5566
262804237,0.0,0.0,81576000,81576000,0,0,81576000,Null,Null,262804237,111461,6653
262806558,0.0,0.0,7290000,6290000,1000000,14,7290000,Null,Null,262806558,4246913,8066
262806561,0.0,0.0,88000,88000,0,0,88000,Null,Null,262806561,111461,2
262806563,0.0,0.0,69000,69000,0,0,69000,Null,Null,262806563,111461,2
262806565,0.0,0.0,49000,49000,0,0,49000,Null,Null,262806565,111461,2
262806574,0.0,0.0,69000,69000,0,0,69000,Null,Null,262806574,111461,2
262806575,0.0,0.0,79500,79500,0,0,79500,Null,Null,262806575,111461,2
262806581,0.0,0.0,119000,119000,0,0,119000,Null,Null,262806581,111461,2
262806616,1.0,1.0,79000,79000,0,0,79000,Null,Null,262806616,111461,2
262806709,1.0,1.0,150000,95000,55000,37,150000,Null,Null,262806709,111461,28482
262806842,0.0,0.0,11704000,11704000,0,0,11704000,Null,Null,262806842,111461,11518
262806915,0.0,0.0,259000,259000,0,0,259000,Null,Null,262806915,111461,7081
262807046,0.0,0.0,46121000,46121000,0,0,46121000,Null,Null,262807046,111461,6653
262807098,0.0,0.0,75000,75000,0,0,75000,Null,Null,262807098,111461,11516
262807109,0.0,0.0,5473000,5473000,0,0,5473000,Null,Null,262807109,111461,8067
262807135,0.0,0.0,170000,170000,0,0,170000,Null,Null,262807135,8100185,8192
262807195,0.0,0.0,7022000,7022000,0,0,7022000,Null,Null,262807195,111461,8067
262807197,0.0,0.0,3990000,2821000,1169000,29,3990000,Null,Null,262807197,247549,1795
262807464,0.0,0.0,15620000,15620000,0,0,15620000,Null,Null,262807464,111461,28860
262807493,0.0,0.0,85000,85000,0,0,85000,Null,Null,262807493,111461,15320
262808109,0.0,0.0,19800000,19800000,0,0,19800000,Null,Null,262808109,111461,8067
262808196,0.0,0.0,599000,599000,0,0,599000,Null,Null,262808196,222115,3422
262808442,1.0,1.0,1580000,890000,690000,44,1580000,Null,Null,262808442,18802,28576
262808554,0.0,0.0,335000,335000,0,0,335000,Null,Null,262808554,223153,11859
262808682,0.0,0.0,600000,600000,0,0,600000,Null,Null,262808682,223153,11859
262808929,0.0,0.0,695000,695000,0,0,695000,Null,Null,262808929,5180961,11881
262808954,0.0,0.0,54000,54000,0,0,54000,Null,Null,262808954,111461,5566
262808972,0.0,0.0,360000,360000,0,0,360000,Null,Null,262808972,5180961,11881
262808980,0.0,0.0,54000,54000,0,0,54000,Null,Null,262808980,111461,5566
262808994,0.0,0.0,98500,98500,0,0,98500,Null,Null,262808994,111461,5566
262811765,0.0,0.0,300000,300000,0,0,300000,Null,Null,262811765,810913,20170
262811830,0.0,0.0,18000,18000,0,0,18000,Null,Null,262811830,111461,20254
262812434,0.0,0.0,385000,385000,0,0,385000,Null,Null,262812434,8193089,11737
262813330,0.0,0.0,563000,563000,0,0,563000,Null,Null,262813330,111461,53074
262813363,0.0,0.0,248000,248000,0,0,248000,Null,Null,262813363,178907,2
262813452,0.0,0.0,15000,15000,0,0,15000,Null,Null,262813452,111461,20254
262813467,0.0,0.0,320000,299000,21000,7,320000,Null,Null,262813467,111461,5531
262815743,0.0,0.0,15000,15000,0,0,15000,Null,Null,262815743,111461,20254
262817099,0.0,0.0,11000,6000,5000,45,11000,Null,Null,262817099,50278,1601
262817315,0.0,0.0,15000,15000,0,0,15000,Null,Null,262817315,111461,20254
262817544,0.0,0.0,1080000,980000,100000,9,1080000,Null,Null,262817544,111461,2324
262817545,0.0,0.0,139000,139000,0,0,139000,Null,Null,262817545,111461,5566
262817570,0.0,0.0,510000,510000,0,0,510000,Null,Null,262817570,7889719,3426
262817599,0.0,0.0,139000,139000,0,0,139000,Null,Null,262817599,111461,5566
262817646,0.0,0.0,259000,259000,0,0,259000,Null,Null,262817646,111461,5566
262817994,0.0,0.0,5563250,5563250,0,0,5563250,Null,Null,262817994,5141153,2
262818022,0.0,0.0,5865000,5865000,0,0,5865000,Null,Null,262818022,5141153,2
262818028,0.0,0.0,4420000,4420000,0,0,4420000,Null,Null,262818028,5141153,2
262818115,0.0,0.0,4675000,4675000,0,0,4675000,Null,Null,262818115,5141153,2
262818350,0.0,0.0,15000,15000,0,0,15000,Null,Null,262818350,111461,20254
262818403,0.0,0.0,4950000,4950000,0,0,4950000,Null,Null,262818403,7982659,7449
262818659,0.0,0.0,19000,19000,0,0,19000,Null,Null,262818659,111461,5566
262818695,0.0,0.0,3289000,2960000,329000,10,3289000,Null,Null,262818695,18985,2977
262818726,0.0,0.0,150000,150000,0,0,150000,Null,Null,262818726,111461,5566
262818804,0.0,0.0,4950000,4950000,0,0,4950000,Null,Null,262818804,7982659,7449
262821140,0.0,0.0,4950000,4950000,0,0,4950000,Null,Null,262821140,7982659,7449
262821774,0.0,0.0,150000,150000,0,0,150000,Null,Null,262821774,111461,11516
262821878,2.0,2.0,3500000,2600000,900000,26,3500000,Null,Null,262821878,368955,28644
262822025,0.0,0.0,4689000,4220000,469000,10,4689000,Null,Null,262822025,18985,4429
262822406,0.0,0.0,4950000,4950000,0,0,4950000,Null,Null,262822406,7982659,7449
262822461,0.0,0.0,4950000,4950000,0,0,4950000,Null,Null,262822461,7982659,7449
262822737,0.0,0.0,750000,750000,0,0,750000,Null,Null,262822737,579445,15236
262823098,0.0,0.0,1299000,1119000,180000,14,1299000,Null,Null,262823098,7825443,2340
262823115,0.0,0.0,599000,399000,200000,33,599000,Null,Null,262823115,7825443,8170
262823131,0.0,0.0,599000,529000,70000,12,599000,Null,Null,262823131,7825443,8170
262823136,0.0,0.0,459000,459000,0,0,459000,Null,Null,262823136,7825443,8170
262823543,0.0,0.0,4950000,4950000,0,0,4950000,Null,Null,262823543,7982659,7449
262823873,0.0,0.0,65000,65000,0,0,65000,Null,Null,262823873,111461,2659
262823888,0.0,0.0,5450000,5450000,0,0,5450000,Null,Null,262823888,579445,15236
262823914,0.0,0.0,600000,600000,0,0,600000,Null,Null,262823914,579445,15236
262824035,0.0,0.0,65000,65000,0,0,65000,Null,Null,262824035,111461,5566
262825339,0.0,0.0,4250000,4250000,0,0,4250000,Null,Null,262825339,7982659,8512
262825611,0.0,0.0,4250000,4250000,0,0,4250000,Null,Null,262825611,7982659,7449
262825623,0.0,0.0,6389000,5750000,639000,10,6389000,Null,Null,262825623,18985,4429
262825700,0.0,0.0,4250000,4250000,0,0,4250000,Null,Null,262825700,7982659,7449
262826147,0.0,0.0,4150000,4150000,0,0,4150000,Null,Null,262826147,7982659,8512
262826337,0.0,0.0,149900,149900,0,0,149900,Null,Null,262826337,111461,5531
262826350,0.0,0.0,4150000,4150000,0,0,4150000,Null,Null,262826350,7982659,8512
262826427,0.0,0.0,4150000,4150000,0,0,4150000,Null,Null,262826427,7982659,8512
262826478,0.0,0.0,4150000,4150000,0,0,4150000,Null,Null,262826478,7982659,8512
262826504,0.0,0.0,4350000,4350000,0,0,4350000,Null,Null,262826504,7982659,8512
262826519,0.0,0.0,699000,699000,0,0,699000,Null,Null,262826519,7415035,2
262829129,0.0,0.0,270000,270000,0,0,270000,Null,Null,262829129,111461,15318
262829145,0.0,0.0,320000,320000,0,0,320000,Null,Null,262829145,111461,15318
262829949,0.0,0.0,320000,320000,0,0,320000,Null,Null,262829949,111461,15318
262829960,0.0,0.0,594000,594000,0,0,594000,Null,Null,262829960,111461,28596
262830152,0.0,0.0,65000,65000,0,0,65000,Null,Null,262830152,111461,8167
262830165,0.0,0.0,59000,59000,0,0,59000,Null,Null,262830165,111461,8167
262830222,0.0,0.0,39000,39000,0,0,39000,Null,Null,262830222,111461,8167
262830267,0.0,0.0,186000,186000,0,0,186000,Null,Null,262830267,50662,2347
262830479,0.0,0.0,3850000,3850000,0,0,3850000,Null,Null,262830479,7982659,8512
262830485,0.0,0.0,367000,367000,0,0,367000,Null,Null,262830485,111461,5267
262830493,0.0,0.0,80000,80000,0,0,80000,Null,Null,262830493,111461,28594
262830575,0.0,0.0,737000,585000,152000,21,737000,Null,Null,262830575,714691,8206
262830577,0.0,0.0,4989000,4490000,499000,10,4989000,Null,Null,262830577,18985,4429
262831024,0.0,0.0,369000,369000,0,0,369000,Null,Null,262831024,50662,17174
262831120,0.0,0.0,1690000,1690000,0,0,1690000,Null,Null,262831120,111461,1626
262831387,0.0,0.0,15000,15000,0,0,15000,Null,Null,262831387,111461,2
262831406,0.0,0.0,9800,9800,0,0,9800,Null,Null,262831406,111461,8073
262831546,0.0,0.0,448000,448000,0,0,448000,Null,Null,262831546,111461,28682
262831573,0.0,0.0,39000,39000,0,0,39000,Null,Null,262831573,111461,8167
262833236,0.0,0.0,55000,55000,0,0,55000,Null,Null,262833236,111461,8167
262833286,0.0,0.0,65000,65000,0,0,65000,Null,Null,262833286,111461,8167
262833383,1.0,1.0,3099000,2299000,800000,26,3099000,Null,Null,262833383,31670,1520
262835601,0.0,0.0,104000,104000,0,0,104000,Null,Null,262835601,50662,1583
262836688,0.0,0.0,219000,219000,0,0,219000,Null,Null,262836688,50662,2347
262836958,0.0,0.0,150000,115000,35000,23,150000,Null,Null,262836958,156043,11859
262838121,0.0,0.0,102000,78000,24000,24,102000,Null,Null,262838121,156043,11873
262838709,4.0,4.0,249000,145000,104000,42,249000,Null,Null,262838709,314675,12908
262839039,0.0,0.0,402000,402000,0,0,402000,Null,Null,262839039,50662,3422
262839113,0.0,0.0,60000,60000,0,0,60000,Null,Null,262839113,111461,1622
262839126,0.0,0.0,85000,85000,0,0,85000,Null,Null,262839126,111461,1634
262839217,0.0,0.0,405000,405000,0,0,405000,Null,Null,262839217,111461,28682
262839220,0.0,0.0,3850000,3850000,0,0,3850000,Null,Null,262839220,7982659,8512
262839304,0.0,0.0,60000,60000,0,0,60000,Null,Null,262839304,111461,1634
262839393,0.0,0.0,20000,20000,0,0,20000,Null,Null,262839393,111461,1634
262839754,0.0,0.0,340000,225000,115000,34,340000,Null,Null,262839754,8181541,2324
262839758,0.0,0.0,150000,150000,0,0,150000,Null,Null,262839758,411431,3805
262839833,18.0,18.0,339000,339000,0,0,339000,Null,Null,262839833,182863,1520
262840191,0.0,0.0,299000,299000,0,0,299000,Null,Null,262840191,411431,3805
262840292,0.0,0.0,145000,145000,0,0,145000,Null,Null,262840292,50662,17170
262841044,0.0,0.0,20000,20000,0,0,20000,Null,Null,262841044,111461,8197
262841934,0.0,0.0,1000000,1000000,0,0,1000000,Null,Null,262841934,623599,8172
262841943,0.0,0.0,60000,60000,0,0,60000,Null,Null,262841943,111461,8197
262841963,0.0,0.0,460000,333000,127000,28,460000,Null,Null,262841963,8181541,28398
262841976,0.0,0.0,1300000,1300000,0,0,1300000,Null,Null,262841976,623599,2340
262842043,0.0,0.0,490000,490000,0,0,490000,Null,Null,262842043,411431,5006
262842640,0.0,0.0,920000,920000,0,0,920000,Null,Null,262842640,623599,2340
262842663,0.0,0.0,4450000,4450000,0,0,4450000,Null,Null,262842663,7982659,8512
262842666,0.0,0.0,1010000,505000,505000,50,1010000,Null,Null,262842666,111461,15318
262842741,0.0,0.0,103000,94000,9000,9,103000,Null,Null,262842741,172643,13878
262842745,0.0,0.0,20000,20000,0,0,20000,Null,Null,262842745,111461,1622
262842857,0.0,0.0,465000,465000,0,0,465000,Null,Null,262842857,52207,8216
262842881,0.0,0.0,4450000,4450000,0,0,4450000,Null,Null,262842881,7982659,8512
262842884,0.0,0.0,103000,94000,9000,9,103000,Null,Null,262842884,172643,13878
262842990,0.0,0.0,99000,75000,24000,24,99000,Null,Null,262842990,47427,2342
262843475,0.0,0.0,140000,140000,0,0,140000,Null,Null,262843475,52207,1583
262843707,0.0,0.0,155000,155000,0,0,155000,Null,Null,262843707,111461,28644
262843711,0.0,0.0,109000,85000,24000,22,109000,Null,Null,262843711,47427,11905
262843730,0.0,0.0,120000,120000,0,0,120000,Null,Null,262843730,111461,15318
262843892,0.0,0.0,57000,57000,0,0,57000,Null,Null,262843892,111461,8224
262843918,0.0,0.0,1395000,1050000,345000,25,1395000,Null,Null,262843918,24909,1636
262843935,0.0,0.0,232000,160000,72000,31,232000,Null,Null,262843935,47427,11905
262843968,0.0,0.0,120000,120000,0,0,120000,Null,Null,262843968,111461,15318
262843984,0.0,0.0,1100000,1100000,0,0,1100000,Null,Null,262843984,52207,53350
262844050,0.0,0.0,2600000,2600000,0,0,2600000,Null,Null,262844050,111461,7081
262844062,1.0,1.0,406000,280000,126000,31,406000,Null,Null,262844062,47427,11905
262844066,0.0,0.0,280000,280000,0,0,280000,Null,Null,262844066,111461,15318
262844173,0.0,0.0,400000,300000,100000,25,400000,Null,Null,262844173,578213,8217
262844183,0.0,0.0,280000,280000,0,0,280000,Null,Null,262844183,111461,15318
262844200,0.0,0.0,1200000,1080000,120000,10,1200000,Null,Null,262844200,638039,2
262844202,0.0,0.0,390000,351000,39000,10,390000,Null,Null,262844202,638039,2
262844204,0.0,0.0,1100000,990000,110000,10,1100000,Null,Null,262844204,638039,2
262844220,0.0,0.0,250000,250000,0,0,250000,Null,Null,262844220,111461,15318
262844224,0.0,0.0,263000,263000,0,0,263000,Null,Null,262844224,111461,2657
262844255,0.0,0.0,1218000,840000,378000,31,1218000,Null,Null,262844255,47427,11905
262844316,0.0,0.0,183000,183000,0,0,183000,Null,Null,262844316,111461,5531
262844457,0.0,0.0,69800,69800,0,0,69800,Null,Null,262844457,111461,1831
262844570,1.0,1.0,85000,85000,0,0,85000,Null,Null,262844570,215259,11887
262844587,0.0,0.0,15000,15000,0,0,15000,Null,Null,262844587,111461,8205
262844776,0.0,0.0,79000,79000,0,0,79000,Null,Null,262844776,111461,2
262844811,0.0,0.0,560000,383000,177000,32,560000,Null,Null,262844811,8181541,2340
262844839,1.0,1.0,299000,235000,64000,21,299000,Null,Null,262844839,111461,1796
262844977,0.0,0.0,679000,632000,47000,7,679000,Null,Null,262844977,111461,28444
262845036,1.0,1.0,125000,125000,0,0,125000,Null,Null,262845036,111461,28684
262845111,0.0,0.0,32000,32000,0,0,32000,Null,Null,262845111,111461,1622
262845276,0.0,0.0,100000,100000,0,0,100000,Null,Null,262845276,111461,28578
262845312,0.0,0.0,858000,858000,0,0,858000,Null,Null,262845312,111461,5566
262845345,0.0,0.0,1250000,1125000,125000,10,1250000,Null,Null,262845345,638039,11845
262845401,0.0,0.0,1395000,1299000,96000,7,1395000,Null,Null,262845401,111461,28444
262845420,1.0,1.0,420000,378000,42000,10,420000,Null,Null,262845420,638039,11857
262845445,0.0,0.0,380000,268000,112000,29,380000,Null,Null,262845445,8181541,2324
262845554,1.0,1.0,1160000,1044000,116000,10,1160000,Null,Null,262845554,638039,11873
262845685,2.0,2.0,299000,239000,60000,20,299000,Null,Null,262845685,111461,1796
262845704,0.0,0.0,739000,688000,51000,7,739000,Null,Null,262845704,111461,28444
262845831,0.0,0.0,290000,275500,14500,5,290000,Null,Null,262845831,845853,11871
262845848,1.0,1.0,459000,379000,80000,17,459000,Null,Null,262845848,111461,1796
262845934,0.0,0.0,23800,23800,0,0,23800,Null,Null,262845934,111461,1831
262845958,0.0,0.0,30000,30000,0,0,30000,Null,Null,262845958,111461,7064
262846094,0.0,0.0,1960000,980000,980000,50,1960000,Null,Null,262846094,5205677,11867
262846114,0.0,0.0,2999000,2999000,0,0,2999000,Null,Null,262846114,4407561,8512
262846181,0.0,0.0,500000,500000,0,0,500000,Null,Null,262846181,579445,15236
262846183,0.0,0.0,690000,690000,0,0,690000,Null,Null,262846183,151948,1636
262846188,0.0,0.0,3800000,3800000,0,0,3800000,Null,Null,262846188,579445,15236
262846199,0.0,0.0,90000,45000,45000,50,90000,Null,Null,262846199,111461,28484
262846219,0.0,0.0,4950000,4950000,0,0,4950000,Null,Null,262846219,579445,15236
262846227,0.0,0.0,950000,950000,0,0,950000,Null,Null,262846227,579445,15236
262846262,0.0,0.0,30000,30000,0,0,30000,Null,Null,262846262,111461,28484
262846386,0.0,0.0,90000,45000,45000,50,90000,Null,Null,262846386,111461,28484
262846473,0.0,0.0,90000,45000,45000,50,90000,Null,Null,262846473,111461,28484
262846583,1.0,1.0,189000,189000,0,0,189000,Null,Null,262846583,18802,4428
262846788,0.0,0.0,284000,284000,0,0,284000,Null,Null,262846788,111461,28644
262846819,0.0,0.0,15500,15500,0,0,15500,Null,Null,262846819,111461,5566
262847300,0.0,0.0,29000,29000,0,0,29000,Null,Null,262847300,111461,5566
262848136,0.0,0.0,19000,19000,0,0,19000,Null,Null,262848136,111461,1813
262848302,0.0,0.0,575000,575000,0,0,575000,Null,Null,262848302,5179953,11861
262848372,0.0,0.0,780000,702000,78000,10,780000,Null,Null,262848372,881487,17170
262848832,0.0,0.0,320000,320000,0,0,320000,Null,Null,262848832,5179953,11861
262848922,0.0,0.0,60000,60000,0,0,60000,Null,Null,262848922,111461,8193
262850817,0.0,0.0,320000,320000,0,0,320000,Null,Null,262850817,722993,11867
262850900,0.0,0.0,575000,575000,0,0,575000,Null,Null,262850900,722993,11867
262850903,16.0,16.0,136000,136000,0,0,136000,Null,Null,262850903,726687,1520
262851214,419.0,419.0,140000,140000,0,0,140000,Null,Null,262851214,542605,1520
262851249,154.0,154.0,140000,140000,0,0,140000,Null,Null,262851249,542605,1520
262851760,0.0,0.0,265000,265000,0,0,265000,Null,Null,262851760,722995,11851
262852213,0.0,0.0,485000,485000,0,0,485000,Null,Null,262852213,111461,1634
262852287,0.0,0.0,399000,336000,63000,16,399000,Null,Null,262852287,111461,1796
262852297,0.0,0.0,285000,285000,0,0,285000,Null,Null,262852297,5173699,11871
262852398,3.0,3.0,399000,326000,73000,18,399000,Null,Null,262852398,111461,1796
262852557,0.0,0.0,235000,235000,0,0,235000,Null,Null,262852557,5168705,11875
262852624,0.0,0.0,1101000,1101000,0,0,1101000,Null,Null,262852624,8193089,11737
262852662,0.0,0.0,630000,630000,0,0,630000,Null,Null,262852662,4003377,11849
262852672,0.0,0.0,1735000,1735000,0,0,1735000,Null,Null,262852672,8193089,11737
262852741,0.0,0.0,3270000,3270000,0,0,3270000,Null,Null,262852741,8193089,11737
262853117,1.0,1.0,499000,419000,80000,16,499000,Null,Null,262853117,111461,1796
262853292,0.0,0.0,5390000,5255000,135000,3,5390000,Null,Null,262853292,18776,2977
262853303,0.0,0.0,516000,516000,0,0,516000,Null,Null,262853303,111461,11939
262853673,2.0,2.0,399000,326000,73000,18,399000,Null,Null,262853673,111461,1796
262853708,0.0,0.0,5390000,5390000,0,0,5390000,Null,Null,262853708,18776,2971
262853715,0.0,0.0,335000,324950,10050,3,335000,Null,Null,262853715,567645,11875
262853726,2.0,2.0,399000,339000,60000,15,399000,Null,Null,262853726,111461,1796
262853787,0.0,0.0,5390000,5390000,0,0,5390000,Null,Null,262853787,18776,28698
262857416,0.0,0.0,24000,24000,0,0,24000,Null,Null,262857416,111461,20254
262859484,0.0,0.0,16000,16000,0,0,16000,Null,Null,262859484,111461,20254
262859592,0.0,0.0,100000,100000,0,0,100000,Null,Null,262859592,111461,28580
262859728,0.0,0.0,448000,448000,0,0,448000,Null,Null,262859728,111461,11859
262860468,0.0,0.0,300000,200000,100000,33,300000,Null,Null,262860468,578213,8217
262860815,0.0,0.0,196000,196000,0,0,196000,Null,Null,262860815,4258811,8309
262860830,0.0,0.0,140000,140000,0,0,140000,Null,Null,262860830,111461,28594
262861274,0.0,0.0,129000,129000,0,0,129000,Null,Null,262861274,166383,1752
262862092,1.0,1.0,303300,303300,0,0,303300,Null,Null,262862092,111461,1819
262862153,0.0,0.0,16000,16000,0,0,16000,Null,Null,262862153,111461,20254
262862331,0.0,0.0,342000,342000,0,0,342000,Null,Null,262862331,111461,8167
262862538,0.0,0.0,129000,129000,0,0,129000,Null,Null,262862538,166383,1752
262862927,0.0,0.0,4710000,4710000,0,0,4710000,Null,Null,262862927,7982659,7449
262862935,1.0,1.0,90000,63000,27000,30,90000,Null,Null,262862935,111461,11935
262865471,0.0,0.0,1090000,1090000,0,0,1090000,Null,Null,262865471,53335,4428
262865584,0.0,0.0,15000,15000,0,0,15000,Null,Null,262865584,111461,7064
262865649,0.0,0.0,300000,175000,125000,42,300000,Null,Null,262865649,578213,4413
262867574,0.0,0.0,900000,900000,0,0,900000,Null,Null,262867574,579445,15236
262870028,0.0,0.0,850000,850000,0,0,850000,Null,Null,262870028,579445,15236
262870030,0.0,0.0,17000,17000,0,0,17000,Null,Null,262870030,111461,20254
262870032,3.0,3.0,126000,126000,0,0,126000,Null,Null,262870032,242895,1520
262870121,0.0,0.0,4900000,4900000,0,0,4900000,Null,Null,262870121,579445,15236
262870425,0.0,0.0,4710000,4710000,0,0,4710000,Null,Null,262870425,7982659,7449
262870432,0.0,0.0,850000,850000,0,0,850000,Null,Null,262870432,579445,15236
262870501,0.0,0.0,3250000,3250000,0,0,3250000,Null,Null,262870501,579445,15236
262870524,0.0,0.0,16000,16000,0,0,16000,Null,Null,262870524,111461,7064
262870645,0.0,0.0,5250000,5250000,0,0,5250000,Null,Null,262870645,579445,15236
262870650,0.0,0.0,1218000,1000000,218000,18,1218000,Null,Null,262870650,47427,11905
262870655,0.0,0.0,4710000,4710000,0,0,4710000,Null,Null,262870655,7982659,7449
262870744,0.0,0.0,300000,150000,150000,50,300000,Null,Null,262870744,155505,3422
262870803,1.0,1.0,54000,37800,16200,30,54000,Null,Null,262870803,111461,8167
262870883,0.0,0.0,4710000,4710000,0,0,4710000,Null,Null,262870883,7982659,7449
262870988,0.0,0.0,330000,227000,103000,31,330000,Null,Null,262870988,47427,11905
262871100,0.0,0.0,350000,250000,100000,29,350000,Null,Null,262871100,578213,1583
262871160,0.0,0.0,570000,393000,177000,31,570000,Null,Null,262871160,47427,11905
262871244,0.0,0.0,69000,69000,0,0,69000,Null,Null,262871244,8189829,20244
262871290,0.0,0.0,100000,50000,50000,50,100000,Null,Null,262871290,111461,15318
262871762,0.0,0.0,60000,47000,13000,22,60000,Null,Null,262871762,111461,8167
262871812,0.0,0.0,16000,16000,0,0,16000,Null,Null,262871812,111461,20254
262871848,0.0,0.0,210000,210000,0,0,210000,Null,Null,262871848,7419011,7078
262871886,0.0,0.0,210000,210000,0,0,210000,Null,Null,262871886,111461,28644
262873307,0.0,0.0,63999,63999,0,0,63999,Null,Null,262873307,111461,2
262873309,0.0,0.0,85000,85000,0,0,85000,Null,Null,262873309,111461,2
262873359,0.0,0.0,139000,139000,0,0,139000,Null,Null,262873359,111461,2
262873377,0.0,0.0,69000,69000,0,0,69000,Null,Null,262873377,111461,2
262873439,0.0,0.0,65000,65000,0,0,65000,Null,Null,262873439,111461,2
262873502,0.0,0.0,65000,65000,0,0,65000,Null,Null,262873502,111461,2
262873530,0.0,0.0,65000,65000,0,0,65000,Null,Null,262873530,111461,2
262873797,0.0,0.0,120000,108000,12000,10,120000,Null,Null,262873797,5220265,8216
262875618,0.0,0.0,950000,950000,0,0,950000,Null,Null,262875618,5347313,2324
262875636,1.0,1.0,170000,170000,0,0,170000,Null,Null,262875636,111461,28598
262875698,0.0,0.0,22000,22000,0,0,22000,Null,Null,262875698,111461,8201
262875884,0.0,0.0,22000,22000,0,0,22000,Null,Null,262875884,111461,8201
262876126,0.0,0.0,22000,22000,0,0,22000,Null,Null,262876126,111461,8201
262876133,0.0,0.0,460000,460000,0,0,460000,Null,Null,262876133,111461,53350
262876200,0.0,0.0,140000,140000,0,0,140000,Null,Null,262876200,111461,28594
262876203,0.0,0.0,22000,22000,0,0,22000,Null,Null,262876203,111461,8201
262876236,0.0,0.0,22000,22000,0,0,22000,Null,Null,262876236,111461,8201
262876285,0.0,0.0,95000,95000,0,0,95000,Null,Null,262876285,111461,8201
262876706,0.0,0.0,350000,350000,0,0,350000,Null,Null,262876706,579445,15236
262876735,0.0,0.0,850000,850000,0,0,850000,Null,Null,262876735,111461,2
262876753,0.0,0.0,350000,350000,0,0,350000,Null,Null,262876753,579445,15236
262876787,0.0,0.0,750000,750000,0,0,750000,Null,Null,262876787,579445,15236
262876972,2.0,2.0,4500000,3900000,600000,13,4500000,Null,Null,262876972,368955,28644
262877000,1.0,1.0,70000,70000,0,0,70000,Null,Null,262877000,199801,11885
262877169,0.0,0.0,980000,980000,0,0,980000,Null,Null,262877169,111461,53350
262877204,0.0,0.0,780000,780000,0,0,780000,Null,Null,262877204,245121,17170
262877222,0.0,0.0,450000,450000,0,0,450000,Null,Null,262877222,245121,1583
262877476,0.0,0.0,5550000,4999000,551000,10,5550000,Null,Null,262877476,4647777,15318
262877479,0.0,0.0,40000,40000,0,0,40000,Null,Null,262877479,111461,28596
262877501,0.0,0.0,63990000,63990000,0,0,63990000,Null,Null,262877501,111461,11518
262877516,0.0,0.0,560000,560000,0,0,560000,Null,Null,262877516,245121,53350
262877518,0.0,0.0,560000,560000,0,0,560000,Null,Null,262877518,245121,53350
262877520,0.0,0.0,520000,520000,0,0,520000,Null,Null,262877520,245121,17170
262877521,0.0,0.0,300000,300000,0,0,300000,Null,Null,262877521,245121,1583
262877524,0.0,0.0,460000,460000,0,0,460000,Null,Null,262877524,245121,17170
262877525,0.0,0.0,390000,390000,0,0,390000,Null,Null,262877525,245121,3424
262877528,0.0,0.0,530000,530000,0,0,530000,Null,Null,262877528,245121,3422
262877529,0.0,0.0,390000,390000,0,0,390000,Null,Null,262877529,245121,2347
262877538,0.0,0.0,480000,432000,48000,10,480000,Null,Null,262877538,245121,2
262877541,0.0,0.0,750000,750000,0,0,750000,Null,Null,262877541,245121,2347
262877545,0.0,0.0,750000,750000,0,0,750000,Null,Null,262877545,245121,17170
262877575,0.0,0.0,40000,40000,0,0,40000,Null,Null,262877575,111461,1815
262877637,0.0,0.0,360000,360000,0,0,360000,Null,Null,262877637,111461,8070
262878174,0.0,0.0,40000,40000,0,0,40000,Null,Null,262878174,111461,28598
262878210,0.0,0.0,2149000,2149000,0,0,2149000,Null,Null,262878210,53335,3428
262878239,0.0,0.0,63990000,63990000,0,0,63990000,Null,Null,262878239,111461,11518
262878380,0.0,0.0,440000,299000,141000,32,440000,Null,Null,262878380,111461,28644
262878579,4.0,4.0,199000,199000,0,0,199000,Null,Null,262878579,111461,1815
262878616,0.0,0.0,40000,40000,0,0,40000,Null,Null,262878616,111461,1815
262878840,0.0,0.0,2740000,2740000,0,0,2740000,Null,Null,262878840,19057,11518
262878851,0.0,0.0,60000,60000,0,0,60000,Null,Null,262878851,111461,1815
262878894,1.0,1.0,60000,60000,0,0,60000,Null,Null,262878894,111461,1815
262878921,0.0,0.0,49000,49000,0,0,49000,Null,Null,262878921,111461,2
262881526,0.0,0.0,49000,49000,0,0,49000,Null,Null,262881526,111461,2
262881564,0.0,0.0,40000,40000,0,0,40000,Null,Null,262881564,111461,1815
262881605,0.0,0.0,20000,20000,0,0,20000,Null,Null,262881605,7823749,11605
262881607,0.0,0.0,69000,69000,0,0,69000,Null,Null,262881607,111461,8194
262882310,0.0,0.0,58000,58000,0,0,58000,Null,Null,262882310,111461,5566
262882654,0.0,0.0,380000,266000,114000,30,380000,Null,Null,262882654,8181541,5566
262883414,0.0,0.0,209000,209000,0,0,209000,Null,Null,262883414,5272071,2
262883462,0.0,0.0,209000,209000,0,0,209000,Null,Null,262883462,5272071,2
262883503,0.0,0.0,299000,299000,0,0,299000,Null,Null,262883503,5272071,2
262883628,0.0,0.0,154000,154000,0,0,154000,Null,Null,262883628,5272071,2
262883736,0.0,0.0,68000,68000,0,0,68000,Null,Null,262883736,5272071,20236
262883888,0.0,0.0,299000,299000,0,0,299000,Null,Null,262883888,5272071,2
262884120,0.0,0.0,39000,39000,0,0,39000,Null,Null,262884120,111461,2
262884183,0.0,0.0,39000,39000,0,0,39000,Null,Null,262884183,111461,2
262884204,0.0,0.0,149000,149000,0,0,149000,Null,Null,262884204,111461,53350
262884282,0.0,0.0,99000,99000,0,0,99000,Null,Null,262884282,111461,49728
262884284,0.0,0.0,49000,49000,0,0,49000,Null,Null,262884284,111461,2
262884288,0.0,0.0,39000,39000,0,0,39000,Null,Null,262884288,111461,2
262885232,0.0,0.0,295000,295000,0,0,295000,Null,Null,262885232,111461,28644
262885327,0.0,0.0,50000,50000,0,0,50000,Null,Null,262885327,111461,8167
262885349,0.0,0.0,4710000,4710000,0,0,4710000,Null,Null,262885349,7982659,7449
262885515,0.0,0.0,4710000,4710000,0,0,4710000,Null,Null,262885515,7982659,7449
262885521,0.0,0.0,39000,39000,0,0,39000,Null,Null,262885521,111461,2
262885558,0.0,0.0,1350000,999000,351000,26,1350000,Null,Null,262885558,258483,20248
262885563,0.0,0.0,39000,39000,0,0,39000,Null,Null,262885563,111461,2
262885765,0.0,0.0,3520000,3520000,0,0,3520000,Null,Null,262885765,19057,11518
262885811,0.0,0.0,49000,49000,0,0,49000,Null,Null,262885811,111461,2
262885813,0.0,0.0,49000,49000,0,0,49000,Null,Null,262885813,111461,2
262885881,0.0,0.0,27000,27000,0,0,27000,Null,Null,262885881,7823749,11605
262886992,0.0,0.0,660000,660000,0,0,660000,Null,Null,262886992,111457,1803
262887090,12.0,12.0,34000,34000,0,0,34000,Null,Null,262887090,7823749,11605
262887220,0.0,0.0,309000,309000,0,0,309000,Null,Null,262887220,7304323,1607
262887516,0.0,0.0,162000,162000,0,0,162000,Null,Null,262887516,21867,8300
262887587,0.0,0.0,24000,24000,0,0,24000,Null,Null,262887587,21867,8300
262887602,0.0,0.0,309000,309000,0,0,309000,Null,Null,262887602,7304323,1607
262887626,0.0,0.0,940000,479000,461000,49,940000,Null,Null,262887626,4647777,15318
262887916,0.0,0.0,149000,149000,0,0,149000,Null,Null,262887916,111461,2
262888473,0.0,0.0,1500000,1350000,150000,10,1500000,Null,Null,262888473,245121,53350
262888541,0.0,0.0,149000,149000,0,0,149000,Null,Null,262888541,111461,2
262888543,0.0,0.0,149000,149000,0,0,149000,Null,Null,262888543,111461,11941
262888545,0.0,0.0,645000,645000,0,0,645000,Null,Null,262888545,111461,6653
262888557,0.0,0.0,3750000,2999000,751000,20,3750000,Null,Null,262888557,4647777,15318
262889676,0.0,0.0,309000,309000,0,0,309000,Null,Null,262889676,242895,1607
262889725,0.0,0.0,1600000,1440000,160000,10,1600000,Null,Null,262889725,245121,17170
262889827,0.0,0.0,26500,26500,0,0,26500,Null,Null,262889827,7823749,4408
262890081,6.0,6.0,499000,499000,0,0,499000,Null,Null,262890081,111461,1815
262890140,0.0,0.0,1242000,1242000,0,0,1242000,Null,Null,262890140,111461,20190
262890236,0.0,0.0,309000,309000,0,0,309000,Null,Null,262890236,242895,1641
262890243,0.0,0.0,220000,130000,90000,41,220000,Null,Null,262890243,8181541,2334
262890276,0.0,0.0,1320000,1188000,132000,10,1320000,Null,Null,262890276,245121,3424
262890297,0.0,0.0,4860000,4860000,0,0,4860000,Null,Null,262890297,7982659,8512
262890370,0.0,0.0,149000,149000,0,0,149000,Null,Null,262890370,111461,11943
262890374,0.0,0.0,149000,149000,0,0,149000,Null,Null,262890374,111461,11941
262890376,0.0,0.0,820000,738000,82000,10,820000,Null,Null,262890376,245121,11737
262890378,0.0,0.0,149000,149000,0,0,149000,Null,Null,262890378,111461,11941
262890398,0.0,0.0,149000,149000,0,0,149000,Null,Null,262890398,111461,2
262890400,0.0,0.0,149000,149000,0,0,149000,Null,Null,262890400,111461,11943
262890402,0.0,0.0,149000,149000,0,0,149000,Null,Null,262890402,111461,2
262890405,0.0,0.0,149000,149000,0,0,149000,Null,Null,262890405,111461,11941
262890418,0.0,0.0,297000,237600,59400,20,297000,Null,Null,262890418,185157,17186
262890420,0.0,0.0,64000,51200,12800,20,64000,Null,Null,262890420,185157,17186
262890422,0.0,0.0,65500,52400,13100,20,65500,Null,Null,262890422,331811,17186
262890424,0.0,0.0,80000,64000,16000,20,80000,Null,Null,262890424,331811,17186
262890426,0.0,0.0,297000,237600,59400,20,297000,Null,Null,262890426,8194961,17186
262890428,0.0,0.0,48600,38880,9720,20,48600,Null,Null,262890428,8195091,17186
262890432,0.0,0.0,80000,64000,16000,20,80000,Null,Null,262890432,8195091,17186
262890433,0.0,0.0,66000,52800,13200,20,66000,Null,Null,262890433,185157,17186
262890442,0.0,0.0,80000,64000,16000,20,80000,Null,Null,262890442,8195095,17186
262890443,0.0,0.0,65500,52400,13100,20,65500,Null,Null,262890443,8195095,17186
262890448,0.0,0.0,99000,79200,19800,20,99000,Null,Null,262890448,185157,17186
262890452,0.0,0.0,151500,121200,30300,20,151500,Null,Null,262890452,331811,17186
262890454,0.0,0.0,66000,52800,13200,20,66000,Null,Null,262890454,8194961,17186
262890456,0.0,0.0,64500,51600,12900,20,64500,Null,Null,262890456,8194961,17186
262890460,0.0,0.0,34200,27360,6840,20,34200,Null,Null,262890460,331811,17186
262890462,0.0,0.0,182000,145600,36400,20,182000,Null,Null,262890462,8195091,17186
262890464,0.0,0.0,91000,72800,18200,20,91000,Null,Null,262890464,331811,17186
262890466,0.0,0.0,99000,79200,19800,20,99000,Null,Null,262890466,8194961,17186
262890470,0.0,0.0,48600,38880,9720,20,48600,Null,Null,262890470,8195095,17186
262890472,0.0,0.0,58500,46800,11700,20,58500,Null,Null,262890472,8194961,17186
262890476,0.0,0.0,80000,64000,16000,20,80000,Null,Null,262890476,331811,17186
262890482,0.0,0.0,151500,121200,30300,20,151500,Null,Null,262890482,8195095,17186
262890490,0.0,0.0,181500,145200,36300,20,181500,Null,Null,262890490,185157,17186
262890494,0.0,0.0,42500,34000,8500,20,42500,Null,Null,262890494,331811,17186
262890498,0.0,0.0,255000,204000,51000,20,255000,Null,Null,262890498,8194961,17186
262890504,0.0,0.0,4860000,4860000,0,0,4860000,Null,Null,262890504,7982659,8512
262890758,0.0,0.0,149000,149000,0,0,149000,Null,Null,262890758,111461,11941
262890933,0.0,0.0,149000,149000,0,0,149000,Null,Null,262890933,111461,11941
262890977,0.0,0.0,380000,289000,91000,24,380000,Null,Null,262890977,183257,15936
262890979,0.0,0.0,149000,149000,0,0,149000,Null,Null,262890979,111461,11941
262890982,0.0,0.0,149000,149000,0,0,149000,Null,Null,262890982,111461,11941
262891152,0.0,0.0,149000,149000,0,0,149000,Null,Null,262891152,111461,11941
262891156,0.0,0.0,149000,149000,0,0,149000,Null,Null,262891156,111461,2
262891163,0.0,0.0,4860000,4860000,0,0,4860000,Null,Null,262891163,7982659,8512
262891182,0.0,0.0,720000,648000,72000,10,720000,Null,Null,262891182,245121,1604
262891188,0.0,0.0,309000,309000,0,0,309000,Null,Null,262891188,7304323,1641
262891217,0.0,0.0,309000,309000,0,0,309000,Null,Null,262891217,7304323,1641
262891335,0.0,0.0,218000,218000,0,0,218000,Null,Null,262891335,242895,1641
262891338,0.0,0.0,29000,29000,0,0,29000,Null,Null,262891338,7823749,1628
262891341,0.0,0.0,880000,647000,233000,26,880000,Null,Null,262891341,8181541,8044
262891350,0.0,0.0,129000,129000,0,0,129000,Null,Null,262891350,111461,4429
262891410,0.0,0.0,309000,309000,0,0,309000,Null,Null,262891410,7304323,1641
262891416,0.0,0.0,149000,149000,0,0,149000,Null,Null,262891416,111461,11941
262891425,0.0,0.0,159000,159000,0,0,159000,Null,Null,262891425,111461,11941
262891429,0.0,0.0,179000,179000,0,0,179000,Null,Null,262891429,111461,11941
262891430,0.0,0.0,169000,169000,0,0,169000,Null,Null,262891430,111461,11941
262891435,0.0,0.0,149000,149000,0,0,149000,Null,Null,262891435,111461,11941
262891481,0.0,0.0,149000,149000,0,0,149000,Null,Null,262891481,111461,11943
262891483,0.0,0.0,149000,149000,0,0,149000,Null,Null,262891483,111461,2334
262891484,0.0,0.0,309000,309000,0,0,309000,Null,Null,262891484,111461,2340
262891487,0.0,0.0,149000,149000,0,0,149000,Null,Null,262891487,111461,11941
262891514,0.0,0.0,149000,149000,0,0,149000,Null,Null,262891514,111461,11941
262891516,0.0,0.0,149000,149000,0,0,149000,Null,Null,262891516,111461,11941
262891518,0.0,0.0,149000,149000,0,0,149000,Null,Null,262891518,111461,11941
262891541,0.0,0.0,715000,643500,71500,10,715000,Null,Null,262891541,245121,1596
262891557,0.0,0.0,217000,217000,0,0,217000,Null,Null,262891557,242895,11605
262891575,0.0,0.0,309000,309000,0,0,309000,Null,Null,262891575,242895,1641
262891623,0.0,0.0,490000,441000,49000,10,490000,Null,Null,262891623,245121,1641
262891798,0.0,0.0,390000,351000,39000,10,390000,Null,Null,262891798,245121,1607
262891927,0.0,0.0,770000,693000,77000,10,770000,Null,Null,262891927,245121,1597
262892004,0.0,0.0,590000,531000,59000,10,590000,Null,Null,262892004,245121,3422
262892016,0.0,0.0,309000,309000,0,0,309000,Null,Null,262892016,242895,1641
262892062,0.0,0.0,120000,120000,0,0,120000,Null,Null,262892062,111461,15318
262892068,0.0,0.0,4500000,4500000,0,0,4500000,Null,Null,262892068,212883,8512
262892112,0.0,0.0,599000,599000,0,0,599000,Null,Null,262892112,197655,2659
262892149,0.0,0.0,690000,621000,69000,10,690000,Null,Null,262892149,245121,11741
262892151,0.0,0.0,120000,120000,0,0,120000,Null,Null,262892151,111461,15318
262892254,0.0,0.0,2205000,1979000,226000,10,2205000,Null,Null,262892254,47424,2342
262892453,0.0,0.0,1200000,1080000,120000,10,1200000,Null,Null,262892453,245121,17170
262892488,2.0,2.0,32000,32000,0,0,32000,Null,Null,262892488,7823749,11605
262892604,5.0,5.0,99000,99000,0,0,99000,Null,Null,262892604,215259,11887
262894898,0.0,0.0,120000,120000,0,0,120000,Null,Null,262894898,111461,15318
262895803,0.0,0.0,500000,478000,22000,4,500000,Null,Null,262895803,111461,4413
262895815,0.0,0.0,80000,80000,0,0,80000,Null,Null,262895815,111461,5263
262895827,0.0,0.0,120000,120000,0,0,120000,Null,Null,262895827,111461,15318
262895895,1.0,1.0,149000,149000,0,0,149000,Null,Null,262895895,111461,1583
262895994,0.0,0.0,330000,169000,161000,49,330000,Null,Null,262895994,4647777,15318
262896025,0.0,0.0,1790000,1550000,240000,13,1790000,Null,Null,262896025,153088,2657
262896202,0.0,0.0,10000,10000,0,0,10000,Null,Null,262896202,111461,2
262897347,0.0,0.0,330000,169000,161000,49,330000,Null,Null,262897347,4647777,15318
262897737,0.0,0.0,5100000,4335000,765000,15,5100000,Null,Null,262897737,112278,5385
262897805,0.0,0.0,126000,63000,63000,50,126000,Null,Null,262897805,8193651,2342
262899667,1880.0,1880.0,1386000,1386000,0,0,1386000,Null,Null,262899667,145335,1520
262899671,0.0,0.0,112000,112000,0,0,112000,Null,Null,262899671,8193651,17186
262901633,8.0,8.0,149000,149000,0,0,149000,Null,Null,262901633,215259,11887
262901635,0.0,0.0,99000,99000,0,0,99000,Null,Null,262901635,215259,11887
262901690,0.0,0.0,23500,23500,0,0,23500,Null,Null,262901690,111461,8167
262903003,0.0,0.0,139000,139000,0,0,139000,Null,Null,262903003,111461,20244
262904564,0.0,0.0,190000,98000,92000,48,190000,Null,Null,262904564,8138899,28452
262904569,0.0,0.0,190000,98000,92000,48,190000,Null,Null,262904569,8138899,28452
262904602,1.0,1.0,230000,129000,101000,44,230000,Null,Null,262904602,8138899,28452
262904604,2.0,2.0,230000,129000,101000,44,230000,Null,Null,262904604,8138899,28452
262904695,0.0,0.0,3300000,2805000,495000,15,3300000,Null,Null,262904695,8130109,8512
262904697,0.0,0.0,3700000,3145000,555000,15,3700000,Null,Null,262904697,8130109,8512
262904721,0.0,0.0,198000,193000,5000,3,198000,Null,Null,262904721,111461,1819
262904731,0.0,0.0,990000,891000,99000,10,990000,Null,Null,262904731,245121,53350
262904733,0.0,0.0,17000,17000,0,0,17000,Null,Null,262904733,111461,20254
262904735,0.0,0.0,135000,135000,0,0,135000,Null,Null,262904735,111461,2334
262904750,0.0,0.0,720000,648000,72000,10,720000,Null,Null,262904750,245121,11759
262904781,43.0,43.0,1734000,767000,967000,56,1734000,Null,Null,262904781,185697,1520
262904801,0.0,0.0,16000,16000,0,0,16000,Null,Null,262904801,111461,20254
262904852,335.0,335.0,1734000,767000,967000,56,1734000,Null,Null,262904852,185697,1520
262904859,1.0,1.0,1700000,1090000,610000,36,1700000,Null,Null,262904859,153086,28454
262904866,0.0,0.0,309000,309000,0,0,309000,Null,Null,262904866,242895,1607
262904888,0.0,0.0,249000,249000,0,0,249000,Null,Null,262904888,111461,2977
262904890,0.0,0.0,550000,369000,181000,33,550000,Null,Null,262904890,153086,12918
262904926,122.0,122.0,1734000,1734000,0,0,1734000,Null,Null,262904926,185697,1520
262905131,0.0,0.0,420000,420000,0,0,420000,Null,Null,262905131,327645,17170
262905343,0.0,0.0,990000,750000,240000,24,990000,Null,Null,262905343,674463,8400
262905407,0.0,0.0,189000,189000,0,0,189000,Null,Null,262905407,111461,1815
262905490,0.0,0.0,12000,12000,0,0,12000,Null,Null,262905490,111461,20254
262905653,0.0,0.0,128800,128800,0,0,128800,Null,Null,262905653,111461,20182
262905728,0.0,0.0,89000,89000,0,0,89000,Null,Null,262905728,7823749,3426
262905784,0.0,0.0,788000,788000,0,0,788000,Null,Null,262905784,111461,6653
262905948,0.0,0.0,4500000,4500000,0,0,4500000,Null,Null,262905948,7982659,8512
262905951,0.0,0.0,1566000,1566000,0,0,1566000,Null,Null,262905951,111461,6653
262906075,0.0,0.0,510000,510000,0,0,510000,Null,Null,262906075,327645,2347
262906158,0.0,0.0,650000,650000,0,0,650000,Null,Null,262906158,327645,17174
262906218,0.0,0.0,89000,89000,0,0,89000,Null,Null,262906218,7823749,1520
262906803,0.0,0.0,450000,450000,0,0,450000,Null,Null,262906803,327645,3426
262906825,0.0,0.0,360000,360000,0,0,360000,Null,Null,262906825,327645,5872
262906858,0.0,0.0,4500000,4500000,0,0,4500000,Null,Null,262906858,212883,8512
262906860,0.0,0.0,4990000,2790000,2200000,44,4990000,Null,Null,262906860,111461,2324
262906877,0.0,0.0,650000,650000,0,0,650000,Null,Null,262906877,327645,2347
262906879,0.0,0.0,122500,122500,0,0,122500,Null,Null,262906879,111461,28736
262906892,0.0,0.0,39000,39000,0,0,39000,Null,Null,262906892,111461,8167
262906922,2.0,2.0,295000,295000,0,0,295000,Null,Null,262906922,145687,11861
262906999,0.0,0.0,149000,149000,0,0,149000,Null,Null,262906999,111461,28464
262907013,0.0,0.0,19000,19000,0,0,19000,Null,Null,262907013,7823749,11605
262907027,0.0,0.0,4500000,4500000,0,0,4500000,Null,Null,262907027,7982659,8512
262907090,0.0,0.0,790000,790000,0,0,790000,Null,Null,262907090,327645,53350
262907092,0.0,0.0,540000,540000,0,0,540000,Null,Null,262907092,111461,11935
262907132,0.0,0.0,4500000,4500000,0,0,4500000,Null,Null,262907132,7982659,8512
262907142,0.0,0.0,98000,98000,0,0,98000,Null,Null,262907142,145687,11861
262907144,0.0,0.0,3590000,3051500,538500,15,3590000,Null,Null,262907144,208841,2340
262907179,0.0,0.0,850000,850000,0,0,850000,Null,Null,262907179,327645,17170
262907222,0.0,0.0,4500000,4500000,0,0,4500000,Null,Null,262907222,7982659,8512
262907227,0.0,0.0,660000,660000,0,0,660000,Null,Null,262907227,327645,2347
262907266,0.0,0.0,750000,750000,0,0,750000,Null,Null,262907266,327645,5893
262907302,0.0,0.0,4990000,4189000,801000,16,4990000,Null,Null,262907302,247549,1795
262907318,0.0,0.0,545000,545000,0,0,545000,Null,Null,262907318,111461,11935
262907346,0.0,0.0,750000,750000,0,0,750000,Null,Null,262907346,327645,5893
262907376,0.0,0.0,650000,650000,0,0,650000,Null,Null,262907376,327645,2347
262907409,0.0,0.0,790000,790000,0,0,790000,Null,Null,262907409,327645,53350
262907443,112.0,112.0,668000,283000,385000,58,668000,Null,Null,262907443,200189,1520
262907451,0.0,0.0,295000,295000,0,0,295000,Null,Null,262907451,111461,6653
262907456,0.0,0.0,850000,850000,0,0,850000,Null,Null,262907456,327645,5893
262907487,0.0,0.0,350000,350000,0,0,350000,Null,Null,262907487,4251927,1609
262907503,0.0,0.0,770000,770000,0,0,770000,Null,Null,262907503,327645,3424
262907602,0.0,0.0,495000,495000,0,0,495000,Null,Null,262907602,327645,3422
262907618,0.0,0.0,12000,12000,0,0,12000,Null,Null,262907618,111461,20254
262907645,0.0,0.0,550000,550000,0,0,550000,Null,Null,262907645,327645,11759
262907664,0.0,0.0,395800,395800,0,0,395800,Null,Null,262907664,111461,5267
262907668,0.0,0.0,350000,350000,0,0,350000,Null,Null,262907668,4251927,1609
262907684,0.0,0.0,149000,149000,0,0,149000,Null,Null,262907684,111461,2334
262907759,0.0,0.0,4500000,4500000,0,0,4500000,Null,Null,262907759,7982659,8512
262907768,0.0,0.0,600000,600000,0,0,600000,Null,Null,262907768,579445,15236
262907835,0.0,0.0,159000,159000,0,0,159000,Null,Null,262907835,111461,11941
262907849,0.0,0.0,159000,159000,0,0,159000,Null,Null,262907849,111461,11941
262907851,0.0,0.0,159000,159000,0,0,159000,Null,Null,262907851,111461,11941
262907866,0.0,0.0,850000,850000,0,0,850000,Null,Null,262907866,579445,15236
262907884,0.0,0.0,159000,159000,0,0,159000,Null,Null,262907884,111461,11941
262907900,0.0,0.0,780000,780000,0,0,780000,Null,Null,262907900,579445,15236
262907904,0.0,0.0,400000,382000,18000,5,400000,Null,Null,262907904,111461,1601
262907926,0.0,0.0,350000,350000,0,0,350000,Null,Null,262907926,4251927,8192
262907959,0.0,0.0,800000,800000,0,0,800000,Null,Null,262907959,579445,15236
262908020,0.0,0.0,500000,500000,0,0,500000,Null,Null,262908020,579445,15236
262908043,0.0,0.0,350000,350000,0,0,350000,Null,Null,262908043,4251927,8192
262908055,0.0,0.0,1110000,1015000,95000,9,1110000,Null,Null,262908055,111461,5893
262908063,0.0,0.0,159000,159000,0,0,159000,Null,Null,262908063,111461,2
262908070,0.0,0.0,179000,179000,0,0,179000,Null,Null,262908070,111461,11941
262908072,0.0,0.0,159000,159000,0,0,159000,Null,Null,262908072,111461,11941
262908074,0.0,0.0,159000,159000,0,0,159000,Null,Null,262908074,111461,2
262908142,0.0,0.0,65000,65000,0,0,65000,Null,Null,262908142,111461,8196
262908158,0.0,0.0,360000,324000,36000,10,360000,Null,Null,262908158,881487,5893
262908199,0.0,0.0,159000,159000,0,0,159000,Null,Null,262908199,111461,11941
262908201,0.0,0.0,159000,159000,0,0,159000,Null,Null,262908201,111461,11941
262908212,0.0,0.0,159000,159000,0,0,159000,Null,Null,262908212,111461,11941
262908216,0.0,0.0,159000,159000,0,0,159000,Null,Null,262908216,111461,11941
262908234,0.0,0.0,169000,169000,0,0,169000,Null,Null,262908234,111461,11941
262908240,0.0,0.0,159000,159000,0,0,159000,Null,Null,262908240,111461,11941
262908254,0.0,0.0,159000,159000,0,0,159000,Null,Null,262908254,111461,11941
262908287,0.0,0.0,249500,242000,7500,3,249500,Null,Null,262908287,111461,1813
262908296,0.0,0.0,12000,12000,0,0,12000,Null,Null,262908296,111461,20254
262908310,0.0,0.0,36500,36500,0,0,36500,Null,Null,262908310,111461,28480
262908333,0.0,0.0,876000,876000,0,0,876000,Null,Null,262908333,111461,1636
262908347,0.0,0.0,159000,159000,0,0,159000,Null,Null,262908347,111461,11941
262908349,0.0,0.0,159000,159000,0,0,159000,Null,Null,262908349,111461,11941
262908358,0.0,0.0,306000,306000,0,0,306000,Null,Null,262908358,111461,11869
262908391,0.0,0.0,309000,309000,0,0,309000,Null,Null,262908391,242895,1641
262908422,0.0,0.0,388000,388000,0,0,388000,Null,Null,262908422,21653,28480
262908475,0.0,0.0,390000,390000,0,0,390000,Null,Null,262908475,111461,11869
262908543,0.0,0.0,350000,350000,0,0,350000,Null,Null,262908543,4251927,8192
262908544,0.0,0.0,188000,188000,0,0,188000,Null,Null,262908544,111461,8205
262908563,0.0,0.0,1200000,1146000,54000,5,1200000,Null,Null,262908563,111461,3424
262908567,0.0,0.0,309000,309000,0,0,309000,Null,Null,262908567,242895,1641
262908635,0.0,0.0,350000,350000,0,0,350000,Null,Null,262908635,4251927,8192
262908717,0.0,0.0,30000,30000,0,0,30000,Null,Null,262908717,111461,9013
262908726,0.0,0.0,550000,525000,25000,5,550000,Null,Null,262908726,111461,11889
262908750,0.0,0.0,399000,387000,12000,3,399000,Null,Null,262908750,111461,5531
262908772,0.0,0.0,490000,468000,22000,4,490000,Null,Null,262908772,111461,17170
262908777,0.0,0.0,876000,876000,0,0,876000,Null,Null,262908777,8183739,1636
262908785,0.0,0.0,312000,312000,0,0,312000,Null,Null,262908785,111461,11873
262908917,1.0,1.0,15000,15000,0,0,15000,Null,Null,262908917,7823749,1601
262909405,0.0,0.0,219000,219000,0,0,219000,Null,Null,262909405,111461,7078
262909545,0.0,0.0,15000,15000,0,0,15000,Null,Null,262909545,111461,1634
262909551,0.0,0.0,690000,621000,69000,10,690000,Null,Null,262909551,881487,8227
262909917,0.0,0.0,1000000,990000,10000,1,1000000,Null,Null,262909917,153088,28444
262910001,0.0,0.0,25000,25000,0,0,25000,Null,Null,262910001,7823749,2348
262910033,0.0,0.0,275000,275000,0,0,275000,Null,Null,262910033,111461,5531
262911721,0.0,0.0,84000,84000,0,0,84000,Null,Null,262911721,111461,2
262913080,0.0,0.0,79000,79000,0,0,79000,Null,Null,262913080,111461,28574
262914970,0.0,0.0,89000,89000,0,0,89000,Null,Null,262914970,111461,11943
262914971,0.0,0.0,89000,89000,0,0,89000,Null,Null,262914971,111461,11941
262914973,0.0,0.0,89000,89000,0,0,89000,Null,Null,262914973,111461,8167
262914975,0.0,0.0,89000,89000,0,0,89000,Null,Null,262914975,111461,11941
262914978,0.0,0.0,89000,89000,0,0,89000,Null,Null,262914978,111461,7064
262914980,0.0,0.0,89000,89000,0,0,89000,Null,Null,262914980,111461,8167
262914981,0.0,0.0,89000,89000,0,0,89000,Null,Null,262914981,111461,7064
262915019,0.0,0.0,89000,89000,0,0,89000,Null,Null,262915019,111461,11943
262915021,0.0,0.0,89000,89000,0,0,89000,Null,Null,262915021,111461,11941
262915027,0.0,0.0,89000,89000,0,0,89000,Null,Null,262915027,111461,11941
262915029,0.0,0.0,89000,89000,0,0,89000,Null,Null,262915029,111461,11941
262915042,0.0,0.0,89000,89000,0,0,89000,Null,Null,262915042,111461,11941
262915051,0.0,0.0,89000,89000,0,0,89000,Null,Null,262915051,111461,11943
262915056,0.0,0.0,99000,99000,0,0,99000,Null,Null,262915056,111461,2
262915057,0.0,0.0,89000,89000,0,0,89000,Null,Null,262915057,111461,11941
262915068,0.0,0.0,99000,99000,0,0,99000,Null,Null,262915068,111461,2
262915075,0.0,0.0,840000,840000,0,0,840000,Null,Null,262915075,881487,5893
262915088,0.0,0.0,89000,89000,0,0,89000,Null,Null,262915088,111461,11941
262915090,0.0,0.0,89000,89000,0,0,89000,Null,Null,262915090,111461,11941
262915092,0.0,0.0,5000000,4499000,501000,10,5000000,Null,Null,262915092,4647777,15318
262915097,0.0,0.0,199000,199000,0,0,199000,Null,Null,262915097,111461,2
262915098,0.0,0.0,89000,89000,0,0,89000,Null,Null,262915098,111461,11941
262915120,0.0,0.0,89000,89000,0,0,89000,Null,Null,262915120,111461,11941
262915121,0.0,0.0,89000,89000,0,0,89000,Null,Null,262915121,111461,11941
262915124,0.0,0.0,89000,89000,0,0,89000,Null,Null,262915124,111461,11943
262915126,0.0,0.0,780000,399000,381000,49,780000,Null,Null,262915126,4647777,15318
262915128,0.0,0.0,89000,89000,0,0,89000,Null,Null,262915128,111461,11943
262915130,0.0,0.0,89000,89000,0,0,89000,Null,Null,262915130,111461,11941
262915132,0.0,0.0,89000,89000,0,0,89000,Null,Null,262915132,111461,11943
262915134,0.0,0.0,89000,89000,0,0,89000,Null,Null,262915134,111461,11941
262915139,0.0,0.0,89000,89000,0,0,89000,Null,Null,262915139,111461,11941
262915142,0.0,0.0,89000,89000,0,0,89000,Null,Null,262915142,111461,11943
262915148,0.0,0.0,89000,89000,0,0,89000,Null,Null,262915148,111461,7064
262915158,0.0,0.0,89000,89000,0,0,89000,Null,Null,262915158,111461,11943
262915170,0.0,0.0,89000,89000,0,0,89000,Null,Null,262915170,111461,11943
262915177,0.0,0.0,89000,89000,0,0,89000,Null,Null,262915177,111461,11943
262915179,0.0,0.0,89000,89000,0,0,89000,Null,Null,262915179,111461,11943
262915181,0.0,0.0,89000,89000,0,0,89000,Null,Null,262915181,111461,11941
262915185,0.0,0.0,92000,92000,0,0,92000,Null,Null,262915185,7823749,11605
262915190,0.0,0.0,79000,79000,0,0,79000,Null,Null,262915190,111461,28576
262915203,0.0,0.0,2860000,2574000,286000,10,2860000,Null,Null,262915203,881487,8227
262915228,0.0,0.0,79000,79000,0,0,79000,Null,Null,262915228,111461,28574
262915233,0.0,0.0,89000,89000,0,0,89000,Null,Null,262915233,111461,11943
262915242,0.0,0.0,89000,89000,0,0,89000,Null,Null,262915242,111461,11941
262915254,0.0,0.0,89000,89000,0,0,89000,Null,Null,262915254,111461,11941
262915270,0.0,0.0,89000,89000,0,0,89000,Null,Null,262915270,111461,11941
262915272,0.0,0.0,99000,99000,0,0,99000,Null,Null,262915272,111461,11941
262915324,0.0,0.0,89000,89000,0,0,89000,Null,Null,262915324,111461,7064
262915326,0.0,0.0,199000,199000,0,0,199000,Null,Null,262915326,111461,2
262915343,0.0,0.0,89000,89000,0,0,89000,Null,Null,262915343,111461,11941
262915345,0.0,0.0,89000,89000,0,0,89000,Null,Null,262915345,111461,11941
262915347,0.0,0.0,680000,455000,225000,33,680000,Null,Null,262915347,8181541,2340
262915354,0.0,0.0,2500,2500,0,0,2500,Null,Null,262915354,7823749,53048
262915361,0.0,0.0,89000,89000,0,0,89000,Null,Null,262915361,111461,7064
262915363,0.0,0.0,89000,89000,0,0,89000,Null,Null,262915363,111461,11941
262915364,0.0,0.0,89000,89000,0,0,89000,Null,Null,262915364,111461,11941
262915376,0.0,0.0,89000,89000,0,0,89000,Null,Null,262915376,111461,11941
262915379,0.0,0.0,89000,89000,0,0,89000,Null,Null,262915379,111461,11943
262915407,0.0,0.0,950000,950000,0,0,950000,Null,Null,262915407,258483,20252
262915413,0.0,0.0,89000,89000,0,0,89000,Null,Null,262915413,111461,11941
262915467,0.0,0.0,49500,44550,4950,10,49500,Null,Null,262915467,881487,1601
262915469,0.0,0.0,60000,60000,0,0,60000,Null,Null,262915469,111461,8193
262915594,0.0,0.0,89000,89000,0,0,89000,Null,Null,262915594,111461,11943
262915595,0.0,0.0,89000,89000,0,0,89000,Null,Null,262915595,111461,11941
262915604,0.0,0.0,89000,89000,0,0,89000,Null,Null,262915604,111461,11941
262915630,0.0,0.0,49500,44550,4950,10,49500,Null,Null,262915630,881487,1601
262915712,0.0,0.0,2500000,1999000,501000,20,2500000,Null,Null,262915712,4647777,15318
262915714,0.0,0.0,49500,44550,4950,10,49500,Null,Null,262915714,881487,1601
262915725,0.0,0.0,830000,579000,251000,30,830000,Null,Null,262915725,4647777,15318
262915731,0.0,0.0,6999000,4999000,2000000,29,6999000,Null,Null,262915731,111461,28454
262915784,0.0,0.0,5000,5000,0,0,5000,Null,Null,262915784,111461,8194
262915792,0.0,0.0,480000,315000,165000,34,480000,Null,Null,262915792,8181541,8167
262915817,0.0,0.0,259000,139000,120000,46,259000,Null,Null,262915817,486875,1752
262915941,0.0,0.0,3130000,2500000,630000,20,3130000,Null,Null,262915941,4647777,15318
262916013,0.0,0.0,15000,15000,0,0,15000,Null,Null,262916013,111461,8193
262916026,0.0,0.0,6500000,6500000,0,0,6500000,Null,Null,262916026,20215,2324
262916028,0.0,0.0,6900000,6415000,485000,7,6900000,Null,Null,262916028,20215,2324
262934507,0.0,0.0,3000,3000,0,0,3000,Null,Null,262934507,111461,49726
262934556,0.0,0.0,590000,531000,59000,10,590000,Null,Null,262934556,881487,17170
262934713,0.0,0.0,680000,425000,255000,38,680000,Null,Null,262934713,8181541,11937
262936160,0.0,0.0,980000,882000,98000,10,980000,Null,Null,262936160,881487,11845
262936165,0.0,0.0,34000,34000,0,0,34000,Null,Null,262936165,7823749,11605
262936444,0.0,0.0,10000,10000,0,0,10000,Null,Null,262936444,111461,20254
262936760,0.0,0.0,350000,315000,35000,10,350000,Null,Null,262936760,881487,1583
262946033,0.0,0.0,1860000,1860000,0,0,1860000,Null,Null,262946033,4647777,15318
262946911,0.0,0.0,1860000,1860000,0,0,1860000,Null,Null,262946911,4647777,15318
262969550,0.0,0.0,199000,138000,61000,31,199000,Null,Null,262969550,20271,1815
262970130,0.0,0.0,1860000,1860000,0,0,1860000,Null,Null,262970130,4647777,15318
262970674,0.0,0.0,350000,315000,35000,10,350000,Null,Null,262970674,881487,8206
262970678,0.0,0.0,139000,135000,4000,3,139000,Null,Null,262970678,111461,4428
262970784,0.0,0.0,50000,50000,0,0,50000,Null,Null,262970784,111461,28460
262970933,0.0,0.0,99000,99000,0,0,99000,Null,Null,262970933,111461,11941
262970944,0.0,0.0,99000,99000,0,0,99000,Null,Null,262970944,111461,7064
262970958,0.0,0.0,99000,99000,0,0,99000,Null,Null,262970958,111461,11943
262970960,0.0,0.0,249000,249000,0,0,249000,Null,Null,262970960,111461,2
262970962,0.0,0.0,149000,149000,0,0,149000,Null,Null,262970962,111461,11943
262970975,0.0,0.0,2890000,2890000,0,0,2890000,Null,Null,262970975,8169073,2
262971081,0.0,0.0,99000,99000,0,0,99000,Null,Null,262971081,111461,11943
262971083,0.0,0.0,99000,99000,0,0,99000,Null,Null,262971083,111461,7064
262971085,0.0,0.0,99000,99000,0,0,99000,Null,Null,262971085,111461,11943
262971087,0.0,0.0,99000,99000,0,0,99000,Null,Null,262971087,111461,11941
262971091,0.0,0.0,99000,99000,0,0,99000,Null,Null,262971091,111461,11941
262971372,131.0,131.0,99000,99000,0,0,99000,Null,Null,262971372,20271,1815
262971407,0.0,0.0,89000,89000,0,0,89000,Null,Null,262971407,111461,7064
262971411,0.0,0.0,2990000,2850000,140000,5,2990000,Null,Null,262971411,20215,7081
262971413,0.0,0.0,99000,99000,0,0,99000,Null,Null,262971413,111461,2334
262971459,0.0,0.0,109000,109000,0,0,109000,Null,Null,262971459,111461,11941
262971465,0.0,0.0,99000,99000,0,0,99000,Null,Null,262971465,111461,11941
262971467,0.0,0.0,99000,99000,0,0,99000,Null,Null,262971467,111461,11941
262971471,0.0,0.0,99000,99000,0,0,99000,Null,Null,262971471,111461,11941
262971475,0.0,0.0,630000,630000,0,0,630000,Null,Null,262971475,881487,5893
262971515,0.0,0.0,99000,99000,0,0,99000,Null,Null,262971515,111461,7064
262971519,0.0,0.0,2500000,1999000,501000,20,2500000,Null,Null,262971519,4647777,15318
262971604,0.0,0.0,99000,99000,0,0,99000,Null,Null,262971604,111461,11941
262971611,0.0,0.0,99000,99000,0,0,99000,Null,Null,262971611,111461,11941
262971618,0.0,0.0,169000,169000,0,0,169000,Null,Null,262971618,111461,11941
262971620,0.0,0.0,169000,169000,0,0,169000,Null,Null,262971620,111461,7064
262971623,0.0,0.0,169000,169000,0,0,169000,Null,Null,262971623,111461,11941
262971629,0.0,0.0,119000,119000,0,0,119000,Null,Null,262971629,111461,11941
262971631,0.0,0.0,119000,119000,0,0,119000,Null,Null,262971631,111461,11941
262971637,0.0,0.0,99000,99000,0,0,99000,Null,Null,262971637,111461,11943
262971639,0.0,0.0,119000,119000,0,0,119000,Null,Null,262971639,111461,11943
262971655,0.0,0.0,30000,30000,0,0,30000,Null,Null,262971655,4738431,3804
262971688,0.0,0.0,79000,79000,0,0,79000,Null,Null,262971688,111461,11941
262971692,0.0,0.0,79000,79000,0,0,79000,Null,Null,262971692,111461,11941
262971748,0.0,0.0,79000,79000,0,0,79000,Null,Null,262971748,111461,7064
262971751,0.0,0.0,119000,119000,0,0,119000,Null,Null,262971751,111461,11941
262971754,0.0,0.0,119000,119000,0,0,119000,Null,Null,262971754,111461,7064
262971756,0.0,0.0,119000,119000,0,0,119000,Null,Null,262971756,111461,11943
262971781,0.0,0.0,119000,119000,0,0,119000,Null,Null,262971781,111461,11941
262971971,0.0,0.0,119000,119000,0,0,119000,Null,Null,262971971,111461,11941
262971973,0.0,0.0,119000,119000,0,0,119000,Null,Null,262971973,111461,11941
262972002,0.0,0.0,119000,119000,0,0,119000,Null,Null,262972002,111461,11943
262972004,0.0,0.0,119000,119000,0,0,119000,Null,Null,262972004,111461,11943
262972006,0.0,0.0,119000,119000,0,0,119000,Null,Null,262972006,111461,7064
262972008,0.0,0.0,119000,119000,0,0,119000,Null,Null,262972008,111461,11943
262972016,0.0,0.0,199000,199000,0,0,199000,Null,Null,262972016,111461,2
262972019,0.0,0.0,119000,119000,0,0,119000,Null,Null,262972019,111461,11943
262972021,0.0,0.0,199000,199000,0,0,199000,Null,Null,262972021,111461,2
262972023,0.0,0.0,119000,119000,0,0,119000,Null,Null,262972023,111461,11941
262972229,0.0,0.0,630000,323000,307000,49,630000,Null,Null,262972229,4647777,15318
262972258,0.0,0.0,299000,299000,0,0,299000,Null,Null,262972258,111461,28464
262972268,0.0,0.0,299000,299000,0,0,299000,Null,Null,262972268,111461,28464
262972314,0.0,0.0,2000,1000,1000,50,2000,Null,Null,262972314,111461,23112
262972317,0.0,0.0,152000,152000,0,0,152000,Null,Null,262972317,111461,8371
262972325,0.0,0.0,32500,31000,1500,5,32500,Null,Null,262972325,111461,11605
262972347,0.0,0.0,1499000,1499000,0,0,1499000,Null,Null,262972347,8169073,10413
262972351,0.0,0.0,980000,499000,481000,49,980000,Null,Null,262972351,4647777,15250
262972405,0.0,0.0,520000,497000,23000,4,520000,Null,Null,262972405,111461,13878
262972407,0.0,0.0,520000,497000,23000,4,520000,Null,Null,262972407,111461,13878
262972409,0.0,0.0,650000,450000,200000,31,650000,Null,Null,262972409,111454,28644
262972422,0.0,0.0,980000,499000,481000,49,980000,Null,Null,262972422,4647777,15250
262972555,0.0,0.0,320000,306000,14000,4,320000,Null,Null,262972555,111461,3422
262972557,0.0,0.0,940000,479000,461000,49,940000,Null,Null,262972557,4647777,15250
262972744,0.0,0.0,350000,334000,16000,5,350000,Null,Null,262972744,111461,3422
262972815,0.0,0.0,599000,572000,27000,5,599000,Null,Null,262972815,111461,1583
262972882,0.0,0.0,599000,572000,27000,5,599000,Null,Null,262972882,111461,11605
262972919,0.0,0.0,400000,382000,18000,5,400000,Null,Null,262972919,111461,11845
262972956,0.0,0.0,159000,159000,0,0,159000,Null,Null,262972956,288399,1520
262973020,0.0,0.0,390000,372000,18000,5,390000,Null,Null,262973020,111461,11605
262973058,1.0,1.0,150000,146000,4000,3,150000,Null,Null,262973058,18802,28428
262973079,0.0,0.0,499000,477000,22000,4,499000,Null,Null,262973079,111461,11605
262973087,0.0,0.0,2000000,1399000,601000,30,2000000,Null,Null,262973087,4647777,15250
262973090,0.0,0.0,250000,239000,11000,4,250000,Null,Null,262973090,111461,17170
262973125,0.0,0.0,5550000,4999000,551000,10,5550000,Null,Null,262973125,4647777,15250
262973131,0.0,0.0,620000,592000,28000,5,620000,Null,Null,262973131,111461,17170
262973201,0.0,0.0,600000,600000,0,0,600000,Null,Null,262973201,579445,15236
262973224,0.0,0.0,199000,199000,0,0,199000,Null,Null,262973224,8100185,1752
262973230,0.0,0.0,650000,650000,0,0,650000,Null,Null,262973230,579445,15236
262973234,1.0,1.0,250000,239000,11000,4,250000,Null,Null,262973234,111461,17170
262973252,0.0,0.0,850000,850000,0,0,850000,Null,Null,262973252,579445,15236
262973262,0.0,0.0,120000,116000,4000,3,120000,Null,Null,262973262,18802,28428
262973304,1.0,1.0,699000,515000,184000,26,699000,Null,Null,262973304,111461,17170
262973320,0.0,0.0,250000,243000,7000,3,250000,Null,Null,262973320,18802,28430
262973434,0.0,0.0,10000,10000,0,0,10000,Null,Null,262973434,111461,20254
262973453,0.0,0.0,299000,286000,13000,4,299000,Null,Null,262973453,111461,17170
262973528,0.0,0.0,399000,381000,18000,5,399000,Null,Null,262973528,111461,3422
262973640,0.0,0.0,550000,525000,25000,5,550000,Null,Null,262973640,111461,17170
262974356,0.0,0.0,2980000,2942000,38000,1,2980000,Null,Null,262974356,111461,8067
262974390,12.0,12.0,306000,130000,176000,58,306000,Null,Null,262974390,200189,1520
262974762,0.0,0.0,3000000,2940000,60000,2,3000000,Null,Null,262974762,111461,11516
262974962,68.0,68.0,306000,130000,176000,58,306000,Null,Null,262974962,200189,1520
262976176,0.0,0.0,36000,36000,0,0,36000,Null,Null,262976176,111461,8201
262977418,0.0,0.0,59400,59400,0,0,59400,Null,Null,262977418,111461,2
262977597,0.0,0.0,1290000,990000,300000,23,1290000,Null,Null,262977597,674463,8400
262977632,0.0,0.0,80000,40000,40000,50,80000,Null,Null,262977632,111461,28484
262977670,0.0,0.0,250000,239000,11000,4,250000,Null,Null,262977670,111461,53350
262977690,0.0,0.0,80000,40000,40000,50,80000,Null,Null,262977690,111461,28484
262977704,0.0,0.0,80000,40000,40000,50,80000,Null,Null,262977704,111461,28484
262977717,0.0,0.0,610000,420000,190000,31,610000,Null,Null,262977717,111461,53350
262977730,0.0,0.0,499000,477000,22000,4,499000,Null,Null,262977730,111461,53350
262977777,0.0,0.0,139500,133000,6500,5,139500,Null,Null,262977777,111461,8196
262977791,0.0,0.0,215000,209000,6000,3,215000,Null,Null,262977791,21653,2324
262977855,0.0,0.0,815000,595000,220000,27,815000,Null,Null,262977855,111461,1601
262977890,0.0,0.0,299000,286000,13000,4,299000,Null,Null,262977890,111461,3424
262977948,0.0,0.0,380000,363000,17000,4,380000,Null,Null,262977948,111461,53350
262977965,0.0,0.0,116000,116000,0,0,116000,Null,Null,262977965,111461,15236
262978046,0.0,0.0,250000,239000,11000,4,250000,Null,Null,262978046,111461,13878
262979392,0.0,0.0,1250000,1194000,56000,4,1250000,Null,Null,262979392,111461,11889
262979412,0.0,0.0,850000,850000,0,0,850000,Null,Null,262979412,579445,15236
262979435,0.0,0.0,4800000,4800000,0,0,4800000,Null,Null,262979435,579445,15236
262979468,0.0,0.0,4650000,4650000,0,0,4650000,Null,Null,262979468,579445,15236
262979493,0.0,0.0,6900000,6900000,0,0,6900000,Null,Null,262979493,579445,15236
262979505,0.0,0.0,6250000,6250000,0,0,6250000,Null,Null,262979505,579445,15236
262979508,0.0,0.0,170000,150000,20000,12,170000,Null,Null,262979508,18804,1626
262979525,0.0,0.0,950000,950000,0,0,950000,Null,Null,262979525,579445,15236
262979544,0.0,0.0,550000,550000,0,0,550000,Null,Null,262979544,579445,15236
262979546,1.0,1.0,900000,860000,40000,4,900000,Null,Null,262979546,111461,5893
262979554,0.0,0.0,5850000,5850000,0,0,5850000,Null,Null,262979554,579445,15236
262979686,0.0,0.0,900000,860000,40000,4,900000,Null,Null,262979686,111461,5893
262979695,0.0,0.0,400000,360000,40000,10,400000,Null,Null,262979695,18804,1626
262979710,108.0,108.0,1000,1000,0,0,1000,Null,Null,262979710,111461,1815
262979720,0.0,0.0,5290000,5158000,132000,2,5290000,Null,Null,262979720,18776,2971
262979768,0.0,0.0,1290000,990000,300000,23,1290000,Null,Null,262979768,674463,8400
262979781,0.0,0.0,317000,317000,0,0,317000,Null,Null,262979781,21653,2324
262979794,0.0,0.0,400000,360000,40000,10,400000,Null,Null,262979794,18804,1626
262979941,0.0,0.0,600000,460000,140000,23,600000,Null,Null,262979941,18804,1626
262980054,0.0,0.0,890000,890000,0,0,890000,Null,Null,262980054,111461,28398
262980193,0.0,0.0,275000,247500,27500,10,275000,Null,Null,262980193,881487,8308
262980493,0.0,0.0,235000,235000,0,0,235000,Null,Null,262980493,21653,2977
262980513,0.0,0.0,490000,490000,0,0,490000,Null,Null,262980513,5073869,1815
262980534,2.0,2.0,850000,850000,0,0,850000,Null,Null,262980534,177927,12864
262980600,0.0,0.0,135000,135000,0,0,135000,Null,Null,262980600,160189,11883
262980623,2.0,2.0,503000,503000,0,0,503000,Null,Null,262980623,111461,11943
262980629,0.0,0.0,7200000,5000000,2200000,31,7200000,Null,Null,262980629,111461,28454
262980644,0.0,0.0,168000,168000,0,0,168000,Null,Null,262980644,160189,11883
262980671,0.0,0.0,176000,176000,0,0,176000,Null,Null,262980671,160189,11883
262980886,0.0,0.0,479000,407150,71850,15,479000,Null,Null,262980886,185177,11861
262982224,0.0,0.0,1790000,1521500,268500,15,1790000,Null,Null,262982224,250181,11849
262982409,0.0,0.0,1290000,1096500,193500,15,1290000,Null,Null,262982409,250181,11849
262982508,18.0,18.0,219000,219000,0,0,219000,Null,Null,262982508,613301,1520
262982667,0.0,0.0,90000,90000,0,0,90000,Null,Null,262982667,111461,8197
262982838,0.0,0.0,40000,40000,0,0,40000,Null,Null,262982838,111461,11935
262982844,0.0,0.0,7150000,7150000,0,0,7150000,Null,Null,262982844,8146111,28712
262983661,0.0,0.0,130000,130000,0,0,130000,Null,Null,262983661,212267,5006
262983709,0.0,0.0,5290000,5131000,159000,3,5290000,Null,Null,262983709,18776,2971
262983720,0.0,0.0,5290000,5290000,0,0,5290000,Null,Null,262983720,18776,28698
262983775,0.0,0.0,260000,260000,0,0,260000,Null,Null,262983775,111461,8167
262983869,0.0,0.0,98000,98000,0,0,98000,Null,Null,262983869,111461,15320
262990521,0.0,0.0,116000,116000,0,0,116000,Null,Null,262990521,111461,15320
262990971,0.0,0.0,350000,329000,21000,6,350000,Null,Null,262990971,41083,1838
262991554,0.0,0.0,1300000,1300000,0,0,1300000,Null,Null,262991554,875757,11885
262993272,0.0,0.0,32000,32000,0,0,32000,Null,Null,262993272,111461,11935
262993286,0.0,0.0,56000,56000,0,0,56000,Null,Null,262993286,111461,8193
263012137,0.0,0.0,600000,600000,0,0,600000,Null,Null,263012137,111461,11923
263019801,0.0,0.0,55000,55000,0,0,55000,Null,Null,263019801,111461,8198
263020863,0.0,0.0,10000,10000,0,0,10000,Null,Null,263020863,111461,8205
263021758,0.0,0.0,195000,195000,0,0,195000,Null,Null,263021758,111461,8198
263021771,0.0,0.0,230000,230000,0,0,230000,Null,Null,263021771,111461,2334
263022173,0.0,0.0,120000,120000,0,0,120000,Null,Null,263022173,111461,2334
263022236,0.0,0.0,350000,350000,0,0,350000,Null,Null,263022236,111461,11941
263022275,0.0,0.0,31000,31000,0,0,31000,Null,Null,263022275,111461,8068
263022277,0.0,0.0,30000,30000,0,0,30000,Null,Null,263022277,111461,26658
263022279,0.0,0.0,12900,12900,0,0,12900,Null,Null,263022279,111461,8068
263022280,0.0,0.0,14900,14900,0,0,14900,Null,Null,263022280,111461,26658
263022282,0.0,0.0,30000,30000,0,0,30000,Null,Null,263022282,111461,26658
263022628,0.0,0.0,199000,199000,0,0,199000,Null,Null,263022628,111461,53352
263022716,0.0,0.0,25000,25000,0,0,25000,Null,Null,263022716,111461,8167
263022751,0.0,0.0,25000,25000,0,0,25000,Null,Null,263022751,111461,8167
263022756,0.0,0.0,339000,339000,0,0,339000,Null,Null,263022756,111461,53352
263022768,0.0,0.0,5189000,4670000,519000,10,5189000,Null,Null,263022768,18985,8400
263022828,0.0,0.0,50000,50000,0,0,50000,Null,Null,263022828,111461,8167
263022878,0.0,0.0,1240000,930000,310000,25,1240000,Null,Null,263022878,179099,2324
263022948,0.0,0.0,289000,289000,0,0,289000,Null,Null,263022948,111461,28460
263022974,0.0,0.0,146900,146900,0,0,146900,Null,Null,263022974,486945,1583
263023130,0.0,0.0,6489000,5840000,649000,10,6489000,Null,Null,263023130,18985,8400
263023321,0.0,0.0,20000,20000,0,0,20000,Null,Null,263023321,111461,8196
263023454,0.0,0.0,299000,299000,0,0,299000,Null,Null,263023454,111461,28576
263023473,0.0,0.0,55000,55000,0,0,55000,Null,Null,263023473,111461,8196
263023553,0.0,0.0,4989000,4241000,748000,15,4989000,Null,Null,263023553,18985,8400
263023590,0.0,0.0,460000,460000,0,0,460000,Null,Null,263023590,7889719,3426
263023627,0.0,0.0,130000,99000,31000,24,130000,Null,Null,263023627,235091,8223
263023793,0.0,0.0,6289000,5346000,943000,15,6289000,Null,Null,263023793,18985,8400
263023813,0.0,0.0,130000,99000,31000,24,130000,Null,Null,263023813,235091,8223
263023863,0.0,0.0,195000,195000,0,0,195000,Null,Null,263023863,50432,8223
263024187,0.0,0.0,43000,43000,0,0,43000,Null,Null,263024187,111461,8193
263024191,0.0,0.0,510000,510000,0,0,510000,Null,Null,263024191,7889719,3426
263024205,2.0,2.0,640000,640000,0,0,640000,Null,Null,263024205,3216013,12864
263024229,0.0,0.0,190000,135000,55000,29,190000,Null,Null,263024229,156901,1601
263024283,0.0,0.0,175000,175000,0,0,175000,Null,Null,263024283,50432,8223
263024316,0.0,0.0,40000,40000,0,0,40000,Null,Null,263024316,111461,8196
263024324,0.0,0.0,165000,165000,0,0,165000,Null,Null,263024324,50432,8223
263024362,0.0,0.0,130000,99000,31000,24,130000,Null,Null,263024362,235091,8223
263024378,0.0,0.0,195000,195000,0,0,195000,Null,Null,263024378,21253,1583
263024408,0.0,0.0,199000,199000,0,0,199000,Null,Null,263024408,716223,13878
263024756,0.0,0.0,130000,99000,31000,24,130000,Null,Null,263024756,235091,8223
263024769,0.0,0.0,500000,500000,0,0,500000,Null,Null,263024769,7889719,5893
263024803,0.0,0.0,15000,15000,0,0,15000,Null,Null,263024803,111461,8167
263024811,0.0,0.0,1699000,1648000,51000,3,1699000,Null,Null,263024811,5763205,5531
263024816,0.0,0.0,263000,220000,43000,16,263000,Null,Null,263024816,259989,3422
263025021,0.0,0.0,130000,99000,31000,24,130000,Null,Null,263025021,235091,8223
263025243,1.0,1.0,399000,355000,44000,11,399000,Null,Null,263025243,111461,1796
263025572,0.0,0.0,1000,1000,0,0,1000,Null,Null,263025572,111461,2
263027057,0.0,0.0,36000,36000,0,0,36000,Null,Null,263027057,111461,2
263027075,0.0,0.0,50000,50000,0,0,50000,Null,Null,263027075,111461,8167
263027580,0.0,0.0,130000,99000,31000,24,130000,Null,Null,263027580,235091,8223
263027587,0.0,0.0,199000,199000,0,0,199000,Null,Null,263027587,111461,53352
263027653,0.0,0.0,216000,216000,0,0,216000,Null,Null,263027653,111461,53352
263027678,0.0,0.0,600000,600000,0,0,600000,Null,Null,263027678,7889719,17170
263027685,0.0,0.0,25155,25155,0,0,25155,Null,Null,263027685,111461,28480
263027859,0.0,0.0,130000,99000,31000,24,130000,Null,Null,263027859,235091,8223
263027878,0.0,0.0,899000,760000,139000,15,899000,Null,Null,263027878,259989,3422
263027915,0.0,0.0,339000,339000,0,0,339000,Null,Null,263027915,111461,53352
263027936,0.0,0.0,18989000,16141000,2848000,15,18989000,Null,Null,263027936,18985,4429
263027990,0.0,0.0,360000,360000,0,0,360000,Null,Null,263027990,7889719,2347
263028003,0.0,0.0,339000,339000,0,0,339000,Null,Null,263028003,111461,53352
263028031,0.0,0.0,980000,830000,150000,15,980000,Null,Null,263028031,259989,1583
263028093,0.0,0.0,300000,300000,0,0,300000,Null,Null,263028093,7889719,11605
263028117,0.0,0.0,20000,20000,0,0,20000,Null,Null,263028117,111461,8167
263028179,0.0,0.0,950000,922000,28000,3,950000,Null,Null,263028179,5763205,5531
263028281,0.0,0.0,263000,220000,43000,16,263000,Null,Null,263028281,259989,3422
263028291,0.0,0.0,420000,420000,0,0,420000,Null,Null,263028291,7889719,3422
263028354,0.0,0.0,30000,30000,0,0,30000,Null,Null,263028354,41083,1831
263028360,0.0,0.0,450000,450000,0,0,450000,Null,Null,263028360,111461,11935
263028372,0.0,0.0,195000,195000,0,0,195000,Null,Null,263028372,111461,8167
263028381,37.0,37.0,430000,378400,51600,12,430000,Null,Null,263028381,27961,1520
263028431,0.0,0.0,175000,175000,0,0,175000,Null,Null,263028431,111461,8167
263028452,0.0,0.0,450000,450000,0,0,450000,Null,Null,263028452,7889719,3422
263028454,0.0,0.0,175000,175000,0,0,175000,Null,Null,263028454,111461,8167
263028476,0.0,0.0,194000,194000,0,0,194000,Null,Null,263028476,111461,28644
263028482,0.0,0.0,8030000,8030000,0,0,8030000,Null,Null,263028482,8146111,28712
263028484,0.0,0.0,195000,195000,0,0,195000,Null,Null,263028484,111461,8167
263028509,0.0,0.0,220000,220000,0,0,220000,Null,Null,263028509,111461,11935
263028515,0.0,0.0,199000,199000,0,0,199000,Null,Null,263028515,111461,8167
263028555,818.0,818.0,215000,193500,21500,10,215000,Null,Null,263028555,27961,2
263028732,0.0,0.0,220000,190000,30000,14,220000,Null,Null,263028732,111461,28596
263028782,0.0,0.0,15000,15000,0,0,15000,Null,Null,263028782,111461,2
263028822,0.0,0.0,25000,25000,0,0,25000,Null,Null,263028822,111461,2
263028945,0.0,0.0,475000,475000,0,0,475000,Null,Null,263028945,111461,2
263028949,0.0,0.0,475000,475000,0,0,475000,Null,Null,263028949,111461,2
263028951,0.0,0.0,200000,200000,0,0,200000,Null,Null,263028951,111461,2
263028955,0.0,0.0,1000000,1000000,0,0,1000000,Null,Null,263028955,111461,2
263028971,0.0,0.0,475000,475000,0,0,475000,Null,Null,263028971,111461,2
263028974,0.0,0.0,875000,875000,0,0,875000,Null,Null,263028974,111461,2
263028976,0.0,0.0,1500000,1500000,0,0,1500000,Null,Null,263028976,111461,2
263028991,0.0,0.0,565000,565000,0,0,565000,Null,Null,263028991,111461,2
263028999,0.0,0.0,2500000,2500000,0,0,2500000,Null,Null,263028999,111461,2
263029021,0.0,0.0,725000,725000,0,0,725000,Null,Null,263029021,111461,2
263029023,0.0,0.0,850000,850000,0,0,850000,Null,Null,263029023,111461,2
263029024,0.0,0.0,850000,850000,0,0,850000,Null,Null,263029024,111461,2
263029025,0.0,0.0,625000,625000,0,0,625000,Null,Null,263029025,111461,2
263029026,0.0,0.0,565000,565000,0,0,565000,Null,Null,263029026,111461,2
263029032,0.0,0.0,155000,155000,0,0,155000,Null,Null,263029032,111461,2
263029066,0.0,0.0,200000,200000,0,0,200000,Null,Null,263029066,111461,2
263029076,0.0,0.0,1189000,1189000,0,0,1189000,Null,Null,263029076,111461,2
263029081,0.0,0.0,475000,475000,0,0,475000,Null,Null,263029081,111461,2
263029085,0.0,0.0,179000,179000,0,0,179000,Null,Null,263029085,111461,2
263029087,0.0,0.0,350000,350000,0,0,350000,Null,Null,263029087,111461,2
263029088,0.0,0.0,315000,315000,0,0,315000,Null,Null,263029088,111461,2
263029090,0.0,0.0,125000,125000,0,0,125000,Null,Null,263029090,111461,2
263029093,0.0,0.0,2500000,2500000,0,0,2500000,Null,Null,263029093,111461,2
263029094,0.0,0.0,350000,350000,0,0,350000,Null,Null,263029094,111461,2
263029099,0.0,0.0,1500000,1500000,0,0,1500000,Null,Null,263029099,111461,2
263029105,0.0,0.0,2250000,2250000,0,0,2250000,Null,Null,263029105,111461,2
263029110,0.0,0.0,750000,750000,0,0,750000,Null,Null,263029110,111461,2
263029112,0.0,0.0,975000,975000,0,0,975000,Null,Null,263029112,111461,2
263029124,0.0,0.0,2000000,2000000,0,0,2000000,Null,Null,263029124,111461,2
263029131,0.0,0.0,179000,179000,0,0,179000,Null,Null,263029131,111461,2
263029132,0.0,0.0,300000,300000,0,0,300000,Null,Null,263029132,111461,2
263029134,0.0,0.0,190000,190000,0,0,190000,Null,Null,263029134,111461,2
263029135,0.0,0.0,1100000,1100000,0,0,1100000,Null,Null,263029135,111461,2
263029136,0.0,0.0,200000,200000,0,0,200000,Null,Null,263029136,111461,2
263029141,0.0,0.0,1100000,1100000,0,0,1100000,Null,Null,263029141,111461,2
263029158,0.0,0.0,6000000,6000000,0,0,6000000,Null,Null,263029158,111461,2
263029224,111.0,111.0,710000,300000,410000,58,710000,Null,Null,263029224,259827,1520
263029285,1.0,1.0,1245000,1245000,0,0,1245000,Null,Null,263029285,111461,2
263029291,0.0,0.0,1250000,1250000,0,0,1250000,Null,Null,263029291,111461,2
263029315,0.0,0.0,566000,566000,0,0,566000,Null,Null,263029315,111454,1819
263029320,0.0,0.0,1550000,1550000,0,0,1550000,Null,Null,263029320,111461,2334
263029329,0.0,0.0,1290000,1290000,0,0,1290000,Null,Null,263029329,19788,8043
263029415,0.0,0.0,300000,300000,0,0,300000,Null,Null,263029415,7889719,3426
263029433,0.0,0.0,319000,319000,0,0,319000,Null,Null,263029433,185177,11861
263029979,0.0,0.0,1589000,1589000,0,0,1589000,Null,Null,263029979,111461,53350
263029998,0.0,0.0,80000,69000,11000,14,80000,Null,Null,263029998,235091,8223
263030054,0.0,0.0,80000,69000,11000,14,80000,Null,Null,263030054,235091,8223
263030268,0.0,0.0,790000,790000,0,0,790000,Null,Null,263030268,111461,3426
263030396,0.0,0.0,5450000,5450000,0,0,5450000,Null,Null,263030396,579445,15236
263030455,0.0,0.0,5250000,5250000,0,0,5250000,Null,Null,263030455,579445,15236
263030563,0.0,0.0,1068000,1068000,0,0,1068000,Null,Null,263030563,111461,2
263030579,0.0,0.0,774000,774000,0,0,774000,Null,Null,263030579,111461,2
263030596,0.0,0.0,658800,658800,0,0,658800,Null,Null,263030596,111461,2
263030621,0.0,0.0,588000,588000,0,0,588000,Null,Null,263030621,111461,2
263030630,0.0,0.0,620000,620000,0,0,620000,Null,Null,263030630,111461,53350
263030653,0.0,0.0,4250000,4250000,0,0,4250000,Null,Null,263030653,579445,15236
263030998,0.0,0.0,1090000,935000,155000,14,1090000,Null,Null,263030998,111461,2340
263031002,0.0,0.0,1140000,1140000,0,0,1140000,Null,Null,263031002,7889719,5893
263031012,0.0,0.0,339000,339000,0,0,339000,Null,Null,263031012,111461,53352
263031025,0.0,0.0,200000,145000,55000,28,200000,Null,Null,263031025,204385,1813
263031076,0.0,0.0,350000,350000,0,0,350000,Null,Null,263031076,111461,2
263031078,0.0,0.0,245000,245000,0,0,245000,Null,Null,263031078,111461,2
263031084,0.0,0.0,198000,198000,0,0,198000,Null,Null,263031084,111461,2
263031096,0.0,0.0,239000,239000,0,0,239000,Null,Null,263031096,111461,2
263031142,0.0,0.0,229000,229000,0,0,229000,Null,Null,263031142,111461,2
263031147,0.0,0.0,109000,109000,0,0,109000,Null,Null,263031147,111461,2
263031149,0.0,0.0,389000,389000,0,0,389000,Null,Null,263031149,111461,2
263031161,0.0,0.0,250000,250000,0,0,250000,Null,Null,263031161,111461,2
263031162,0.0,0.0,6800,6800,0,0,6800,Null,Null,263031162,111461,2
263031189,0.0,0.0,125000,125000,0,0,125000,Null,Null,263031189,111461,2
263031212,0.0,0.0,169000,169000,0,0,169000,Null,Null,263031212,111461,2
263031214,0.0,0.0,360000,360000,0,0,360000,Null,Null,263031214,111461,2
263031225,0.0,0.0,360000,360000,0,0,360000,Null,Null,263031225,111461,2
263031244,0.0,0.0,490000,490000,0,0,490000,Null,Null,263031244,111461,2
263031297,0.0,0.0,8000,8000,0,0,8000,Null,Null,263031297,111461,2
263031300,0.0,0.0,15000,15000,0,0,15000,Null,Null,263031300,111461,2
263031320,0.0,0.0,139000,139000,0,0,139000,Null,Null,263031320,111461,2
263031334,0.0,0.0,150000,150000,0,0,150000,Null,Null,263031334,111461,2
263031386,0.0,0.0,199000,199000,0,0,199000,Null,Null,263031386,111461,2
263031392,0.0,0.0,198000,198000,0,0,198000,Null,Null,263031392,111461,2
263031843,0.0,0.0,260000,260000,0,0,260000,Null,Null,263031843,111461,2
263031868,0.0,0.0,260000,260000,0,0,260000,Null,Null,263031868,111461,2
263032084,0.0,0.0,250000,220000,30000,12,250000,Null,Null,263032084,111461,28596
263032118,0.0,0.0,180000,180000,0,0,180000,Null,Null,263032118,111461,8167
263032127,0.0,0.0,1590000,1250000,340000,21,1590000,Null,Null,263032127,111461,2340
263032132,0.0,0.0,4690000,3850000,840000,18,4690000,Null,Null,263032132,162007,1795
263032298,0.0,0.0,168000,151200,16800,10,168000,Null,Null,263032298,8164011,11869
263032326,0.0,0.0,1950000,1950000,0,0,1950000,Null,Null,263032326,111461,8073
263032331,0.0,0.0,799000,625000,174000,22,799000,Null,Null,263032331,111461,8225
263032347,0.0,0.0,799000,625000,174000,22,799000,Null,Null,263032347,111461,8225
263032382,0.0,0.0,90000,90000,0,0,90000,Null,Null,263032382,111461,2
263032384,0.0,0.0,133000,133000,0,0,133000,Null,Null,263032384,111461,2
263032579,0.0,0.0,120000,108000,12000,10,120000,Null,Null,263032579,5220265,17170
263032600,0.0,0.0,329000,307000,22000,7,329000,Null,Null,263032600,111461,20182
263032602,0.0,0.0,389000,389000,0,0,389000,Null,Null,263032602,111461,53352
263032618,0.0,0.0,1190000,1040000,150000,13,1190000,Null,Null,263032618,111461,2340
263032719,0.0,0.0,40000,25000,15000,38,40000,Null,Null,263032719,861155,1641
263032829,0.0,0.0,790000,790000,0,0,790000,Null,Null,263032829,111461,53350
263032843,0.0,0.0,270000,270000,0,0,270000,Null,Null,263032843,111461,28578
263032859,0.0,0.0,1990000,1691500,298500,15,1990000,Null,Null,263032859,208841,2340
263033253,0.0,0.0,1850000,1850000,0,0,1850000,Null,Null,263033253,111461,5566
263033276,0.0,0.0,14328000,14328000,0,0,14328000,Null,Null,263033276,111461,11518
263033281,0.0,0.0,2900000,2190000,710000,24,2900000,Null,Null,263033281,111461,2340
263033287,0.0,0.0,155000,139500,15500,10,155000,Null,Null,263033287,8164011,11873
263033349,0.0,0.0,109000,109000,0,0,109000,Null,Null,263033349,166419,28574
263033406,0.0,0.0,285000,285000,0,0,285000,Null,Null,263033406,495789,13878
263033431,0.0,0.0,389000,389000,0,0,389000,Null,Null,263033431,111461,53352
263033526,0.0,0.0,152898,138999,13899,9,152898,Null,Null,263033526,149308,28574
263033594,0.0,0.0,152898,138999,13899,9,152898,Null,Null,263033594,149308,28576
263033607,0.0,0.0,339000,339000,0,0,339000,Null,Null,263033607,111461,53352
263033615,0.0,0.0,428249,389318,38931,9,428249,Null,Null,263033615,149308,28576
263033657,0.0,0.0,9489000,8540000,949000,10,9489000,Null,Null,263033657,18985,8400
263033662,0.0,0.0,138999,138999,0,0,138999,Null,Null,263033662,149256,28574
263033714,0.0,0.0,550000,550000,0,0,550000,Null,Null,263033714,212267,12878
263033868,0.0,0.0,3590000,2872000,718000,20,3590000,Null,Null,263033868,208841,2340
263033906,0.0,0.0,175000,175000,0,0,175000,Null,Null,263033906,111461,11935
263033992,0.0,0.0,225000,202500,22500,10,225000,Null,Null,263033992,8164011,11873
263034059,0.0,0.0,1590000,1590000,0,0,1590000,Null,Null,263034059,111461,53350
263034112,0.0,0.0,339000,339000,0,0,339000,Null,Null,263034112,111461,53352
263034179,0.0,0.0,168000,168000,0,0,168000,Null,Null,263034179,111461,5264
263034182,0.0,0.0,2490000,2090000,400000,16,2490000,Null,Null,263034182,111461,2340
263034350,0.0,0.0,9500,9500,0,0,9500,Null,Null,263034350,111461,28480
263034380,0.0,0.0,1500000,1500000,0,0,1500000,Null,Null,263034380,111461,5566
263034398,0.0,0.0,9500,9500,0,0,9500,Null,Null,263034398,111461,28480
263034437,0.0,0.0,9500,9500,0,0,9500,Null,Null,263034437,111461,28480
263034441,0.0,0.0,565600,402280,163320,29,565600,Null,Null,263034441,486945,1604
263034597,0.0,0.0,390000,305000,85000,22,390000,Null,Null,263034597,111461,11935
263034815,0.0,0.0,3990000,3391500,598500,15,3990000,Null,Null,263034815,208841,2340
263034843,0.0,0.0,389000,389000,0,0,389000,Null,Null,263034843,111461,53352
263034952,0.0,0.0,45000,45000,0,0,45000,Null,Null,263034952,111461,8516
263034968,0.0,0.0,234000,234000,0,0,234000,Null,Null,263034968,111461,53352
263034999,0.0,0.0,185000,185000,0,0,185000,Null,Null,263034999,8164011,11873
263035017,0.0,0.0,234000,234000,0,0,234000,Null,Null,263035017,111461,53352
263035210,0.0,0.0,389000,389000,0,0,389000,Null,Null,263035210,111461,53352
263035464,0.0,0.0,265000,265000,0,0,265000,Null,Null,263035464,495789,13878
263035628,0.0,0.0,179000,179000,0,0,179000,Null,Null,263035628,111461,28580
263035690,0.0,0.0,9489000,8066000,1423000,15,9489000,Null,Null,263035690,18985,8400
263035824,0.0,0.0,1550000,1550000,0,0,1550000,Null,Null,263035824,111461,5566
263035831,0.0,0.0,79000,79000,0,0,79000,Null,Null,263035831,111461,20254
263035901,3.0,3.0,3590000,3590000,0,0,3590000,Null,Null,263035901,208841,1520
263035959,0.0,0.0,234000,234000,0,0,234000,Null,Null,263035959,111461,53352
263036526,0.0,0.0,234000,234000,0,0,234000,Null,Null,263036526,111461,53352
263036591,0.0,0.0,131000,69000,62000,47,131000,Null,Null,263036591,48599,1612
263036688,0.0,0.0,2500000,2500000,0,0,2500000,Null,Null,263036688,623599,8172
263036753,0.0,0.0,600000,570000,30000,5,600000,Null,Null,263036753,161943,11877
263036843,0.0,0.0,4300000,4300000,0,0,4300000,Null,Null,263036843,623599,8172
263037218,0.0,0.0,3225000,3063750,161250,5,3225000,Null,Null,263037218,161943,11877
263037635,0.0,0.0,49000,49000,0,0,49000,Null,Null,263037635,111461,28482
263037646,0.0,0.0,250000,250000,0,0,250000,Null,Null,263037646,183257,15320
263037746,0.0,0.0,2750000,2612500,137500,5,2750000,Null,Null,263037746,161943,11877
263037754,0.0,0.0,135000,135000,0,0,135000,Null,Null,263037754,111461,20258
263037758,0.0,0.0,750000,379000,371000,49,750000,Null,Null,263037758,4741947,12908
263037765,0.0,0.0,149000,149000,0,0,149000,Null,Null,263037765,111461,13878
263037783,0.0,0.0,350000,350000,0,0,350000,Null,Null,263037783,5121107,28736
263037788,0.0,0.0,2752000,2752000,0,0,2752000,Null,Null,263037788,26150,8512
263038530,0.0,0.0,3455000,2694000,761000,22,3455000,Null,Null,263038530,26150,8513
263038917,0.0,0.0,990000,940500,49500,5,990000,Null,Null,263038917,161943,11845
263039447,0.0,0.0,160000,144000,16000,10,160000,Null,Null,263039447,5220265,17170
263039745,0.0,0.0,180000,162000,18000,10,180000,Null,Null,263039745,5220265,17170
263039950,0.0,0.0,150000,150000,0,0,150000,Null,Null,263039950,111461,8167
263040173,0.0,0.0,110000,110000,0,0,110000,Null,Null,263040173,161943,11857
263040220,0.0,0.0,770000,770000,0,0,770000,Null,Null,263040220,161943,11857
263040259,0.0,0.0,289000,289000,0,0,289000,Null,Null,263040259,111461,2324
263040268,0.0,0.0,289000,289000,0,0,289000,Null,Null,263040268,111461,2324
263040302,0.0,0.0,359000,359000,0,0,359000,Null,Null,263040302,111461,11516
263040304,0.0,0.0,359000,359000,0,0,359000,Null,Null,263040304,111461,11516
263040314,0.0,0.0,269000,269000,0,0,269000,Null,Null,263040314,111461,11516
263040349,0.0,0.0,269000,269000,0,0,269000,Null,Null,263040349,111461,11516
263040436,0.0,0.0,619000,619000,0,0,619000,Null,Null,263040436,111461,2324
263040438,0.0,0.0,790000,790000,0,0,790000,Null,Null,263040438,161943,11859
263040444,0.0,0.0,619000,619000,0,0,619000,Null,Null,263040444,111461,11516
263040479,0.0,0.0,590000,590000,0,0,590000,Null,Null,263040479,161943,11867
263040514,0.0,0.0,139000,139000,0,0,139000,Null,Null,263040514,111461,1813
263040518,0.0,0.0,139000,139000,0,0,139000,Null,Null,263040518,111461,1813
263040527,0.0,0.0,1090000,1090000,0,0,1090000,Null,Null,263040527,161943,11871
263040546,0.0,0.0,139000,139000,0,0,139000,Null,Null,263040546,111461,2324
263040569,0.0,0.0,199000,199000,0,0,199000,Null,Null,263040569,524561,2324
263040606,0.0,0.0,139000,139000,0,0,139000,Null,Null,263040606,111461,2324
263040615,0.0,0.0,199000,199000,0,0,199000,Null,Null,263040615,524561,2324
263040632,0.0,0.0,139000,139000,0,0,139000,Null,Null,263040632,111461,2324
263040636,0.0,0.0,139000,139000,0,0,139000,Null,Null,263040636,111461,2324
263040887,0.0,0.0,139000,139000,0,0,139000,Null,Null,263040887,111461,20244
263041039,0.0,0.0,2690000,2623000,67000,2,2690000,Null,Null,263041039,18776,1831
263041214,3.0,3.0,4690000,3890000,800000,17,4690000,Null,Null,263041214,162007,1795
263041325,0.0,0.0,2690000,2609000,81000,3,2690000,Null,Null,263041325,18776,1831
263041867,0.0,0.0,17000,17000,0,0,17000,Null,Null,263041867,111461,28434
263041899,0.0,0.0,150000,89000,61000,41,150000,Null,Null,263041899,111461,28482
263041903,0.0,0.0,25000,25000,0,0,25000,Null,Null,263041903,111461,8198
263041923,0.0,0.0,150000,85000,65000,43,150000,Null,Null,263041923,111461,28482
263041929,0.0,0.0,150000,85000,65000,43,150000,Null,Null,263041929,111461,28482
263042211,1.0,1.0,699000,699000,0,0,699000,Null,Null,263042211,111461,2340
263042242,0.0,0.0,380000,380000,0,0,380000,Null,Null,263042242,111461,8170
263042246,0.0,0.0,460000,460000,0,0,460000,Null,Null,263042246,111461,2334
263042474,0.0,0.0,24000,24000,0,0,24000,Null,Null,263042474,111461,28434
263042556,0.0,0.0,12000,12000,0,0,12000,Null,Null,263042556,111461,20254
263042600,0.0,0.0,1555000,1555000,0,0,1555000,Null,Null,263042600,111461,8073
263042627,0.0,0.0,12000,12000,0,0,12000,Null,Null,263042627,111461,20254
263044399,0.0,0.0,224000,224000,0,0,224000,Null,Null,263044399,223749,1583
263044464,0.0,0.0,390000,369000,21000,5,390000,Null,Null,263044464,41083,1838
263044523,0.0,0.0,337000,228000,109000,32,337000,Null,Null,263044523,185265,1613
263044576,0.0,0.0,230000,230000,0,0,230000,Null,Null,263044576,223749,17170
263044598,0.0,0.0,65000,65000,0,0,65000,Null,Null,263044598,8194293,17186
263044609,0.0,0.0,12500,12500,0,0,12500,Null,Null,263044609,111461,28434
263045201,0.0,0.0,35000,35000,0,0,35000,Null,Null,263045201,111461,28480
263045250,0.0,0.0,12000,12000,0,0,12000,Null,Null,263045250,111461,20254
263045656,0.0,0.0,1096000,548000,548000,50,1096000,Null,Null,263045656,111461,15250
263045678,0.0,0.0,135000,135000,0,0,135000,Null,Null,263045678,111461,5263
263045684,0.0,0.0,22000,22000,0,0,22000,Null,Null,263045684,111461,8193
263045721,0.0,0.0,4750000,4750000,0,0,4750000,Null,Null,263045721,7982659,7449
263045775,0.0,0.0,236000,118000,118000,50,236000,Null,Null,263045775,111461,15318
263046033,0.0,0.0,5590000,4690000,900000,16,5590000,Null,Null,263046033,8194285,8066
263046044,0.0,0.0,2400000,1800000,600000,25,2400000,Null,Null,263046044,46007,17170
263046053,0.0,0.0,92000,92000,0,0,92000,Null,Null,263046053,111461,28482
263046066,0.0,0.0,1150000,862500,287500,25,1150000,Null,Null,263046066,46007,2347
263046086,0.0,0.0,360000,338400,21600,6,360000,Null,Null,263046086,859997,8223
263046094,0.0,0.0,350000,350000,0,0,350000,Null,Null,263046094,4251927,1609
263046245,0.0,0.0,350000,350000,0,0,350000,Null,Null,263046245,4251927,1609
263046263,0.0,0.0,4750000,4750000,0,0,4750000,Null,Null,263046263,7982659,7449
263046267,0.0,0.0,480000,240000,240000,50,480000,Null,Null,263046267,416127,17170
263046366,0.0,0.0,350000,350000,0,0,350000,Null,Null,263046366,4251927,1609
263046401,0.0,0.0,4750000,4750000,0,0,4750000,Null,Null,263046401,7982659,7449
263046518,0.0,0.0,350000,350000,0,0,350000,Null,Null,263046518,4251927,1609
263046619,0.0,0.0,600000,600000,0,0,600000,Null,Null,263046619,4247317,3426
263046707,0.0,0.0,350000,350000,0,0,350000,Null,Null,263046707,4251927,1609
263046778,0.0,0.0,750000,645000,105000,14,750000,Null,Null,263046778,46007,1601
263046797,0.0,0.0,27000,27000,0,0,27000,Null,Null,263046797,111461,28478
263046868,0.0,0.0,350000,350000,0,0,350000,Null,Null,263046868,4251927,1609
263046991,0.0,0.0,569000,569000,0,0,569000,Null,Null,263046991,18805,1838
263047185,0.0,0.0,479000,450260,28740,6,479000,Null,Null,263047185,859997,11605
263047240,0.0,0.0,350000,350000,0,0,350000,Null,Null,263047240,4251927,1609
263047342,8.0,8.0,29000,29000,0,0,29000,Null,Null,263047342,7823749,11605
263047349,0.0,0.0,550000,550000,0,0,550000,Null,Null,263047349,18805,1836
263047426,0.0,0.0,2950000,2950000,0,0,2950000,Null,Null,263047426,579445,15236
263047432,0.0,0.0,690000,690000,0,0,690000,Null,Null,263047432,18805,1836
263047445,0.0,0.0,2200000,2200000,0,0,2200000,Null,Null,263047445,416127,53350
263047452,0.0,0.0,399000,265000,134000,34,399000,Null,Null,263047452,929841,11941
263047457,0.0,0.0,108000,108000,0,0,108000,Null,Null,263047457,111461,2
263047471,0.0,0.0,430000,430000,0,0,430000,Null,Null,263047471,111461,53350
263047475,0.0,0.0,2900000,2900000,0,0,2900000,Null,Null,263047475,579445,15236
263047479,0.0,0.0,1790000,1790000,0,0,1790000,Null,Null,263047479,46007,8227
263047513,0.0,0.0,2750000,2750000,0,0,2750000,Null,Null,263047513,579445,15236
263047534,0.0,0.0,690000,690000,0,0,690000,Null,Null,263047534,46007,8227
263047696,0.0,0.0,109000,87000,22000,20,109000,Null,Null,263047696,114328,1583
263047699,0.0,0.0,890000,890000,0,0,890000,Null,Null,263047699,416127,1597
263047752,0.0,0.0,2500,2500,0,0,2500,Null,Null,263047752,7823749,17186
263047761,0.0,0.0,590000,590000,0,0,590000,Null,Null,263047761,46007,11605
263047875,0.0,0.0,2490000,1939000,551000,22,2490000,Null,Null,263047875,247549,1795
263048026,0.0,0.0,390000,390000,0,0,390000,Null,Null,263048026,111461,53350
263048189,0.0,0.0,1000,1000,0,0,1000,Null,Null,263048189,111461,23112
263048296,0.0,0.0,249000,249000,0,0,249000,Null,Null,263048296,111461,28644
263048485,0.0,0.0,9000,9000,0,0,9000,Null,Null,263048485,7823749,17186
263048538,0.0,0.0,315000,315000,0,0,315000,Null,Null,263048538,111461,26652
263048746,2.0,2.0,500000,319000,181000,36,500000,Null,Null,263048746,734589,6742
263048807,0.0,0.0,69000,69000,0,0,69000,Null,Null,263048807,111461,5893
263048930,0.0,0.0,312000,312000,0,0,312000,Null,Null,263048930,550883,5263
263048950,0.0,0.0,390000,390000,0,0,390000,Null,Null,263048950,111461,3426
263049235,0.0,0.0,312000,312000,0,0,312000,Null,Null,263049235,550883,5263
263049244,0.0,0.0,750000,712500,37500,5,750000,Null,Null,263049244,243693,4593
263049443,0.0,0.0,378000,378000,0,0,378000,Null,Null,263049443,550883,5263
263049475,0.0,0.0,49000,49000,0,0,49000,Null,Null,263049475,111461,8202
263049477,0.0,0.0,49000,49000,0,0,49000,Null,Null,263049477,111461,8202
263049487,0.0,0.0,49000,49000,0,0,49000,Null,Null,263049487,111461,8202
263049516,0.0,0.0,5750000,5750000,0,0,5750000,Null,Null,263049516,111644,5385
263049604,0.0,0.0,358000,358000,0,0,358000,Null,Null,263049604,550883,5263
263049607,0.0,0.0,5040000,5040000,0,0,5040000,Null,Null,263049607,111644,5384
263049689,0.0,0.0,5110000,5110000,0,0,5110000,Null,Null,263049689,111644,8512
263049723,0.0,0.0,5110000,5110000,0,0,5110000,Null,Null,263049723,111644,8512
263049725,0.0,0.0,169000,169000,0,0,169000,Null,Null,263049725,111461,20254
263049742,0.0,0.0,70000,70000,0,0,70000,Null,Null,263049742,174069,1820
263049813,0.0,0.0,378000,378000,0,0,378000,Null,Null,263049813,550883,5263
263051132,0.0,0.0,29000,29000,0,0,29000,Null,Null,263051132,7823749,11605
263051232,0.0,0.0,358000,358000,0,0,358000,Null,Null,263051232,550883,5263
263051300,0.0,0.0,49000,49000,0,0,49000,Null,Null,263051300,7823749,17186
263051316,0.0,0.0,216000,216000,0,0,216000,Null,Null,263051316,8194293,8309
263051496,0.0,0.0,14000,14000,0,0,14000,Null,Null,263051496,7823749,13878
263051611,0.0,0.0,131000,69000,62000,47,131000,Null,Null,263051611,48599,1612
263051647,6.0,6.0,159000,133560,25440,16,159000,Null,Null,263051647,111461,28454
263052062,0.0,0.0,131000,69000,62000,47,131000,Null,Null,263052062,48599,1612
263052073,0.0,0.0,1150000,1150000,0,0,1150000,Null,Null,263052073,223233,26652
263052220,0.0,0.0,118000,118000,0,0,118000,Null,Null,263052220,7823749,3426
263052328,0.0,0.0,430000,430000,0,0,430000,Null,Null,263052328,111461,53350
263052615,0.0,0.0,129000,129000,0,0,129000,Null,Null,263052615,7823749,3426
263052661,0.0,0.0,131000,69000,62000,47,131000,Null,Null,263052661,48599,1612
263052870,0.0,0.0,5690000,5690000,0,0,5690000,Null,Null,263052870,7982659,8512
263052975,0.0,0.0,520000,520000,0,0,520000,Null,Null,263052975,111461,53350
263053356,2.0,2.0,49000,49000,0,0,49000,Null,Null,263053356,111461,5900
263053426,0.0,0.0,26500,26500,0,0,26500,Null,Null,263053426,111461,2
263053472,0.0,0.0,5690000,5690000,0,0,5690000,Null,Null,263053472,7982659,8512
263053867,0.0,0.0,739000,739000,0,0,739000,Null,Null,263053867,111461,53350
263053943,0.0,0.0,378000,378000,0,0,378000,Null,Null,263053943,550883,5263
263054035,0.0,0.0,652000,652000,0,0,652000,Null,Null,263054035,111393,5263
263054066,0.0,0.0,70000,70000,0,0,70000,Null,Null,263054066,7823749,1601
263054104,0.0,0.0,620000,620000,0,0,620000,Null,Null,263054104,245121,8216
263054111,0.0,0.0,990000,990000,0,0,990000,Null,Null,263054111,8176703,11845
263054354,0.0,0.0,270000,147000,123000,46,270000,Null,Null,263054354,4813065,8226
263054431,0.0,0.0,440000,396000,44000,10,440000,Null,Null,263054431,245121,1583
263054802,0.0,0.0,270000,243000,27000,10,270000,Null,Null,263054802,245121,5900
263054815,0.0,0.0,131000,69000,62000,47,131000,Null,Null,263054815,48599,1612
263054871,0.0,0.0,1300000,1300000,0,0,1300000,Null,Null,263054871,111461,8073
263054876,0.0,0.0,358000,358000,0,0,358000,Null,Null,263054876,550883,5263
263054893,0.0,0.0,520000,468000,52000,10,520000,Null,Null,263054893,245121,1600
263054940,0.0,0.0,850000,850000,0,0,850000,Null,Null,263054940,111461,53350
263054955,133.0,133.0,1020000,431000,589000,58,1020000,Null,Null,263054955,27396,1520
263054966,0.0,0.0,652000,652000,0,0,652000,Null,Null,263054966,111393,5263
263055035,0.0,0.0,35000,35000,0,0,35000,Null,Null,263055035,111461,8225
263055157,0.0,0.0,384000,212000,172000,45,384000,Null,Null,263055157,470105,8212
263055159,0.0,0.0,1222000,1222000,0,0,1222000,Null,Null,263055159,111461,5566
263055166,0.0,0.0,1089000,1000000,89000,8,1089000,Null,Null,263055166,111461,2324
263055171,0.0,0.0,139000,139000,0,0,139000,Null,Null,263055171,246045,1819
263055218,0.0,0.0,960000,615000,345000,36,960000,Null,Null,263055218,5829937,8300
263055233,0.0,0.0,48000,27500,20500,43,48000,Null,Null,263055233,5829937,8300
263055238,0.0,0.0,28000,21500,6500,23,28000,Null,Null,263055238,5829937,8300
263055241,0.0,0.0,1440000,750000,690000,48,1440000,Null,Null,263055241,5829937,8300
263055250,0.0,0.0,360000,240000,120000,33,360000,Null,Null,263055250,5829937,8300
263055278,0.0,0.0,480000,315000,165000,34,480000,Null,Null,263055278,5829937,8300
263055289,0.0,0.0,144000,98000,46000,32,144000,Null,Null,263055289,5829937,8300
263055295,0.0,0.0,240000,162000,78000,33,240000,Null,Null,263055295,5829937,8300
263055362,0.0,0.0,680000,445000,235000,35,680000,Null,Null,263055362,8181541,11933
263055538,0.0,0.0,195000,195000,0,0,195000,Null,Null,263055538,111461,2
263055796,0.0,0.0,131000,69000,62000,47,131000,Null,Null,263055796,48599,8206
263055882,0.0,0.0,3800000,3800000,0,0,3800000,Null,Null,263055882,288651,5264
263055915,0.0,0.0,620000,620000,0,0,620000,Null,Null,263055915,111461,53350
263055969,0.0,0.0,119000,119000,0,0,119000,Null,Null,263055969,111461,7064
263055974,0.0,0.0,17000,17000,0,0,17000,Null,Null,263055974,7823749,1601
263055985,1.0,1.0,7000000,5390000,1610000,23,7000000,Null,Null,263055985,892671,8165
263056043,0.0,0.0,377000,209000,168000,45,377000,Null,Null,263056043,470105,8226
263056064,0.0,0.0,119000,119000,0,0,119000,Null,Null,263056064,111461,11941
263056065,0.0,0.0,119000,119000,0,0,119000,Null,Null,263056065,111461,11941
263056162,0.0,0.0,262000,135000,127000,48,262000,Null,Null,263056162,48599,1612
263056215,0.0,0.0,119000,119000,0,0,119000,Null,Null,263056215,111461,11943
263056217,0.0,0.0,699000,699000,0,0,699000,Null,Null,263056217,111461,53350
263056285,0.0,0.0,747000,415000,332000,44,747000,Null,Null,263056285,470105,8226
263056327,0.0,0.0,1500000,1500000,0,0,1500000,Null,Null,263056327,8176703,11845
263056342,0.0,0.0,119000,119000,0,0,119000,Null,Null,263056342,111461,11943
263056344,0.0,0.0,119000,119000,0,0,119000,Null,Null,263056344,111461,7064
263056345,0.0,0.0,119000,119000,0,0,119000,Null,Null,263056345,111461,7064
263056383,0.0,0.0,405000,380700,24300,6,405000,Null,Null,263056383,859997,17170
263056416,0.0,0.0,139000,139000,0,0,139000,Null,Null,263056416,111461,11943
263056432,0.0,0.0,119000,119000,0,0,119000,Null,Null,263056432,111461,11943
263056450,0.0,0.0,79000,79000,0,0,79000,Null,Null,263056450,111461,11943
263056514,0.0,0.0,2200000,2200000,0,0,2200000,Null,Null,263056514,8176703,11845
263056518,0.0,0.0,1850000,1850000,0,0,1850000,Null,Null,263056518,714023,17170
263056526,0.0,0.0,529000,497260,31740,6,529000,Null,Null,263056526,859997,17170
263056547,0.0,0.0,119000,119000,0,0,119000,Null,Null,263056547,111461,11943
263056588,0.0,0.0,119000,119000,0,0,119000,Null,Null,263056588,111461,11941
263056620,0.0,0.0,119000,119000,0,0,119000,Null,Null,263056620,111461,7064
263056625,0.0,0.0,220000,220000,0,0,220000,Null,Null,263056625,111461,28596
263056632,0.0,0.0,389000,365660,23340,6,389000,Null,Null,263056632,859997,17170
263056639,0.0,0.0,119000,119000,0,0,119000,Null,Null,263056639,111461,11943
263056641,0.0,0.0,119000,119000,0,0,119000,Null,Null,263056641,111461,11941
263057046,0.0,0.0,1200000,1200000,0,0,1200000,Null,Null,263057046,5262165,53350
263057048,0.0,0.0,119000,119000,0,0,119000,Null,Null,263057048,111461,7064
263057089,0.0,0.0,4290000,3290000,1000000,23,4290000,Null,Null,263057089,8194285,8066
263057096,0.0,0.0,179000,168260,10740,6,179000,Null,Null,263057096,859997,1612
263057098,0.0,0.0,99000,99000,0,0,99000,Null,Null,263057098,111461,11941
263057100,0.0,0.0,99000,99000,0,0,99000,Null,Null,263057100,111461,11941
263057102,0.0,0.0,109000,109000,0,0,109000,Null,Null,263057102,111461,11941
263057103,0.0,0.0,99000,99000,0,0,99000,Null,Null,263057103,111461,11941
263057106,0.0,0.0,99000,99000,0,0,99000,Null,Null,263057106,111461,11941
263057107,0.0,0.0,99000,99000,0,0,99000,Null,Null,263057107,111461,11941
263057108,0.0,0.0,99000,99000,0,0,99000,Null,Null,263057108,111461,11941
263057109,0.0,0.0,109000,109000,0,0,109000,Null,Null,263057109,111461,11941
263057114,0.0,0.0,109000,109000,0,0,109000,Null,Null,263057114,111461,11941
263057116,0.0,0.0,109000,109000,0,0,109000,Null,Null,263057116,111461,11941
263057118,0.0,0.0,99000,99000,0,0,99000,Null,Null,263057118,111461,11941
263057119,0.0,0.0,99000,99000,0,0,99000,Null,Null,263057119,111461,11941
263057120,0.0,0.0,99000,99000,0,0,99000,Null,Null,263057120,111461,11941
263057124,0.0,0.0,99000,99000,0,0,99000,Null,Null,263057124,111461,11941
263057125,0.0,0.0,99000,99000,0,0,99000,Null,Null,263057125,111461,11941
263057128,0.0,0.0,89000,89000,0,0,89000,Null,Null,263057128,111461,11941
263057133,0.0,0.0,99000,99000,0,0,99000,Null,Null,263057133,111461,11941
263057136,0.0,0.0,99000,99000,0,0,99000,Null,Null,263057136,111461,8167
263057138,0.0,0.0,99000,99000,0,0,99000,Null,Null,263057138,111461,11941
263057140,0.0,0.0,79000,79000,0,0,79000,Null,Null,263057140,111461,11941
263057141,0.0,0.0,89000,89000,0,0,89000,Null,Null,263057141,111461,11941
263057142,0.0,0.0,89000,89000,0,0,89000,Null,Null,263057142,111461,11941
263057146,0.0,0.0,79000,79000,0,0,79000,Null,Null,263057146,111461,11941
263057147,0.0,0.0,99000,99000,0,0,99000,Null,Null,263057147,111461,11941
263057153,0.0,0.0,89000,89000,0,0,89000,Null,Null,263057153,111461,11941
263057155,0.0,0.0,99000,99000,0,0,99000,Null,Null,263057155,111461,11941
263057157,0.0,0.0,89000,89000,0,0,89000,Null,Null,263057157,111461,11941
263057159,0.0,0.0,89000,89000,0,0,89000,Null,Null,263057159,111461,11941
263057161,0.0,0.0,89000,89000,0,0,89000,Null,Null,263057161,111461,11941
263057163,0.0,0.0,55000,55000,0,0,55000,Null,Null,263057163,111461,11941
263057175,0.0,0.0,89000,89000,0,0,89000,Null,Null,263057175,111461,7064
263057182,0.0,0.0,89000,89000,0,0,89000,Null,Null,263057182,111461,11943
263057190,0.0,0.0,89000,89000,0,0,89000,Null,Null,263057190,111461,11943
263057192,0.0,0.0,89000,89000,0,0,89000,Null,Null,263057192,111461,11941
263057196,0.0,0.0,89000,89000,0,0,89000,Null,Null,263057196,7823749,8206
263057203,0.0,0.0,199000,99500,99500,50,199000,Null,Null,263057203,332519,1583
263057241,0.0,0.0,89000,89000,0,0,89000,Null,Null,263057241,111461,11941
263057251,0.0,0.0,12000,12000,0,0,12000,Null,Null,263057251,111461,20254
263057257,0.0,0.0,79000,79000,0,0,79000,Null,Null,263057257,111461,11943
263057322,0.0,0.0,429000,403260,25740,6,429000,Null,Null,263057322,859997,13878
263057336,0.0,0.0,79000,79000,0,0,79000,Null,Null,263057336,111461,11941
263057343,0.0,0.0,19000,14500,4500,24,19000,Null,Null,263057343,48599,1601
263057368,0.0,0.0,299000,299000,0,0,299000,Null,Null,263057368,111461,1520
263057381,0.0,0.0,79000,79000,0,0,79000,Null,Null,263057381,111461,7064
263057401,0.0,0.0,355000,333700,21300,6,355000,Null,Null,263057401,859997,1752
263057450,0.0,0.0,1200000,1200000,0,0,1200000,Null,Null,263057450,5262165,53350
263057507,0.0,0.0,79000,79000,0,0,79000,Null,Null,263057507,111461,11941
263057510,0.0,0.0,79000,79000,0,0,79000,Null,Null,263057510,111461,7064
263057516,0.0,0.0,79000,79000,0,0,79000,Null,Null,263057516,111461,7064
263057522,0.0,0.0,79000,79000,0,0,79000,Null,Null,263057522,111461,8167
263057555,0.0,0.0,79000,79000,0,0,79000,Null,Null,263057555,111461,11941
263057575,0.0,0.0,79000,79000,0,0,79000,Null,Null,263057575,111461,11941
263057577,0.0,0.0,79000,79000,0,0,79000,Null,Null,263057577,111461,11941
263057610,0.0,0.0,89000,89000,0,0,89000,Null,Null,263057610,111461,11943
263057611,0.0,0.0,89000,89000,0,0,89000,Null,Null,263057611,111461,11941
263057640,0.0,0.0,89000,89000,0,0,89000,Null,Null,263057640,111461,7064
263057642,0.0,0.0,79000,79000,0,0,79000,Null,Null,263057642,111461,11941
263057659,0.0,0.0,1200000,1200000,0,0,1200000,Null,Null,263057659,5262165,3426
263057664,0.0,0.0,315000,296100,18900,6,315000,Null,Null,263057664,859997,13878
263057703,0.0,0.0,79000,79000,0,0,79000,Null,Null,263057703,111461,11941
263057705,0.0,0.0,79000,79000,0,0,79000,Null,Null,263057705,111461,11941
263057908,0.0,0.0,139000,69500,69500,50,139000,Null,Null,263057908,47489,1583
263057982,0.0,0.0,79000,79000,0,0,79000,Null,Null,263057982,111461,11943
263058116,0.0,0.0,89000,89000,0,0,89000,Null,Null,263058116,111461,11943
263058118,0.0,0.0,79000,79000,0,0,79000,Null,Null,263058118,111461,11941
263058120,0.0,0.0,79000,79000,0,0,79000,Null,Null,263058120,111461,7064
263058159,0.0,0.0,450000,450000,0,0,450000,Null,Null,263058159,5262165,53350
263058183,0.0,0.0,190000,125000,65000,34,190000,Null,Null,263058183,48599,1601
263058495,0.0,0.0,99000,99000,0,0,99000,Null,Null,263058495,111461,8167
263058509,0.0,0.0,15000,15000,0,0,15000,Null,Null,263058509,111461,20254
263058521,0.0,0.0,89000,89000,0,0,89000,Null,Null,263058521,111461,8167
263058609,2.0,2.0,69000,69000,0,0,69000,Null,Null,263058609,111461,8167
263058646,0.0,0.0,10000,10000,0,0,10000,Null,Null,263058646,7823749,8197
263058695,1.0,1.0,270000,147000,123000,46,270000,Null,Null,263058695,470105,17162
263058823,0.0,0.0,30000,30000,0,0,30000,Null,Null,263058823,3793401,11605
263058829,0.0,0.0,12000,12000,0,0,12000,Null,Null,263058829,111461,20254
263059025,0.0,0.0,4990000,4690000,300000,6,4990000,Null,Null,263059025,18802,1795
263059963,0.0,0.0,1099000,1099000,0,0,1099000,Null,Null,263059963,162957,4428
263059976,0.0,0.0,12000,12000,0,0,12000,Null,Null,263059976,111461,20254
263059994,0.0,0.0,120000,120000,0,0,120000,Null,Null,263059994,149256,28576
263060169,0.0,0.0,22381000,22381000,0,0,22381000,Null,Null,263060169,111461,6653
263060204,0.0,0.0,990000,499000,491000,50,990000,Null,Null,263060204,18802,28454
263060220,0.0,0.0,52000,52000,0,0,52000,Null,Null,263060220,111461,20252
263060222,0.0,0.0,4200000,4200000,0,0,4200000,Null,Null,263060222,7982659,8512
263060242,0.0,0.0,120000,120000,0,0,120000,Null,Null,263060242,149256,28576
263060294,0.0,0.0,6490000,5990000,500000,8,6490000,Null,Null,263060294,18802,1795
263060317,0.0,0.0,120000,120000,0,0,120000,Null,Null,263060317,149256,28576
263060353,0.0,0.0,4200000,4200000,0,0,4200000,Null,Null,263060353,7982659,8512
263060389,0.0,0.0,350000,350000,0,0,350000,Null,Null,263060389,243693,5566
263060432,0.0,0.0,189000,189000,0,0,189000,Null,Null,263060432,294433,1641
263060492,0.0,0.0,189000,189000,0,0,189000,Null,Null,263060492,294433,1641
263060530,0.0,0.0,129000,129000,0,0,129000,Null,Null,263060530,294433,8196
263060561,0.0,0.0,500000,500000,0,0,500000,Null,Null,263060561,111461,28644
263060615,0.0,0.0,168000,168000,0,0,168000,Null,Null,263060615,111461,8400
263060713,0.0,0.0,1000,1000,0,0,1000,Null,Null,263060713,111461,2
263060749,0.0,0.0,750000,750000,0,0,750000,Null,Null,263060749,111461,28644
263060838,0.0,0.0,500000,500000,0,0,500000,Null,Null,263060838,111461,26652
263060845,0.0,0.0,29000,29000,0,0,29000,Null,Null,263060845,250407,11875
263060850,0.0,0.0,680000,680000,0,0,680000,Null,Null,263060850,111461,7079
263060890,0.0,0.0,600000,600000,0,0,600000,Null,Null,263060890,111461,7079
263061402,0.0,0.0,690000,621000,69000,10,690000,Null,Null,263061402,881487,53350
263061513,0.0,0.0,690000,621000,69000,10,690000,Null,Null,263061513,881487,2347
263061675,0.0,0.0,790000,711000,79000,10,790000,Null,Null,263061675,881487,17170
263061691,0.0,0.0,360000,324000,36000,10,360000,Null,Null,263061691,881487,5893
263061949,0.0,0.0,516000,464400,51600,10,516000,Null,Null,263061949,881487,5893
263061969,0.0,0.0,1530000,1377000,153000,10,1530000,Null,Null,263061969,881487,8227
263062106,0.0,0.0,1890500,1701450,189050,10,1890500,Null,Null,263062106,881487,5893
263062250,0.0,0.0,1539000,1385100,153900,10,1539000,Null,Null,263062250,881487,8227
263062294,0.0,0.0,620000,558000,62000,10,620000,Null,Null,263062294,881487,53350
263062389,0.0,0.0,45000,45000,0,0,45000,Null,Null,263062389,111461,15250
263062509,0.0,0.0,535000,535000,0,0,535000,Null,Null,263062509,111461,1634
263062630,0.0,0.0,80000,80000,0,0,80000,Null,Null,263062630,111461,1819
263063350,0.0,0.0,55000,55000,0,0,55000,Null,Null,263063350,111461,2
263063644,0.0,0.0,35000,35000,0,0,35000,Null,Null,263063644,111461,2
263063721,0.0,0.0,18000,18000,0,0,18000,Null,Null,263063721,111461,2
263064063,0.0,0.0,55000,55000,0,0,55000,Null,Null,263064063,111461,28574
263065826,0.0,0.0,420000,420000,0,0,420000,Null,Null,263065826,111461,49724
263065870,0.0,0.0,320000,320000,0,0,320000,Null,Null,263065870,111461,2
263066197,0.0,0.0,130000,130000,0,0,130000,Null,Null,263066197,149308,28576
263066262,0.0,0.0,12000,12000,0,0,12000,Null,Null,263066262,111461,20254
263066523,1.0,1.0,18000,18000,0,0,18000,Null,Null,263066523,111461,20254
263066582,30.0,30.0,2145000,2145000,0,0,2145000,Null,Null,263066582,19018,1520
263066608,0.0,0.0,315000,228000,87000,28,315000,Null,Null,263066608,470105,1616
263066689,0.0,0.0,44699000,44699000,0,0,44699000,Null,Null,263066689,111461,23056
263066691,0.0,0.0,1500,1500,0,0,1500,Null,Null,263066691,111461,2363
263066771,0.0,0.0,888000,888000,0,0,888000,Null,Null,263066771,111461,5566
263066795,0.0,0.0,5290000,5290000,0,0,5290000,Null,Null,263066795,111461,1626
263066797,0.0,0.0,1500,990,510,34,1500,Null,Null,263066797,111461,2363
263066808,0.0,0.0,360000,360000,0,0,360000,Null,Null,263066808,183315,11859
263066812,0.0,0.0,654000,450000,204000,31,654000,Null,Null,263066812,470105,8223
263066861,0.0,0.0,899000,899000,0,0,899000,Null,Null,263066861,111461,5566
263067009,0.0,0.0,378000,378000,0,0,378000,Null,Null,263067009,294433,1641
263067111,0.0,0.0,899000,899000,0,0,899000,Null,Null,263067111,111461,8073
263067368,0.0,0.0,458000,458000,0,0,458000,Null,Null,263067368,111461,5267
263067373,0.0,0.0,9607000,8490000,1117000,12,9607000,Null,Null,263067373,47424,2342
263067468,0.0,0.0,590000,531000,59000,10,590000,Null,Null,263067468,881487,2347
263067604,0.0,0.0,325000,325000,0,0,325000,Null,Null,263067604,413747,1601
263067644,0.0,0.0,420000,420000,0,0,420000,Null,Null,263067644,8078383,8206
263067834,0.0,0.0,590000,531000,59000,10,590000,Null,Null,263067834,881487,11605
263067866,0.0,0.0,325000,325000,0,0,325000,Null,Null,263067866,413747,1601
263067868,0.0,0.0,279000,279000,0,0,279000,Null,Null,263067868,8078383,53350
263067879,0.0,0.0,220000,209000,11000,5,220000,Null,Null,263067879,41083,1838
263067988,0.0,0.0,209000,209000,0,0,209000,Null,Null,263067988,111461,28462
263068183,0.0,0.0,159000,159000,0,0,159000,Null,Null,263068183,111461,28464
263068286,0.0,0.0,899000,899000,0,0,899000,Null,Null,263068286,111461,5566
263068297,0.0,0.0,159000,159000,0,0,159000,Null,Null,263068297,111461,28464
263068303,0.0,0.0,625000,625000,0,0,625000,Null,Null,263068303,111461,10413
263068345,0.0,0.0,1885000,1300000,585000,31,1885000,Null,Null,263068345,47427,11905
263068411,0.0,0.0,2250000,2250000,0,0,2250000,Null,Null,263068411,579445,15236
263068462,0.0,0.0,680000,470000,210000,31,680000,Null,Null,263068462,47427,11905
263068486,0.0,0.0,3250000,3250000,0,0,3250000,Null,Null,263068486,579445,15236
263068529,0.0,0.0,420000,289000,131000,31,420000,Null,Null,263068529,47427,11905
263068616,0.0,0.0,347000,240000,107000,31,347000,Null,Null,263068616,47427,11905
263068671,0.0,0.0,898000,898000,0,0,898000,Null,Null,263068671,111461,5566
263068676,0.0,0.0,1560000,1404000,156000,10,1560000,Null,Null,263068676,881487,8227
263068710,0.0,0.0,3950000,3950000,0,0,3950000,Null,Null,263068710,579445,15236
263068719,3.0,3.0,682000,345000,337000,49,682000,Null,Null,263068719,47427,11905
263068725,0.0,0.0,325000,325000,0,0,325000,Null,Null,263068725,413747,1601
263068729,0.0,0.0,615000,615000,0,0,615000,Null,Null,263068729,111461,2334
263068767,0.0,0.0,950000,950000,0,0,950000,Null,Null,263068767,579445,15236
263068773,0.0,0.0,725000,639000,86000,12,725000,Null,Null,263068773,47427,11905
263068777,0.0,0.0,615000,615000,0,0,615000,Null,Null,263068777,111461,2334
263068828,0.0,0.0,110000,110000,0,0,110000,Null,Null,263068828,111461,26652
263068834,0.0,0.0,725000,639000,86000,12,725000,Null,Null,263068834,47427,11905
263068973,0.0,0.0,89000,89000,0,0,89000,Null,Null,263068973,7823749,8221
263068975,0.0,0.0,499000,499000,0,0,499000,Null,Null,263068975,111461,10413
263069062,0.0,0.0,100000,100000,0,0,100000,Null,Null,263069062,47427,11905
263069083,0.0,0.0,215000,195000,20000,9,215000,Null,Null,263069083,8192645,1637
263069102,0.0,0.0,200000,200000,0,0,200000,Null,Null,263069102,47427,11905
263069180,0.0,0.0,774000,774000,0,0,774000,Null,Null,263069180,111461,2324
263069390,0.0,0.0,235000,215000,20000,9,235000,Null,Null,263069390,8192645,13878
263069524,0.0,0.0,99000,60390,38610,39,99000,Null,Null,263069524,500047,5566
263070022,0.0,0.0,1500,1500,0,0,1500,Null,Null,263070022,111461,2
263070283,0.0,0.0,450000,379000,71000,16,450000,Null,Null,263070283,8192645,13878
263070305,0.0,0.0,99000,60390,38610,39,99000,Null,Null,263070305,500047,3805
263070313,0.0,0.0,1129500,1016550,112950,10,1129500,Null,Null,263070313,881487,8227
263070319,0.0,0.0,899000,899000,0,0,899000,Null,Null,263070319,213529,5566
263070330,0.0,0.0,775000,775000,0,0,775000,Null,Null,263070330,111461,8067
263070333,0.0,0.0,75000,75000,0,0,75000,Null,Null,263070333,7823749,8206
263071074,0.0,0.0,627000,627000,0,0,627000,Null,Null,263071074,111461,11803
263071097,0.0,0.0,430000,349000,81000,19,430000,Null,Null,263071097,8192645,1637
263071156,0.0,0.0,500000,450000,50000,10,500000,Null,Null,263071156,499843,11873
263071173,0.0,0.0,899000,899000,0,0,899000,Null,Null,263071173,510967,5566
263071421,0.0,0.0,550000,550000,0,0,550000,Null,Null,263071421,111461,3426
263071454,0.0,0.0,299000,199000,100000,33,299000,Null,Null,263071454,111461,1815
263071507,0.0,0.0,665000,535000,130000,20,665000,Null,Null,263071507,8192645,13878
263071759,0.0,0.0,3190000,2890000,300000,9,3190000,Null,Null,263071759,162007,1795
263071771,0.0,0.0,850000,850000,0,0,850000,Null,Null,263071771,111461,5566
263071793,0.0,0.0,120000,120000,0,0,120000,Null,Null,263071793,8100443,11875
263071900,0.0,0.0,3990000,3540000,450000,11,3990000,Null,Null,263071900,162007,1795
263071926,0.0,0.0,470000,399000,71000,15,470000,Null,Null,263071926,8192645,13878
263071970,0.0,0.0,13000,13000,0,0,13000,Null,Null,263071970,7823749,1601
263072001,0.0,0.0,4490000,3990000,500000,11,4490000,Null,Null,263072001,162007,1795
263072010,0.0,0.0,8490000,8490000,0,0,8490000,Null,Null,263072010,18802,1795
263072071,0.0,0.0,75000,72000,3000,4,75000,Null,Null,263072071,111461,2
263072073,0.0,0.0,100000,92000,8000,8,100000,Null,Null,263072073,111461,2
263072075,0.0,0.0,133000,122000,11000,8,133000,Null,Null,263072075,111461,2
263072077,0.0,0.0,40000,36800,3200,8,40000,Null,Null,263072077,111461,2
263072082,0.0,0.0,165000,151800,13200,8,165000,Null,Null,263072082,111461,2
263072084,0.0,0.0,87000,80000,7000,8,87000,Null,Null,263072084,111461,2
263072085,0.0,0.0,85000,56000,29000,34,85000,Null,Null,263072085,111461,2
263072087,0.0,0.0,86000,84000,2000,2,86000,Null,Null,263072087,111461,2
263072092,0.0,0.0,92000,86000,6000,7,92000,Null,Null,263072092,111461,2
263072093,0.0,0.0,114000,104000,10000,9,114000,Null,Null,263072093,111461,2
263072096,0.0,0.0,39000,37000,2000,5,39000,Null,Null,263072096,111461,2
263072099,0.0,0.0,73600,59000,14600,20,73600,Null,Null,263072099,111461,2
263072102,0.0,0.0,113000,103000,10000,9,113000,Null,Null,263072102,111461,2
263072104,0.0,0.0,65000,55000,10000,15,65000,Null,Null,263072104,111461,2
263072112,0.0,0.0,140000,128000,12000,9,140000,Null,Null,263072112,111461,2
263072116,0.0,0.0,81000,74500,6500,8,81000,Null,Null,263072116,111461,2
263072118,0.0,0.0,136400,125000,11400,8,136400,Null,Null,263072118,111461,2
263072122,0.0,0.0,228000,209000,19000,8,228000,Null,Null,263072122,111461,2
263072126,0.0,0.0,46000,42000,4000,9,46000,Null,Null,263072126,111461,2
263072127,0.0,0.0,99000,91000,8000,8,99000,Null,Null,263072127,111461,2
263072130,0.0,0.0,20000,18400,1600,8,20000,Null,Null,263072130,111461,2
263072132,0.0,0.0,85000,78000,7000,8,85000,Null,Null,263072132,111461,2
263072134,0.0,0.0,320000,310000,10000,3,320000,Null,Null,263072134,471233,2
263072136,0.0,0.0,75000,69000,6000,8,75000,Null,Null,263072136,111461,2
263072141,0.0,0.0,91000,83700,7300,8,91000,Null,Null,263072141,111461,2
263072151,0.0,0.0,150000,138000,12000,8,150000,Null,Null,263072151,111461,2
263072153,0.0,0.0,66500,61000,5500,8,66500,Null,Null,263072153,111461,2
263072155,0.0,0.0,70000,64400,5600,8,70000,Null,Null,263072155,111461,2
263072193,0.0,0.0,375000,375000,0,0,375000,Null,Null,263072193,726687,8223
263072326,0.0,0.0,430000,350000,80000,19,430000,Null,Null,263072326,8192645,1752
263072328,0.0,0.0,300000,300000,0,0,300000,Null,Null,263072328,111461,8513
263072334,0.0,0.0,1160000,1160000,0,0,1160000,Null,Null,263072334,111461,5566
263072416,0.0,0.0,170000,170000,0,0,170000,Null,Null,263072416,111461,8225
263072500,0.0,0.0,999000,999000,0,0,999000,Null,Null,263072500,4407561,8512
263072603,0.0,0.0,450000,379000,71000,16,450000,Null,Null,263072603,8192645,8226
263072605,0.0,0.0,145000,145000,0,0,145000,Null,Null,263072605,111461,28644
263072607,0.0,0.0,38000,38000,0,0,38000,Null,Null,263072607,7823749,11835
263073123,0.0,0.0,70000,46400,23600,34,70000,Null,Null,263073123,4259871,11877
263073125,0.0,0.0,250000,250000,0,0,250000,Null,Null,263073125,111461,8225
263073128,0.0,0.0,6690000,6690000,0,0,6690000,Null,Null,263073128,25422,1795
263073177,0.0,0.0,119000,119000,0,0,119000,Null,Null,263073177,111461,28464
263073248,0.0,0.0,684000,684000,0,0,684000,Null,Null,263073248,21651,4429
263073284,0.0,0.0,599000,599000,0,0,599000,Null,Null,263073284,111393,28696
263073286,0.0,0.0,97400,94000,3400,3,97400,Null,Null,263073286,111461,28480
263073297,0.0,0.0,20298000,20298000,0,0,20298000,Null,Null,263073297,111461,28868
263073345,0.0,0.0,584000,584000,0,0,584000,Null,Null,263073345,111393,28696
263073348,0.0,0.0,155000,155000,0,0,155000,Null,Null,263073348,111461,28644
263073371,0.0,0.0,39000,39000,0,0,39000,Null,Null,263073371,111461,8225
263073482,0.0,0.0,269000,269000,0,0,269000,Null,Null,263073482,111461,28462
263073487,0.0,0.0,5490000,4990000,500000,9,5490000,Null,Null,263073487,162007,1795
263073555,0.0,0.0,4990000,4590000,400000,8,4990000,Null,Null,263073555,162007,1795
263073562,0.0,0.0,199000,199000,0,0,199000,Null,Null,263073562,111461,28462
263073663,0.0,0.0,239000,239000,0,0,239000,Null,Null,263073663,111461,28462
263073802,0.0,0.0,490000,490000,0,0,490000,Null,Null,263073802,18984,3428
263073904,0.0,0.0,199890,199890,0,0,199890,Null,Null,263073904,111461,2
263074041,0.0,0.0,104890,104890,0,0,104890,Null,Null,263074041,111461,2
263074340,0.0,0.0,42890,42890,0,0,42890,Null,Null,263074340,111461,2
263074528,0.0,0.0,14328000,14328000,0,0,14328000,Null,Null,263074528,111461,11518
263074569,0.0,0.0,635000,635000,0,0,635000,Null,Null,263074569,111461,28462
263074631,0.0,0.0,925000,925000,0,0,925000,Null,Null,263074631,111461,10413
263074643,0.0,0.0,665000,486000,179000,27,665000,Null,Null,263074643,8192645,8226
263074659,0.0,0.0,158000,158000,0,0,158000,Null,Null,263074659,7516279,1613
263074690,0.0,0.0,270000,149000,121000,45,270000,Null,Null,263074690,470105,17162
263074701,8.0,8.0,119000,119000,0,0,119000,Null,Null,263074701,203917,1520
263074713,0.0,0.0,750000,750000,0,0,750000,Null,Null,263074713,111461,53350
263074728,0.0,0.0,110000,110000,0,0,110000,Null,Null,263074728,4202899,1831
263074759,0.0,0.0,899000,899000,0,0,899000,Null,Null,263074759,111461,10413
263074762,0.0,0.0,7361000,7361000,0,0,7361000,Null,Null,263074762,111461,2324
263074919,0.0,0.0,3500,3500,0,0,3500,Null,Null,263074919,7823749,13878
263074964,0.0,0.0,849000,849000,0,0,849000,Null,Null,263074964,18984,1838
263074974,0.0,0.0,20298000,20298000,0,0,20298000,Null,Null,263074974,111461,2324
263075443,0.0,0.0,270000,149000,121000,45,270000,Null,Null,263075443,470105,17162
263075454,0.0,0.0,299000,299000,0,0,299000,Null,Null,263075454,4407561,5385
263075587,0.0,0.0,1510000,1510000,0,0,1510000,Null,Null,263075587,111461,10413
263075601,0.0,0.0,650000,650000,0,0,650000,Null,Null,263075601,111461,53350
263075629,0.0,0.0,5400000,5400000,0,0,5400000,Null,Null,263075629,579445,15236
263075663,0.0,0.0,510000,510000,0,0,510000,Null,Null,263075663,111461,28462
263075722,0.0,0.0,9911000,9911000,0,0,9911000,Null,Null,263075722,111461,2324
263075735,0.0,0.0,4250000,4250000,0,0,4250000,Null,Null,263075735,579445,15236
263075792,0.0,0.0,1690000,1690000,0,0,1690000,Null,Null,263075792,111461,28462
263075799,0.0,0.0,2250000,2250000,0,0,2250000,Null,Null,263075799,579445,15236
263076175,0.0,0.0,899000,899000,0,0,899000,Null,Null,263076175,8188233,11689
263076278,0.0,0.0,11000,11000,0,0,11000,Null,Null,263076278,48381,1601
263076454,0.0,0.0,650000,650000,0,0,650000,Null,Null,263076454,111461,53350
263076934,0.0,0.0,23000,23000,0,0,23000,Null,Null,263076934,7823749,11605
263076977,0.0,0.0,650000,650000,0,0,650000,Null,Null,263076977,8188233,2340
263076992,4.0,4.0,4200000,3780000,420000,10,4200000,Null,Null,263076992,111461,1789
263077099,0.0,0.0,120000,120000,0,0,120000,Null,Null,263077099,111461,49722
263077127,0.0,0.0,1390000,1390000,0,0,1390000,Null,Null,263077127,209501,3428
263077133,0.0,0.0,990000,990000,0,0,990000,Null,Null,263077133,209501,1831
263077135,0.0,0.0,110000,110000,0,0,110000,Null,Null,263077135,48381,1601
263077197,0.0,0.0,235000,235000,0,0,235000,Null,Null,263077197,111461,28462
263077504,0.0,0.0,259000,259000,0,0,259000,Null,Null,263077504,111461,28462
263077583,0.0,0.0,9766000,9766000,0,0,9766000,Null,Null,263077583,111461,2324
263077714,0.0,0.0,10000,10000,0,0,10000,Null,Null,263077714,111461,20258
263077844,0.0,0.0,2300000,2300000,0,0,2300000,Null,Null,263077844,8194777,17186
263078009,0.0,0.0,380000,350000,30000,8,380000,Null,Null,263078009,8194775,11857
263078235,0.0,0.0,4690000,4690000,0,0,4690000,Null,Null,263078235,7982659,8512
263078237,0.0,0.0,1500,1500,0,0,1500,Null,Null,263078237,111461,23136
263078348,0.0,0.0,30500000,30500000,0,0,30500000,Null,Null,263078348,111461,6653
263078430,0.0,0.0,1499000,1499000,0,0,1499000,Null,Null,263078430,7391941,11935
263078435,0.0,0.0,289000,289000,0,0,289000,Null,Null,263078435,111461,7061
263078446,0.0,0.0,90000,90000,0,0,90000,Null,Null,263078446,7338129,11875
263078469,0.0,0.0,4590000,3901500,688500,15,4590000,Null,Null,263078469,208841,2340
263078565,0.0,0.0,1190000,1190000,0,0,1190000,Null,Null,263078565,111461,10413
263078757,0.0,0.0,149000,149000,0,0,149000,Null,Null,263078757,111461,1616
263078790,0.0,0.0,780000,780000,0,0,780000,Null,Null,263078790,8188233,5905
263078943,0.0,0.0,4590000,4590000,0,0,4590000,Null,Null,263078943,208841,2340
263078951,0.0,0.0,64000,64000,0,0,64000,Null,Null,263078951,7516279,8602
263078985,0.0,0.0,185000,185000,0,0,185000,Null,Null,263078985,111461,28644
263079029,0.0,0.0,4490000,4490000,0,0,4490000,Null,Null,263079029,7982659,8512
263079038,0.0,0.0,699000,699000,0,0,699000,Null,Null,263079038,111461,28462
263079064,0.0,0.0,780000,780000,0,0,780000,Null,Null,263079064,8188233,11937
263079151,0.0,0.0,20298000,20298000,0,0,20298000,Null,Null,263079151,111461,28868
263079187,0.0,0.0,113000,113000,0,0,113000,Null,Null,263079187,179125,11835
263079222,0.0,0.0,4990000,4241500,748500,15,4990000,Null,Null,263079222,208841,2340
263079259,0.0,0.0,269000,269000,0,0,269000,Null,Null,263079259,111461,28462
263079558,0.0,0.0,180000,180000,0,0,180000,Null,Null,263079558,111461,15318
263079790,0.0,0.0,120000,120000,0,0,120000,Null,Null,263079790,111461,15318
263079811,0.0,0.0,116000,116000,0,0,116000,Null,Null,263079811,111461,15318
263079850,0.0,0.0,279000,279000,0,0,279000,Null,Null,263079850,111461,28462
263079860,0.0,0.0,10000,10000,0,0,10000,Null,Null,263079860,111461,20258
263079919,2.0,2.0,215000,215000,0,0,215000,Null,Null,263079919,5242323,11835
263080008,0.0,0.0,221000,221000,0,0,221000,Null,Null,263080008,111461,28732
263080011,0.0,0.0,115000,115000,0,0,115000,Null,Null,263080011,5242323,11835
263080267,0.0,0.0,53000,29000,24000,45,53000,Null,Null,263080267,48381,1583
263080307,0.0,0.0,209000,209000,0,0,209000,Null,Null,263080307,5272071,2340
263080371,0.0,0.0,210000,210000,0,0,210000,Null,Null,263080371,111461,8519
263080518,0.0,0.0,49000,49000,0,0,49000,Null,Null,263080518,7823749,11835
263080580,0.0,0.0,209000,209000,0,0,209000,Null,Null,263080580,5272071,2340
263080684,0.0,0.0,150000,150000,0,0,150000,Null,Null,263080684,111461,28736
263080702,0.0,0.0,24000,24000,0,0,24000,Null,Null,263080702,111461,20236
263080731,0.0,0.0,239000,239000,0,0,239000,Null,Null,263080731,111461,28462
263080764,0.0,0.0,209000,209000,0,0,209000,Null,Null,263080764,5272071,2340
263081149,0.0,0.0,279000,279000,0,0,279000,Null,Null,263081149,111461,28462
263081172,0.0,0.0,2490000,2236000,254000,10,2490000,Null,Null,263081172,111461,20258
263081207,0.0,0.0,545000,545000,0,0,545000,Null,Null,263081207,111461,28454
263081315,0.0,0.0,639000,595000,44000,7,639000,Null,Null,263081315,111461,20182
263081417,0.0,0.0,120000,120000,0,0,120000,Null,Null,263081417,111461,28594
263081460,0.0,0.0,255000,255000,0,0,255000,Null,Null,263081460,111461,28462
263081502,0.0,0.0,15000,15000,0,0,15000,Null,Null,263081502,111461,8309
263081809,0.0,0.0,460000,460000,0,0,460000,Null,Null,263081809,5040375,12864
263081821,0.0,0.0,129000,129000,0,0,129000,Null,Null,263081821,7823749,11835
263082174,0.0,0.0,149000,149000,0,0,149000,Null,Null,263082174,111461,2324
263082359,0.0,0.0,2359000,2359000,0,0,2359000,Null,Null,263082359,111461,20250
263082533,0.0,0.0,200000,150000,50000,25,200000,Null,Null,263082533,4584203,17186
263082624,0.0,0.0,339000,315000,24000,7,339000,Null,Null,263082624,111461,20182
263082693,0.0,0.0,141000,141000,0,0,141000,Null,Null,263082693,288079,11873
263083153,0.0,0.0,450000,450000,0,0,450000,Null,Null,263083153,288079,11847
263083159,0.0,0.0,279000,279000,0,0,279000,Null,Null,263083159,7823755,1583
263083438,13.0,13.0,279000,139500,139500,50,279000,Null,Null,263083438,859997,2
263083462,0.0,0.0,17000,8900,8100,48,17000,Null,Null,263083462,50278,1601
263083497,55.0,55.0,295000,265500,29500,10,295000,Null,Null,263083497,859997,2
263083505,0.0,0.0,5499000,5499000,0,0,5499000,Null,Null,263083505,111461,20252
263083523,0.0,0.0,549000,549000,0,0,549000,Null,Null,263083523,7823755,2347
263083537,0.0,0.0,189000,176000,13000,7,189000,Null,Null,263083537,111461,20182
263083692,0.0,0.0,5290000,3980000,1310000,25,5290000,Null,Null,263083692,8194285,8067
263083908,0.0,0.0,239000,239000,0,0,239000,Null,Null,263083908,111461,2324
263083969,0.0,0.0,118000,118000,0,0,118000,Null,Null,263083969,288079,11873
263083972,0.0,0.0,14000,14000,0,0,14000,Null,Null,263083972,7823749,1628
263083975,0.0,0.0,99000,94050,4950,5,99000,Null,Null,263083975,243693,28460
263084035,0.0,0.0,12000,12000,0,0,12000,Null,Null,263084035,111461,20254
263084237,0.0,0.0,149000,149000,0,0,149000,Null,Null,263084237,111461,1616
263084241,0.0,0.0,133000,133000,0,0,133000,Null,Null,263084241,288079,11859
263084272,0.0,0.0,289000,289000,0,0,289000,Null,Null,263084272,111461,8223
263084810,0.0,0.0,7000000,5990000,1010000,14,7000000,Null,Null,263084810,892671,8165
263084819,0.0,0.0,12000,12000,0,0,12000,Null,Null,263084819,111461,20254
263084960,0.0,0.0,495000,495000,0,0,495000,Null,Null,263084960,7823755,8206
263085420,0.0,0.0,155000,155000,0,0,155000,Null,Null,263085420,111461,2324
263085444,0.0,0.0,830000,747000,83000,10,830000,Null,Null,263085444,7391407,53350
263085490,0.0,0.0,205000,205000,0,0,205000,Null,Null,263085490,111461,28644
263085532,0.0,0.0,309000,309000,0,0,309000,Null,Null,263085532,7823755,3426
263085534,0.0,0.0,520000,520000,0,0,520000,Null,Null,263085534,111461,7079
263085610,0.0,0.0,1800000,1800000,0,0,1800000,Null,Null,263085610,111461,7079
263085648,0.0,0.0,849000,629200,219800,26,849000,Null,Null,263085648,48201,11887
263085680,0.0,0.0,318000,254400,63600,20,318000,Null,Null,263085680,48201,11887
263085813,0.0,0.0,120000,99000,21000,18,120000,Null,Null,263085813,111461,28428
263085828,0.0,0.0,900000,900000,0,0,900000,Null,Null,263085828,111461,7079
263085929,0.0,0.0,1000000,1000000,0,0,1000000,Null,Null,263085929,111461,7079
263085936,0.0,0.0,157900,153000,4900,3,157900,Null,Null,263085936,111461,28696
263086121,0.0,0.0,495000,495000,0,0,495000,Null,Null,263086121,7823755,17170
263086144,0.0,0.0,595000,595000,0,0,595000,Null,Null,263086144,7823755,17170
263086787,0.0,0.0,3350000,3350000,0,0,3350000,Null,Null,263086787,162957,1815
263086829,0.0,0.0,4990000,4990000,0,0,4990000,Null,Null,263086829,7982659,8512
263087206,0.0,0.0,250000,250000,0,0,250000,Null,Null,263087206,111461,7078
263087304,0.0,0.0,245000,245000,0,0,245000,Null,Null,263087304,111461,7078
263088208,0.0,0.0,35000,35000,0,0,35000,Null,Null,263088208,111461,2
263088310,0.0,0.0,125000,125000,0,0,125000,Null,Null,263088310,111461,2
263088314,0.0,0.0,970000,970000,0,0,970000,Null,Null,263088314,111461,2
263088322,0.0,0.0,97000,97000,0,0,97000,Null,Null,263088322,111461,2
263088323,0.0,0.0,125000,125000,0,0,125000,Null,Null,263088323,111461,2
263088338,0.0,0.0,97000,97000,0,0,97000,Null,Null,263088338,111461,2
263088342,0.0,0.0,97000,97000,0,0,97000,Null,Null,263088342,111461,2
263088344,0.0,0.0,97000,97000,0,0,97000,Null,Null,263088344,111461,2
263088355,0.0,0.0,97000,97000,0,0,97000,Null,Null,263088355,111461,2
263088373,0.0,0.0,97000,97000,0,0,97000,Null,Null,263088373,111461,2
263088376,0.0,0.0,97000,97000,0,0,97000,Null,Null,263088376,111461,2
263088943,0.0,0.0,225000,225000,0,0,225000,Null,Null,263088943,411791,13878
263089151,0.0,0.0,190000,190000,0,0,190000,Null,Null,263089151,111461,3804
263089260,0.0,0.0,329000,329000,0,0,329000,Null,Null,263089260,4407561,5385
263089417,0.0,0.0,120000,120000,0,0,120000,Null,Null,263089417,111461,28738
263089534,0.0,0.0,2780000,2780000,0,0,2780000,Null,Null,263089534,111461,2
263089536,0.0,0.0,1590000,1590000,0,0,1590000,Null,Null,263089536,111461,2
263089538,0.0,0.0,2290000,2290000,0,0,2290000,Null,Null,263089538,111461,8511
263089540,0.0,0.0,2830000,2830000,0,0,2830000,Null,Null,263089540,111461,2
263089542,0.0,0.0,2890000,2890000,0,0,2890000,Null,Null,263089542,111461,8511
263089545,0.0,0.0,13970000,13970000,0,0,13970000,Null,Null,263089545,111461,2
263089548,0.0,0.0,720000,720000,0,0,720000,Null,Null,263089548,111461,8511
263089550,0.0,0.0,9540000,9540000,0,0,9540000,Null,Null,263089550,111461,2
263089552,0.0,0.0,1760000,1760000,0,0,1760000,Null,Null,263089552,111461,8511
263089554,0.0,0.0,1870000,1870000,0,0,1870000,Null,Null,263089554,111461,2
263089556,0.0,0.0,2780000,2780000,0,0,2780000,Null,Null,263089556,111461,2
263089558,0.0,0.0,2150000,2150000,0,0,2150000,Null,Null,263089558,111461,2
263089560,0.0,0.0,1700000,1700000,0,0,1700000,Null,Null,263089560,111461,8511
263089562,0.0,0.0,1420000,1420000,0,0,1420000,Null,Null,263089562,111461,2
263089564,0.0,0.0,6140000,6140000,0,0,6140000,Null,Null,263089564,111461,2
263089566,0.0,0.0,3120000,3120000,0,0,3120000,Null,Null,263089566,111461,2
263089568,0.0,0.0,1760000,1760000,0,0,1760000,Null,Null,263089568,111461,2
263089570,0.0,0.0,1960000,1960000,0,0,1960000,Null,Null,263089570,111461,2
263089572,0.0,0.0,7790000,7790000,0,0,7790000,Null,Null,263089572,111461,2
263089574,0.0,0.0,2080000,2080000,0,0,2080000,Null,Null,263089574,111461,8511
263089576,0.0,0.0,1760000,1760000,0,0,1760000,Null,Null,263089576,111461,8511
263089578,0.0,0.0,2550000,2550000,0,0,2550000,Null,Null,263089578,111461,2
263089580,0.0,0.0,4820000,4820000,0,0,4820000,Null,Null,263089580,111461,8511
263089582,0.0,0.0,1020000,1020000,0,0,1020000,Null,Null,263089582,111461,2
263089583,0.0,0.0,740000,740000,0,0,740000,Null,Null,263089583,111461,8511
263089597,0.0,0.0,2550000,2550000,0,0,2550000,Null,Null,263089597,111461,2
263089599,0.0,0.0,2490000,2490000,0,0,2490000,Null,Null,263089599,111461,2
263089601,0.0,0.0,3120000,3120000,0,0,3120000,Null,Null,263089601,111461,2
263089603,0.0,0.0,2270000,2270000,0,0,2270000,Null,Null,263089603,111461,8511
263089605,0.0,0.0,2150000,2150000,0,0,2150000,Null,Null,263089605,111461,8511
263089607,0.0,0.0,2150000,2150000,0,0,2150000,Null,Null,263089607,111461,8511
263089609,0.0,0.0,1460000,1460000,0,0,1460000,Null,Null,263089609,111461,8511
263089611,0.0,0.0,4140000,4140000,0,0,4140000,Null,Null,263089611,111461,8511
263089613,0.0,0.0,2990000,2990000,0,0,2990000,Null,Null,263089613,111461,8511
263089615,0.0,0.0,2950000,2950000,0,0,2950000,Null,Null,263089615,111461,8511
263089617,0.0,0.0,2780000,2780000,0,0,2780000,Null,Null,263089617,111461,8511
263089619,0.0,0.0,1920000,1920000,0,0,1920000,Null,Null,263089619,111461,8511
263089622,0.0,0.0,3350000,3350000,0,0,3350000,Null,Null,263089622,111461,2
263089624,0.0,0.0,4790000,4790000,0,0,4790000,Null,Null,263089624,111461,8511
263089625,0.0,0.0,1040000,1040000,0,0,1040000,Null,Null,263089625,111461,8511
263089628,0.0,0.0,3350000,3350000,0,0,3350000,Null,Null,263089628,111461,2
263089630,0.0,0.0,570000,570000,0,0,570000,Null,Null,263089630,111461,8511
263089731,0.0,0.0,235000,235000,0,0,235000,Null,Null,263089731,411791,4413
263092671,0.0,0.0,10000,10000,0,0,10000,Null,Null,263092671,111461,2
263092869,0.0,0.0,250000,250000,0,0,250000,Null,Null,263092869,4973949,28644
263094428,0.0,0.0,390000,370000,20000,5,390000,Null,Null,263094428,111461,28618
263094944,0.0,0.0,390000,370000,20000,5,390000,Null,Null,263094944,111461,28618
263094967,0.0,0.0,450000,430000,20000,4,450000,Null,Null,263094967,111461,28618
263096174,0.0,0.0,2690000,2690000,0,0,2690000,Null,Null,263096174,18776,1831
263096794,0.0,0.0,409000,409000,0,0,409000,Null,Null,263096794,111461,20244
263097043,0.0,0.0,12000,12000,0,0,12000,Null,Null,263097043,111461,20254
263097055,0.0,0.0,199000,139000,60000,30,199000,Null,Null,263097055,8052179,8167
263097680,0.0,0.0,170000,85000,85000,50,170000,Null,Null,263097680,50278,1601
263097960,0.0,0.0,24000,24000,0,0,24000,Null,Null,263097960,111461,20254
263098330,0.0,0.0,793000,442000,351000,44,793000,Null,Null,263098330,470105,17162
263098631,0.0,0.0,999000,999000,0,0,999000,Null,Null,263098631,591117,2340
263098697,0.0,0.0,329000,329000,0,0,329000,Null,Null,263098697,179125,11835
263098770,0.0,0.0,9630000,9630000,0,0,9630000,Null,Null,263098770,144779,1805
263098842,0.0,0.0,129000,129000,0,0,129000,Null,Null,263098842,111461,28576
263099211,0.0,0.0,6900000,4900000,2000000,29,6900000,Null,Null,263099211,144779,1805
263099250,0.0,0.0,111000,65000,46000,41,111000,Null,Null,263099250,48381,3422
263099701,0.0,0.0,2100000,2100000,0,0,2100000,Null,Null,263099701,111461,11885
263099726,0.0,0.0,1080000,1080000,0,0,1080000,Null,Null,263099726,8194911,2340
263099869,0.0,0.0,1099000,1099000,0,0,1099000,Null,Null,263099869,7391941,2340
263100192,0.0,0.0,2490000,2490000,0,0,2490000,Null,Null,263100192,111461,2
263100198,0.0,0.0,2040000,2040000,0,0,2040000,Null,Null,263100198,111461,2
263100200,0.0,0.0,1990000,1990000,0,0,1990000,Null,Null,263100200,111461,5385
263100202,0.0,0.0,1130000,1130000,0,0,1130000,Null,Null,263100202,111461,2
263100203,0.0,0.0,2150000,2150000,0,0,2150000,Null,Null,263100203,111461,2
263100211,0.0,0.0,2890000,2890000,0,0,2890000,Null,Null,263100211,111461,5385
263100215,0.0,0.0,2950000,2950000,0,0,2950000,Null,Null,263100215,111461,5385
263100217,0.0,0.0,2380000,2380000,0,0,2380000,Null,Null,263100217,111461,5385
263100219,0.0,0.0,4080000,4080000,0,0,4080000,Null,Null,263100219,111461,2
263100221,0.0,0.0,1420000,1420000,0,0,1420000,Null,Null,263100221,111461,2
263100228,0.0,0.0,1250000,1250000,0,0,1250000,Null,Null,263100228,111461,2
263100230,0.0,0.0,4710000,4710000,0,0,4710000,Null,Null,263100230,111461,2
263100232,0.0,0.0,1250000,1250000,0,0,1250000,Null,Null,263100232,111461,5384
263100245,0.0,0.0,2160000,2160000,0,0,2160000,Null,Null,263100245,111461,2
263100248,0.0,0.0,4140000,4140000,0,0,4140000,Null,Null,263100248,111461,5385
263100249,0.0,0.0,2330000,2330000,0,0,2330000,Null,Null,263100249,111461,2
263100250,0.0,0.0,850000,850000,0,0,850000,Null,Null,263100250,111461,2
263100252,0.0,0.0,2310000,2310000,0,0,2310000,Null,Null,263100252,111461,2
263100256,0.0,0.0,1960000,1960000,0,0,1960000,Null,Null,263100256,111461,5385
263100264,0.0,0.0,3060000,3060000,0,0,3060000,Null,Null,263100264,111461,5385
263100266,0.0,0.0,1360000,1360000,0,0,1360000,Null,Null,263100266,111461,2
263100268,0.0,0.0,1990000,1990000,0,0,1990000,Null,Null,263100268,111461,2
263100270,0.0,0.0,1530000,1530000,0,0,1530000,Null,Null,263100270,111461,5384
263100272,0.0,0.0,2780000,2780000,0,0,2780000,Null,Null,263100272,111461,2
263100274,0.0,0.0,6240000,6240000,0,0,6240000,Null,Null,263100274,111461,2
263100276,0.0,0.0,3850000,3850000,0,0,3850000,Null,Null,263100276,111461,2
263100278,0.0,0.0,1420000,1420000,0,0,1420000,Null,Null,263100278,111461,2
263100280,0.0,0.0,8300000,8300000,0,0,8300000,Null,Null,263100280,111461,2
263100284,0.0,0.0,3230000,3230000,0,0,3230000,Null,Null,263100284,111461,2
263100286,0.0,0.0,1990000,1990000,0,0,1990000,Null,Null,263100286,111461,5385
263100288,0.0,0.0,2300000,2300000,0,0,2300000,Null,Null,263100288,111461,5384
263100290,0.0,0.0,4030000,4030000,0,0,4030000,Null,Null,263100290,111461,2
263100292,0.0,0.0,1700000,1700000,0,0,1700000,Null,Null,263100292,111461,5385
263100294,0.0,0.0,1420000,1420000,0,0,1420000,Null,Null,263100294,111461,2
263100296,0.0,0.0,2610000,2610000,0,0,2610000,Null,Null,263100296,111461,5384
263100297,0.0,0.0,2670000,2670000,0,0,2670000,Null,Null,263100297,111461,2
263100303,0.0,0.0,2440000,2440000,0,0,2440000,Null,Null,263100303,111461,5384
263100310,0.0,0.0,2550000,2550000,0,0,2550000,Null,Null,263100310,111461,2
263100315,0.0,0.0,1400000,1400000,0,0,1400000,Null,Null,263100315,111461,2
263100316,0.0,0.0,2720000,2720000,0,0,2720000,Null,Null,263100316,111461,2
263100319,0.0,0.0,1870000,1870000,0,0,1870000,Null,Null,263100319,111461,2
263100322,0.0,0.0,2100000,2100000,0,0,2100000,Null,Null,263100322,111461,2
263100324,0.0,0.0,2980000,2980000,0,0,2980000,Null,Null,263100324,111461,2
263100326,0.0,0.0,1590000,1590000,0,0,1590000,Null,Null,263100326,111461,2
263100330,0.0,0.0,2670000,2670000,0,0,2670000,Null,Null,263100330,111461,5385
263100332,0.0,0.0,3330000,3330000,0,0,3330000,Null,Null,263100332,111461,2
263100334,0.0,0.0,1730000,1730000,0,0,1730000,Null,Null,263100334,111461,5384
263100336,0.0,0.0,2550000,2550000,0,0,2550000,Null,Null,263100336,111461,5384
263100341,0.0,0.0,2640000,2640000,0,0,2640000,Null,Null,263100341,111461,2
263100343,0.0,0.0,2290000,2290000,0,0,2290000,Null,Null,263100343,111461,2
263100345,0.0,0.0,4760000,4760000,0,0,4760000,Null,Null,263100345,111461,2
263100347,0.0,0.0,2890000,2890000,0,0,2890000,Null,Null,263100347,111461,2
263100349,0.0,0.0,2510000,2510000,0,0,2510000,Null,Null,263100349,111461,2
263100351,0.0,0.0,2190000,2190000,0,0,2190000,Null,Null,263100351,111461,2
263100352,0.0,0.0,2610000,2610000,0,0,2610000,Null,Null,263100352,111461,5385
263100355,0.0,0.0,1850000,1850000,0,0,1850000,Null,Null,263100355,111461,2
263100357,0.0,0.0,8100000,8100000,0,0,8100000,Null,Null,263100357,111461,5384
263100359,0.0,0.0,2070000,2070000,0,0,2070000,Null,Null,263100359,111461,2
263100362,0.0,0.0,2840000,2840000,0,0,2840000,Null,Null,263100362,111461,2
263100364,0.0,0.0,2270000,2270000,0,0,2270000,Null,Null,263100364,111461,2
263100366,0.0,0.0,2530000,2530000,0,0,2530000,Null,Null,263100366,111461,5384
263100368,0.0,0.0,1760000,1760000,0,0,1760000,Null,Null,263100368,111461,2
263100370,0.0,0.0,5440000,5440000,0,0,5440000,Null,Null,263100370,111461,2
263100375,0.0,0.0,1190000,1190000,0,0,1190000,Null,Null,263100375,111461,2
263100377,0.0,0.0,1130000,1130000,0,0,1130000,Null,Null,263100377,111461,2
263100379,0.0,0.0,1590000,1590000,0,0,1590000,Null,Null,263100379,111461,2
263100381,0.0,0.0,7680000,7680000,0,0,7680000,Null,Null,263100381,111461,5384
263100383,0.0,0.0,1360000,1360000,0,0,1360000,Null,Null,263100383,111461,2
263100385,0.0,0.0,1080000,1080000,0,0,1080000,Null,Null,263100385,111461,5385
263100387,0.0,0.0,3690000,3690000,0,0,3690000,Null,Null,263100387,111461,5384
263100389,0.0,0.0,1080000,1080000,0,0,1080000,Null,Null,263100389,111461,2
263100391,0.0,0.0,1080000,1080000,0,0,1080000,Null,Null,263100391,111461,2
263100393,0.0,0.0,1080000,1080000,0,0,1080000,Null,Null,263100393,111461,2
263100395,0.0,0.0,1110000,1110000,0,0,1110000,Null,Null,263100395,111461,2
263100400,0.0,0.0,1310000,1310000,0,0,1310000,Null,Null,263100400,111461,2
263100402,0.0,0.0,3010000,3010000,0,0,3010000,Null,Null,263100402,111461,2
263100404,0.0,0.0,1530000,1530000,0,0,1530000,Null,Null,263100404,111461,2
263100406,0.0,0.0,4030000,4030000,0,0,4030000,Null,Null,263100406,111461,2
263100408,0.0,0.0,1050000,1050000,0,0,1050000,Null,Null,263100408,111461,2
263100417,0.0,0.0,2950000,2950000,0,0,2950000,Null,Null,263100417,111461,5385
263100419,0.0,0.0,3120000,3120000,0,0,3120000,Null,Null,263100419,111461,2
263100421,0.0,0.0,3120000,3120000,0,0,3120000,Null,Null,263100421,111461,5385
263100423,0.0,0.0,3800000,3800000,0,0,3800000,Null,Null,263100423,111461,2
263100425,0.0,0.0,1470000,1470000,0,0,1470000,Null,Null,263100425,111461,2
263100426,0.0,0.0,2670000,2670000,0,0,2670000,Null,Null,263100426,111461,2
263100429,0.0,0.0,2830000,2830000,0,0,2830000,Null,Null,263100429,111461,5385
263100431,0.0,0.0,4370000,4370000,0,0,4370000,Null,Null,263100431,111461,2
263100433,0.0,0.0,2890000,2890000,0,0,2890000,Null,Null,263100433,111461,5385
263100435,0.0,0.0,2950000,2950000,0,0,2950000,Null,Null,263100435,111461,5385
263100437,0.0,0.0,1850000,1850000,0,0,1850000,Null,Null,263100437,111461,2
263100439,0.0,0.0,1170000,1170000,0,0,1170000,Null,Null,263100439,111461,2
263100441,0.0,0.0,1590000,1590000,0,0,1590000,Null,Null,263100441,111461,2
263100443,0.0,0.0,3230000,3230000,0,0,3230000,Null,Null,263100443,111461,2
263100445,0.0,0.0,1250000,1250000,0,0,1250000,Null,Null,263100445,111461,5385
263100447,0.0,0.0,1840000,1840000,0,0,1840000,Null,Null,263100447,111461,2
263100449,0.0,0.0,2070000,2070000,0,0,2070000,Null,Null,263100449,111461,2
263100451,0.0,0.0,2100000,2100000,0,0,2100000,Null,Null,263100451,111461,2
263100456,0.0,0.0,3230000,3230000,0,0,3230000,Null,Null,263100456,111461,2
263100458,0.0,0.0,2060000,2060000,0,0,2060000,Null,Null,263100458,111461,2
263100464,1.0,1.0,9416000,9416000,0,0,9416000,Null,Null,263100464,144779,1805
263100518,0.0,0.0,23000,23000,0,0,23000,Null,Null,263100518,7823749,11605
263100766,1.0,1.0,23000,23000,0,0,23000,Null,Null,263100766,7823749,11605
263100772,0.0,0.0,1790000,1790000,0,0,1790000,Null,Null,263100772,8194777,8172
263100888,0.0,0.0,270000,147000,123000,46,270000,Null,Null,263100888,470105,17162
263101002,0.0,0.0,240000,240000,0,0,240000,Null,Null,263101002,189983,1636
263101248,0.0,0.0,650000,650000,0,0,650000,Null,Null,263101248,8194921,5905
263101279,0.0,0.0,270000,147000,123000,46,270000,Null,Null,263101279,470105,17162
263101285,0.0,0.0,12500000,12500000,0,0,12500000,Null,Null,263101285,111461,7079
263101288,0.0,0.0,309000,309000,0,0,309000,Null,Null,263101288,242895,1641
263101335,0.0,0.0,3590000,2872000,718000,20,3590000,Null,Null,263101335,208841,2340
263101598,0.0,0.0,5960000,2980000,2980000,50,5960000,Null,Null,263101598,111461,15318
263102204,0.0,0.0,5000000,2500000,2500000,50,5000000,Null,Null,263102204,111461,15318
263102232,0.0,0.0,790000,711000,79000,10,790000,Null,Null,263102232,208841,8170
263102268,0.0,0.0,720000,720000,0,0,720000,Null,Null,263102268,111461,2
263102336,0.0,0.0,12500000,12500000,0,0,12500000,Null,Null,263102336,111461,28868
263102655,0.0,0.0,359100,359100,0,0,359100,Null,Null,263102655,189983,8192
263102847,0.0,0.0,420000,390000,30000,7,420000,Null,Null,263102847,111461,28618
263102855,0.0,0.0,4310000,4310000,0,0,4310000,Null,Null,263102855,7982659,8512
263102878,0.0,0.0,59000,59000,0,0,59000,Null,Null,263102878,7823749,2162
263102889,0.0,0.0,2100000,2100000,0,0,2100000,Null,Null,263102889,111461,2
263102891,0.0,0.0,1590000,1590000,0,0,1590000,Null,Null,263102891,111461,2
263102893,0.0,0.0,1730000,1730000,0,0,1730000,Null,Null,263102893,111461,5385
263102894,0.0,0.0,1250000,1250000,0,0,1250000,Null,Null,263102894,111461,2
263102897,0.0,0.0,1820000,1820000,0,0,1820000,Null,Null,263102897,111461,2
263102901,0.0,0.0,3010000,3010000,0,0,3010000,Null,Null,263102901,111461,2
263102903,0.0,0.0,2460000,2460000,0,0,2460000,Null,Null,263102903,111461,2
263102905,0.0,0.0,1250000,1250000,0,0,1250000,Null,Null,263102905,111461,2
263102907,0.0,0.0,2460000,2460000,0,0,2460000,Null,Null,263102907,111461,2
263102909,0.0,0.0,1780000,1780000,0,0,1780000,Null,Null,263102909,111461,2
263102910,0.0,0.0,2670000,2670000,0,0,2670000,Null,Null,263102910,111461,5384
263102913,0.0,0.0,2670000,2670000,0,0,2670000,Null,Null,263102913,111461,5384
263102915,0.0,0.0,3800000,3800000,0,0,3800000,Null,Null,263102915,111461,5385
263102917,0.0,0.0,1810000,1810000,0,0,1810000,Null,Null,263102917,111461,2
263103045,0.0,0.0,65000,65000,0,0,65000,Null,Null,263103045,111461,28480
263103277,0.0,0.0,9590000,7440000,2150000,22,9590000,Null,Null,263103277,4649279,11516
263103301,0.0,0.0,420000,390000,30000,7,420000,Null,Null,263103301,111461,28618
263103329,0.0,0.0,275000,150000,125000,45,275000,Null,Null,263103329,470105,1752
263103339,0.0,0.0,28000,28000,0,0,28000,Null,Null,263103339,111461,28576
263103451,0.0,0.0,2990000,2541500,448500,15,2990000,Null,Null,263103451,208841,2340
263103686,0.0,0.0,238700,238700,0,0,238700,Null,Null,263103686,189983,8192
263103724,0.0,0.0,4310000,4310000,0,0,4310000,Null,Null,263103724,7982659,8512
263104030,0.0,0.0,10000,10000,0,0,10000,Null,Null,263104030,7823749,1601
263104041,1.0,1.0,109000,109000,0,0,109000,Null,Null,263104041,419129,28484
263104309,0.0,0.0,890000,890000,0,0,890000,Null,Null,263104309,212267,28616
263104320,0.0,0.0,390000,370000,20000,5,390000,Null,Null,263104320,111461,28618
263104334,0.0,0.0,335000,335000,0,0,335000,Null,Null,263104334,111461,1832
263104360,0.0,0.0,500000,290000,210000,42,500000,Null,Null,263104360,111461,2324
263104378,3.0,3.0,99000,99000,0,0,99000,Null,Null,263104378,419129,12294
263104395,0.0,0.0,37000,20500,16500,45,37000,Null,Null,263104395,259421,1601
263104739,0.0,0.0,420000,390000,30000,7,420000,Null,Null,263104739,111461,28618
263104783,0.0,0.0,59000,59000,0,0,59000,Null,Null,263104783,7823749,11845
263104829,0.0,0.0,5990000,5091500,898500,15,5990000,Null,Null,263104829,208841,2340
263105171,0.0,0.0,390000,370000,20000,5,390000,Null,Null,263105171,111461,28618
263105176,0.0,0.0,4350000,4350000,0,0,4350000,Null,Null,263105176,7982659,7449
263105388,0.0,0.0,2650000,2650000,0,0,2650000,Null,Null,263105388,579445,15236
263105390,0.0,0.0,12000,12000,0,0,12000,Null,Null,263105390,111461,20254
263106781,0.0,0.0,2250000,2250000,0,0,2250000,Null,Null,263106781,579445,15236
263106791,0.0,0.0,169000,169000,0,0,169000,Null,Null,263106791,111461,2
263106792,0.0,0.0,169000,169000,0,0,169000,Null,Null,263106792,111461,2
263106798,0.0,0.0,199000,199000,0,0,199000,Null,Null,263106798,111461,2
263106800,0.0,0.0,169000,169000,0,0,169000,Null,Null,263106800,111461,2
263106802,0.0,0.0,169000,169000,0,0,169000,Null,Null,263106802,111461,2
263106840,0.0,0.0,169000,169000,0,0,169000,Null,Null,263106840,111461,11941
263106842,0.0,0.0,169000,169000,0,0,169000,Null,Null,263106842,111461,2
263106848,0.0,0.0,169000,169000,0,0,169000,Null,Null,263106848,111461,11941
263106856,0.0,0.0,169000,169000,0,0,169000,Null,Null,263106856,111461,2
263106902,0.0,0.0,169000,169000,0,0,169000,Null,Null,263106902,111461,2
263106906,0.0,0.0,169000,169000,0,0,169000,Null,Null,263106906,111461,2
263106919,0.0,0.0,169000,169000,0,0,169000,Null,Null,263106919,111461,11941
263106922,0.0,0.0,4350000,4350000,0,0,4350000,Null,Null,263106922,7982659,7449
263106924,0.0,0.0,169000,169000,0,0,169000,Null,Null,263106924,111461,2
263106940,0.0,0.0,169000,169000,0,0,169000,Null,Null,263106940,111461,2
263107021,0.0,0.0,7500,7500,0,0,7500,Null,Null,263107021,111461,2
263107024,0.0,0.0,24999,24999,0,0,24999,Null,Null,263107024,111461,2
263107026,0.0,0.0,29800,29800,0,0,29800,Null,Null,263107026,111461,2
263107033,0.0,0.0,4999,4999,0,0,4999,Null,Null,263107033,111461,2
263107034,0.0,0.0,15999,15999,0,0,15999,Null,Null,263107034,111461,2
263107056,0.0,0.0,169000,169000,0,0,169000,Null,Null,263107056,111461,11941
263107060,0.0,0.0,169000,169000,0,0,169000,Null,Null,263107060,111461,2
263107072,0.0,0.0,1290000,1032000,258000,20,1290000,Null,Null,263107072,208841,2340
263107083,0.0,0.0,390000,370000,20000,5,390000,Null,Null,263107083,111461,28618
263107125,0.0,0.0,309000,309000,0,0,309000,Null,Null,263107125,242895,1641
263107218,1.0,1.0,215000,215000,0,0,215000,Null,Null,263107218,7823749,7061
263107330,0.0,0.0,390000,370000,20000,5,390000,Null,Null,263107330,111461,28618
263107371,0.0,0.0,390000,370000,20000,5,390000,Null,Null,263107371,111461,28618
263107444,0.0,0.0,55000,55000,0,0,55000,Null,Null,263107444,111461,2
263107546,0.0,0.0,55000,55000,0,0,55000,Null,Null,263107546,111461,2
263107547,0.0,0.0,320000,320000,0,0,320000,Null,Null,263107547,111461,2
263107604,0.0,0.0,165000,165000,0,0,165000,Null,Null,263107604,111461,2
263107676,0.0,0.0,185000,185000,0,0,185000,Null,Null,263107676,111461,2
263107762,0.0,0.0,105000,105000,0,0,105000,Null,Null,263107762,111461,28594
263108163,0.0,0.0,4350000,4350000,0,0,4350000,Null,Null,263108163,7982659,7449
263108396,0.0,0.0,4350000,4350000,0,0,4350000,Null,Null,263108396,7982659,8512
263108559,0.0,0.0,370000,199000,171000,46,370000,Null,Null,263108559,259421,1601
263109161,0.0,0.0,1350000,1350000,0,0,1350000,Null,Null,263109161,8191413,11847
263109187,0.0,0.0,450000,450000,0,0,450000,Null,Null,263109187,622395,53350
263109291,0.0,0.0,4390000,4390000,0,0,4390000,Null,Null,263109291,7982659,8512
263109326,0.0,0.0,1150000,1150000,0,0,1150000,Null,Null,263109326,8191413,11869
263109364,0.0,0.0,4390000,4390000,0,0,4390000,Null,Null,263109364,7982659,8512
263109848,0.0,0.0,37000,19900,17100,46,37000,Null,Null,263109848,148247,2348
263109865,0.0,0.0,1460000,1460000,0,0,1460000,Null,Null,263109865,8191413,11851
263110139,0.0,0.0,490000,441000,49000,10,490000,Null,Null,263110139,111461,8217
263110349,0.0,0.0,9590000,6731000,2859000,30,9590000,Null,Null,263110349,4649279,11516
263112324,0.0,0.0,89000,89000,0,0,89000,Null,Null,263112324,7823749,8216
263112957,0.0,0.0,108000,108000,0,0,108000,Null,Null,263112957,21651,5006
263112994,0.0,0.0,21000,21000,0,0,21000,Null,Null,263112994,111461,20254
263113003,0.0,0.0,5990000,5091500,898500,15,5990000,Null,Null,263113003,208841,2340
263113041,0.0,0.0,80000,60000,20000,25,80000,Null,Null,263113041,365727,11873
263113056,0.0,0.0,60000,60000,0,0,60000,Null,Null,263113056,111454,28458
263113123,0.0,0.0,313000,313000,0,0,313000,Null,Null,263113123,111454,5531
263113131,0.0,0.0,188700,188700,0,0,188700,Null,Null,263113131,7368403,2
263113132,0.0,0.0,255765,255765,0,0,255765,Null,Null,263113132,7368403,2
263113135,0.0,0.0,140250,140250,0,0,140250,Null,Null,263113135,7368403,2
263113149,0.0,0.0,195500,195500,0,0,195500,Null,Null,263113149,7368403,2
263113150,0.0,0.0,300050,300050,0,0,300050,Null,Null,263113150,7368403,2
263113254,0.0,0.0,179000,179000,0,0,179000,Null,Null,263113254,111461,11941
263113255,0.0,0.0,179000,179000,0,0,179000,Null,Null,263113255,111461,2
263113258,0.0,0.0,179000,179000,0,0,179000,Null,Null,263113258,111461,2
263113262,0.0,0.0,179000,179000,0,0,179000,Null,Null,263113262,111461,2
263113268,0.0,0.0,179000,179000,0,0,179000,Null,Null,263113268,111461,2
263113270,0.0,0.0,179000,179000,0,0,179000,Null,Null,263113270,111461,2
263113482,0.0,0.0,690000,690000,0,0,690000,Null,Null,263113482,111461,53350
263113525,0.0,0.0,900000,830000,70000,8,900000,Null,Null,263113525,153088,2657
263113546,0.0,0.0,3590000,3051500,538500,15,3590000,Null,Null,263113546,208841,2340
263113553,0.0,0.0,30000,20000,10000,33,30000,Null,Null,263113553,365727,11869
263113575,0.0,0.0,305000,305000,0,0,305000,Null,Null,263113575,111454,28644
263113616,0.0,0.0,45000,45000,0,0,45000,Null,Null,263113616,7823749,1601
263113731,0.0,0.0,1390000,1390000,0,0,1390000,Null,Null,263113731,8191413,11861
263113821,0.0,0.0,495000,495000,0,0,495000,Null,Null,263113821,111461,3426
263113855,0.0,0.0,60000,60000,0,0,60000,Null,Null,263113855,21653,5006
263113997,0.0,0.0,260000,210000,50000,19,260000,Null,Null,263113997,111461,20174
263114032,0.0,0.0,179000,179000,0,0,179000,Null,Null,263114032,111461,2
263114037,0.0,0.0,179000,179000,0,0,179000,Null,Null,263114037,111461,2
263114040,0.0,0.0,179000,179000,0,0,179000,Null,Null,263114040,111461,2
263114048,0.0,0.0,150000,120000,30000,20,150000,Null,Null,263114048,365727,11861
263114061,0.0,0.0,7990000,6590000,1400000,18,7990000,Null,Null,263114061,8194285,8066
263114130,0.0,0.0,122000,122000,0,0,122000,Null,Null,263114130,5351873,8223
263114264,0.0,0.0,5650000,5650000,0,0,5650000,Null,Null,263114264,8191413,11873
263114301,0.0,0.0,774000,774000,0,0,774000,Null,Null,263114301,111461,2324
263114325,0.0,0.0,770000,770000,0,0,770000,Null,Null,263114325,4251649,11867
263114429,0.0,0.0,16000,16000,0,0,16000,Null,Null,263114429,111461,20254
263114438,0.0,0.0,529000,529000,0,0,529000,Null,Null,263114438,111461,53350
263114531,0.0,0.0,700000,700000,0,0,700000,Null,Null,263114531,4251649,11879
263114534,0.0,0.0,59000,59000,0,0,59000,Null,Null,263114534,111461,8172
263114572,0.0,0.0,800000,800000,0,0,800000,Null,Null,263114572,8194465,1520
263114591,0.0,0.0,2990000,2541500,448500,15,2990000,Null,Null,263114591,208841,2340
263114767,0.0,0.0,800000,800000,0,0,800000,Null,Null,263114767,4251649,11845
263114800,0.0,0.0,750000,750000,0,0,750000,Null,Null,263114800,111461,53350
263114826,0.0,0.0,18000,18000,0,0,18000,Null,Null,263114826,111461,20254
263114832,0.0,0.0,380000,380000,0,0,380000,Null,Null,263114832,4251649,11845
263114846,0.0,0.0,59000,59000,0,0,59000,Null,Null,263114846,7823749,1628
263114923,0.0,0.0,850000,850000,0,0,850000,Null,Null,263114923,183257,15250
263115000,0.0,0.0,588000,588000,0,0,588000,Null,Null,263115000,111461,8167
263115054,0.0,0.0,870000,870000,0,0,870000,Null,Null,263115054,111461,53350
263115238,0.0,0.0,385000,385000,0,0,385000,Null,Null,263115238,111461,11897
263115360,0.0,0.0,779000,779000,0,0,779000,Null,Null,263115360,111461,11516
263117048,0.0,0.0,150000,120000,30000,20,150000,Null,Null,263117048,365727,11869
263117168,0.0,0.0,100000,100000,0,0,100000,Null,Null,263117168,111461,1622
263117266,0.0,0.0,749000,749000,0,0,749000,Null,Null,263117266,883525,8300
263117324,0.0,0.0,330000,297000,33000,10,330000,Null,Null,263117324,8164011,13878
263117360,0.0,0.0,600000,600000,0,0,600000,Null,Null,263117360,4251649,11861
263117362,0.0,0.0,285500,285500,0,0,285500,Null,Null,263117362,111461,8519
263117368,0.0,0.0,549000,549000,0,0,549000,Null,Null,263117368,7823755,3422
263117428,0.0,0.0,119500,119500,0,0,119500,Null,Null,263117428,111461,8519
263117438,0.0,0.0,570000,345000,225000,39,570000,Null,Null,263117438,248445,2347
263117440,0.0,0.0,190000,190000,0,0,190000,Null,Null,263117440,111461,2324
263117451,0.0,0.0,839000,839000,0,0,839000,Null,Null,263117451,111461,53350
263117489,0.0,0.0,229500,229500,0,0,229500,Null,Null,263117489,111461,8519
263117493,0.0,0.0,599000,587000,12000,2,599000,Null,Null,263117493,112638,1796
263117529,0.0,0.0,630000,630000,0,0,630000,Null,Null,263117529,4251649,11859
263117532,0.0,0.0,2400000,2400000,0,0,2400000,Null,Null,263117532,527109,28736
263117538,0.0,0.0,657000,657000,0,0,657000,Null,Null,263117538,5728711,8308
263117597,0.0,0.0,569000,569000,0,0,569000,Null,Null,263117597,7823755,3422
263117599,0.0,0.0,55000,55000,0,0,55000,Null,Null,263117599,111461,7064
263117638,0.0,0.0,145000,145000,0,0,145000,Null,Null,263117638,47489,8227
263118492,0.0,0.0,225000,202500,22500,10,225000,Null,Null,263118492,8164011,1752
263118502,0.0,0.0,730000,730000,0,0,730000,Null,Null,263118502,4251649,11875
263118512,0.0,0.0,399000,399000,0,0,399000,Null,Null,263118512,183257,15250
263118529,0.0,0.0,20000,20000,0,0,20000,Null,Null,263118529,208871,15250
263118623,0.0,0.0,18000,18000,0,0,18000,Null,Null,263118623,111461,20254
263118627,0.0,0.0,5905000,5905000,0,0,5905000,Null,Null,263118627,111461,28482
263118634,0.0,0.0,49000,49000,0,0,49000,Null,Null,263118634,7823749,11837
263118638,0.0,0.0,774000,774000,0,0,774000,Null,Null,263118638,5728711,8308
263118692,0.0,0.0,205000,205000,0,0,205000,Null,Null,263118692,111461,7078
263118696,1.0,1.0,299000,299000,0,0,299000,Null,Null,263118696,111461,1832
263118728,0.0,0.0,130000,130000,0,0,130000,Null,Null,263118728,111461,28578
263118736,0.0,0.0,268598,268598,0,0,268598,Null,Null,263118736,111461,28596
263118741,0.0,0.0,657000,657000,0,0,657000,Null,Null,263118741,5728711,13878
263118754,0.0,0.0,129000,99000,30000,23,129000,Null,Null,263118754,365727,1627
263118756,0.0,0.0,562000,339000,223000,40,562000,Null,Null,263118756,248445,2347
263118785,0.0,0.0,369000,369000,0,0,369000,Null,Null,263118785,111461,2324
263118804,0.0,0.0,507000,507000,0,0,507000,Null,Null,263118804,5728711,13878
263118810,0.0,0.0,330000,297000,33000,10,330000,Null,Null,263118810,8164011,1616
263119019,0.0,0.0,179000,170050,8950,5,179000,Null,Null,263119019,312329,4429
263119103,0.0,0.0,297000,297000,0,0,297000,Null,Null,263119103,5728711,8308
263119112,0.0,0.0,900000,790000,110000,12,900000,Null,Null,263119112,153088,2657
263119116,0.0,0.0,900000,790000,110000,12,900000,Null,Null,263119116,153088,2657
263119121,0.0,0.0,459000,459000,0,0,459000,Null,Null,263119121,7823755,11605
263119167,0.0,0.0,507000,507000,0,0,507000,Null,Null,263119167,5728711,13878
263119169,0.0,0.0,390000,370000,20000,5,390000,Null,Null,263119169,111461,28618
263119172,0.0,0.0,2950000,2950000,0,0,2950000,Null,Null,263119172,893943,20170
263119174,0.0,0.0,220000,220000,0,0,220000,Null,Null,263119174,111461,20190
263119240,0.0,0.0,390000,370000,20000,5,390000,Null,Null,263119240,111461,28618
263119474,0.0,0.0,338000,338000,0,0,338000,Null,Null,263119474,5728711,13878
263119569,0.0,0.0,507000,507000,0,0,507000,Null,Null,263119569,5728711,13878
263119595,0.0,0.0,495000,495000,0,0,495000,Null,Null,263119595,7823755,11605
263119789,0.0,0.0,657000,657000,0,0,657000,Null,Null,263119789,5728711,13878
263119857,0.0,0.0,297000,297000,0,0,297000,Null,Null,263119857,5728711,8308
263119870,0.0,0.0,390000,370000,20000,5,390000,Null,Null,263119870,111461,28618
263119923,0.0,0.0,438000,438000,0,0,438000,Null,Null,263119923,5728711,13878
263119932,0.0,0.0,190000,190000,0,0,190000,Null,Null,263119932,111461,20190
263119943,0.0,0.0,0,390000,0,0,390000,Null,Null,263119943,111461,0
263119947,0.0,0.0,235000,235000,0,0,235000,Null,Null,263119947,111461,2324
263119950,0.0,0.0,48000,48000,0,0,48000,Null,Null,263119950,111461,20254
263119954,0.0,0.0,419000,419000,0,0,419000,Null,Null,263119954,111461,11516
263120011,0.0,0.0,507000,507000,0,0,507000,Null,Null,263120011,5728711,13878
263120120,0.0,0.0,240000,235000,5000,2,240000,Null,Null,263120120,5347313,28480
263120131,0.0,0.0,390000,370000,20000,5,390000,Null,Null,263120131,111461,28618
263120166,0.0,0.0,657000,657000,0,0,657000,Null,Null,263120166,5728711,13878
263120610,0.0,0.0,298000,298000,0,0,298000,Null,Null,263120610,5728711,8308
263120626,0.0,0.0,390000,370000,20000,5,390000,Null,Null,263120626,111461,28618
263120648,0.0,0.0,594000,594000,0,0,594000,Null,Null,263120648,5728711,8308
263120782,0.0,0.0,350000,299000,51000,15,350000,Null,Null,263120782,111461,28618
263120797,0.0,0.0,2690000,2690000,0,0,2690000,Null,Null,263120797,111461,2334
263120877,0.0,0.0,390000,370000,20000,5,390000,Null,Null,263120877,111461,28618
263120919,0.0,0.0,4850000,4850000,0,0,4850000,Null,Null,263120919,7982659,8512
263120935,0.0,0.0,4850000,4850000,0,0,4850000,Null,Null,263120935,7982659,8512
263122942,0.0,0.0,4850000,4850000,0,0,4850000,Null,Null,263122942,7982659,7449
263123293,0.0,0.0,390000,370000,20000,5,390000,Null,Null,263123293,111461,28618
263123320,0.0,0.0,390000,370000,20000,5,390000,Null,Null,263123320,111461,28618
263123386,0.0,0.0,390000,370000,20000,5,390000,Null,Null,263123386,111461,28618
263123400,0.0,0.0,390000,370000,20000,5,390000,Null,Null,263123400,111461,28618
263123425,0.0,0.0,900000,900000,0,0,900000,Null,Null,263123425,111461,20236
263123469,0.0,0.0,215000,215000,0,0,215000,Null,Null,263123469,7823755,53350
263138914,0.0,0.0,585000,585000,0,0,585000,Null,Null,263138914,7391407,2
263166410,0.0,0.0,41320000,41320000,0,0,41320000,Null,Null,263166410,111461,2
263166530,0.0,0.0,40480000,40480000,0,0,40480000,Null,Null,263166530,111461,2
263166552,0.0,0.0,60136000,60136000,0,0,60136000,Null,Null,263166552,111461,2
263166768,0.0,0.0,2494400,2494400,0,0,2494400,Null,Null,263166768,111461,2
263166839,0.0,0.0,36520000,36520000,0,0,36520000,Null,Null,263166839,111461,2
263166967,0.0,0.0,39400000,39400000,0,0,39400000,Null,Null,263166967,111461,2
263166976,0.0,0.0,71560000,71560000,0,0,71560000,Null,Null,263166976,111461,2
263167118,0.0,0.0,36400000,36400000,0,0,36400000,Null,Null,263167118,111461,2
263167135,0.0,0.0,46200000,46200000,0,0,46200000,Null,Null,263167135,111461,2
263167214,0.0,0.0,44800000,44800000,0,0,44800000,Null,Null,263167214,111461,2
263167267,0.0,0.0,37480000,37480000,0,0,37480000,Null,Null,263167267,111461,2
263167383,0.0,0.0,51400000,51400000,0,0,51400000,Null,Null,263167383,111461,2
263167400,0.0,0.0,49720000,49720000,0,0,49720000,Null,Null,263167400,111461,2
263167407,0.0,0.0,38296000,38296000,0,0,38296000,Null,Null,263167407,111461,2
263167543,0.0,0.0,6250240,6250240,0,0,6250240,Null,Null,263167543,111461,2
263167586,0.0,0.0,38950000,38950000,0,0,38950000,Null,Null,263167586,111461,2
263167654,0.0,0.0,43336000,43336000,0,0,43336000,Null,Null,263167654,111461,2
263167698,0.0,0.0,71400000,71400000,0,0,71400000,Null,Null,263167698,111461,2
263167782,0.0,0.0,37800000,37800000,0,0,37800000,Null,Null,263167782,111461,2
263167789,0.0,0.0,56440000,56440000,0,0,56440000,Null,Null,263167789,111461,2
263167844,0.0,0.0,77000000,77000000,0,0,77000000,Null,Null,263167844,111461,2
263167901,0.0,0.0,47080000,47080000,0,0,47080000,Null,Null,263167901,111461,2
263168108,0.0,0.0,46200000,46200000,0,0,46200000,Null,Null,263168108,111461,2
263168311,0.0,0.0,49720000,49720000,0,0,49720000,Null,Null,263168311,111461,2
263168372,0.0,0.0,37800000,37800000,0,0,37800000,Null,Null,263168372,111461,2
263168374,0.0,0.0,53000000,53000000,0,0,53000000,Null,Null,263168374,111461,2
263168424,0.0,0.0,58120000,58120000,0,0,58120000,Null,Null,263168424,111461,2
263168431,0.0,0.0,36400000,36400000,0,0,36400000,Null,Null,263168431,111461,2
263168434,0.0,0.0,93400000,93400000,0,0,93400000,Null,Null,263168434,111461,2
263168608,0.0,0.0,50600000,50600000,0,0,50600000,Null,Null,263168608,111461,2
263168638,0.0,0.0,36186400,36186400,0,0,36186400,Null,Null,263168638,111461,2
263168649,0.0,0.0,39200000,39200000,0,0,39200000,Null,Null,263168649,111461,2
263168762,0.0,0.0,60200000,60200000,0,0,60200000,Null,Null,263168762,111461,2
263168802,0.0,0.0,98950000,98950000,0,0,98950000,Null,Null,263168802,111461,2
263168929,0.0,0.0,41400000,41400000,0,0,41400000,Null,Null,263168929,111461,2
263168994,0.0,0.0,1800000,1800000,0,0,1800000,Null,Null,263168994,111461,2
263169000,0.0,0.0,48000000,48000000,0,0,48000000,Null,Null,263169000,111461,2
263169072,0.0,0.0,46000000,46000000,0,0,46000000,Null,Null,263169072,111461,2
263169132,0.0,0.0,55540000,55540000,0,0,55540000,Null,Null,263169132,111461,2
263169155,0.0,0.0,11152000,11152000,0,0,11152000,Null,Null,263169155,111461,2
263169217,0.0,0.0,42160000,42160000,0,0,42160000,Null,Null,263169217,111461,2
263169421,0.0,0.0,40000000,40000000,0,0,40000000,Null,Null,263169421,111461,2
263169492,0.0,0.0,51800000,51800000,0,0,51800000,Null,Null,263169492,111461,2
263169522,0.0,0.0,39000000,39000000,0,0,39000000,Null,Null,263169522,111461,2
263169568,0.0,0.0,58800000,58800000,0,0,58800000,Null,Null,263169568,111461,2
263169655,0.0,0.0,59800000,59800000,0,0,59800000,Null,Null,263169655,111461,2
263169779,0.0,0.0,36712000,36712000,0,0,36712000,Null,Null,263169779,111461,2
263169833,0.0,0.0,50600000,50600000,0,0,50600000,Null,Null,263169833,111461,2
263169891,0.0,0.0,51800000,51800000,0,0,51800000,Null,Null,263169891,111461,2
263169989,0.0,0.0,55720000,55720000,0,0,55720000,Null,Null,263169989,111461,2
263170094,0.0,0.0,44136000,44136000,0,0,44136000,Null,Null,263170094,111461,2
263170245,0.0,0.0,14440000,14440000,0,0,14440000,Null,Null,263170245,111461,2
263170316,0.0,0.0,46000000,46000000,0,0,46000000,Null,Null,263170316,111461,2
263170359,0.0,0.0,59800000,59800000,0,0,59800000,Null,Null,263170359,111461,2
263170396,0.0,0.0,39400000,39400000,0,0,39400000,Null,Null,263170396,111461,2
263170407,0.0,0.0,40320000,40320000,0,0,40320000,Null,Null,263170407,111461,2
263170454,0.0,0.0,40600000,40600000,0,0,40600000,Null,Null,263170454,111461,2
263170521,0.0,0.0,98920000,98920000,0,0,98920000,Null,Null,263170521,111461,2
263170557,0.0,0.0,46360000,46360000,0,0,46360000,Null,Null,263170557,111461,2
263170572,0.0,0.0,51400000,51400000,0,0,51400000,Null,Null,263170572,111461,2
263170598,0.0,0.0,44800000,44800000,0,0,44800000,Null,Null,263170598,111461,2
263170607,0.0,0.0,41800000,41800000,0,0,41800000,Null,Null,263170607,111461,2
263170621,0.0,0.0,47600000,47600000,0,0,47600000,Null,Null,263170621,111461,2
263170640,0.0,0.0,3240000,3240000,0,0,3240000,Null,Null,263170640,111461,2
263170792,0.0,0.0,50400000,50400000,0,0,50400000,Null,Null,263170792,111461,2
263170891,0.0,0.0,55400000,55400000,0,0,55400000,Null,Null,263170891,111461,2
263171103,0.0,0.0,61000000,61000000,0,0,61000000,Null,Null,263171103,111461,2
263171140,0.0,0.0,49000000,49000000,0,0,49000000,Null,Null,263171140,111461,2
263171220,0.0,0.0,60780000,60780000,0,0,60780000,Null,Null,263171220,111461,2
263171224,0.0,0.0,58800000,58800000,0,0,58800000,Null,Null,263171224,111461,2
263171345,0.0,0.0,50400000,50400000,0,0,50400000,Null,Null,263171345,111461,2
263171352,0.0,0.0,63496000,63496000,0,0,63496000,Null,Null,263171352,111461,2
263171369,0.0,0.0,90000000,90000000,0,0,90000000,Null,Null,263171369,111461,2
263171461,0.0,0.0,53200000,53200000,0,0,53200000,Null,Null,263171461,111461,2
263171613,0.0,0.0,63400000,63400000,0,0,63400000,Null,Null,263171613,111461,2
263171904,0.0,0.0,37960000,37960000,0,0,37960000,Null,Null,263171904,111461,2
263171970,0.0,0.0,48040000,48040000,0,0,48040000,Null,Null,263171970,111461,2
263172074,0.0,0.0,5568000,5568000,0,0,5568000,Null,Null,263172074,111461,2
263172125,0.0,0.0,49000000,49000000,0,0,49000000,Null,Null,263172125,111461,2
263172151,0.0,0.0,36000000,36000000,0,0,36000000,Null,Null,263172151,111461,2
263172170,0.0,0.0,48040000,48040000,0,0,48040000,Null,Null,263172170,111461,2
263172183,0.0,0.0,50600000,50600000,0,0,50600000,Null,Null,263172183,111461,2
263172229,0.0,0.0,39640000,39640000,0,0,39640000,Null,Null,263172229,111461,2
263172269,0.0,0.0,61480000,61480000,0,0,61480000,Null,Null,263172269,111461,2
263172293,0.0,0.0,67240000,67240000,0,0,67240000,Null,Null,263172293,111461,2
263172308,0.0,0.0,39400000,39400000,0,0,39400000,Null,Null,263172308,111461,2
263172405,0.0,0.0,36840000,36840000,0,0,36840000,Null,Null,263172405,111461,2
263172477,0.0,0.0,40200000,40200000,0,0,40200000,Null,Null,263172477,111461,2
263172522,0.0,0.0,48040000,48040000,0,0,48040000,Null,Null,263172522,111461,2
263172528,0.0,0.0,78280000,78280000,0,0,78280000,Null,Null,263172528,111461,2
263172531,0.0,0.0,54536000,54536000,0,0,54536000,Null,Null,263172531,111461,2
263172708,0.0,0.0,36712000,36712000,0,0,36712000,Null,Null,263172708,111461,2
263172729,0.0,0.0,40600000,40600000,0,0,40600000,Null,Null,263172729,111461,2
263172748,0.0,0.0,36840000,36840000,0,0,36840000,Null,Null,263172748,111461,2
263172765,0.0,0.0,36400000,36400000,0,0,36400000,Null,Null,263172765,111461,2
263172766,0.0,0.0,44680000,44680000,0,0,44680000,Null,Null,263172766,111461,2
263172770,0.0,0.0,39640000,39640000,0,0,39640000,Null,Null,263172770,111461,2
263172786,0.0,0.0,5740800,5740800,0,0,5740800,Null,Null,263172786,111461,2
263172790,0.0,0.0,1510000,1510000,0,0,1510000,Null,Null,263172790,111461,2
263172919,0.0,0.0,37800000,37800000,0,0,37800000,Null,Null,263172919,111461,2
263172936,0.0,0.0,46360000,46360000,0,0,46360000,Null,Null,263172936,111461,2
263173052,0.0,0.0,41248000,41248000,0,0,41248000,Null,Null,263173052,111461,2
263173247,0.0,0.0,37800000,37800000,0,0,37800000,Null,Null,263173247,111461,2
263173263,0.0,0.0,37800000,37800000,0,0,37800000,Null,Null,263173263,111461,2
263173289,0.0,0.0,53200000,53200000,0,0,53200000,Null,Null,263173289,111461,2
263173420,0.0,0.0,37736000,37736000,0,0,37736000,Null,Null,263173420,111461,2
263173476,0.0,0.0,38363200,38363200,0,0,38363200,Null,Null,263173476,111461,2
263173646,0.0,0.0,63160000,63160000,0,0,63160000,Null,Null,263173646,111461,2
263173734,0.0,0.0,1924480,1924480,0,0,1924480,Null,Null,263173734,111461,2
263174008,0.0,0.0,41051200,41051200,0,0,41051200,Null,Null,263174008,111461,2
263174062,0.0,0.0,38800000,38800000,0,0,38800000,Null,Null,263174062,111461,2
263174102,0.0,0.0,390000,370000,20000,5,390000,Null,Null,263174102,111461,28618
263174341,0.0,0.0,390000,370000,20000,5,390000,Null,Null,263174341,111461,28618
263174389,0.0,0.0,390000,370000,20000,5,390000,Null,Null,263174389,111461,28618
263174649,0.0,0.0,390000,370000,20000,5,390000,Null,Null,263174649,111461,28618
263174659,0.0,0.0,390000,370000,20000,5,390000,Null,Null,263174659,111461,28618
263174786,0.0,0.0,390000,370000,20000,5,390000,Null,Null,263174786,111461,28618
263174800,27.0,27.0,69000,69000,0,0,69000,Null,Null,263174800,111461,1883
263179972,0.0,0.0,40600000,40600000,0,0,40600000,Null,Null,263179972,111461,2
263180159,0.0,0.0,5790000,5790000,0,0,5790000,Null,Null,263180159,111461,2
263180367,0.0,0.0,50400000,50400000,0,0,50400000,Null,Null,263180367,111461,2
263180579,0.0,0.0,41800000,41800000,0,0,41800000,Null,Null,263180579,111461,2
263180683,0.0,0.0,60200000,60200000,0,0,60200000,Null,Null,263180683,111461,2
263180919,0.0,0.0,43400000,43400000,0,0,43400000,Null,Null,263180919,111461,2
263181141,0.0,0.0,54600000,54600000,0,0,54600000,Null,Null,263181141,111461,2
263181172,0.0,0.0,40600000,40600000,0,0,40600000,Null,Null,263181172,111461,2
263181219,0.0,0.0,37100000,37100000,0,0,37100000,Null,Null,263181219,111461,2
263181225,0.0,0.0,42000000,42000000,0,0,42000000,Null,Null,263181225,111461,2
263181281,0.0,0.0,72800000,72800000,0,0,72800000,Null,Null,263181281,111461,2
263181384,0.0,0.0,40600000,40600000,0,0,40600000,Null,Null,263181384,111461,2
263181453,0.0,0.0,82600000,82600000,0,0,82600000,Null,Null,263181453,111461,2
263181463,0.0,0.0,1700000,1700000,0,0,1700000,Null,Null,263181463,111461,2
263181578,0.0,0.0,40600000,40600000,0,0,40600000,Null,Null,263181578,111461,2
263181967,0.0,0.0,5440000,5440000,0,0,5440000,Null,Null,263181967,111461,2
263182149,0.0,0.0,50400000,50400000,0,0,50400000,Null,Null,263182149,111461,2
263182213,0.0,0.0,36400000,36400000,0,0,36400000,Null,Null,263182213,111461,2
263182229,0.0,0.0,39600000,39600000,0,0,39600000,Null,Null,263182229,111461,2
263182294,0.0,0.0,64400000,64400000,0,0,64400000,Null,Null,263182294,111461,2
263182322,0.0,0.0,5800000,5800000,0,0,5800000,Null,Null,263182322,111461,2
263182352,0.0,0.0,50400000,50400000,0,0,50400000,Null,Null,263182352,111461,2
263182361,0.0,0.0,49000000,49000000,0,0,49000000,Null,Null,263182361,111461,2
263182386,0.0,0.0,1450000,1450000,0,0,1450000,Null,Null,263182386,111461,2
263182419,0.0,0.0,46200000,46200000,0,0,46200000,Null,Null,263182419,111461,2
263182660,0.0,0.0,72800000,72800000,0,0,72800000,Null,Null,263182660,111461,2
263182677,0.0,0.0,45100000,45100000,0,0,45100000,Null,Null,263182677,111461,2
263182712,0.0,0.0,89600000,89600000,0,0,89600000,Null,Null,263182712,111461,2
263182717,0.0,0.0,40600000,40600000,0,0,40600000,Null,Null,263182717,111461,2
263182786,0.0,0.0,54000000,54000000,0,0,54000000,Null,Null,263182786,111461,2
263182884,0.0,0.0,50400000,50400000,0,0,50400000,Null,Null,263182884,111461,2
263182923,0.0,0.0,1000,1000,0,0,1000,Null,Null,263182923,111461,2
263183015,0.0,0.0,37800000,37800000,0,0,37800000,Null,Null,263183015,111461,2
263183033,0.0,0.0,1500000,1500000,0,0,1500000,Null,Null,263183033,111461,2
263183359,0.0,0.0,16100000,16100000,0,0,16100000,Null,Null,263183359,111461,2
263183468,0.0,0.0,49000000,49000000,0,0,49000000,Null,Null,263183468,111461,2
263183492,0.0,0.0,47600000,47600000,0,0,47600000,Null,Null,263183492,111461,2
263183888,0.0,0.0,53700000,53700000,0,0,53700000,Null,Null,263183888,111461,2
263183926,0.0,0.0,39200000,39200000,0,0,39200000,Null,Null,263183926,111461,2
263184022,0.0,0.0,57400000,57400000,0,0,57400000,Null,Null,263184022,111461,2
263184309,0.0,0.0,64400000,64400000,0,0,64400000,Null,Null,263184309,111461,2
263184324,0.0,0.0,51840000,51840000,0,0,51840000,Null,Null,263184324,111461,2
263184666,0.0,0.0,58800000,58800000,0,0,58800000,Null,Null,263184666,111461,2
263184689,0.0,0.0,37800000,37800000,0,0,37800000,Null,Null,263184689,111461,2
263184901,0.0,0.0,82800000,82800000,0,0,82800000,Null,Null,263184901,111461,2
263185140,0.0,0.0,47600000,47600000,0,0,47600000,Null,Null,263185140,111461,2
263185309,0.0,0.0,67200000,67200000,0,0,67200000,Null,Null,263185309,111461,2
263185318,0.0,0.0,37950000,37950000,0,0,37950000,Null,Null,263185318,111461,2
263185325,0.0,0.0,39200000,39200000,0,0,39200000,Null,Null,263185325,111461,2
263185368,0.0,0.0,45605000,45605000,0,0,45605000,Null,Null,263185368,111461,2
263185464,0.0,0.0,51800000,51800000,0,0,51800000,Null,Null,263185464,111461,2
263185509,0.0,0.0,60200000,60200000,0,0,60200000,Null,Null,263185509,111461,2
263185534,0.0,0.0,37800000,37800000,0,0,37800000,Null,Null,263185534,111461,2
263186261,0.0,0.0,37200000,37200000,0,0,37200000,Null,Null,263186261,111461,2
263186375,0.0,0.0,88800000,88800000,0,0,88800000,Null,Null,263186375,111461,2
263186581,0.0,0.0,96600000,96600000,0,0,96600000,Null,Null,263186581,111461,2
263186704,0.0,0.0,57600000,57600000,0,0,57600000,Null,Null,263186704,111461,2
263186800,0.0,0.0,42000000,42000000,0,0,42000000,Null,Null,263186800,111461,2
263187068,0.0,0.0,40800000,40800000,0,0,40800000,Null,Null,263187068,111461,2
263187343,0.0,0.0,5800000,5800000,0,0,5800000,Null,Null,263187343,111461,2
263187383,0.0,0.0,42000000,42000000,0,0,42000000,Null,Null,263187383,111461,2
263187384,0.0,0.0,51800000,51800000,0,0,51800000,Null,Null,263187384,111461,2
263187401,0.0,0.0,100800000,100800000,0,0,100800000,Null,Null,263187401,111461,2
263187410,0.0,0.0,3100000,3100000,0,0,3100000,Null,Null,263187410,111461,2
263188107,0.0,0.0,47800000,47800000,0,0,47800000,Null,Null,263188107,111461,2
263188141,0.0,0.0,43400000,43400000,0,0,43400000,Null,Null,263188141,111461,2
263188272,0.0,0.0,86400000,86400000,0,0,86400000,Null,Null,263188272,111461,2
263189180,0.0,0.0,37800000,37800000,0,0,37800000,Null,Null,263189180,111461,2
263189283,0.0,0.0,39380000,39380000,0,0,39380000,Null,Null,263189283,111461,2
263189953,0.0,0.0,55000000,55000000,0,0,55000000,Null,Null,263189953,111461,2
263189973,0.0,0.0,64200000,64200000,0,0,64200000,Null,Null,263189973,111461,2
263190109,0.0,0.0,5450000,5450000,0,0,5450000,Null,Null,263190109,111461,2
263190124,0.0,0.0,16100000,16100000,0,0,16100000,Null,Null,263190124,111461,2
263190187,0.0,0.0,42000000,42000000,0,0,42000000,Null,Null,263190187,111461,2
263190252,0.0,0.0,99000000,99000000,0,0,99000000,Null,Null,263190252,111461,2
263190641,0.0,0.0,37200000,37200000,0,0,37200000,Null,Null,263190641,111461,2
263190927,0.0,0.0,39000000,39000000,0,0,39000000,Null,Null,263190927,111461,2
263191144,0.0,0.0,4690000,4690000,0,0,4690000,Null,Null,263191144,111461,2
263191411,0.0,0.0,38400000,38400000,0,0,38400000,Null,Null,263191411,111461,2
263192238,0.0,0.0,48000000,48000000,0,0,48000000,Null,Null,263192238,111461,2
263192322,0.0,0.0,37800000,37800000,0,0,37800000,Null,Null,263192322,111461,2
263192346,0.0,0.0,52800000,52800000,0,0,52800000,Null,Null,263192346,111461,2
263192362,0.0,0.0,39000000,39000000,0,0,39000000,Null,Null,263192362,111461,2
263192517,0.0,0.0,36500000,36500000,0,0,36500000,Null,Null,263192517,111461,2
263192818,0.0,0.0,44800000,44800000,0,0,44800000,Null,Null,263192818,111461,2
263192859,0.0,0.0,47000000,47000000,0,0,47000000,Null,Null,263192859,111461,2
263193418,0.0,0.0,37000000,37000000,0,0,37000000,Null,Null,263193418,111461,2
263193764,0.0,0.0,65000,65000,0,0,65000,Null,Null,263193764,111461,20258
263194437,0.0,0.0,115000,115000,0,0,115000,Null,Null,263194437,111461,15250
263195306,0.0,0.0,88000,88000,0,0,88000,Null,Null,263195306,111461,12908
263195357,0.0,0.0,36000,36000,0,0,36000,Null,Null,263195357,111461,12908
263195667,0.0,0.0,800000,800000,0,0,800000,Null,Null,263195667,111461,8198
263195739,0.0,0.0,18000,18000,0,0,18000,Null,Null,263195739,111461,20254
263195778,0.0,0.0,631000,380000,251000,40,631000,Null,Null,263195778,248445,17170
263196037,0.0,0.0,1090000,790000,300000,28,1090000,Null,Null,263196037,40780,28454
263196333,0.0,0.0,600000,600000,0,0,600000,Null,Null,263196333,327645,3424
263196414,0.0,0.0,65000,55000,10000,15,65000,Null,Null,263196414,26675,28452
263196416,0.0,0.0,65000,55000,10000,15,65000,Null,Null,263196416,26675,28452
263196434,0.0,0.0,595000,595000,0,0,595000,Null,Null,263196434,327645,2347
263196473,0.0,0.0,650000,650000,0,0,650000,Null,Null,263196473,111461,11885
263196585,0.0,0.0,650000,650000,0,0,650000,Null,Null,263196585,327645,53350
263196765,0.0,0.0,4850000,4850000,0,0,4850000,Null,Null,263196765,7982659,8512
263196769,0.0,0.0,18000,18000,0,0,18000,Null,Null,263196769,111461,20254
263196774,0.0,0.0,75000,75000,0,0,75000,Null,Null,263196774,111461,5267
263196896,0.0,0.0,690000,690000,0,0,690000,Null,Null,263196896,327645,17170
263196983,0.0,0.0,665000,665000,0,0,665000,Null,Null,263196983,327645,2347
263197019,0.0,0.0,3950000,3950000,0,0,3950000,Null,Null,263197019,7982659,8512
263197067,0.0,0.0,1160000,580000,580000,50,1160000,Null,Null,263197067,111461,15318
263197083,0.0,0.0,450000,450000,0,0,450000,Null,Null,263197083,189445,28574
263197255,0.0,0.0,50000,50000,0,0,50000,Null,Null,263197255,111461,2
263197286,0.0,0.0,760000,760000,0,0,760000,Null,Null,263197286,327645,53350
263197293,0.0,0.0,3950000,3950000,0,0,3950000,Null,Null,263197293,7982659,8512
263197959,0.0,0.0,3950000,3950000,0,0,3950000,Null,Null,263197959,7982659,8512
263198004,0.0,0.0,68000,68000,0,0,68000,Null,Null,263198004,111461,7064
263198031,0.0,0.0,790000,790000,0,0,790000,Null,Null,263198031,327645,17174
263198047,0.0,0.0,412000,412000,0,0,412000,Null,Null,263198047,21651,1815
263198960,0.0,0.0,3850000,3850000,0,0,3850000,Null,Null,263198960,7982659,8511
263198970,0.0,0.0,800000,800000,0,0,800000,Null,Null,263198970,111461,8198
263199091,0.0,0.0,110000,110000,0,0,110000,Null,Null,263199091,64137,3428
263199149,0.0,0.0,3850000,3850000,0,0,3850000,Null,Null,263199149,7982659,8512
263199485,0.0,0.0,800000,800000,0,0,800000,Null,Null,263199485,111461,8198
263199520,0.0,0.0,115000,115000,0,0,115000,Null,Null,263199520,111461,8167
263199615,0.0,0.0,3850000,3850000,0,0,3850000,Null,Null,263199615,7982659,8512
263199627,0.0,0.0,215000,215000,0,0,215000,Null,Null,263199627,111461,8167
263199713,0.0,0.0,299000,299000,0,0,299000,Null,Null,263199713,18776,1831
263199724,0.0,0.0,195000,195000,0,0,195000,Null,Null,263199724,111461,1836
263199772,0.0,0.0,600000,600000,0,0,600000,Null,Null,263199772,25697,28450
263199813,0.0,0.0,495000,495000,0,0,495000,Null,Null,263199813,327645,3422
263199847,0.0,0.0,3850000,3850000,0,0,3850000,Null,Null,263199847,7982659,8512
263199986,0.0,0.0,885000,708000,177000,20,885000,Null,Null,263199986,8164011,8226
263200041,0.0,0.0,3850000,3850000,0,0,3850000,Null,Null,263200041,7982659,8512
263200301,0.0,0.0,89000,79000,10000,11,89000,Null,Null,263200301,53040,8308
263200361,0.0,0.0,800000,800000,0,0,800000,Null,Null,263200361,111461,8198
263200382,0.0,0.0,89000,79000,10000,11,89000,Null,Null,263200382,53040,8308
263200487,0.0,0.0,380000,350000,30000,8,380000,Null,Null,263200487,8194775,11865
263200513,0.0,0.0,3850000,3850000,0,0,3850000,Null,Null,263200513,7982659,8512
263201145,0.0,0.0,3850000,3850000,0,0,3850000,Null,Null,263201145,7982659,8512
263201203,0.0,0.0,6590000,4990000,1600000,24,6590000,Null,Null,263201203,8194285,8066
263201230,0.0,0.0,690000,690000,0,0,690000,Null,Null,263201230,327645,1601
263201296,0.0,0.0,3850000,3850000,0,0,3850000,Null,Null,263201296,7982659,8512
263201388,0.0,0.0,495000,495000,0,0,495000,Null,Null,263201388,327645,3424
263201608,0.0,0.0,3850000,3850000,0,0,3850000,Null,Null,263201608,7982659,8512
263201820,0.0,0.0,299000,290000,9000,3,299000,Null,Null,263201820,18776,1831
263201856,0.0,0.0,3850000,3850000,0,0,3850000,Null,Null,263201856,7982659,8512
263201922,0.0,0.0,195000,195000,0,0,195000,Null,Null,263201922,111461,1836
263201999,0.0,0.0,299000,299000,0,0,299000,Null,Null,263201999,18776,1831
263202059,0.0,0.0,495000,495000,0,0,495000,Null,Null,263202059,327645,1601
263202189,0.0,0.0,4150000,4150000,0,0,4150000,Null,Null,263202189,7982659,8512
263202198,0.0,0.0,820000,419000,401000,49,820000,Null,Null,263202198,4647777,15318
263202295,0.0,0.0,600000,600000,0,0,600000,Null,Null,263202295,25697,28450
263202366,0.0,0.0,1830000,1299000,531000,29,1830000,Null,Null,263202366,4647777,15318
263202422,0.0,0.0,4350000,4350000,0,0,4350000,Null,Null,263202422,7982659,8512
263202515,0.0,0.0,820000,419000,401000,49,820000,Null,Null,263202515,4647777,15318
263202556,0.0,0.0,560000,560000,0,0,560000,Null,Null,263202556,327645,1583
263202560,0.0,0.0,80000,46000,34000,43,80000,Null,Null,263202560,111461,11923
263202571,0.0,0.0,590000,590000,0,0,590000,Null,Null,263202571,111461,53350
263202676,0.0,0.0,2850000,2800000,50000,2,2850000,Null,Null,263202676,5347313,2324
263202738,0.0,0.0,600000,600000,0,0,600000,Null,Null,263202738,25697,28450
263202779,0.0,0.0,90000,55000,35000,39,90000,Null,Null,263202779,111461,11923
263202781,0.0,0.0,224000,224000,0,0,224000,Null,Null,263202781,676077,1752
263202797,0.0,0.0,110000,110000,0,0,110000,Null,Null,263202797,33203,2
263202838,0.0,0.0,190000,190000,0,0,190000,Null,Null,263202838,111461,28428
263202950,0.0,0.0,80000,65000,15000,19,80000,Null,Null,263202950,111461,11923
263206948,0.0,0.0,299000,299000,0,0,299000,Null,Null,263206948,213569,8216
263207150,0.0,0.0,3950000,3950000,0,0,3950000,Null,Null,263207150,7982659,8511
263207329,0.0,0.0,3950000,3950000,0,0,3950000,Null,Null,263207329,7982659,8511
263207376,0.0,0.0,475000,475000,0,0,475000,Null,Null,263207376,327645,1583
263207390,0.0,0.0,58000,58000,0,0,58000,Null,Null,263207390,111461,28578
263207671,0.0,0.0,330000,330000,0,0,330000,Null,Null,263207671,213569,13878
263207696,0.0,0.0,530000,530000,0,0,530000,Null,Null,263207696,327645,53350
263207731,0.0,0.0,530000,530000,0,0,530000,Null,Null,263207731,327645,53350
263207934,0.0,0.0,3950000,3950000,0,0,3950000,Null,Null,263207934,7982659,8512
263207986,0.0,0.0,1750000,1575000,175000,10,1750000,Null,Null,263207986,8195169,53350
263207995,0.0,0.0,125000,125000,0,0,125000,Null,Null,263207995,111461,28574
263208335,0.0,0.0,3950000,3950000,0,0,3950000,Null,Null,263208335,7982659,8511
263208434,0.0,0.0,1995000,1795000,200000,10,1995000,Null,Null,263208434,8195169,53350
263208469,0.0,0.0,135000,135000,0,0,135000,Null,Null,263208469,111461,15320
263208696,0.0,0.0,4150000,4150000,0,0,4150000,Null,Null,263208696,7982659,8512
263208763,0.0,0.0,1050000,945000,105000,10,1050000,Null,Null,263208763,8195169,53350
263208969,0.0,0.0,4150000,4150000,0,0,4150000,Null,Null,263208969,7982659,8512
263209180,0.0,0.0,1950000,1755000,195000,10,1950000,Null,Null,263209180,8195169,17170
263209233,0.0,0.0,3990000,3990000,0,0,3990000,Null,Null,263209233,860053,15250
263209406,0.0,0.0,1649000,1649000,0,0,1649000,Null,Null,263209406,8175811,28454
263209413,0.0,0.0,120000,100000,20000,17,120000,Null,Null,263209413,365727,11873
263209434,0.0,0.0,319000,319000,0,0,319000,Null,Null,263209434,111461,2324
263209538,0.0,0.0,5150000,5150000,0,0,5150000,Null,Null,263209538,7982659,8512
263209730,0.0,0.0,2550000,2295000,255000,10,2550000,Null,Null,263209730,8195169,17170
263209748,0.0,0.0,18000,18000,0,0,18000,Null,Null,263209748,162547,1601
263210007,0.0,0.0,550000,550000,0,0,550000,Null,Null,263210007,111461,53350
263210013,0.0,0.0,5150000,5150000,0,0,5150000,Null,Null,263210013,7982659,8512
263210101,0.0,0.0,200000,160000,40000,20,200000,Null,Null,263210101,365727,11869
263210103,0.0,0.0,5150000,5150000,0,0,5150000,Null,Null,263210103,7982659,8512
263210190,0.0,0.0,287000,287000,0,0,287000,Null,Null,263210190,254399,11741
263210281,0.0,0.0,175000,175000,0,0,175000,Null,Null,263210281,111461,1752
263210324,0.0,0.0,588000,588000,0,0,588000,Null,Null,263210324,111461,11937
263210348,0.0,0.0,1030000,1030000,0,0,1030000,Null,Null,263210348,111461,3426
263239289,0.0,0.0,36000,36000,0,0,36000,Null,Null,263239289,21653,1831
263239294,0.0,0.0,4660000,4660000,0,0,4660000,Null,Null,263239294,7982659,8512
263239406,0.0,0.0,135000,110000,25000,19,135000,Null,Null,263239406,365727,11859
263239529,0.0,0.0,650000,650000,0,0,650000,Null,Null,263239529,632579,11935
263239534,0.0,0.0,399000,399000,0,0,399000,Null,Null,263239534,213569,8216
263239540,0.0,0.0,175000,175000,0,0,175000,Null,Null,263239540,111461,1752
263239768,0.0,0.0,1030000,1030000,0,0,1030000,Null,Null,263239768,5002791,3422
263239770,0.0,0.0,588000,588000,0,0,588000,Null,Null,263239770,111461,11937
263239833,0.0,0.0,1560000,1560000,0,0,1560000,Null,Null,263239833,632579,1626
263240186,1.0,1.0,175000,175000,0,0,175000,Null,Null,263240186,111461,1752
263241661,0.0,0.0,330000,330000,0,0,330000,Null,Null,263241661,111461,11943
263241666,0.0,0.0,588000,588000,0,0,588000,Null,Null,263241666,111461,11933
263241764,0.0,0.0,5290000,3550000,1740000,33,5290000,Null,Null,263241764,8194285,8066
263241811,0.0,0.0,175000,175000,0,0,175000,Null,Null,263241811,111461,1752
263241928,0.0,0.0,1200000,1200000,0,0,1200000,Null,Null,263241928,111461,3426
263243714,0.0,0.0,375000,375000,0,0,375000,Null,Null,263243714,111461,11897
263243800,0.0,0.0,6850000,6850000,0,0,6850000,Null,Null,263243800,579445,15318
263243814,0.0,0.0,375000,375000,0,0,375000,Null,Null,263243814,111461,11897
263243952,0.0,0.0,899000,899000,0,0,899000,Null,Null,263243952,5724829,8511
263243967,0.0,0.0,375000,375000,0,0,375000,Null,Null,263243967,111461,11897
263244108,0.0,0.0,5850000,5850000,0,0,5850000,Null,Null,263244108,579445,15318
263244201,0.0,0.0,340000,340000,0,0,340000,Null,Null,263244201,21653,4593
263244243,0.0,0.0,6790000,6790000,0,0,6790000,Null,Null,263244243,74999,11516
263244260,0.0,0.0,4250000,4250000,0,0,4250000,Null,Null,263244260,579445,15318
263244262,0.0,0.0,4300000,4300000,0,0,4300000,Null,Null,263244262,7982659,8512
263244277,0.0,0.0,1908000,1908000,0,0,1908000,Null,Null,263244277,174069,12864
263244348,0.0,0.0,2146000,2146000,0,0,2146000,Null,Null,263244348,174069,12864
263246375,0.0,0.0,4500000,4500000,0,0,4500000,Null,Null,263246375,7982659,8512
263246542,0.0,0.0,192000,192000,0,0,192000,Null,Null,263246542,8194293,3424
263247165,0.0,0.0,51000000,51000000,0,0,51000000,Null,Null,263247165,111461,2
263247177,0.0,0.0,46400000,46400000,0,0,46400000,Null,Null,263247177,111461,2
263247271,0.0,0.0,47400000,47400000,0,0,47400000,Null,Null,263247271,111461,2
263247277,0.0,0.0,47000000,47000000,0,0,47000000,Null,Null,263247277,111461,2
263247320,0.0,0.0,40000000,40000000,0,0,40000000,Null,Null,263247320,111461,2
263247324,0.0,0.0,36000000,36000000,0,0,36000000,Null,Null,263247324,111461,2
263247326,0.0,0.0,11200000,11200000,0,0,11200000,Null,Null,263247326,111461,2
263247407,0.0,0.0,50000000,50000000,0,0,50000000,Null,Null,263247407,111461,2
263247419,0.0,0.0,38400000,38400000,0,0,38400000,Null,Null,263247419,111461,2
263247422,0.0,0.0,43200000,43200000,0,0,43200000,Null,Null,263247422,111461,2
263247494,0.0,0.0,50400000,50400000,0,0,50400000,Null,Null,263247494,111461,2
263247496,0.0,0.0,108000000,108000000,0,0,108000000,Null,Null,263247496,111461,2
263247498,0.0,0.0,60000000,60000000,0,0,60000000,Null,Null,263247498,111461,2
263247556,0.0,0.0,78000000,78000000,0,0,78000000,Null,Null,263247556,111461,2
263247573,0.0,0.0,38320000,38320000,0,0,38320000,Null,Null,263247573,111461,2
263247581,0.0,0.0,40320000,40320000,0,0,40320000,Null,Null,263247581,111461,2
263247651,0.0,0.0,39000000,39000000,0,0,39000000,Null,Null,263247651,111461,2
263247744,0.0,0.0,50000000,50000000,0,0,50000000,Null,Null,263247744,111461,2
263247753,0.0,0.0,37000000,37000000,0,0,37000000,Null,Null,263247753,111461,2
263247756,0.0,0.0,38880000,38880000,0,0,38880000,Null,Null,263247756,111461,2
263247779,0.0,0.0,36720000,36720000,0,0,36720000,Null,Null,263247779,111461,2
263247803,0.0,0.0,72000000,72000000,0,0,72000000,Null,Null,263247803,111461,2
263247830,0.0,0.0,93600000,93600000,0,0,93600000,Null,Null,263247830,111461,2
263247839,0.0,0.0,36800000,36800000,0,0,36800000,Null,Null,263247839,111461,2
263247868,0.0,0.0,54000000,54000000,0,0,54000000,Null,Null,263247868,111461,2
263247881,0.0,0.0,79200000,79200000,0,0,79200000,Null,Null,263247881,111461,2
263247887,0.0,0.0,36000000,36000000,0,0,36000000,Null,Null,263247887,111461,2
263247967,0.0,0.0,63264000,63264000,0,0,63264000,Null,Null,263247967,111461,2
263247996,0.0,0.0,47520000,47520000,0,0,47520000,Null,Null,263247996,111461,2
263248002,0.0,0.0,43000000,43000000,0,0,43000000,Null,Null,263248002,111461,2
263248045,0.0,0.0,50000000,50000000,0,0,50000000,Null,Null,263248045,111461,2
263248054,0.0,0.0,66000000,66000000,0,0,66000000,Null,Null,263248054,111461,2
263248107,0.0,0.0,52784000,52784000,0,0,52784000,Null,Null,263248107,111461,2
263248155,0.0,0.0,50000000,50000000,0,0,50000000,Null,Null,263248155,111461,2
263248168,0.0,0.0,78000000,78000000,0,0,78000000,Null,Null,263248168,111461,2
263248199,0.0,0.0,48000000,48000000,0,0,48000000,Null,Null,263248199,111461,2
263248212,0.0,0.0,97920000,97920000,0,0,97920000,Null,Null,263248212,111461,2
263248230,0.0,0.0,39200000,39200000,0,0,39200000,Null,Null,263248230,111461,2
263248347,0.0,0.0,48960000,48960000,0,0,48960000,Null,Null,263248347,111461,2
263248387,0.0,0.0,42000000,42000000,0,0,42000000,Null,Null,263248387,111461,2
263248436,0.0,0.0,61920000,61920000,0,0,61920000,Null,Null,263248436,111461,2
263248496,0.0,0.0,36000000,36000000,0,0,36000000,Null,Null,263248496,111461,2
263248651,0.0,0.0,51000000,51000000,0,0,51000000,Null,Null,263248651,111461,2
263248656,0.0,0.0,57600000,57600000,0,0,57600000,Null,Null,263248656,111461,2
263248668,0.0,0.0,45000000,45000000,0,0,45000000,Null,Null,263248668,111461,2
263248733,0.0,0.0,45600000,45600000,0,0,45600000,Null,Null,263248733,111461,2
263248879,0.0,0.0,36894000,36894000,0,0,36894000,Null,Null,263248879,111461,2
263248928,0.0,0.0,50000000,50000000,0,0,50000000,Null,Null,263248928,111461,2
263248933,0.0,0.0,44000000,44000000,0,0,44000000,Null,Null,263248933,111461,2
263249140,0.0,0.0,48800000,48800000,0,0,48800000,Null,Null,263249140,111461,2
263249272,0.0,0.0,42400000,42400000,0,0,42400000,Null,Null,263249272,111461,2
263249313,0.0,0.0,38150000,38150000,0,0,38150000,Null,Null,263249313,111461,2
263249319,0.0,0.0,59040000,59040000,0,0,59040000,Null,Null,263249319,111461,2
263249321,0.0,0.0,48000000,48000000,0,0,48000000,Null,Null,263249321,111461,2
263249341,0.0,0.0,40000000,40000000,0,0,40000000,Null,Null,263249341,111461,2
263249568,0.0,0.0,38304000,38304000,0,0,38304000,Null,Null,263249568,111461,2
263249573,0.0,0.0,40800000,40800000,0,0,40800000,Null,Null,263249573,111461,2
263249665,0.0,0.0,54000000,54000000,0,0,54000000,Null,Null,263249665,111461,2
263249678,0.0,0.0,38250000,38250000,0,0,38250000,Null,Null,263249678,111461,2
263249679,0.0,0.0,54720000,54720000,0,0,54720000,Null,Null,263249679,111461,2
263249716,0.0,0.0,41600000,41600000,0,0,41600000,Null,Null,263249716,111461,2
263249724,0.0,0.0,46400000,46400000,0,0,46400000,Null,Null,263249724,111461,2
263249739,0.0,0.0,39840000,39840000,0,0,39840000,Null,Null,263249739,111461,2
263249785,0.0,0.0,64560000,64560000,0,0,64560000,Null,Null,263249785,111461,2
263249791,0.0,0.0,50000000,50000000,0,0,50000000,Null,Null,263249791,111461,2
263249840,0.0,0.0,68400000,68400000,0,0,68400000,Null,Null,263249840,111461,2
263249960,0.0,0.0,54000000,54000000,0,0,54000000,Null,Null,263249960,111461,2
263249994,0.0,0.0,250000,250000,0,0,250000,Null,Null,263249994,111461,2
263250021,0.0,0.0,42000000,42000000,0,0,42000000,Null,Null,263250021,111461,2
263250034,0.0,0.0,65000000,65000000,0,0,65000000,Null,Null,263250034,111461,2
263250070,0.0,0.0,60000000,60000000,0,0,60000000,Null,Null,263250070,111461,2
263250080,0.0,0.0,40000000,40000000,0,0,40000000,Null,Null,263250080,111461,2
263250131,0.0,0.0,58800000,58800000,0,0,58800000,Null,Null,263250131,111461,2
263250156,0.0,0.0,58000000,58000000,0,0,58000000,Null,Null,263250156,111461,2
263250176,0.0,0.0,63000000,63000000,0,0,63000000,Null,Null,263250176,111461,2
263250219,0.0,0.0,50000000,50000000,0,0,50000000,Null,Null,263250219,111461,2
263250223,0.0,0.0,41420000,41420000,0,0,41420000,Null,Null,263250223,111461,2
263250263,0.0,0.0,83520000,83520000,0,0,83520000,Null,Null,263250263,111461,2
263250292,0.0,0.0,52800000,52800000,0,0,52800000,Null,Null,263250292,111461,2
263250306,0.0,0.0,39000000,39000000,0,0,39000000,Null,Null,263250306,111461,2
263250308,0.0,0.0,38000000,38000000,0,0,38000000,Null,Null,263250308,111461,2
263250356,0.0,0.0,42510000,42510000,0,0,42510000,Null,Null,263250356,111461,2
263250365,0.0,0.0,66000000,66000000,0,0,66000000,Null,Null,263250365,111461,2
263250438,0.0,0.0,58642000,58642000,0,0,58642000,Null,Null,263250438,111461,2
263250458,0.0,0.0,50000000,50000000,0,0,50000000,Null,Null,263250458,111461,2
263250543,0.0,0.0,62400000,62400000,0,0,62400000,Null,Null,263250543,111461,2
263250562,0.0,0.0,42510000,42510000,0,0,42510000,Null,Null,263250562,111461,2
263250565,0.0,0.0,37600000,37600000,0,0,37600000,Null,Null,263250565,111461,2
263250712,0.0,0.0,36800000,36800000,0,0,36800000,Null,Null,263250712,111461,2
263250721,0.0,0.0,38500000,38500000,0,0,38500000,Null,Null,263250721,111461,2
263250804,0.0,0.0,38150000,38150000,0,0,38150000,Null,Null,263250804,111461,2
263250864,0.0,0.0,4550000,4550000,0,0,4550000,Null,Null,263250864,8131421,2324
263250865,0.0,0.0,50400000,50400000,0,0,50400000,Null,Null,263250865,111461,2
263250934,0.0,0.0,42000000,42000000,0,0,42000000,Null,Null,263250934,111461,2
263250962,0.0,0.0,49050000,49050000,0,0,49050000,Null,Null,263250962,111461,2
263251047,0.0,0.0,36000000,36000000,0,0,36000000,Null,Null,263251047,111461,2
263251066,0.0,0.0,112320000,112320000,0,0,112320000,Null,Null,263251066,111461,2
263251068,0.0,0.0,36000000,36000000,0,0,36000000,Null,Null,263251068,111461,2
263251101,0.0,0.0,61920000,61920000,0,0,61920000,Null,Null,263251101,111461,2
263251112,0.0,0.0,45000000,45000000,0,0,45000000,Null,Null,263251112,111461,2
263251154,0.0,0.0,40320000,40320000,0,0,40320000,Null,Null,263251154,111461,2
263251233,0.0,0.0,66000000,66000000,0,0,66000000,Null,Null,263251233,111461,2
263251252,0.0,0.0,52500000,52500000,0,0,52500000,Null,Null,263251252,111461,2
263251364,0.0,0.0,50000000,50000000,0,0,50000000,Null,Null,263251364,111461,2
263251390,0.0,0.0,43200000,43200000,0,0,43200000,Null,Null,263251390,111461,2
263251504,0.0,0.0,37440000,37440000,0,0,37440000,Null,Null,263251504,111461,2
263251532,0.0,0.0,46000000,46000000,0,0,46000000,Null,Null,263251532,111461,2
263251585,0.0,0.0,50000000,50000000,0,0,50000000,Null,Null,263251585,111461,2
263251611,0.0,0.0,45000000,45000000,0,0,45000000,Null,Null,263251611,111461,2
263251628,0.0,0.0,95040000,95040000,0,0,95040000,Null,Null,263251628,111461,2
263251631,0.0,0.0,43200000,43200000,0,0,43200000,Null,Null,263251631,111461,2
263251675,0.0,0.0,86400000,86400000,0,0,86400000,Null,Null,263251675,111461,2
263251704,0.0,0.0,36000000,36000000,0,0,36000000,Null,Null,263251704,111461,2
263251762,0.0,0.0,51840000,51840000,0,0,51840000,Null,Null,263251762,111461,2
263251792,0.0,0.0,99000,99000,0,0,99000,Null,Null,263251792,111461,2
263251807,0.0,0.0,50000000,50000000,0,0,50000000,Null,Null,263251807,111461,2
263251849,0.0,0.0,38400000,38400000,0,0,38400000,Null,Null,263251849,111461,2
263251857,0.0,0.0,63360000,63360000,0,0,63360000,Null,Null,263251857,111461,2
263251983,0.0,0.0,36000000,36000000,0,0,36000000,Null,Null,263251983,111461,2
263252006,0.0,0.0,50400000,50400000,0,0,50400000,Null,Null,263252006,111461,2
263252130,0.0,0.0,36000000,36000000,0,0,36000000,Null,Null,263252130,111461,2
263252173,0.0,0.0,38390400,38390400,0,0,38390400,Null,Null,263252173,111461,2
263252196,0.0,0.0,44400000,44400000,0,0,44400000,Null,Null,263252196,111461,2
263252223,0.0,0.0,40320000,40320000,0,0,40320000,Null,Null,263252223,111461,2
263252225,0.0,0.0,38240000,38240000,0,0,38240000,Null,Null,263252225,111461,2
263252226,0.0,0.0,41000000,41000000,0,0,41000000,Null,Null,263252226,111461,2
263252230,0.0,0.0,39200000,39200000,0,0,39200000,Null,Null,263252230,111461,2
263252238,0.0,0.0,37000000,37000000,0,0,37000000,Null,Null,263252238,111461,2
263252244,0.0,0.0,90720000,90720000,0,0,90720000,Null,Null,263252244,111461,2
263252284,0.0,0.0,43200000,43200000,0,0,43200000,Null,Null,263252284,111461,2
263252290,0.0,0.0,67500000,67500000,0,0,67500000,Null,Null,263252290,111461,2
263252347,0.0,0.0,78000000,78000000,0,0,78000000,Null,Null,263252347,111461,2
263252364,0.0,0.0,74400000,74400000,0,0,74400000,Null,Null,263252364,111461,2
263252419,0.0,0.0,41000000,41000000,0,0,41000000,Null,Null,263252419,111461,2
263252446,0.0,0.0,160000,160000,0,0,160000,Null,Null,263252446,111461,2
263252472,0.0,0.0,240000,240000,0,0,240000,Null,Null,263252472,111461,2
263252500,0.0,0.0,74392500,74392500,0,0,74392500,Null,Null,263252500,111461,2
263252503,0.0,0.0,56160000,56160000,0,0,56160000,Null,Null,263252503,111461,2
263252525,0.0,0.0,81600000,81600000,0,0,81600000,Null,Null,263252525,111461,2
263252530,0.0,0.0,68000000,68000000,0,0,68000000,Null,Null,263252530,111461,2
263252629,0.0,0.0,46000000,46000000,0,0,46000000,Null,Null,263252629,111461,2
263252671,0.0,0.0,36800000,36800000,0,0,36800000,Null,Null,263252671,111461,2
263252696,0.0,0.0,47984000,47984000,0,0,47984000,Null,Null,263252696,111461,2
263252756,0.0,0.0,47520000,47520000,0,0,47520000,Null,Null,263252756,111461,2
263252778,0.0,0.0,37000000,37000000,0,0,37000000,Null,Null,263252778,111461,2
263252806,0.0,0.0,57600000,57600000,0,0,57600000,Null,Null,263252806,111461,2
263252833,0.0,0.0,52000000,52000000,0,0,52000000,Null,Null,263252833,111461,2
263252846,0.0,0.0,50000000,50000000,0,0,50000000,Null,Null,263252846,111461,2
263252879,0.0,0.0,64800000,64800000,0,0,64800000,Null,Null,263252879,111461,2
263252918,0.0,0.0,37000000,37000000,0,0,37000000,Null,Null,263252918,111461,2
263252932,0.0,0.0,54000000,54000000,0,0,54000000,Null,Null,263252932,111461,2
263252963,0.0,0.0,37000000,37000000,0,0,37000000,Null,Null,263252963,111461,2
263253028,0.0,0.0,55200000,55200000,0,0,55200000,Null,Null,263253028,111461,2
263253116,0.0,0.0,37600000,37600000,0,0,37600000,Null,Null,263253116,111461,2
263253142,0.0,0.0,48000000,48000000,0,0,48000000,Null,Null,263253142,111461,2
263253168,0.0,0.0,47039040,47039040,0,0,47039040,Null,Null,263253168,111461,2
263253182,0.0,0.0,53000000,53000000,0,0,53000000,Null,Null,263253182,111461,2
263253208,0.0,0.0,41000000,41000000,0,0,41000000,Null,Null,263253208,111461,2
263253268,0.0,0.0,41760000,41760000,0,0,41760000,Null,Null,263253268,111461,2
263253366,0.0,0.0,78000000,78000000,0,0,78000000,Null,Null,263253366,111461,2
263253370,0.0,0.0,64473500,64473500,0,0,64473500,Null,Null,263253370,111461,2
263253377,0.0,0.0,79200000,79200000,0,0,79200000,Null,Null,263253377,111461,2
263253378,0.0,0.0,46000000,46000000,0,0,46000000,Null,Null,263253378,111461,2
263253415,0.0,0.0,40000000,40000000,0,0,40000000,Null,Null,263253415,111461,2
263253445,0.0,0.0,45000000,45000000,0,0,45000000,Null,Null,263253445,111461,2
263253454,0.0,0.0,50000000,50000000,0,0,50000000,Null,Null,263253454,111461,2
263253519,0.0,0.0,53000000,53000000,0,0,53000000,Null,Null,263253519,111461,2
263253551,0.0,0.0,1200000,1200000,0,0,1200000,Null,Null,263253551,111461,53350
263253572,0.0,0.0,53000000,53000000,0,0,53000000,Null,Null,263253572,111461,2
263253577,0.0,0.0,48000000,48000000,0,0,48000000,Null,Null,263253577,111461,2
263253619,0.0,0.0,99999999,99999999,0,0,99999999,Null,Null,263253619,111461,2
263253676,0.0,0.0,40000000,40000000,0,0,40000000,Null,Null,263253676,111461,2
263253677,0.0,0.0,74392500,74392500,0,0,74392500,Null,Null,263253677,111461,2
263253740,0.0,0.0,68000000,68000000,0,0,68000000,Null,Null,263253740,111461,2
263253787,0.0,0.0,54400000,54400000,0,0,54400000,Null,Null,263253787,111461,2
263253850,0.0,0.0,40000000,40000000,0,0,40000000,Null,Null,263253850,111461,2
263253856,0.0,0.0,46870000,46870000,0,0,46870000,Null,Null,263253856,111461,2
263253968,0.0,0.0,120000000,120000000,0,0,120000000,Null,Null,263253968,111461,2
263253988,0.0,0.0,37000000,37000000,0,0,37000000,Null,Null,263253988,111461,2
263254015,0.0,0.0,120000000,120000000,0,0,120000000,Null,Null,263254015,111461,2
263254069,0.0,0.0,42000000,42000000,0,0,42000000,Null,Null,263254069,111461,2
263254183,0.0,0.0,79200000,79200000,0,0,79200000,Null,Null,263254183,111461,2
263254272,0.0,0.0,39676000,39676000,0,0,39676000,Null,Null,263254272,111461,2
263254287,0.0,0.0,42900000,42900000,0,0,42900000,Null,Null,263254287,111461,2
263254336,0.0,0.0,41760000,41760000,0,0,41760000,Null,Null,263254336,111461,2
263254342,0.0,0.0,40000000,40000000,0,0,40000000,Null,Null,263254342,111461,2
263254349,0.0,0.0,37000000,37000000,0,0,37000000,Null,Null,263254349,111461,2
263254417,0.0,0.0,47640000,47640000,0,0,47640000,Null,Null,263254417,111461,2
263254468,0.0,0.0,56850000,56850000,0,0,56850000,Null,Null,263254468,111461,2
263254503,0.0,0.0,46900000,46900000,0,0,46900000,Null,Null,263254503,111461,2
263254650,0.0,0.0,119000000,119000000,0,0,119000000,Null,Null,263254650,111461,2
263254668,0.0,0.0,47412820,47412820,0,0,47412820,Null,Null,263254668,111461,2
263254710,0.0,0.0,57530200,57530200,0,0,57530200,Null,Null,263254710,111461,2
263254744,0.0,0.0,48000000,48000000,0,0,48000000,Null,Null,263254744,111461,2
263254806,0.0,0.0,46870000,46870000,0,0,46870000,Null,Null,263254806,111461,2
263254822,0.0,0.0,59514000,59514000,0,0,59514000,Null,Null,263254822,111461,2
263254918,0.0,0.0,65465400,65465400,0,0,65465400,Null,Null,263254918,111461,2
263254928,0.0,0.0,108000000,108000000,0,0,108000000,Null,Null,263254928,111461,2
263254934,0.0,0.0,45000000,45000000,0,0,45000000,Null,Null,263254934,111461,2
263255104,0.0,0.0,59950000,59950000,0,0,59950000,Null,Null,263255104,111461,2
263255118,0.0,0.0,39378430,39378430,0,0,39378430,Null,Null,263255118,111461,2
263255124,0.0,0.0,60000000,60000000,0,0,60000000,Null,Null,263255124,111461,2
263255134,0.0,0.0,38684100,38684100,0,0,38684100,Null,Null,263255134,111461,2
263255140,0.0,0.0,43600000,43600000,0,0,43600000,Null,Null,263255140,111461,2
263255158,0.0,0.0,56160000,56160000,0,0,56160000,Null,Null,263255158,111461,2
263255245,0.0,0.0,72479000,72479000,0,0,72479000,Null,Null,263255245,111461,2
263255336,0.0,0.0,38000000,38000000,0,0,38000000,Null,Null,263255336,111461,2
263255386,0.0,0.0,199000,199000,0,0,199000,Null,Null,263255386,111461,2
263255427,0.0,0.0,49200000,49200000,0,0,49200000,Null,Null,263255427,111461,2
263255447,0.0,0.0,38150000,38150000,0,0,38150000,Null,Null,263255447,111461,2
263255504,0.0,0.0,41420000,41420000,0,0,41420000,Null,Null,263255504,111461,2
263255543,0.0,0.0,38000000,38000000,0,0,38000000,Null,Null,263255543,111461,2
263255545,0.0,0.0,40000000,40000000,0,0,40000000,Null,Null,263255545,111461,2
263255577,0.0,0.0,67449200,67449200,0,0,67449200,Null,Null,263255577,111461,2
263255790,0.0,0.0,2890000,2890000,0,0,2890000,Null,Null,263255790,7982659,8512
263255902,0.0,0.0,1850000,1850000,0,0,1850000,Null,Null,263255902,8131421,2324
263255911,0.0,0.0,2890000,2890000,0,0,2890000,Null,Null,263255911,7982659,8512
263255989,0.0,0.0,2990000,2541500,448500,15,2990000,Null,Null,263255989,208841,2340
263256204,0.0,0.0,1680000,1680000,0,0,1680000,Null,Null,263256204,19057,1805
263256228,0.0,0.0,1150000,1150000,0,0,1150000,Null,Null,263256228,111461,53350
263256275,0.0,0.0,2890000,2890000,0,0,2890000,Null,Null,263256275,7982659,8512
263256302,0.0,0.0,990000,792000,198000,20,990000,Null,Null,263256302,8164011,8223
263256356,0.0,0.0,2890000,2890000,0,0,2890000,Null,Null,263256356,7982659,8512
263256392,0.0,0.0,675000,540000,135000,20,675000,Null,Null,263256392,8164011,1752
263256466,0.0,0.0,246000,246000,0,0,246000,Null,Null,263256466,21653,1819
263256595,0.0,0.0,1290000,1290000,0,0,1290000,Null,Null,263256595,19057,2324
263256650,0.0,0.0,4590000,4590000,0,0,4590000,Null,Null,263256650,7982659,8512
263256654,0.0,0.0,3680000,3200000,480000,13,3680000,Null,Null,263256654,5700191,11933
263256692,0.0,0.0,990000,792000,198000,20,990000,Null,Null,263256692,8164011,13878
263256782,0.0,0.0,50000000,50000000,0,0,50000000,Null,Null,263256782,111461,2
263256793,0.0,0.0,39200000,39200000,0,0,39200000,Null,Null,263256793,111461,2
263256863,0.0,0.0,39200000,39200000,0,0,39200000,Null,Null,263256863,111461,2
263256879,0.0,0.0,41440000,41440000,0,0,41440000,Null,Null,263256879,111461,2
263256885,0.0,0.0,39200000,39200000,0,0,39200000,Null,Null,263256885,111461,2
263256887,0.0,0.0,51719200,51719200,0,0,51719200,Null,Null,263256887,111461,2
263256899,0.0,0.0,51520000,51520000,0,0,51520000,Null,Null,263256899,111461,2
263256929,0.0,0.0,53760000,53760000,0,0,53760000,Null,Null,263256929,111461,2
263256987,0.0,0.0,50400000,50400000,0,0,50400000,Null,Null,263256987,111461,2
263257074,0.0,0.0,36000000,36000000,0,0,36000000,Null,Null,263257074,111461,2
263257147,0.0,0.0,40320000,40320000,0,0,40320000,Null,Null,263257147,111461,2
263257170,0.0,0.0,51520000,51520000,0,0,51520000,Null,Null,263257170,111461,2
263257232,0.0,0.0,40600000,40600000,0,0,40600000,Null,Null,263257232,111461,2
263257378,0.0,0.0,37578173,37578173,0,0,37578173,Null,Null,263257378,111461,2
263257385,0.0,0.0,71680000,71680000,0,0,71680000,Null,Null,263257385,111461,2
263257449,0.0,0.0,43400000,43400000,0,0,43400000,Null,Null,263257449,111461,2
263257497,0.0,0.0,50000000,50000000,0,0,50000000,Null,Null,263257497,111461,2
263257507,0.0,0.0,40320000,40320000,0,0,40320000,Null,Null,263257507,111461,2
263257508,0.0,0.0,77280000,77280000,0,0,77280000,Null,Null,263257508,111461,2
263257571,0.0,0.0,42000000,42000000,0,0,42000000,Null,Null,263257571,111461,2
263257583,0.0,0.0,39200000,39200000,0,0,39200000,Null,Null,263257583,111461,2
263257600,0.0,0.0,58240000,58240000,0,0,58240000,Null,Null,263257600,111461,2
263257769,0.0,0.0,39168000,39168000,0,0,39168000,Null,Null,263257769,111461,2
263257876,0.0,0.0,43400000,43400000,0,0,43400000,Null,Null,263257876,111461,2
263257918,0.0,0.0,55200000,55200000,0,0,55200000,Null,Null,263257918,111461,2
263257970,0.0,0.0,54252000,54252000,0,0,54252000,Null,Null,263257970,111461,2
263257984,0.0,0.0,43680000,43680000,0,0,43680000,Null,Null,263257984,111461,2
263258104,0.0,0.0,46200000,46200000,0,0,46200000,Null,Null,263258104,111461,2
263258444,0.0,0.0,48160000,48160000,0,0,48160000,Null,Null,263258444,111461,2
263258590,0.0,0.0,50000000,50000000,0,0,50000000,Null,Null,263258590,111461,2
263258629,0.0,0.0,49000000,49000000,0,0,49000000,Null,Null,263258629,111461,2
263258871,0.0,0.0,51660000,51660000,0,0,51660000,Null,Null,263258871,111461,2
263258895,0.0,0.0,50000000,50000000,0,0,50000000,Null,Null,263258895,111461,2
263259179,0.0,0.0,58240000,58240000,0,0,58240000,Null,Null,263259179,111461,2
263259325,0.0,0.0,40800000,40800000,0,0,40800000,Null,Null,263259325,111461,2
263259440,0.0,0.0,36400000,36400000,0,0,36400000,Null,Null,263259440,111461,2
263259449,0.0,0.0,41300000,41300000,0,0,41300000,Null,Null,263259449,111461,2
263259484,0.0,0.0,40320000,40320000,0,0,40320000,Null,Null,263259484,111461,2
263259511,0.0,0.0,53000000,53000000,0,0,53000000,Null,Null,263259511,111461,2
263259524,0.0,0.0,40600000,40600000,0,0,40600000,Null,Null,263259524,111461,2
263259550,0.0,0.0,50000000,50000000,0,0,50000000,Null,Null,263259550,111461,2
263259558,0.0,0.0,36540000,36540000,0,0,36540000,Null,Null,263259558,111461,2
263259587,0.0,0.0,47040000,47040000,0,0,47040000,Null,Null,263259587,111461,2
263259595,0.0,0.0,40800000,40800000,0,0,40800000,Null,Null,263259595,111461,2
263259915,0.0,0.0,50000000,50000000,0,0,50000000,Null,Null,263259915,111461,2
263259966,0.0,0.0,45920000,45920000,0,0,45920000,Null,Null,263259966,111461,2
263260036,0.0,0.0,49000000,49000000,0,0,49000000,Null,Null,263260036,111461,2
263260041,0.0,0.0,40600000,40600000,0,0,40600000,Null,Null,263260041,111461,2
263260070,0.0,0.0,38080000,38080000,0,0,38080000,Null,Null,263260070,111461,2
263260090,0.0,0.0,42000000,42000000,0,0,42000000,Null,Null,263260090,111461,2
263260116,0.0,0.0,41000000,41000000,0,0,41000000,Null,Null,263260116,111461,2
263260382,0.0,0.0,39200000,39200000,0,0,39200000,Null,Null,263260382,111461,2
263260448,0.0,0.0,42000000,42000000,0,0,42000000,Null,Null,263260448,111461,2
263260559,0.0,0.0,43400000,43400000,0,0,43400000,Null,Null,263260559,111461,2
263260574,0.0,0.0,40320000,40320000,0,0,40320000,Null,Null,263260574,111461,2
263260789,0.0,0.0,41440000,41440000,0,0,41440000,Null,Null,263260789,111461,2
263260807,0.0,0.0,12880000,12880000,0,0,12880000,Null,Null,263260807,111461,2
263260894,0.0,0.0,49000000,49000000,0,0,49000000,Null,Null,263260894,111461,2
263260965,0.0,0.0,49000000,49000000,0,0,49000000,Null,Null,263260965,111461,2
263261025,0.0,0.0,37800000,37800000,0,0,37800000,Null,Null,263261025,111461,2
263261079,0.0,0.0,44800000,44800000,0,0,44800000,Null,Null,263261079,111461,2
263261102,0.0,0.0,42000000,42000000,0,0,42000000,Null,Null,263261102,111461,2
263261223,0.0,0.0,58800000,58800000,0,0,58800000,Null,Null,263261223,111461,2
263261228,0.0,0.0,37800000,37800000,0,0,37800000,Null,Null,263261228,111461,2
263261249,0.0,0.0,36400000,36400000,0,0,36400000,Null,Null,263261249,111461,2
263261304,0.0,0.0,46200000,46200000,0,0,46200000,Null,Null,263261304,111461,2
263261312,0.0,0.0,39200000,39200000,0,0,39200000,Null,Null,263261312,111461,2
263261494,0.0,0.0,36960000,36960000,0,0,36960000,Null,Null,263261494,111461,2
263261597,0.0,0.0,40320000,40320000,0,0,40320000,Null,Null,263261597,111461,2
263261606,0.0,0.0,37800000,37800000,0,0,37800000,Null,Null,263261606,111461,2
263261674,0.0,0.0,77000000,77000000,0,0,77000000,Null,Null,263261674,111461,2
263261704,0.0,0.0,44800000,44800000,0,0,44800000,Null,Null,263261704,111461,2
263261716,0.0,0.0,63296240,63296240,0,0,63296240,Null,Null,263261716,111461,2
263261881,0.0,0.0,38400000,38400000,0,0,38400000,Null,Null,263261881,111461,2
263261912,0.0,0.0,47400000,47400000,0,0,47400000,Null,Null,263261912,111461,2
263262014,0.0,0.0,36400000,36400000,0,0,36400000,Null,Null,263262014,111461,2
263262192,0.0,0.0,40600000,40600000,0,0,40600000,Null,Null,263262192,111461,2
263262268,0.0,0.0,51100000,51100000,0,0,51100000,Null,Null,263262268,111461,2
263262309,0.0,0.0,43400000,43400000,0,0,43400000,Null,Null,263262309,111461,2
263262319,0.0,0.0,40600000,40600000,0,0,40600000,Null,Null,263262319,111461,2
263262376,0.0,0.0,44640000,44640000,0,0,44640000,Null,Null,263262376,111461,2
263262422,0.0,0.0,41300000,41300000,0,0,41300000,Null,Null,263262422,111461,2
263262425,0.0,0.0,36400000,36400000,0,0,36400000,Null,Null,263262425,111461,2
263262477,0.0,0.0,50000000,50000000,0,0,50000000,Null,Null,263262477,111461,2
263262487,0.0,0.0,44800000,44800000,0,0,44800000,Null,Null,263262487,111461,2
263262559,0.0,0.0,57400000,57400000,0,0,57400000,Null,Null,263262559,111461,2
263262627,0.0,0.0,39500000,39500000,0,0,39500000,Null,Null,263262627,111461,2
263262671,0.0,0.0,42000000,42000000,0,0,42000000,Null,Null,263262671,111461,2
263262698,0.0,0.0,45600000,45600000,0,0,45600000,Null,Null,263262698,111461,2
263262707,0.0,0.0,40800000,40800000,0,0,40800000,Null,Null,263262707,111461,2
263262751,0.0,0.0,43198400,43198400,0,0,43198400,Null,Null,263262751,111461,2
263262955,0.0,0.0,47400000,47400000,0,0,47400000,Null,Null,263262955,111461,2
263262957,0.0,0.0,43198400,43198400,0,0,43198400,Null,Null,263262957,111461,2
263263001,0.0,0.0,42000000,42000000,0,0,42000000,Null,Null,263263001,111461,2
263263035,0.0,0.0,66080000,66080000,0,0,66080000,Null,Null,263263035,111461,2
263263043,0.0,0.0,44800000,44800000,0,0,44800000,Null,Null,263263043,111461,2
263263077,0.0,0.0,39200000,39200000,0,0,39200000,Null,Null,263263077,111461,2
263263102,0.0,0.0,37200000,37200000,0,0,37200000,Null,Null,263263102,111461,2
263263155,0.0,0.0,48160000,48160000,0,0,48160000,Null,Null,263263155,111461,2
263263208,0.0,0.0,50000000,50000000,0,0,50000000,Null,Null,263263208,111461,2
263263452,0.0,0.0,38080000,38080000,0,0,38080000,Null,Null,263263452,111461,2
263263494,0.0,0.0,50000000,50000000,0,0,50000000,Null,Null,263263494,111461,2
263263496,0.0,0.0,36400000,36400000,0,0,36400000,Null,Null,263263496,111461,2
263263580,0.0,0.0,40600000,40600000,0,0,40600000,Null,Null,263263580,111461,2
263263588,0.0,0.0,1920,1920,0,0,1920,Null,Null,263263588,111461,2
263263623,0.0,0.0,49000000,49000000,0,0,49000000,Null,Null,263263623,111461,2
263263638,0.0,0.0,4590000,4590000,0,0,4590000,Null,Null,263263638,7982659,8512
263263729,0.0,0.0,39744000,39744000,0,0,39744000,Null,Null,263263729,111461,2
263263807,0.0,0.0,49000000,49000000,0,0,49000000,Null,Null,263263807,111461,2
263263928,0.0,0.0,36400000,36400000,0,0,36400000,Null,Null,263263928,111461,2
263263977,0.0,0.0,50000000,50000000,0,0,50000000,Null,Null,263263977,111461,2
263264004,0.0,0.0,49000000,49000000,0,0,49000000,Null,Null,263264004,111461,2
263264059,0.0,0.0,37000000,37000000,0,0,37000000,Null,Null,263264059,111461,2
263264113,0.0,0.0,51000000,51000000,0,0,51000000,Null,Null,263264113,111461,2
263264124,0.0,0.0,43400000,43400000,0,0,43400000,Null,Null,263264124,111461,2
263264237,0.0,0.0,465000,372000,93000,20,465000,Null,Null,263264237,8164011,11873
263264719,0.0,0.0,399000,399000,0,0,399000,Null,Null,263264719,111461,1813
263264729,0.0,0.0,4590000,4590000,0,0,4590000,Null,Null,263264729,7982659,8512
263264756,0.0,0.0,8900000,8900000,0,0,8900000,Null,Null,263264756,111461,11516
263264834,0.0,0.0,4590000,4590000,0,0,4590000,Null,Null,263264834,7982659,8512
263264997,0.0,0.0,5790000,5790000,0,0,5790000,Null,Null,263264997,7982659,8512
263265463,0.0,0.0,39000,39000,0,0,39000,Null,Null,263265463,111461,8167
263265748,0.0,0.0,3300000,3250000,50000,2,3300000,Null,Null,263265748,5347313,12882
263265953,0.0,0.0,7390000,7390000,0,0,7390000,Null,Null,263265953,7982659,8512
263266002,0.0,0.0,7390000,7390000,0,0,7390000,Null,Null,263266002,7982659,5384
263266044,0.0,0.0,118000,118000,0,0,118000,Null,Null,263266044,111461,7064
263266134,0.0,0.0,4350000,4350000,0,0,4350000,Null,Null,263266134,7982659,8512
263266167,0.0,0.0,190000,190000,0,0,190000,Null,Null,263266167,111461,15320
263266180,0.0,0.0,4350000,4350000,0,0,4350000,Null,Null,263266180,7982659,8512
263266195,0.0,0.0,4350000,4350000,0,0,4350000,Null,Null,263266195,7982659,8512
263266225,0.0,0.0,890000,890000,0,0,890000,Null,Null,263266225,146479,8400
263266258,0.0,0.0,4350000,4350000,0,0,4350000,Null,Null,263266258,7982659,8512
263266273,0.0,0.0,1860000,1860000,0,0,1860000,Null,Null,263266273,885749,8512
263266291,0.0,0.0,1860000,1860000,0,0,1860000,Null,Null,263266291,885749,8511
263266377,0.0,0.0,1860000,1860000,0,0,1860000,Null,Null,263266377,885749,8511
263271357,0.0,0.0,1389000,1389000,0,0,1389000,Null,Null,263271357,7823755,53350
263271816,0.0,0.0,260000,260000,0,0,260000,Null,Null,263271816,7823755,53350
263271911,0.0,0.0,2660000,2660000,0,0,2660000,Null,Null,263271911,5181029,11879
263271979,0.0,0.0,1090000,1090000,0,0,1090000,Null,Null,263271979,7823755,5893
263272037,0.0,0.0,1200000,1200000,0,0,1200000,Null,Null,263272037,223153,11859
263272067,0.0,0.0,1150000,1150000,0,0,1150000,Null,Null,263272067,5179953,11861
263272086,0.0,0.0,1150000,1150000,0,0,1150000,Null,Null,263272086,722993,11867
263272196,0.0,0.0,8960000,4480000,4480000,50,8960000,Null,Null,263272196,111461,15318
263272229,0.0,0.0,1390000,1390000,0,0,1390000,Null,Null,263272229,5180961,11881
263272654,0.0,0.0,183000,178000,5000,3,183000,Null,Null,263272654,111461,12918
263272774,0.0,0.0,145000,145000,0,0,145000,Null,Null,263272774,111461,15320
263272815,0.0,0.0,549000,549000,0,0,549000,Null,Null,263272815,606305,2342
263273125,0.0,0.0,153000,153000,0,0,153000,Null,Null,263273125,111461,15320
263273302,0.0,0.0,130000,130000,0,0,130000,Null,Null,263273302,111461,15320
263273304,0.0,0.0,10000,10000,0,0,10000,Null,Null,263273304,111461,20258
263273343,0.0,0.0,170000,170000,0,0,170000,Null,Null,263273343,111461,15320
263273346,0.0,0.0,160000,160000,0,0,160000,Null,Null,263273346,111461,15320
263273353,0.0,0.0,153000,153000,0,0,153000,Null,Null,263273353,111461,15320
263273355,0.0,0.0,140000,140000,0,0,140000,Null,Null,263273355,111461,15320
263273357,0.0,0.0,160000,160000,0,0,160000,Null,Null,263273357,111461,15320
263273367,0.0,0.0,140000,140000,0,0,140000,Null,Null,263273367,111461,15320
263273391,0.0,0.0,138000,138000,0,0,138000,Null,Null,263273391,111461,15320
263273393,40.0,40.0,160000,130000,30000,19,160000,Null,Null,263273393,111461,1815
263273407,0.0,0.0,133000,133000,0,0,133000,Null,Null,263273407,111461,15320
263273426,0.0,0.0,160000,160000,0,0,160000,Null,Null,263273426,111461,15320
263273437,0.0,0.0,160000,160000,0,0,160000,Null,Null,263273437,111461,15320
263273439,0.0,0.0,175000,175000,0,0,175000,Null,Null,263273439,111461,15320
263273602,0.0,0.0,120000,120000,0,0,120000,Null,Null,263273602,162313,28484
263273618,0.0,0.0,602000,602000,0,0,602000,Null,Null,263273618,111461,2
263273628,0.0,0.0,642000,642000,0,0,642000,Null,Null,263273628,111461,2
263273630,0.0,0.0,850000,850000,0,0,850000,Null,Null,263273630,111461,2
263273636,0.0,0.0,930000,930000,0,0,930000,Null,Null,263273636,111461,2
263273640,0.0,0.0,873000,873000,0,0,873000,Null,Null,263273640,111461,2
263273652,0.0,0.0,750000,750000,0,0,750000,Null,Null,263273652,111461,2
263273654,0.0,0.0,764000,764000,0,0,764000,Null,Null,263273654,111461,2
263273656,0.0,0.0,843000,843000,0,0,843000,Null,Null,263273656,111461,2
263273660,0.0,0.0,497000,497000,0,0,497000,Null,Null,263273660,111461,2
263273678,0.0,0.0,1090000,1090000,0,0,1090000,Null,Null,263273678,111461,2
263273681,0.0,0.0,1200000,1200000,0,0,1200000,Null,Null,263273681,111461,2
263273684,0.0,0.0,1099000,1099000,0,0,1099000,Null,Null,263273684,111461,2
263273687,0.0,0.0,990000,990000,0,0,990000,Null,Null,263273687,111461,2
263273842,0.0,0.0,150000,150000,0,0,150000,Null,Null,263273842,111461,28598
263273865,0.0,0.0,34900,34900,0,0,34900,Null,Null,263273865,111461,28480
263273877,0.0,0.0,420000,420000,0,0,420000,Null,Null,263273877,444133,11845
263273920,0.0,0.0,870000,870000,0,0,870000,Null,Null,263273920,444133,11875
263274032,0.0,0.0,610000,610000,0,0,610000,Null,Null,263274032,444133,11847
263274236,0.0,0.0,476000,238000,238000,50,476000,Null,Null,263274236,50479,8216
263274580,0.0,0.0,4889000,3660000,1229000,25,4889000,Null,Null,263274580,18802,1795
263274668,0.0,0.0,140000,140000,0,0,140000,Null,Null,263274668,111461,15320
263274837,0.0,0.0,79000,79000,0,0,79000,Null,Null,263274837,111461,20258
263274869,0.0,0.0,559000,559000,0,0,559000,Null,Null,263274869,111461,53350
263275024,0.0,0.0,4550000,4550000,0,0,4550000,Null,Null,263275024,7982659,7449
263275042,0.0,0.0,3590000,3051500,538500,15,3590000,Null,Null,263275042,208841,2340
263275068,0.0,0.0,199000,199000,0,0,199000,Null,Null,263275068,111461,2977
263275111,0.0,0.0,150000,135000,15000,10,150000,Null,Null,263275111,8178065,53352
263275119,0.0,0.0,16000,13000,3000,19,16000,Null,Null,263275119,111461,8197
263275199,0.0,0.0,138000,138000,0,0,138000,Null,Null,263275199,111461,15320
263275210,0.0,0.0,388000,223000,165000,43,388000,Null,Null,263275210,7376321,11883
263275561,0.0,0.0,5350000,5350000,0,0,5350000,Null,Null,263275561,7982659,8512
263276258,0.0,0.0,129000,129000,0,0,129000,Null,Null,263276258,111461,2977
263277265,0.0,0.0,1200000,1200000,0,0,1200000,Null,Null,263277265,111461,53350
263277271,0.0,0.0,5290000,3950000,1340000,25,5290000,Null,Null,263277271,18802,1795
263277277,0.0,0.0,198000,192000,6000,3,198000,Null,Null,263277277,111461,20254
263277297,0.0,0.0,249000,236550,12450,5,249000,Null,Null,263277297,5249391,1637
263277326,0.0,0.0,5550000,5550000,0,0,5550000,Null,Null,263277326,7982659,8512
263277332,0.0,0.0,389000,389000,0,0,389000,Null,Null,263277332,111461,2971
263277362,0.0,0.0,620000,607600,12400,2,620000,Null,Null,263277362,8187003,11899
263277497,0.0,0.0,5350000,5350000,0,0,5350000,Null,Null,263277497,7982659,8512
263277528,0.0,0.0,7490000,7490000,0,0,7490000,Null,Null,263277528,111461,11516
263277569,0.0,0.0,249000,236550,12450,5,249000,Null,Null,263277569,5249391,1636
263277580,0.0,0.0,150000,150000,0,0,150000,Null,Null,263277580,111461,15320
263277648,0.0,0.0,164000,159000,5000,3,164000,Null,Null,263277648,21651,20182
263277667,0.0,0.0,170000,170000,0,0,170000,Null,Null,263277667,111461,15320
263277757,0.0,0.0,5350000,5350000,0,0,5350000,Null,Null,263277757,7982659,8512
263277863,0.0,0.0,329000,329000,0,0,329000,Null,Null,263277863,111461,2971
263277948,0.0,0.0,4350000,4350000,0,0,4350000,Null,Null,263277948,7982659,7449
263278025,0.0,0.0,4350000,4350000,0,0,4350000,Null,Null,263278025,7982659,7449
263278527,0.0,0.0,50000,50000,0,0,50000,Null,Null,263278527,111461,28472
263278674,0.0,0.0,4350000,4350000,0,0,4350000,Null,Null,263278674,7982659,8511
263278863,0.0,0.0,4250000,4250000,0,0,4250000,Null,Null,263278863,579445,15318
263278886,0.0,0.0,120000,120000,0,0,120000,Null,Null,263278886,111461,15320
263278892,0.0,0.0,4350000,4350000,0,0,4350000,Null,Null,263278892,7982659,8511
263278913,0.0,0.0,4250000,4250000,0,0,4250000,Null,Null,263278913,579445,15318
263278917,0.0,0.0,760000,737200,22800,3,760000,Null,Null,263278917,8187003,11899
263278944,0.0,0.0,3400000,3400000,0,0,3400000,Null,Null,263278944,579445,15318
263287126,0.0,0.0,72000,72000,0,0,72000,Null,Null,263287126,111461,15320
263287416,0.0,0.0,4350000,4350000,0,0,4350000,Null,Null,263287416,7982659,5384
263287654,0.0,0.0,399000,399000,0,0,399000,Null,Null,263287654,111461,2971
263287759,0.0,0.0,15000,15000,0,0,15000,Null,Null,263287759,111461,28484
263287761,0.0,0.0,60000,60000,0,0,60000,Null,Null,263287761,111461,15320
263287858,0.0,0.0,54000,54000,0,0,54000,Null,Null,263287858,111461,15320
263287907,0.0,0.0,1450000,1450000,0,0,1450000,Null,Null,263287907,47484,8171
263287910,0.0,0.0,382000,382000,0,0,382000,Null,Null,263287910,243107,28738
263287927,0.0,0.0,85000,85000,0,0,85000,Null,Null,263287927,111461,15320
263289995,0.0,0.0,520000,520000,0,0,520000,Null,Null,263289995,243107,28736
263291702,0.0,0.0,320000,275000,45000,14,320000,Null,Null,263291702,810913,20174
263291732,0.0,0.0,300000,245000,55000,18,300000,Null,Null,263291732,810913,5566
263291798,0.0,0.0,500000,385000,115000,23,500000,Null,Null,263291798,810913,20174
263291830,0.0,0.0,670000,565000,105000,16,670000,Null,Null,263291830,362793,4428
263291907,0.0,0.0,450000,375000,75000,17,450000,Null,Null,263291907,362757,4428
263291974,0.0,0.0,450000,365000,85000,19,450000,Null,Null,263291974,185665,4428
263292008,0.0,0.0,320000,280000,40000,13,320000,Null,Null,263292008,111461,20174
263292028,0.0,0.0,230000,230000,0,0,230000,Null,Null,263292028,21651,28480
263292068,0.0,0.0,250000,195000,55000,22,250000,Null,Null,263292068,111461,20174
263292100,0.0,0.0,560000,450000,110000,20,560000,Null,Null,263292100,111461,20174
263292171,0.0,0.0,180000,135000,45000,25,180000,Null,Null,263292171,111461,20174
263292177,0.0,0.0,1600000,1280000,320000,20,1600000,Null,Null,263292177,704815,15320
263292187,0.0,0.0,360000,285000,75000,21,360000,Null,Null,263292187,111461,20174
263292235,0.0,0.0,160000,125000,35000,22,160000,Null,Null,263292235,111461,20174
263292352,0.0,0.0,129000,117390,11610,9,129000,Null,Null,263292352,461155,28736
263292410,0.0,0.0,880000,695000,185000,21,880000,Null,Null,263292410,111461,20174
263292417,0.0,0.0,45000,45000,0,0,45000,Null,Null,263292417,111461,15320
263292773,0.0,0.0,1100000,950000,150000,14,1100000,Null,Null,263292773,111461,20174
263292800,0.0,0.0,1044000,1044000,0,0,1044000,Null,Null,263292800,111461,2340
263292843,0.0,0.0,523000,358000,165000,32,523000,Null,Null,263292843,7376321,11889
263292860,0.0,0.0,1044000,1044000,0,0,1044000,Null,Null,263292860,111461,2340
263292868,0.0,0.0,7590000,7590000,0,0,7590000,Null,Null,263292868,47484,2340
263293072,0.0,0.0,3990000,3990000,0,0,3990000,Null,Null,263293072,47484,2340
263293139,0.0,0.0,120000,120000,0,0,120000,Null,Null,263293139,111461,26652
263293165,0.0,0.0,425000,425000,0,0,425000,Null,Null,263293165,111461,26652
263293169,0.0,0.0,425000,425000,0,0,425000,Null,Null,263293169,111461,7075
263293183,0.0,0.0,185600,185600,0,0,185600,Null,Null,263293183,111461,2
263293339,0.0,0.0,135000,135000,0,0,135000,Null,Null,263293339,41048,2
263293514,0.0,0.0,59000,59000,0,0,59000,Null,Null,263293514,111461,17162
263293523,0.0,0.0,1490000,1490000,0,0,1490000,Null,Null,263293523,47484,8172
263293564,0.0,0.0,59000,59000,0,0,59000,Null,Null,263293564,111461,17162
263293586,0.0,0.0,265000,265000,0,0,265000,Null,Null,263293586,221867,11857
263293708,0.0,0.0,3290000,1980000,1310000,40,3290000,Null,Null,263293708,8194285,8066
263293710,0.0,0.0,14000,14000,0,0,14000,Null,Null,263293710,111461,20250
263293713,0.0,0.0,59000,59000,0,0,59000,Null,Null,263293713,111461,17162
263293752,0.0,0.0,935000,935000,0,0,935000,Null,Null,263293752,111461,26652
263293762,0.0,0.0,1890000,1890000,0,0,1890000,Null,Null,263293762,111461,26652
263293767,0.0,0.0,205000,205000,0,0,205000,Null,Null,263293767,111461,2
263293768,0.0,0.0,1119000,1119000,0,0,1119000,Null,Null,263293768,111461,26652
263293769,0.0,0.0,459000,459000,0,0,459000,Null,Null,263293769,111461,26652
263293786,0.0,0.0,1109000,1109000,0,0,1109000,Null,Null,263293786,111461,26652
263293787,0.0,0.0,435000,435000,0,0,435000,Null,Null,263293787,111461,2
263293792,0.0,0.0,1890000,1890000,0,0,1890000,Null,Null,263293792,111461,26652
263293794,0.0,0.0,459000,459000,0,0,459000,Null,Null,263293794,111461,26652
263293796,0.0,0.0,1119000,1119000,0,0,1119000,Null,Null,263293796,111461,26652
263293842,0.0,0.0,1550000,1550000,0,0,1550000,Null,Null,263293842,111461,26652
263293849,0.0,0.0,449000,449000,0,0,449000,Null,Null,263293849,111461,26652
263293851,0.0,0.0,1890000,1890000,0,0,1890000,Null,Null,263293851,111461,26652
263293852,0.0,0.0,120000,120000,0,0,120000,Null,Null,263293852,111461,26652
263293978,0.0,0.0,199000,199000,0,0,199000,Null,Null,263293978,111461,2
263293982,0.0,0.0,1109000,1109000,0,0,1109000,Null,Null,263293982,111461,26652
263293984,0.0,0.0,1589000,1589000,0,0,1589000,Null,Null,263293984,111461,2
263294040,0.0,0.0,820000,820000,0,0,820000,Null,Null,263294040,424299,8170
263294080,0.0,0.0,29000,29000,0,0,29000,Null,Null,263294080,111461,8194
263294121,0.0,0.0,3790000,3790000,0,0,3790000,Null,Null,263294121,47484,2340
263294142,0.0,0.0,463000,298000,165000,36,463000,Null,Null,263294142,7376321,11883
263294159,0.0,0.0,589000,589000,0,0,589000,Null,Null,263294159,221867,11859
263294165,0.0,0.0,140000,140000,0,0,140000,Null,Null,263294165,21651,28480
263294183,0.0,0.0,59000,59000,0,0,59000,Null,Null,263294183,111461,17162
263294360,0.0,0.0,39000,39000,0,0,39000,Null,Null,263294360,111461,8194
263294365,0.0,0.0,20900,20900,0,0,20900,Null,Null,263294365,111461,20254
263294393,0.0,0.0,59000,59000,0,0,59000,Null,Null,263294393,111461,17162
263294411,0.0,0.0,30000,30000,0,0,30000,Null,Null,263294411,111461,15320
263294462,0.0,0.0,59000,59000,0,0,59000,Null,Null,263294462,111461,17162
263294514,0.0,0.0,275000,149000,126000,46,275000,Null,Null,263294514,200189,11857
263294625,0.0,0.0,250000,250000,0,0,250000,Null,Null,263294625,40780,1815
263294815,0.0,0.0,189000,189000,0,0,189000,Null,Null,263294815,111461,2347
263294819,0.0,0.0,185000,166500,18500,10,185000,Null,Null,263294819,8164011,11869
263294823,0.0,0.0,8190000,8190000,0,0,8190000,Null,Null,263294823,47484,2340
263294894,0.0,0.0,395000,230000,165000,42,395000,Null,Null,263294894,7376321,11883
263294922,0.0,0.0,300000,175000,125000,42,300000,Null,Null,263294922,200189,11845
263295008,0.0,0.0,150000,150000,0,0,150000,Null,Null,263295008,111461,15318
263295069,0.0,0.0,120000,120000,0,0,120000,Null,Null,263295069,111461,15318
263295170,0.0,0.0,3990000,3990000,0,0,3990000,Null,Null,263295170,47484,2340
263295198,0.0,0.0,4990001,4990001,0,0,4990001,Null,Null,263295198,7245323,5531
263295312,0.0,0.0,260000,260000,0,0,260000,Null,Null,263295312,277553,2
263295313,0.0,0.0,170000,170000,0,0,170000,Null,Null,263295313,277553,2
263295314,0.0,0.0,240000,240000,0,0,240000,Null,Null,263295314,277553,2
263295317,0.0,0.0,220000,220000,0,0,220000,Null,Null,263295317,277553,2
263295326,0.0,0.0,64000,64000,0,0,64000,Null,Null,263295326,277553,2
263295331,0.0,0.0,360000,360000,0,0,360000,Null,Null,263295331,277553,2
263295332,0.0,0.0,270000,270000,0,0,270000,Null,Null,263295332,277553,2
263295337,0.0,0.0,170000,170000,0,0,170000,Null,Null,263295337,277553,2
263295341,0.0,0.0,280000,280000,0,0,280000,Null,Null,263295341,277553,2
263295414,0.0,0.0,363000,198000,165000,45,363000,Null,Null,263295414,7376321,11883
263295520,0.0,0.0,399000,399000,0,0,399000,Null,Null,263295520,213569,8216
263295634,0.0,0.0,425000,260000,165000,39,425000,Null,Null,263295634,7376321,11883
263295687,0.0,0.0,14000,14000,0,0,14000,Null,Null,263295687,111461,20254
263295817,0.0,0.0,425000,260000,165000,39,425000,Null,Null,263295817,7376321,11883
263295844,0.0,0.0,4300000,4300000,0,0,4300000,Null,Null,263295844,47484,2340
263295873,0.0,0.0,700000,700000,0,0,700000,Null,Null,263295873,25697,28450
263295946,0.0,0.0,9590000,7190000,2400000,25,9590000,Null,Null,263295946,113119,2324
263295957,0.0,0.0,16000,16000,0,0,16000,Null,Null,263295957,111461,20254
263296224,0.0,0.0,2200000,2200000,0,0,2200000,Null,Null,263296224,5347313,7081
263296228,0.0,0.0,269000,269000,0,0,269000,Null,Null,263296228,213569,8223
263296238,0.0,0.0,570000,570000,0,0,570000,Null,Null,263296238,47484,8170
263296254,0.0,0.0,2511000,2511000,0,0,2511000,Null,Null,263296254,174069,12864
263296292,0.0,0.0,800000,450000,350000,44,800000,Null,Null,263296292,111461,8171
263296316,0.0,0.0,1290000,1290000,0,0,1290000,Null,Null,263296316,47484,8170
263296419,0.0,0.0,1980000,1980000,0,0,1980000,Null,Null,263296419,174069,12864
263296475,0.0,0.0,800000,800000,0,0,800000,Null,Null,263296475,25697,28450
263296530,0.0,0.0,112000,112000,0,0,112000,Null,Null,263296530,174069,12864
263296555,0.0,0.0,173000,173000,0,0,173000,Null,Null,263296555,174069,12864
263296573,0.0,0.0,1030000,1030000,0,0,1030000,Null,Null,263296573,47484,11933
263296697,0.0,0.0,269000,269000,0,0,269000,Null,Null,263296697,213569,8223
263296865,0.0,0.0,980000,980000,0,0,980000,Null,Null,263296865,47484,8171
263296869,0.0,0.0,165000,165000,0,0,165000,Null,Null,263296869,149308,28594
263296995,0.0,0.0,199000,199000,0,0,199000,Null,Null,263296995,213569,4413
263297009,0.0,0.0,59000,59000,0,0,59000,Null,Null,263297009,111461,1622
263297146,0.0,0.0,900000,900000,0,0,900000,Null,Null,263297146,25697,28450
263297240,0.0,0.0,165000,165000,0,0,165000,Null,Null,263297240,149308,28594
263297384,0.0,0.0,1490000,1490000,0,0,1490000,Null,Null,263297384,47484,8168
263297537,0.0,0.0,279000,219000,60000,22,279000,Null,Null,263297537,111461,15318
263297613,0.0,0.0,32000,32000,0,0,32000,Null,Null,263297613,111461,2
263297615,0.0,0.0,75000,75000,0,0,75000,Null,Null,263297615,111461,2
263297644,0.0,0.0,49000,49000,0,0,49000,Null,Null,263297644,111461,2
263297652,0.0,0.0,35900,35900,0,0,35900,Null,Null,263297652,111461,2
263297666,0.0,0.0,175000,175000,0,0,175000,Null,Null,263297666,111461,2
263301627,0.0,0.0,95000,95000,0,0,95000,Null,Null,263301627,111461,28594
263302714,0.0,0.0,1500000,1500000,0,0,1500000,Null,Null,263302714,111461,1634
263303170,0.0,0.0,25000,25000,0,0,25000,Null,Null,263303170,111461,20250
263303256,0.0,0.0,180000,159000,21000,12,180000,Null,Null,263303256,569135,2
263303258,0.0,0.0,200000,170000,30000,15,200000,Null,Null,263303258,569135,2
263303260,0.0,0.0,650000,650000,0,0,650000,Null,Null,263303260,569135,2
263303262,0.0,0.0,400000,340000,60000,15,400000,Null,Null,263303262,569135,2
263303264,0.0,0.0,1100000,990000,110000,10,1100000,Null,Null,263303264,111461,2
263308260,0.0,0.0,4350000,4350000,0,0,4350000,Null,Null,263308260,7982659,5384
263308288,0.0,0.0,4350000,4350000,0,0,4350000,Null,Null,263308288,7982659,5384
263308339,0.0,0.0,4750000,4750000,0,0,4750000,Null,Null,263308339,7982659,8512
263308460,0.0,0.0,4750000,4750000,0,0,4750000,Null,Null,263308460,7982659,7449
263308589,0.0,0.0,120000,120000,0,0,120000,Null,Null,263308589,5220265,17170
263308625,0.0,0.0,2800000,2800000,0,0,2800000,Null,Null,263308625,7982659,5384
263308667,0.0,0.0,2800000,2800000,0,0,2800000,Null,Null,263308667,7982659,5384
263308672,0.0,0.0,4250000,4250000,0,0,4250000,Null,Null,263308672,579445,15318
263308687,0.0,0.0,4250000,4250000,0,0,4250000,Null,Null,263308687,579445,15318
263308716,0.0,0.0,6850000,6850000,0,0,6850000,Null,Null,263308716,579445,15318
263308731,0.0,0.0,1600000,1600000,0,0,1600000,Null,Null,263308731,579445,15318
263308733,0.0,0.0,2350000,2350000,0,0,2350000,Null,Null,263308733,7982659,5384
263308761,0.0,0.0,4250000,4250000,0,0,4250000,Null,Null,263308761,579445,15318
263308814,0.0,0.0,900000,900000,0,0,900000,Null,Null,263308814,25697,28450
263308908,0.0,0.0,2350000,2350000,0,0,2350000,Null,Null,263308908,7982659,5385
263308931,0.0,0.0,273700,273700,0,0,273700,Null,Null,263308931,111461,2
263308935,0.0,0.0,189000,189000,0,0,189000,Null,Null,263308935,111461,2
263308971,0.0,0.0,42000,42000,0,0,42000,Null,Null,263308971,111461,2
263308972,0.0,0.0,46000,46000,0,0,46000,Null,Null,263308972,111461,2
263309005,0.0,0.0,59000,59000,0,0,59000,Null,Null,263309005,111461,2
263309049,0.0,0.0,99000,99000,0,0,99000,Null,Null,263309049,111461,2
263309067,0.0,0.0,11200,11200,0,0,11200,Null,Null,263309067,111461,2
263309072,0.0,0.0,83300,83300,0,0,83300,Null,Null,263309072,111461,2
263309241,0.0,0.0,31500,31500,0,0,31500,Null,Null,263309241,111461,2
263309280,0.0,0.0,65000,65000,0,0,65000,Null,Null,263309280,111461,2
263309300,0.0,0.0,59500,59500,0,0,59500,Null,Null,263309300,111461,2
263309321,0.0,0.0,87000,87000,0,0,87000,Null,Null,263309321,111461,2
263309338,0.0,0.0,190000,190000,0,0,190000,Null,Null,263309338,111461,2
263309367,0.0,0.0,139300,139300,0,0,139300,Null,Null,263309367,111461,2
263309422,0.0,0.0,2450000,2450000,0,0,2450000,Null,Null,263309422,7982659,5384
263309448,0.0,0.0,1850000,1665000,185000,10,1850000,Null,Null,263309448,704815,15236
263309466,0.0,0.0,1850000,1665000,185000,10,1850000,Null,Null,263309466,704815,15236
263309502,0.0,0.0,2450000,2450000,0,0,2450000,Null,Null,263309502,7982659,5384
263309590,0.0,0.0,3650000,3650000,0,0,3650000,Null,Null,263309590,7982659,5384
263309601,0.0,0.0,4990000,4990000,0,0,4990000,Null,Null,263309601,112735,1795
263309778,0.0,0.0,141000,141000,0,0,141000,Null,Null,263309778,111461,5566
263309915,0.0,0.0,160000,160000,0,0,160000,Null,Null,263309915,5220265,17170
263310346,0.0,0.0,98000,98000,0,0,98000,Null,Null,263310346,111461,2
263310375,0.0,0.0,108000,108000,0,0,108000,Null,Null,263310375,111461,2
263310416,0.0,0.0,68000,68000,0,0,68000,Null,Null,263310416,111461,2
263310442,0.0,0.0,68000,68000,0,0,68000,Null,Null,263310442,111461,2
263310468,0.0,0.0,58000,58000,0,0,58000,Null,Null,263310468,111461,2
263310475,0.0,0.0,42000,42000,0,0,42000,Null,Null,263310475,111461,2
263310546,0.0,0.0,139300,139300,0,0,139300,Null,Null,263310546,111461,2
263310583,0.0,0.0,78000,78000,0,0,78000,Null,Null,263310583,111461,2
263310597,0.0,0.0,198000,198000,0,0,198000,Null,Null,263310597,111461,2
263310622,0.0,0.0,278000,278000,0,0,278000,Null,Null,263310622,111461,2
263310702,0.0,0.0,16000,16000,0,0,16000,Null,Null,263310702,111461,2
263310779,0.0,0.0,42000,42000,0,0,42000,Null,Null,263310779,111461,2
263310801,0.0,0.0,190000,190000,0,0,190000,Null,Null,263310801,111461,2
263310817,0.0,0.0,180000,180000,0,0,180000,Null,Null,263310817,5220265,17170
263310819,0.0,0.0,2650000,2650000,0,0,2650000,Null,Null,263310819,7982659,5384
263310848,0.0,0.0,2650000,2650000,0,0,2650000,Null,Null,263310848,7982659,5384
263310872,0.0,0.0,650000,410000,240000,37,650000,Null,Null,263310872,150002,28638
263310885,0.0,0.0,2650000,2650000,0,0,2650000,Null,Null,263310885,7982659,5384
263310908,0.0,0.0,799900,489000,310900,39,799900,Null,Null,263310908,17826,3428
263310910,0.0,0.0,2490000,2490000,0,0,2490000,Null,Null,263310910,7982659,5384
263310949,0.0,0.0,2490000,2490000,0,0,2490000,Null,Null,263310949,7982659,5384
263311071,0.0,0.0,2999000,2390000,609000,20,2999000,Null,Null,263311071,53335,2971
263311084,0.0,0.0,2350000,2350000,0,0,2350000,Null,Null,263311084,7982659,5384
263311107,0.0,0.0,2350000,2350000,0,0,2350000,Null,Null,263311107,7982659,5384
263311128,0.0,0.0,9000,9000,0,0,9000,Null,Null,263311128,111461,20254
263311132,0.0,0.0,750000,750000,0,0,750000,Null,Null,263311132,5220265,17170
263311153,0.0,0.0,935000,935000,0,0,935000,Null,Null,263311153,243693,12294
263311304,0.0,0.0,2350000,2350000,0,0,2350000,Null,Null,263311304,7982659,5385
263311399,0.0,0.0,180000,180000,0,0,180000,Null,Null,263311399,5220265,17170
263311405,0.0,0.0,2350000,2350000,0,0,2350000,Null,Null,263311405,7982659,5385
263316791,0.0,0.0,880000,880000,0,0,880000,Null,Null,263316791,5220265,17170
263316803,0.0,0.0,250000,250000,0,0,250000,Null,Null,263316803,212267,3805
263316836,0.0,0.0,210000,210000,0,0,210000,Null,Null,263316836,212267,3805
263316870,0.0,0.0,240000,240000,0,0,240000,Null,Null,263316870,212267,20174
263316898,0.0,0.0,220000,220000,0,0,220000,Null,Null,263316898,212267,20174
263318037,0.0,0.0,1000,1000,0,0,1000,Null,Null,263318037,111461,53074
263318059,0.0,0.0,300000,300000,0,0,300000,Null,Null,263318059,212267,20174
263318173,0.0,0.0,309000,309000,0,0,309000,Null,Null,263318173,111461,2324
263318195,0.0,0.0,4250000,4250000,0,0,4250000,Null,Null,263318195,7982659,7449
263318197,0.0,0.0,309000,309000,0,0,309000,Null,Null,263318197,111461,2324
263318301,0.0,0.0,4250000,4250000,0,0,4250000,Null,Null,263318301,7982659,7449
263318347,0.0,0.0,4250000,4250000,0,0,4250000,Null,Null,263318347,7982659,7449
263318350,0.0,0.0,169000,169000,0,0,169000,Null,Null,263318350,111461,1838
263318354,0.0,0.0,169000,169000,0,0,169000,Null,Null,263318354,111461,1838
263318385,0.0,0.0,29000,29000,0,0,29000,Null,Null,263318385,111461,1622
263318421,0.0,0.0,29000,29000,0,0,29000,Null,Null,263318421,111461,1622
263318432,0.0,0.0,4150000,4150000,0,0,4150000,Null,Null,263318432,7982659,7449
263318459,0.0,0.0,109000,69000,40000,37,109000,Null,Null,263318459,500047,2173
263318480,0.0,0.0,42000,42000,0,0,42000,Null,Null,263318480,111461,2
263318500,0.0,0.0,42000,42000,0,0,42000,Null,Null,263318500,111461,2
263318536,0.0,0.0,190000,190000,0,0,190000,Null,Null,263318536,111461,2
263318584,0.0,0.0,11200,11200,0,0,11200,Null,Null,263318584,111461,2
263318676,0.0,0.0,56700,56700,0,0,56700,Null,Null,263318676,111461,2
263318696,0.0,0.0,99000,99000,0,0,99000,Null,Null,263318696,111461,2
263318724,0.0,0.0,37100,37100,0,0,37100,Null,Null,263318724,111461,2
263318787,0.0,0.0,189000,189000,0,0,189000,Null,Null,263318787,111461,2
263318827,0.0,0.0,139300,139300,0,0,139300,Null,Null,263318827,111461,2
263318899,0.0,0.0,89000,89000,0,0,89000,Null,Null,263318899,111461,2
263318930,0.0,0.0,100000,100000,0,0,100000,Null,Null,263318930,111461,2
263318936,0.0,0.0,84000,84000,0,0,84000,Null,Null,263318936,111461,2
263318943,0.0,0.0,273700,273700,0,0,273700,Null,Null,263318943,111461,2
263318959,0.0,0.0,75000,75000,0,0,75000,Null,Null,263318959,111461,12882
263323897,0.0,0.0,33000,33000,0,0,33000,Null,Null,263323897,111461,20254
263323901,0.0,0.0,39000,39000,0,0,39000,Null,Null,263323901,111461,2340
263324035,0.0,0.0,350000,350000,0,0,350000,Null,Null,263324035,228967,28574
263325731,0.0,0.0,130000,130000,0,0,130000,Null,Null,263325731,111461,20250
263325883,0.0,0.0,99000,99000,0,0,99000,Null,Null,263325883,111461,5566
263325923,0.0,0.0,198000,198000,0,0,198000,Null,Null,263325923,288079,8309
263326004,0.0,0.0,9155000,9155000,0,0,9155000,Null,Null,263326004,26150,8513
263326006,0.0,0.0,10364000,10364000,0,0,10364000,Null,Null,263326006,26150,8513
263326008,0.0,0.0,7945000,7945000,0,0,7945000,Null,Null,263326008,26150,8513
263326011,0.0,0.0,9080000,9080000,0,0,9080000,Null,Null,263326011,26150,8513
263326013,0.0,0.0,9500000,9500000,0,0,9500000,Null,Null,263326013,26150,8513
263326015,0.0,0.0,5182000,5182000,0,0,5182000,Null,Null,263326015,26150,8513
263326053,0.0,0.0,140000,140000,0,0,140000,Null,Null,263326053,111461,5566
263326324,0.0,0.0,10000,10000,0,0,10000,Null,Null,263326324,111461,28434
263326374,0.0,0.0,410000,410000,0,0,410000,Null,Null,263326374,111461,15318
263326453,0.0,0.0,10500,10500,0,0,10500,Null,Null,263326453,111461,28434
263326603,0.0,0.0,470000,470000,0,0,470000,Null,Null,263326603,111461,2334
263326859,0.0,0.0,65000,65000,0,0,65000,Null,Null,263326859,111461,23244
263326867,0.0,0.0,6000,6000,0,0,6000,Null,Null,263326867,111461,23596
263326966,0.0,0.0,3000000,2940000,60000,2,3000000,Null,Null,263326966,111461,8067
263326971,0.0,0.0,45000,45000,0,0,45000,Null,Null,263326971,111461,15250
263327357,0.0,0.0,400000,400000,0,0,400000,Null,Null,263327357,197335,11897
263327386,0.0,0.0,2490000,2236000,254000,10,2490000,Null,Null,263327386,111461,20258
263327465,0.0,0.0,2990000,2850000,140000,5,2990000,Null,Null,263327465,20215,7081
263327583,0.0,0.0,115000,115000,0,0,115000,Null,Null,263327583,111461,15250
263328367,0.0,0.0,45000,45000,0,0,45000,Null,Null,263328367,111461,15250
263328472,0.0,0.0,39000,39000,0,0,39000,Null,Null,263328472,111461,28434
263328474,0.0,0.0,100000,69000,31000,31,100000,Null,Null,263328474,111461,8167
263328628,0.0,0.0,95000,95000,0,0,95000,Null,Null,263328628,111461,28594
263328635,0.0,0.0,28000,28000,0,0,28000,Null,Null,263328635,111461,28434
263329245,0.0,0.0,95000,95000,0,0,95000,Null,Null,263329245,111461,28594
263333963,0.0,0.0,90000,90000,0,0,90000,Null,Null,263333963,7899545,28576
263334583,0.0,0.0,165000,165000,0,0,165000,Null,Null,263334583,149308,28594
263334686,0.0,0.0,65000,65000,0,0,65000,Null,Null,263334686,111461,28480
263334749,0.0,0.0,55000,55000,0,0,55000,Null,Null,263334749,7324269,11885
263334768,0.0,0.0,58000,58000,0,0,58000,Null,Null,263334768,7324269,11857
263334846,0.0,0.0,1950000,1950000,0,0,1950000,Null,Null,263334846,574313,11753
263335000,0.0,0.0,45000,45000,0,0,45000,Null,Null,263335000,7324269,11857
263335046,0.0,0.0,33000,33000,0,0,33000,Null,Null,263335046,7324269,11873
263335070,0.0,0.0,15000,15000,0,0,15000,Null,Null,263335070,7324269,11861
263335248,0.0,0.0,17000,17000,0,0,17000,Null,Null,263335248,7324269,11857
263335264,0.0,0.0,29900000,29900000,0,0,29900000,Null,Null,263335264,74999,11516
263335270,0.0,0.0,4630000,4630000,0,0,4630000,Null,Null,263335270,7982659,8513
263335421,0.0,0.0,4630000,4630000,0,0,4630000,Null,Null,263335421,7982659,8513
263335463,0.0,0.0,75000,75000,0,0,75000,Null,Null,263335463,7324269,11875
263335543,0.0,0.0,150000,135000,15000,10,150000,Null,Null,263335543,5220265,17174
263335560,0.0,0.0,4630000,4630000,0,0,4630000,Null,Null,263335560,7982659,8513
263335676,0.0,0.0,250000,225000,25000,10,250000,Null,Null,263335676,5220265,17170
263335690,0.0,0.0,4630000,4630000,0,0,4630000,Null,Null,263335690,7982659,8513
263335773,0.0,0.0,150000,135000,15000,10,150000,Null,Null,263335773,5220265,17170
263335882,0.0,0.0,159900,159900,0,0,159900,Null,Null,263335882,8173845,8308
263335998,0.0,0.0,45000,45000,0,0,45000,Null,Null,263335998,7324269,11845
263336061,0.0,0.0,15000,15000,0,0,15000,Null,Null,263336061,7324269,11869
263336101,0.0,0.0,135000,108000,27000,20,135000,Null,Null,263336101,198555,8223
263336160,0.0,0.0,750000,450000,300000,40,750000,Null,Null,263336160,408385,1520
263336172,0.0,0.0,18000,18000,0,0,18000,Null,Null,263336172,7324269,11857
263336175,0.0,0.0,4550000,4550000,0,0,4550000,Null,Null,263336175,7982659,7449
263336281,0.0,0.0,95000,95000,0,0,95000,Null,Null,263336281,111461,28594
263336301,0.0,0.0,29000,29000,0,0,29000,Null,Null,263336301,7324269,11873
263336323,0.0,0.0,4550000,4550000,0,0,4550000,Null,Null,263336323,7982659,7449
263336592,0.0,0.0,68000,68000,0,0,68000,Null,Null,263336592,7324269,11857
263336684,0.0,0.0,4300000,4300000,0,0,4300000,Null,Null,263336684,5002791,17170
263336849,0.0,0.0,58000,58000,0,0,58000,Null,Null,263336849,7324269,11857
263336934,0.0,0.0,1350000,1350000,0,0,1350000,Null,Null,263336934,243107,28736
263337006,0.0,0.0,350000,350000,0,0,350000,Null,Null,263337006,111461,2334
263337018,0.0,0.0,59000,59000,0,0,59000,Null,Null,263337018,7324269,11857
263337021,0.0,0.0,1800000,1800000,0,0,1800000,Null,Null,263337021,5002791,53350
263337051,0.0,0.0,4250000,4250000,0,0,4250000,Null,Null,263337051,7982659,7449
263337059,1.0,1.0,69000,69000,0,0,69000,Null,Null,263337059,7324269,11871
263337766,0.0,0.0,69000,69000,0,0,69000,Null,Null,263337766,7324269,11871
263337846,0.0,0.0,150000,150000,0,0,150000,Null,Null,263337846,5220265,17170
263337889,0.0,0.0,19500,19500,0,0,19500,Null,Null,263337889,7324269,11873
263338007,0.0,0.0,27000,27000,0,0,27000,Null,Null,263338007,7324269,11857
263338021,0.0,0.0,3900000,3900000,0,0,3900000,Null,Null,263338021,8195711,8227
263338141,0.0,0.0,48000,48000,0,0,48000,Null,Null,263338141,7324269,11845
263338198,0.0,0.0,9590000,6690000,2900000,30,9590000,Null,Null,263338198,113119,2324
263338211,0.0,0.0,88000,88000,0,0,88000,Null,Null,263338211,7324269,11859
263338213,0.0,0.0,4150000,4150000,0,0,4150000,Null,Null,263338213,7982659,8511
263338296,0.0,0.0,80000,80000,0,0,80000,Null,Null,263338296,7324269,11859
263338298,0.0,0.0,19000,19000,0,0,19000,Null,Null,263338298,111461,7064
263338318,0.0,0.0,4150000,4150000,0,0,4150000,Null,Null,263338318,7982659,8512
263338338,0.0,0.0,4200000,3600000,600000,14,4200000,Null,Null,263338338,5347313,5566
263338351,0.0,0.0,520000,520000,0,0,520000,Null,Null,263338351,111461,8167
263338360,0.0,0.0,4150000,4150000,0,0,4150000,Null,Null,263338360,7982659,8512
263338375,0.0,0.0,79000,79000,0,0,79000,Null,Null,263338375,7324269,11869
263338398,0.0,0.0,44000,44000,0,0,44000,Null,Null,263338398,7324269,11861
263338433,0.0,0.0,999000,999000,0,0,999000,Null,Null,263338433,4696145,5905
263338552,0.0,0.0,890000,890000,0,0,890000,Null,Null,263338552,853413,1637
263338554,0.0,0.0,760000,760000,0,0,760000,Null,Null,263338554,4696145,11935
263338616,0.0,0.0,300000,195000,105000,35,300000,Null,Null,263338616,6272999,8227
263338703,0.0,0.0,890000,890000,0,0,890000,Null,Null,263338703,853413,1636
263338706,0.0,0.0,95000,95000,0,0,95000,Null,Null,263338706,243107,28736
263338735,0.0,0.0,980000,980000,0,0,980000,Null,Null,263338735,4696145,11935
263338758,0.0,0.0,225000,202500,22500,10,225000,Null,Null,263338758,8164011,11869
263338842,0.0,0.0,760000,760000,0,0,760000,Null,Null,263338842,4696145,7064
263338942,0.0,0.0,225000,202500,22500,10,225000,Null,Null,263338942,8164011,11869
263338986,0.0,0.0,900000,900000,0,0,900000,Null,Null,263338986,8173845,8308
263339028,0.0,0.0,3900000,3900000,0,0,3900000,Null,Null,263339028,8195731,7061
263339165,0.0,0.0,116000,116000,0,0,116000,Null,Null,263339165,306897,11881
263339257,31.0,31.0,750000,750000,0,0,750000,Null,Null,263339257,18802,1815
263339292,0.0,0.0,158000,158000,0,0,158000,Null,Null,263339292,111461,20250
263339301,0.0,0.0,490000,490000,0,0,490000,Null,Null,263339301,306897,11845
263339392,0.0,0.0,1090000,1090000,0,0,1090000,Null,Null,263339392,252755,28596
263339481,0.0,0.0,7200000,6990000,210000,3,7200000,Null,Null,263339481,5347313,1813
263339699,0.0,0.0,1250000,1250000,0,0,1250000,Null,Null,263339699,252755,28596
263339739,0.0,0.0,70000,70000,0,0,70000,Null,Null,263339739,243107,20174
263339756,0.0,0.0,66000,66000,0,0,66000,Null,Null,263339756,243107,20174
263339777,0.0,0.0,990000,990000,0,0,990000,Null,Null,263339777,252755,28596
263341019,0.0,0.0,200000,185000,15000,8,200000,Null,Null,263341019,111454,28640
263341965,0.0,0.0,259000,259000,0,0,259000,Null,Null,263341965,111461,5531
263342012,0.0,0.0,550000,550000,0,0,550000,Null,Null,263342012,27390,11857
263344833,0.0,0.0,125000,75000,50000,40,125000,Null,Null,263344833,111461,11845
263345203,0.0,0.0,199000,199000,0,0,199000,Null,Null,263345203,111461,2971
263345254,0.0,0.0,330000,330000,0,0,330000,Null,Null,263345254,111461,20174
263347699,0.0,0.0,750000,450000,300000,40,750000,Null,Null,263347699,408385,1520
263347895,0.0,0.0,395000,395000,0,0,395000,Null,Null,263347895,4438761,8602
263348076,0.0,0.0,406000,406000,0,0,406000,Null,Null,263348076,111461,2
263348517,0.0,0.0,69000,69000,0,0,69000,Null,Null,263348517,111461,2340
263348551,0.0,0.0,159000,159000,0,0,159000,Null,Null,263348551,111461,2
263348817,0.0,0.0,85000,85000,0,0,85000,Null,Null,263348817,155216,11885
263348879,0.0,0.0,216450,216450,0,0,216450,Null,Null,263348879,111461,6653
263348907,0.0,0.0,28860,28860,0,0,28860,Null,Null,263348907,111461,6653
263348917,0.0,0.0,31080,31080,0,0,31080,Null,Null,263348917,111461,6653
263348921,0.0,0.0,99900,99900,0,0,99900,Null,Null,263348921,111461,28434
263348929,0.0,0.0,943500,943500,0,0,943500,Null,Null,263348929,111461,6653
263348931,0.0,0.0,15540,15540,0,0,15540,Null,Null,263348931,111461,6653
263348934,0.0,0.0,26640,26640,0,0,26640,Null,Null,263348934,111461,6653
263348960,0.0,0.0,1454100,1454100,0,0,1454100,Null,Null,263348960,111461,6653
263348973,0.0,0.0,17205,17205,0,0,17205,Null,Null,263348973,111461,6653
263348996,0.0,0.0,3219000,3219000,0,0,3219000,Null,Null,263348996,111461,6653
263349002,0.0,0.0,88800,88800,0,0,88800,Null,Null,263349002,111461,28434
263349008,0.0,0.0,16650,16650,0,0,16650,Null,Null,263349008,111461,6653
263349010,0.0,0.0,27195,27195,0,0,27195,Null,Null,263349010,111461,6653
263349026,0.0,0.0,333000,333000,0,0,333000,Null,Null,263349026,111461,28434
263349030,0.0,0.0,29970,29970,0,0,29970,Null,Null,263349030,111461,6653
263349031,0.0,0.0,205350,205350,0,0,205350,Null,Null,263349031,111461,6653
263349036,0.0,0.0,88800,88800,0,0,88800,Null,Null,263349036,111461,6653
263349038,0.0,0.0,30525,30525,0,0,30525,Null,Null,263349038,111461,6653
263349040,0.0,0.0,32190,32190,0,0,32190,Null,Null,263349040,111461,6653
263349042,0.0,0.0,15540,15540,0,0,15540,Null,Null,263349042,111461,6653
263349052,0.0,0.0,159840,159840,0,0,159840,Null,Null,263349052,111461,6653
263349054,0.0,0.0,28860,28860,0,0,28860,Null,Null,263349054,111461,6653
263349056,0.0,0.0,73260,73260,0,0,73260,Null,Null,263349056,111461,6653
263349058,0.0,0.0,31080,31080,0,0,31080,Null,Null,263349058,111461,6653
263349059,0.0,0.0,27195,27195,0,0,27195,Null,Null,263349059,111461,6653
263349068,0.0,0.0,24975,24975,0,0,24975,Null,Null,263349068,111461,6653
263349070,0.0,0.0,2719500,2719500,0,0,2719500,Null,Null,263349070,111461,6653
263349078,0.0,0.0,194250,194250,0,0,194250,Null,Null,263349078,111461,6653
263349086,0.0,0.0,17760,17760,0,0,17760,Null,Null,263349086,111461,6653
263349088,0.0,0.0,421800,421800,0,0,421800,Null,Null,263349088,111461,6653
263349096,0.0,0.0,33855,33855,0,0,33855,Null,Null,263349096,111461,6653
263349104,0.0,0.0,15540,15540,0,0,15540,Null,Null,263349104,111461,6653
263349114,0.0,0.0,721500,721500,0,0,721500,Null,Null,263349114,111461,6653
263349136,0.0,0.0,32190,32190,0,0,32190,Null,Null,263349136,111461,6653
263352153,0.0,0.0,1200000,1200000,0,0,1200000,Null,Null,263352153,111461,53350
263352189,0.0,0.0,39000,39000,0,0,39000,Null,Null,263352189,111461,28484
263352209,0.0,0.0,124000,124000,0,0,124000,Null,Null,263352209,111461,15320
263352239,0.0,0.0,85000,85000,0,0,85000,Null,Null,263352239,7324269,11859
263352323,0.0,0.0,88000,88000,0,0,88000,Null,Null,263352323,7324269,11881
263352382,0.0,0.0,132000,132000,0,0,132000,Null,Null,263352382,7324269,11859
263352419,0.0,0.0,152000,152000,0,0,152000,Null,Null,263352419,111461,15320
263352503,0.0,0.0,70000,70000,0,0,70000,Null,Null,263352503,7324269,11881
263352543,0.0,0.0,199000,199000,0,0,199000,Null,Null,263352543,151948,1637
263352575,0.0,0.0,148000,148000,0,0,148000,Null,Null,263352575,7324269,11875
263352618,0.0,0.0,82500,66000,16500,20,82500,Null,Null,263352618,185157,17186
263352691,0.0,0.0,474000,474000,0,0,474000,Null,Null,263352691,111461,28444
263352718,0.0,0.0,126000,126000,0,0,126000,Null,Null,263352718,7324269,11879
263353735,0.0,0.0,21000,21000,0,0,21000,Null,Null,263353735,111461,20222
263353752,0.0,0.0,199000,199000,0,0,199000,Null,Null,263353752,151948,1637
263353834,0.0,0.0,115000,115000,0,0,115000,Null,Null,263353834,7324269,11875
263353852,0.0,0.0,152000,152000,0,0,152000,Null,Null,263353852,111461,15320
263353857,0.0,0.0,58500,46800,11700,20,58500,Null,Null,263353857,185157,17186
263353905,0.0,0.0,475000,475000,0,0,475000,Null,Null,263353905,111461,28444
263354375,0.0,0.0,110000,110000,0,0,110000,Null,Null,263354375,7324269,11875
263354473,0.0,0.0,389000,389000,0,0,389000,Null,Null,263354473,18984,1838
263354480,0.0,0.0,255000,204000,51000,20,255000,Null,Null,263354480,185157,17186
263354484,0.0,0.0,390000,355000,35000,9,390000,Null,Null,263354484,150215,11845
263354490,0.0,0.0,79000,79000,0,0,79000,Null,Null,263354490,7324269,11853
263354559,0.0,0.0,290000,239000,51000,18,290000,Null,Null,263354559,111461,28480
263354608,0.0,0.0,82000,82000,0,0,82000,Null,Null,263354608,7324269,11853
263354697,0.0,0.0,92000,92000,0,0,92000,Null,Null,263354697,7324269,11869
263354769,0.0,0.0,275000,275000,0,0,275000,Null,Null,263354769,306897,11857
263354970,0.0,0.0,590000,590000,0,0,590000,Null,Null,263354970,111461,53350
263354987,0.0,0.0,15000,15000,0,0,15000,Null,Null,263354987,7324269,11869
263355202,0.0,0.0,53000,53000,0,0,53000,Null,Null,263355202,7324269,11869
263355228,0.0,0.0,1900000,1900000,0,0,1900000,Null,Null,263355228,5141153,8227
263355352,0.0,0.0,360000,360000,0,0,360000,Null,Null,263355352,111461,15318
263355383,0.0,0.0,360000,360000,0,0,360000,Null,Null,263355383,111461,15318
263355540,0.0,0.0,45000,45000,0,0,45000,Null,Null,263355540,7324269,11875
263355543,0.0,0.0,90000,61251,28749,32,90000,Null,Null,263355543,500047,28482
263355565,0.0,0.0,260000,260000,0,0,260000,Null,Null,263355565,619971,11869
263356755,0.0,0.0,980000,980000,0,0,980000,Null,Null,263356755,5141153,53350
263356812,0.0,0.0,395000,395000,0,0,395000,Null,Null,263356812,4435757,11877
263356816,0.0,0.0,189000,169000,20000,11,189000,Null,Null,263356816,111461,28480
263356876,0.0,0.0,240000,240000,0,0,240000,Null,Null,263356876,111461,2334
263356960,0.0,0.0,745000,745000,0,0,745000,Null,Null,263356960,4435757,11877
263357059,0.0,0.0,45000,45000,0,0,45000,Null,Null,263357059,7324269,11869
263357357,0.0,0.0,28000,28000,0,0,28000,Null,Null,263357357,7324269,11861
263357469,0.0,0.0,450000,450000,0,0,450000,Null,Null,263357469,111461,53350
263357489,0.0,0.0,900000,900000,0,0,900000,Null,Null,263357489,25697,28450
263357550,0.0,0.0,269000,159000,110000,41,269000,Null,Null,263357550,314675,1838
263357617,0.0,0.0,148000,148000,0,0,148000,Null,Null,263357617,7324269,11859
263357879,0.0,0.0,95000,95000,0,0,95000,Null,Null,263357879,7324269,11869
263357932,0.0,0.0,149000,119000,30000,20,149000,Null,Null,263357932,111461,20244
263357978,0.0,0.0,225000,225000,0,0,225000,Null,Null,263357978,7324269,11861
263358096,0.0,0.0,105000,105000,0,0,105000,Null,Null,263358096,7324269,11861
263358177,0.0,0.0,185000,185000,0,0,185000,Null,Null,263358177,7324269,11875
263358179,0.0,0.0,129000,115000,14000,11,129000,Null,Null,263358179,111461,2324
263358201,0.0,0.0,99000,79000,20000,20,99000,Null,Null,263358201,111461,20244
263358269,0.0,0.0,200000,120000,80000,40,200000,Null,Null,263358269,111461,8201
263358352,0.0,0.0,33000,33000,0,0,33000,Null,Null,263358352,111461,20254
263358363,0.0,0.0,175000,175000,0,0,175000,Null,Null,263358363,7324269,11879
263358533,0.0,0.0,128000,128000,0,0,128000,Null,Null,263358533,7324269,11879
263358542,0.0,0.0,1290000,1290000,0,0,1290000,Null,Null,263358542,111461,1626
263358619,0.0,0.0,24000,24000,0,0,24000,Null,Null,263358619,111461,20254
263358649,0.0,0.0,115000,115000,0,0,115000,Null,Null,263358649,7324269,11865
263358738,0.0,0.0,339000,339000,0,0,339000,Null,Null,263358738,221867,11875
263358854,3.0,3.0,190000,115000,75000,39,190000,Null,Null,263358854,4234729,23022
263358873,0.0,0.0,268000,268000,0,0,268000,Null,Null,263358873,7324269,11845
263358970,0.0,0.0,98000,98000,0,0,98000,Null,Null,263358970,111461,49726
263359500,0.0,0.0,1000000,1000000,0,0,1000000,Null,Null,263359500,25697,28450
263359541,0.0,0.0,379000,379000,0,0,379000,Null,Null,263359541,221867,11845
263359555,0.0,0.0,45000,45000,0,0,45000,Null,Null,263359555,111461,49726
263360004,0.0,0.0,1980000,1980000,0,0,1980000,Null,Null,263360004,174069,12864
263360010,0.0,0.0,2146000,2146000,0,0,2146000,Null,Null,263360010,174069,12864
263360012,0.0,0.0,250000,250000,0,0,250000,Null,Null,263360012,111461,28598
263360111,0.0,0.0,5066000,5066000,0,0,5066000,Null,Null,263360111,174069,12864
263360115,0.0,0.0,198000,198000,0,0,198000,Null,Null,263360115,111461,15320
263360142,0.0,0.0,250000,250000,0,0,250000,Null,Null,263360142,111461,28596
263360151,0.0,0.0,600000,600000,0,0,600000,Null,Null,263360151,111461,1626
263360162,0.0,0.0,613000,613000,0,0,613000,Null,Null,263360162,174069,12864
263360177,0.0,0.0,699000,699000,0,0,699000,Null,Null,263360177,111461,28682
263360181,0.0,0.0,15730000,15730000,0,0,15730000,Null,Null,263360181,111461,2340
263360247,0.0,0.0,154000,154000,0,0,154000,Null,Null,263360247,111461,15320
263360259,0.0,0.0,5800000,5800000,0,0,5800000,Null,Null,263360259,111461,2340
263360267,0.0,0.0,259000,259000,0,0,259000,Null,Null,263360267,111461,2971
263360334,0.0,0.0,140000,140000,0,0,140000,Null,Null,263360334,111461,15320
263360338,0.0,0.0,4225000,4225000,0,0,4225000,Null,Null,263360338,7982659,7449
263366092,0.0,0.0,79000,79000,0,0,79000,Null,Null,263366092,111461,28638
263366098,0.0,0.0,12800000,12080000,720000,6,12800000,Null,Null,263366098,111461,2340
263366103,0.0,0.0,399000,378000,21000,5,399000,Null,Null,263366103,111461,1832
263366130,0.0,0.0,120000,120000,0,0,120000,Null,Null,263366130,111461,15318
263366155,0.0,0.0,235000,235000,0,0,235000,Null,Null,263366155,111461,2971
263366165,0.0,0.0,120000,120000,0,0,120000,Null,Null,263366165,111461,15318
263366190,0.0,0.0,379000,379000,0,0,379000,Null,Null,263366190,111461,20244
263366196,0.0,0.0,120000,120000,0,0,120000,Null,Null,263366196,111461,28592
263366203,0.0,0.0,179000,179000,0,0,179000,Null,Null,263366203,111461,15320
263366228,0.0,0.0,140000,140000,0,0,140000,Null,Null,263366228,111461,15318
263366241,0.0,0.0,150000,150000,0,0,150000,Null,Null,263366241,111461,15318
263366387,0.0,0.0,140000,140000,0,0,140000,Null,Null,263366387,111461,15318
263366416,0.0,0.0,140000,140000,0,0,140000,Null,Null,263366416,111461,15318
263366437,0.0,0.0,45000,45000,0,0,45000,Null,Null,263366437,111461,8202
263366451,0.0,0.0,45000,45000,0,0,45000,Null,Null,263366451,111461,8205
263366456,0.0,0.0,55555,55555,0,0,55555,Null,Null,263366456,111461,8202
263366681,0.0,0.0,44999,44999,0,0,44999,Null,Null,263366681,111461,8202
263367022,0.0,0.0,580000,580000,0,0,580000,Null,Null,263367022,47803,11859
263367043,0.0,0.0,44999,44999,0,0,44999,Null,Null,263367043,111461,8202
263367062,0.0,0.0,55555,55555,0,0,55555,Null,Null,263367062,111461,8205
263367071,0.0,0.0,55555,55555,0,0,55555,Null,Null,263367071,111461,8202
263368525,0.0,0.0,890000,890000,0,0,890000,Null,Null,263368525,206471,8198
263368557,0.0,0.0,195000,195000,0,0,195000,Null,Null,263368557,111461,12918
263369088,0.0,0.0,195000,195000,0,0,195000,Null,Null,263369088,111461,28480
263369282,0.0,0.0,285000,285000,0,0,285000,Null,Null,263369282,111461,1832
263369824,0.0,0.0,1500000,1500000,0,0,1500000,Null,Null,263369824,853413,1636
263369980,0.0,0.0,890000,890000,0,0,890000,Null,Null,263369980,853413,1636
263370055,0.0,0.0,890000,890000,0,0,890000,Null,Null,263370055,853413,1637
263370160,0.0,0.0,169000,169000,0,0,169000,Null,Null,263370160,111461,2
263370258,0.0,0.0,79000,79000,0,0,79000,Null,Null,263370258,111461,2
263370327,0.0,0.0,79000,79000,0,0,79000,Null,Null,263370327,111461,2
263370347,0.0,0.0,89000,89000,0,0,89000,Null,Null,263370347,111461,2
263370349,0.0,0.0,79000,79000,0,0,79000,Null,Null,263370349,111461,2
263370444,0.0,0.0,65000,65000,0,0,65000,Null,Null,263370444,111461,2
263370470,0.0,0.0,65000,65000,0,0,65000,Null,Null,263370470,111461,2
263370680,0.0,0.0,9000,9000,0,0,9000,Null,Null,263370680,111461,2
263370692,0.0,0.0,25000,25000,0,0,25000,Null,Null,263370692,111461,2
263370798,0.0,0.0,30000,30000,0,0,30000,Null,Null,263370798,111461,2
263370874,0.0,0.0,59000,59000,0,0,59000,Null,Null,263370874,111461,20236
263370880,0.0,0.0,135000,135000,0,0,135000,Null,Null,263370880,111461,2
263370964,0.0,0.0,15000,15000,0,0,15000,Null,Null,263370964,111461,2
263371061,0.0,0.0,95000,95000,0,0,95000,Null,Null,263371061,111461,2
263371136,0.0,0.0,49000,49000,0,0,49000,Null,Null,263371136,111461,2
263371187,0.0,0.0,65000,65000,0,0,65000,Null,Null,263371187,111461,2
263371750,0.0,0.0,79000,79000,0,0,79000,Null,Null,263371750,111461,2
263371760,0.0,0.0,114000,114000,0,0,114000,Null,Null,263371760,111461,15320
263371762,0.0,0.0,210000,210000,0,0,210000,Null,Null,263371762,111461,15320
263371764,0.0,0.0,147000,147000,0,0,147000,Null,Null,263371764,111461,15320
263371766,0.0,0.0,165000,165000,0,0,165000,Null,Null,263371766,111461,15320
263371768,0.0,0.0,79000,79000,0,0,79000,Null,Null,263371768,111461,15320
263371825,0.0,0.0,178000,178000,0,0,178000,Null,Null,263371825,111461,15320
263371898,0.0,0.0,175000,175000,0,0,175000,Null,Null,263371898,111461,15320
263371902,0.0,0.0,75000,75000,0,0,75000,Null,Null,263371902,111461,15320
263372013,0.0,0.0,85000,85000,0,0,85000,Null,Null,263372013,111461,15320
263372076,0.0,0.0,55000,55000,0,0,55000,Null,Null,263372076,111461,15320
263372103,0.0,0.0,75000,75000,0,0,75000,Null,Null,263372103,111461,15320
263372105,0.0,0.0,45000,45000,0,0,45000,Null,Null,263372105,111461,15320
263372107,0.0,0.0,45000,45000,0,0,45000,Null,Null,263372107,111461,15320
263372109,0.0,0.0,210000,210000,0,0,210000,Null,Null,263372109,111461,15320
263372159,0.0,0.0,125000,125000,0,0,125000,Null,Null,263372159,111461,2340
263372212,0.0,0.0,80000,60000,20000,25,80000,Null,Null,263372212,26675,28452
263372230,0.0,0.0,80000,60000,20000,25,80000,Null,Null,263372230,26675,28452
263372235,0.0,0.0,80000,60000,20000,25,80000,Null,Null,263372235,26675,28452
263372240,0.0,0.0,80000,60000,20000,25,80000,Null,Null,263372240,26675,28452
263372314,0.0,0.0,73000,58400,14600,20,73000,Null,Null,263372314,8195091,17186
263372317,0.0,0.0,80000,80000,0,0,80000,Null,Null,263372317,26675,28452
263372333,0.0,0.0,80000,60000,20000,25,80000,Null,Null,263372333,26675,28452
263372368,0.0,0.0,80000,60000,20000,25,80000,Null,Null,263372368,26675,28452
263372381,0.0,0.0,80000,60000,20000,25,80000,Null,Null,263372381,26675,28452
263372387,0.0,0.0,80000,80000,0,0,80000,Null,Null,263372387,26675,28452
263372402,0.0,0.0,42800,34240,8560,20,42800,Null,Null,263372402,8195091,17186
263372441,0.0,0.0,2600000,2540000,60000,2,2600000,Null,Null,263372441,111461,2340
263372483,0.0,0.0,3500000,3240000,260000,7,3500000,Null,Null,263372483,111461,2340
263372547,0.0,0.0,4700000,4560000,140000,3,4700000,Null,Null,263372547,111461,2340
263372980,0.0,0.0,250000,250000,0,0,250000,Null,Null,263372980,5220265,17170
263373301,0.0,0.0,150000,150000,0,0,150000,Null,Null,263373301,5220265,17170
263373389,0.0,0.0,499000,299000,200000,40,499000,Null,Null,263373389,111461,3422
263374476,0.0,0.0,369000,369000,0,0,369000,Null,Null,263374476,111461,2971
263374545,0.0,0.0,1290000,1200000,90000,7,1290000,Null,Null,263374545,111461,4429
263374594,0.0,0.0,5790000,4550000,1240000,21,5790000,Null,Null,263374594,8194285,8066
263374605,0.0,0.0,35000,35000,0,0,35000,Null,Null,263374605,111461,12908
263375393,0.0,0.0,270000,270000,0,0,270000,Null,Null,263375393,27390,11857
263383547,0.0,0.0,12650000,9600000,3050000,24,12650000,Null,Null,263383547,5700191,11933
263383592,0.0,0.0,17205,17205,0,0,17205,Null,Null,263383592,111461,6653
263383596,0.0,0.0,249750,249750,0,0,249750,Null,Null,263383596,111461,6653
263383608,0.0,0.0,99900,99900,0,0,99900,Null,Null,263383608,111461,28716
263383931,0.0,0.0,245000,245000,0,0,245000,Null,Null,263383931,27390,11859
263383936,0.0,0.0,120000,120000,0,0,120000,Null,Null,263383936,111461,49724
263384203,0.0,0.0,99000,99000,0,0,99000,Null,Null,263384203,166419,28576
263384252,0.0,0.0,450000,450000,0,0,450000,Null,Null,263384252,111461,2
263384501,0.0,0.0,635000,635000,0,0,635000,Null,Null,263384501,111461,2
263384692,0.0,0.0,470000,470000,0,0,470000,Null,Null,263384692,112638,1796
263384702,0.0,0.0,55000,55000,0,0,55000,Null,Null,263384702,7324269,11845
263384740,0.0,0.0,40819000,40819000,0,0,40819000,Null,Null,263384740,111461,7079
263384821,0.0,0.0,280000,280000,0,0,280000,Null,Null,263384821,27390,11857
263384998,0.0,0.0,310000,310000,0,0,310000,Null,Null,263384998,494489,28576
263385009,0.0,0.0,289000,289000,0,0,289000,Null,Null,263385009,111461,2971
263385016,0.0,0.0,40819000,40819000,0,0,40819000,Null,Null,263385016,111461,7079
263385102,0.0,0.0,154000,154000,0,0,154000,Null,Null,263385102,27390,11857
263385507,0.0,0.0,550000,550000,0,0,550000,Null,Null,263385507,111461,3426
263385516,0.0,0.0,225000,225000,0,0,225000,Null,Null,263385516,111461,13878
263385542,0.0,0.0,265000,265000,0,0,265000,Null,Null,263385542,111461,1838
263385644,0.0,0.0,165000,165000,0,0,165000,Null,Null,263385644,21651,28480
263385673,0.0,0.0,280000,280000,0,0,280000,Null,Null,263385673,229723,28598
263385738,0.0,0.0,195000,195000,0,0,195000,Null,Null,263385738,238861,8223
263385779,0.0,0.0,245000,245000,0,0,245000,Null,Null,263385779,238861,8223
263385826,0.0,0.0,3500,3500,0,0,3500,Null,Null,263385826,111461,2
263385843,0.0,0.0,1000,1000,0,0,1000,Null,Null,263385843,111461,2
263385854,0.0,0.0,1200,1200,0,0,1200,Null,Null,263385854,111461,2
263385880,0.0,0.0,2400,2400,0,0,2400,Null,Null,263385880,111461,2
263386011,0.0,0.0,2200,2200,0,0,2200,Null,Null,263386011,111461,2
263386320,0.0,0.0,1000,1000,0,0,1000,Null,Null,263386320,111461,2
263386394,0.0,0.0,1600,1600,0,0,1600,Null,Null,263386394,111461,2
263386477,0.0,0.0,1300,1300,0,0,1300,Null,Null,263386477,111461,2
263386686,0.0,0.0,1100,1100,0,0,1100,Null,Null,263386686,111461,2
263386882,0.0,0.0,1300,1300,0,0,1300,Null,Null,263386882,111461,2
263386990,0.0,0.0,1050,1050,0,0,1050,Null,Null,263386990,111461,2
263387134,0.0,0.0,1000,1000,0,0,1000,Null,Null,263387134,111461,2
263387348,0.0,0.0,600000,600000,0,0,600000,Null,Null,263387348,111461,11849
263387387,0.0,0.0,590000,590000,0,0,590000,Null,Null,263387387,111461,53350
263387413,0.0,0.0,1200000,1200000,0,0,1200000,Null,Null,263387413,111461,11845
263387707,0.0,0.0,13220000,9600000,3620000,27,13220000,Null,Null,263387707,5700191,2340
263387738,0.0,0.0,950000,950000,0,0,950000,Null,Null,263387738,111461,53350
263387812,0.0,0.0,195000,195000,0,0,195000,Null,Null,263387812,238861,8223
263387979,0.0,0.0,19890,19890,0,0,19890,Null,Null,263387979,505165,2
263388020,0.0,0.0,9500,9500,0,0,9500,Null,Null,263388020,505165,2
263388108,0.0,0.0,309000,309000,0,0,309000,Null,Null,263388108,111461,2971
263388344,0.0,0.0,980000,980000,0,0,980000,Null,Null,263388344,111461,53350
263388490,0.0,0.0,294000,294000,0,0,294000,Null,Null,263388490,21651,28480
263388495,0.0,0.0,49000,49000,0,0,49000,Null,Null,263388495,613101,1612
263388502,1.0,1.0,400000,259000,141000,35,400000,Null,Null,263388502,463577,9013
263388504,0.0,0.0,30000,30000,0,0,30000,Null,Null,263388504,243107,20174
263388596,0.0,0.0,1735000,1735000,0,0,1735000,Null,Null,263388596,6264871,26652
263388601,0.0,0.0,101000,101000,0,0,101000,Null,Null,263388601,111461,2514
263388603,0.0,0.0,1485000,1485000,0,0,1485000,Null,Null,263388603,111461,27196
263388604,0.0,0.0,21000,21000,0,0,21000,Null,Null,263388604,111461,2337
263388616,0.0,0.0,281000,281000,0,0,281000,Null,Null,263388616,111461,9052
263388617,0.0,0.0,10000,10000,0,0,10000,Null,Null,263388617,111461,2363
263388620,0.0,0.0,135000,135000,0,0,135000,Null,Null,263388620,111461,23272
263388724,0.0,0.0,650000,650000,0,0,650000,Null,Null,263388724,5141153,3426
263388809,0.0,0.0,250000,250000,0,0,250000,Null,Null,263388809,153733,11817
263388904,0.0,0.0,45000,45000,0,0,45000,Null,Null,263388904,243107,20174
263389356,0.0,0.0,1550000,1550000,0,0,1550000,Null,Null,263389356,6264871,26652
263389798,0.0,0.0,21000,21000,0,0,21000,Null,Null,263389798,111461,20254
263389808,0.0,0.0,1665000,1665000,0,0,1665000,Null,Null,263389808,6264871,26652
263390039,0.0,0.0,200000,120000,80000,40,200000,Null,Null,263390039,111461,8201
263390203,0.0,0.0,250000,250000,0,0,250000,Null,Null,263390203,111461,15318
263390325,0.0,0.0,65000,65000,0,0,65000,Null,Null,263390325,111461,28458
263390327,0.0,0.0,1600000,1520000,80000,5,1600000,Null,Null,263390327,7503671,2
263390431,0.0,0.0,265000,265000,0,0,265000,Null,Null,263390431,111461,1838
263390462,0.0,0.0,109000,109000,0,0,109000,Null,Null,263390462,21651,1819
263390658,0.0,0.0,249000,249000,0,0,249000,Null,Null,263390658,676055,11873
263390669,0.0,0.0,4050000,3090000,960000,24,4050000,Null,Null,263390669,5700191,11935
263390692,0.0,0.0,59000,59000,0,0,59000,Null,Null,263390692,111461,1815
263390803,0.0,0.0,399000,399000,0,0,399000,Null,Null,263390803,111461,2512
263390827,0.0,0.0,59000,59000,0,0,59000,Null,Null,263390827,111461,1815
263390860,0.0,0.0,220000,220000,0,0,220000,Null,Null,263390860,486879,8309
263391120,0.0,0.0,2929000,2929000,0,0,2929000,Null,Null,263391120,21651,28596
263391167,0.0,0.0,89000,89000,0,0,89000,Null,Null,263391167,21651,28484
263391266,0.0,0.0,339000,339000,0,0,339000,Null,Null,263391266,21651,8400
263391296,0.0,0.0,250000,250000,0,0,250000,Null,Null,263391296,212267,28460
263391617,0.0,0.0,29000,29000,0,0,29000,Null,Null,263391617,48727,11605
263391628,0.0,0.0,120000,120000,0,0,120000,Null,Null,263391628,4647777,15318
263391670,0.0,0.0,99000,99000,0,0,99000,Null,Null,263391670,212267,3805
263391966,0.0,0.0,900000,630000,270000,30,900000,Null,Null,263391966,111461,53350
263392012,0.0,0.0,1150000,977500,172500,15,1150000,Null,Null,263392012,704815,15320
263392078,0.0,0.0,10350000,7960000,2390000,23,10350000,Null,Null,263392078,4649279,11516
263392106,0.0,0.0,460000,460000,0,0,460000,Null,Null,263392106,5172305,11875
263392254,0.0,0.0,880000,748000,132000,15,880000,Null,Null,263392254,704815,15320
263392310,0.0,0.0,375000,375000,0,0,375000,Null,Null,263392310,174069,12864
263392366,0.0,0.0,950000,807500,142500,15,950000,Null,Null,263392366,704815,15320
263392476,0.0,0.0,750000,637500,112500,15,750000,Null,Null,263392476,704815,15320
263392479,1.0,1.0,30000,30000,0,0,30000,Null,Null,263392479,112499,8305
263392499,0.0,0.0,6900000,6900000,0,0,6900000,Null,Null,263392499,111461,28460
263392556,0.0,0.0,850000,722500,127500,15,850000,Null,Null,263392556,704815,15320
263392605,0.0,0.0,1700000,1500000,200000,12,1700000,Null,Null,263392605,5347313,2324
263392626,0.0,0.0,14110000,10850000,3260000,23,14110000,Null,Null,263392626,4649279,11516
263392690,0.0,0.0,959500,959500,0,0,959500,Null,Null,263392690,5719107,2
263392692,0.0,0.0,2404800,2404800,0,0,2404800,Null,Null,263392692,5719107,2
263392694,0.0,0.0,684000,684000,0,0,684000,Null,Null,263392694,5719107,2
263392696,0.0,0.0,828000,828000,0,0,828000,Null,Null,263392696,5719107,2
263392697,0.0,0.0,450500,450500,0,0,450500,Null,Null,263392697,5719107,2
263392703,0.0,0.0,383400,383400,0,0,383400,Null,Null,263392703,5719107,2
263392704,0.0,0.0,931000,931000,0,0,931000,Null,Null,263392704,5719107,2
263392705,0.0,0.0,855000,855000,0,0,855000,Null,Null,263392705,5719107,2
263392709,0.0,0.0,145800,145800,0,0,145800,Null,Null,263392709,5719107,2
263392711,0.0,0.0,1178000,1178000,0,0,1178000,Null,Null,263392711,5719107,2
263392713,0.0,0.0,256500,256500,0,0,256500,Null,Null,263392713,5719107,2
263392715,0.0,0.0,299000,299000,0,0,299000,Null,Null,263392715,5719107,2
263392717,0.0,0.0,180000,180000,0,0,180000,Null,Null,263392717,5719107,2
263392718,0.0,0.0,2755000,2755000,0,0,2755000,Null,Null,263392718,5719107,2
263392725,0.0,0.0,774000,774000,0,0,774000,Null,Null,263392725,5719107,2
263392726,0.0,0.0,367200,367200,0,0,367200,Null,Null,263392726,5719107,2
263392736,0.0,0.0,720000,720000,0,0,720000,Null,Null,263392736,5719107,2
263392742,0.0,0.0,1598400,1598400,0,0,1598400,Null,Null,263392742,5719107,2
263392744,0.0,0.0,2282850,2282850,0,0,2282850,Null,Null,263392744,5719107,2
263392746,0.0,0.0,1729950,1729950,0,0,1729950,Null,Null,263392746,5719107,2
263392759,0.0,0.0,1054500,1054500,0,0,1054500,Null,Null,263392759,5719107,2
263392780,0.0,0.0,1200000,730000,470000,39,1200000,Null,Null,263392780,192113,5267
263393022,0.0,0.0,1620000,1506000,114000,7,1620000,Null,Null,263393022,19018,11833
263393097,0.0,0.0,1099000,1099000,0,0,1099000,Null,Null,263393097,162007,8400
263393193,0.0,0.0,950000,665000,285000,30,950000,Null,Null,263393193,8196121,8309
263393347,23.0,23.0,600000,395000,205000,34,600000,Null,Null,263393347,4234729,23832
263393376,0.0,0.0,2150000,2008000,142000,7,2150000,Null,Null,263393376,19018,11833
263393457,0.0,0.0,6900000,6900000,0,0,6900000,Null,Null,263393457,243915,12876
263393593,0.0,0.0,79500,79500,0,0,79500,Null,Null,263393593,111461,28682
263393868,0.0,0.0,13000,6500,6500,50,13000,Null,Null,263393868,477953,8305
263394013,0.0,0.0,350000,350000,0,0,350000,Null,Null,263394013,499843,2
263394080,0.0,0.0,799000,499000,300000,38,799000,Null,Null,263394080,25422,1626
263394158,0.0,0.0,78000,78000,0,0,78000,Null,Null,263394158,143006,1634
263394196,0.0,0.0,350000,189000,161000,46,350000,Null,Null,263394196,200189,11845
263394199,0.0,0.0,42000,42000,0,0,42000,Null,Null,263394199,111461,8167
263394295,0.0,0.0,97000,97000,0,0,97000,Null,Null,263394295,143006,1634
263394306,0.0,0.0,109000,109000,0,0,109000,Null,Null,263394306,7324269,11857
263394323,0.0,0.0,1100000,770000,330000,30,1100000,Null,Null,263394323,8196121,11749
263394388,0.0,0.0,98000,98000,0,0,98000,Null,Null,263394388,7324269,11877
263394456,0.0,0.0,695000,695000,0,0,695000,Null,Null,263394456,111461,2340
263394463,0.0,0.0,75000,75000,0,0,75000,Null,Null,263394463,7324269,11881
263394564,0.0,0.0,30000,30000,0,0,30000,Null,Null,263394564,7324269,11861
263394578,0.0,0.0,350000,199000,151000,43,350000,Null,Null,263394578,200189,11857
263394658,0.0,0.0,4450000,4450000,0,0,4450000,Null,Null,263394658,7982659,8512
263394681,0.0,0.0,139000,139000,0,0,139000,Null,Null,263394681,7324269,11875
263394712,0.0,0.0,1500,1500,0,0,1500,Null,Null,263394712,114515,2265
263394772,0.0,0.0,2395000,2395000,0,0,2395000,Null,Null,263394772,4228643,8066
263394778,0.0,0.0,4065000,3688000,377000,9,4065000,Null,Null,263394778,19018,10228
263394833,0.0,0.0,149000,74500,74500,50,149000,Null,Null,263394833,332519,1583
263394948,0.0,0.0,59000,59000,0,0,59000,Null,Null,263394948,285975,11873
263395004,0.0,0.0,225000,225000,0,0,225000,Null,Null,263395004,285975,11879
263395043,0.0,0.0,145000,145000,0,0,145000,Null,Null,263395043,285975,11869
263395144,0.0,0.0,460000,460000,0,0,460000,Null,Null,263395144,111461,11861
263395195,0.0,0.0,98000,98000,0,0,98000,Null,Null,263395195,285975,11873
263395281,0.0,0.0,149000,74500,74500,50,149000,Null,Null,263395281,332519,4413
263395296,0.0,0.0,89000,89000,0,0,89000,Null,Null,263395296,285975,11875
263395445,0.0,0.0,59000,59000,0,0,59000,Null,Null,263395445,425489,28428
263395459,0.0,0.0,79000,79000,0,0,79000,Null,Null,263395459,7324269,11865
263395604,0.0,0.0,1920000,1792000,128000,7,1920000,Null,Null,263395604,19018,11833
263395727,0.0,0.0,750000,389000,361000,48,750000,Null,Null,263395727,200189,11845
263395911,0.0,0.0,119000,119000,0,0,119000,Null,Null,263395911,7324269,11859
263395917,0.0,0.0,209000,115000,94000,45,209000,Null,Null,263395917,27489,1583
263396034,0.0,0.0,799000,549000,250000,31,799000,Null,Null,263396034,215231,28480
263396042,0.0,0.0,65000,65000,0,0,65000,Null,Null,263396042,7324269,11857
263396125,0.0,0.0,450000,249000,201000,45,450000,Null,Null,263396125,200189,11847
263396161,0.0,0.0,149000,149000,0,0,149000,Null,Null,263396161,7324269,11845
263396165,0.0,0.0,595000,595000,0,0,595000,Null,Null,263396165,111461,28444
263396647,0.0,0.0,159000,159000,0,0,159000,Null,Null,263396647,7324269,11879
263396667,0.0,0.0,300000,189000,111000,37,300000,Null,Null,263396667,8195827,2340
263397246,0.0,0.0,114000,114000,0,0,114000,Null,Null,263397246,285975,11859
263397276,0.0,0.0,300000,180000,120000,40,300000,Null,Null,263397276,8195827,5905
263400197,0.0,0.0,24000,24000,0,0,24000,Null,Null,263400197,285975,11857
263400260,0.0,0.0,225000,225000,0,0,225000,Null,Null,263400260,285975,11877
263400428,0.0,0.0,149000,149000,0,0,149000,Null,Null,263400428,285975,11879
263401299,0.0,0.0,279858,279858,0,0,279858,Null,Null,263401299,111461,28598
263401482,0.0,0.0,250000,250000,0,0,250000,Null,Null,263401482,111461,28596
263401526,0.0,0.0,100000,100000,0,0,100000,Null,Null,263401526,425489,28428
263401819,0.0,0.0,350000,350000,0,0,350000,Null,Null,263401819,111461,2324
263401840,0.0,0.0,1900,1900,0,0,1900,Null,Null,263401840,111461,27180
263401847,0.0,0.0,3500000,3240000,260000,7,3500000,Null,Null,263401847,111461,2340
263401849,0.0,0.0,3500000,3240000,260000,7,3500000,Null,Null,263401849,111461,2340
263401876,0.0,0.0,265000,265000,0,0,265000,Null,Null,263401876,111461,2324
263401956,0.0,0.0,334074,334074,0,0,334074,Null,Null,263401956,53269,11857
263404014,0.0,0.0,47900,47900,0,0,47900,Null,Null,263404014,111461,2340
263404016,0.0,0.0,138000,138000,0,0,138000,Null,Null,263404016,111461,1831
263404032,0.0,0.0,590000,590000,0,0,590000,Null,Null,263404032,74988,8192
263404042,0.0,0.0,950000,950000,0,0,950000,Null,Null,263404042,525351,1596
263404047,0.0,0.0,1050000,1050000,0,0,1050000,Null,Null,263404047,4773145,1605
263404049,0.0,0.0,890000,890000,0,0,890000,Null,Null,263404049,4773145,8188
263404056,0.0,0.0,1085000,550000,535000,49,1085000,Null,Null,263404056,7378235,11885
263404063,0.0,0.0,1399000,1399000,0,0,1399000,Null,Null,263404063,8196043,11741
263404071,0.0,0.0,650000,650000,0,0,650000,Null,Null,263404071,5220265,5893
263405265,0.0,0.0,1290000,1290000,0,0,1290000,Null,Null,263405265,8196043,1597
263405342,0.0,0.0,22300000,22300000,0,0,22300000,Null,Null,263405342,111461,7075
263405485,0.0,0.0,1950000,1950000,0,0,1950000,Null,Null,263405485,711483,17170
263405505,0.0,0.0,1650000,1650000,0,0,1650000,Null,Null,263405505,711483,17170
263405512,0.0,0.0,380000,380000,0,0,380000,Null,Null,263405512,5220265,3426
263406035,0.0,0.0,98000,98000,0,0,98000,Null,Null,263406035,111461,2
263406179,0.0,0.0,4560000,4560000,0,0,4560000,Null,Null,263406179,111461,2340
263410491,0.0,0.0,25000,25000,0,0,25000,Null,Null,263410491,111461,8198
263410562,0.0,0.0,1550000,1395000,155000,10,1550000,Null,Null,263410562,704815,15236
263410565,0.0,0.0,115000,115000,0,0,115000,Null,Null,263410565,111461,15250
263412473,0.0,0.0,50000,28900,21100,42,50000,Null,Null,263412473,111461,8167
263412710,0.0,0.0,330000,330000,0,0,330000,Null,Null,263412710,111461,2334
263412723,0.0,0.0,35500,35500,0,0,35500,Null,Null,263412723,111461,28576
263413358,0.0,0.0,69000,69000,0,0,69000,Null,Null,263413358,111461,2334
263413557,0.0,0.0,799000,759050,39950,5,799000,Null,Null,263413557,111461,20254
263413755,0.0,0.0,1280000,1280000,0,0,1280000,Null,Null,263413755,5179953,11861
263414448,0.0,0.0,79000,79000,0,0,79000,Null,Null,263414448,111461,2
263414532,0.0,0.0,79000,79000,0,0,79000,Null,Null,263414532,111461,2
263414534,0.0,0.0,79000,79000,0,0,79000,Null,Null,263414534,111461,2
263414541,0.0,0.0,79000,79000,0,0,79000,Null,Null,263414541,111461,2
263414543,0.0,0.0,69000,69000,0,0,69000,Null,Null,263414543,111461,2
263414545,0.0,0.0,79000,79000,0,0,79000,Null,Null,263414545,111461,2
263414547,0.0,0.0,79000,79000,0,0,79000,Null,Null,263414547,111461,2
263415434,0.0,0.0,299000,299000,0,0,299000,Null,Null,263415434,111461,11943
263415450,0.0,0.0,349000,349000,0,0,349000,Null,Null,263415450,111461,2334
263415454,0.0,0.0,459000,459000,0,0,459000,Null,Null,263415454,111461,1634
263415456,0.0,0.0,190000,190000,0,0,190000,Null,Null,263415456,111461,1634
263415458,0.0,0.0,190000,190000,0,0,190000,Null,Null,263415458,111461,1634
263415460,0.0,0.0,529000,529000,0,0,529000,Null,Null,263415460,111461,1634
263415462,0.0,0.0,459000,459000,0,0,459000,Null,Null,263415462,111461,1634
263415494,0.0,0.0,169000,169000,0,0,169000,Null,Null,263415494,373635,28576
263415503,0.0,0.0,169000,169000,0,0,169000,Null,Null,263415503,373635,28576
263415745,0.0,0.0,25000,25000,0,0,25000,Null,Null,263415745,111461,5566
263415754,0.0,0.0,239000,239000,0,0,239000,Null,Null,263415754,168073,28480
263415826,0.0,0.0,120000,120000,0,0,120000,Null,Null,263415826,445887,28484
263415959,0.0,0.0,78000,78000,0,0,78000,Null,Null,263415959,419037,11833
263415961,0.0,0.0,29999,29999,0,0,29999,Null,Null,263415961,4717113,11923
263416110,0.0,0.0,159000,159000,0,0,159000,Null,Null,263416110,285975,11879
263416117,0.0,0.0,5800000,5800000,0,0,5800000,Null,Null,263416117,111461,2340
263416939,0.0,0.0,209000,209000,0,0,209000,Null,Null,263416939,285975,11879
263417237,0.0,0.0,88000,88000,0,0,88000,Null,Null,263417237,285975,11875
263417252,0.0,0.0,118000,118000,0,0,118000,Null,Null,263417252,285975,11875
263418018,0.0,0.0,99000,99000,0,0,99000,Null,Null,263418018,111461,28484
263419428,0.0,0.0,375000,375000,0,0,375000,Null,Null,263419428,567997,11845
263419553,0.0,0.0,30000,30000,0,0,30000,Null,Null,263419553,111461,1831
263419579,0.0,0.0,279000,279000,0,0,279000,Null,Null,263419579,567997,11875
263419679,0.0,0.0,118000,118000,0,0,118000,Null,Null,263419679,7324269,11845
263419701,0.0,0.0,120000,120000,0,0,120000,Null,Null,263419701,111461,28484
263419744,0.0,0.0,1199000,1199000,0,0,1199000,Null,Null,263419744,5724829,5384
263419748,0.0,0.0,98000,98000,0,0,98000,Null,Null,263419748,7324269,11881
263419776,0.0,0.0,190000,190000,0,0,190000,Null,Null,263419776,445887,28576
263419843,0.0,0.0,1199000,1199000,0,0,1199000,Null,Null,263419843,5724829,5384
263419845,0.0,0.0,100000,100000,0,0,100000,Null,Null,263419845,425489,28428
263419899,0.0,0.0,579000,299000,280000,48,579000,Null,Null,263419899,361359,4593
263419905,0.0,0.0,128000,128000,0,0,128000,Null,Null,263419905,7324269,11849
263419945,0.0,0.0,180000,180000,0,0,180000,Null,Null,263419945,7324269,11849
263419982,0.0,0.0,89000,89000,0,0,89000,Null,Null,263419982,7324269,11861
263422208,0.0,0.0,259000,259000,0,0,259000,Null,Null,263422208,111461,2971
263425399,0.0,0.0,370000,235000,135000,36,370000,Null,Null,263425399,63747,4452
263433314,0.0,0.0,579000,299000,280000,48,579000,Null,Null,263433314,361359,4593
263435573,0.0,0.0,108000,108000,0,0,108000,Null,Null,263435573,7324269,11861
263436105,0.0,0.0,80000,80000,0,0,80000,Null,Null,263436105,425489,28428
263436177,0.0,0.0,75000,75000,0,0,75000,Null,Null,263436177,7324269,11859
263436189,0.0,0.0,170000,170000,0,0,170000,Null,Null,263436189,27376,5900
263436255,0.0,0.0,359000,359000,0,0,359000,Null,Null,263436255,285975,11897
263436259,0.0,0.0,185000,111000,74000,40,185000,Null,Null,263436259,408385,11869
263436263,0.0,0.0,219000,219000,0,0,219000,Null,Null,263436263,111461,2971
263436476,0.0,0.0,6990000,4190000,2800000,40,6990000,Null,Null,263436476,112638,1794
263436480,0.0,0.0,238000,198000,40000,17,238000,Null,Null,263436480,486875,1752
263436485,0.0,0.0,419000,419000,0,0,419000,Null,Null,263436485,111461,23706
263436613,0.0,0.0,2450000,2281000,169000,7,2450000,Null,Null,263436613,19018,11833
263436648,0.0,0.0,2220,2220,0,0,2220,Null,Null,263436648,111461,23446
263436669,0.0,0.0,2719500,2719500,0,0,2719500,Null,Null,263436669,111461,6653
263436689,0.0,0.0,105450,105450,0,0,105450,Null,Null,263436689,111461,28434
263436695,0.0,0.0,377400,377400,0,0,377400,Null,Null,263436695,111461,6653
263436701,0.0,0.0,88800,88800,0,0,88800,Null,Null,263436701,111461,6653
263436711,0.0,0.0,333000,333000,0,0,333000,Null,Null,263436711,111461,28434
263436721,0.0,0.0,99900,99900,0,0,99900,Null,Null,263436721,111461,28716
263436725,0.0,0.0,399600,399600,0,0,399600,Null,Null,263436725,111461,6653
263436757,0.0,0.0,260850,260850,0,0,260850,Null,Null,263436757,111461,6653
263436794,0.0,0.0,1454100,1454100,0,0,1454100,Null,Null,263436794,111461,6653
263436808,0.0,0.0,31080,31080,0,0,31080,Null,Null,263436808,111461,6653
263436812,0.0,0.0,28860,28860,0,0,28860,Null,Null,263436812,111461,6653
263436826,0.0,0.0,3219000,3219000,0,0,3219000,Null,Null,263436826,111461,6653
263436878,0.0,0.0,170940,170940,0,0,170940,Null,Null,263436878,111461,6653
263436896,0.0,0.0,88800,88800,0,0,88800,Null,Null,263436896,111461,28434
263436927,0.0,0.0,271950,271950,0,0,271950,Null,Null,263436927,111461,6653
263436934,0.0,0.0,17205,17205,0,0,17205,Null,Null,263436934,111461,6653
263436936,0.0,0.0,2719500,2719500,0,0,2719500,Null,Null,263436936,111461,6653
263436938,0.0,0.0,30525,30525,0,0,30525,Null,Null,263436938,111461,6653
263436950,0.0,0.0,88800,88800,0,0,88800,Null,Null,263436950,111461,6653
263436954,0.0,0.0,32190,32190,0,0,32190,Null,Null,263436954,111461,6653
263436956,0.0,0.0,285270,285270,0,0,285270,Null,Null,263436956,111461,6653
263436963,0.0,0.0,1776000,1776000,0,0,1776000,Null,Null,263436963,111461,28716
263436981,0.0,0.0,15540,15540,0,0,15540,Null,Null,263436981,111461,6653
263436983,0.0,0.0,421800,421800,0,0,421800,Null,Null,263436983,111461,6653
263437029,0.0,0.0,194250,194250,0,0,194250,Null,Null,263437029,111461,6653
263437031,0.0,0.0,73260,73260,0,0,73260,Null,Null,263437031,111461,6653
263437190,0.0,0.0,99900,99900,0,0,99900,Null,Null,263437190,111461,8519
263437248,0.0,0.0,125000,125000,0,0,125000,Null,Null,263437248,111461,11877
263437267,0.0,0.0,15730000,15730000,0,0,15730000,Null,Null,263437267,111461,2340
263437272,0.0,0.0,15730000,15730000,0,0,15730000,Null,Null,263437272,111461,2340
263437320,0.0,0.0,129000,129000,0,0,129000,Null,Null,263437320,7324269,11877
263437448,0.0,0.0,189000,189000,0,0,189000,Null,Null,263437448,111461,28640
263437452,0.0,0.0,850000,850000,0,0,850000,Null,Null,263437452,8131421,2324
263437492,0.0,0.0,168110,168110,0,0,168110,Null,Null,263437492,111461,2
263437639,0.0,0.0,136000,136000,0,0,136000,Null,Null,263437639,8177907,3179
263437667,0.0,0.0,828000,828000,0,0,828000,Null,Null,263437667,111461,8400
263437708,0.0,0.0,129000,129000,0,0,129000,Null,Null,263437708,7324269,11859
263437740,0.0,0.0,2800000,2772000,28000,1,2800000,Null,Null,263437740,243693,3804
263437780,0.0,0.0,79000,79000,0,0,79000,Null,Null,263437780,288079,11879
263437978,0.0,0.0,212000,212000,0,0,212000,Null,Null,263437978,21651,28738
263438005,0.0,0.0,472000,472000,0,0,472000,Null,Null,263438005,246045,12918
263438008,0.0,0.0,2990000,1590000,1400000,47,2990000,Null,Null,263438008,112638,1795
263438014,0.0,0.0,92000,92000,0,0,92000,Null,Null,263438014,8177907,3179
263438044,0.0,0.0,70000,70000,0,0,70000,Null,Null,263438044,243107,28724
263438055,0.0,0.0,299000,299000,0,0,299000,Null,Null,263438055,8178267,3428
263438074,0.0,0.0,85000,85000,0,0,85000,Null,Null,263438074,7324269,11851
263438116,0.0,0.0,13050000,13050000,0,0,13050000,Null,Null,263438116,111461,7075
263438199,0.0,0.0,5990000,4390000,1600000,27,5990000,Null,Null,263438199,112638,1794
263438480,0.0,0.0,1200000,840000,360000,30,1200000,Null,Null,263438480,8196121,1612
263438501,0.0,0.0,299000,299000,0,0,299000,Null,Null,263438501,7324269,11859
263439870,0.0,0.0,22200000,22200000,0,0,22200000,Null,Null,263439870,111461,7075
263439901,0.0,0.0,168000,168000,0,0,168000,Null,Null,263439901,7516279,2347
263439998,0.0,0.0,39000,39000,0,0,39000,Null,Null,263439998,7324269,11873
263440021,0.0,0.0,158000,158000,0,0,158000,Null,Null,263440021,7516279,1613
263440161,0.0,0.0,13050000,13050000,0,0,13050000,Null,Null,263440161,111461,7075
263440189,0.0,0.0,85000,85000,0,0,85000,Null,Null,263440189,285975,11869
263440247,0.0,0.0,88000,88000,0,0,88000,Null,Null,263440247,285975,11859
263440265,20.0,20.0,59000,30000,29000,49,59000,Null,Null,263440265,74755,1520
263440343,0.0,0.0,125000,86000,39000,31,125000,Null,Null,263440343,8169233,1583
263440419,0.0,0.0,325000,325000,0,0,325000,Null,Null,263440419,243107,10413
263440462,0.0,0.0,1100000,770000,330000,30,1100000,Null,Null,263440462,8196121,53350
263440464,0.0,0.0,15000,10000,5000,33,15000,Null,Null,263440464,8169233,1601
263440616,25.0,25.0,559000,559000,0,0,559000,Null,Null,263440616,111461,1520
263440643,0.0,0.0,89000,79000,10000,11,89000,Null,Null,263440643,111461,20244
263440895,0.0,0.0,95000,95000,0,0,95000,Null,Null,263440895,111461,8223
263440952,0.0,0.0,159000,159000,0,0,159000,Null,Null,263440952,111461,8223
263440972,0.0,0.0,99000,99000,0,0,99000,Null,Null,263440972,111461,20244
263440986,0.0,0.0,1799000,1799000,0,0,1799000,Null,Null,263440986,8182151,12676
263440997,0.0,0.0,335093,335093,0,0,335093,Null,Null,263440997,53269,11857
263441017,0.0,0.0,95000,95000,0,0,95000,Null,Null,263441017,111461,23056
263441159,0.0,0.0,129000,99000,30000,23,129000,Null,Null,263441159,111461,20244
263441264,0.0,0.0,1799000,1799000,0,0,1799000,Null,Null,263441264,7415035,12676
263441266,0.0,0.0,230000,230000,0,0,230000,Null,Null,263441266,111461,15318
263441273,0.0,0.0,169000,139000,30000,18,169000,Null,Null,263441273,111461,20236
263441318,0.0,0.0,180000,180000,0,0,180000,Null,Null,263441318,111461,15318
263441461,0.0,0.0,206759,206759,0,0,206759,Null,Null,263441461,53269,11857
263441523,0.0,0.0,130000,130000,0,0,130000,Null,Null,263441523,111461,20244
263441586,0.0,0.0,69000,39000,30000,43,69000,Null,Null,263441586,111461,1622
263441644,0.0,0.0,382000,382000,0,0,382000,Null,Null,263441644,111461,2
263441673,0.0,0.0,56000,56000,0,0,56000,Null,Null,263441673,111461,2
263441675,0.0,0.0,580000,580000,0,0,580000,Null,Null,263441675,111461,2
263441686,0.0,0.0,108000,108000,0,0,108000,Null,Null,263441686,111461,2
263441693,0.0,0.0,469000,469000,0,0,469000,Null,Null,263441693,111461,2
263441707,0.0,0.0,1617000,1617000,0,0,1617000,Null,Null,263441707,111461,2
263441708,0.0,0.0,60000,60000,0,0,60000,Null,Null,263441708,111461,2
263441709,0.0,0.0,970000,970000,0,0,970000,Null,Null,263441709,111461,2
263441726,0.0,0.0,280000,280000,0,0,280000,Null,Null,263441726,111461,2
263441734,0.0,0.0,435000,435000,0,0,435000,Null,Null,263441734,111461,2
263441735,0.0,0.0,133000,133000,0,0,133000,Null,Null,263441735,111461,2
263441750,0.0,0.0,1190000,1190000,0,0,1190000,Null,Null,263441750,111461,2
263441768,0.0,0.0,2910000,2910000,0,0,2910000,Null,Null,263441768,111461,2
263441774,0.0,0.0,1355000,1355000,0,0,1355000,Null,Null,263441774,111461,2
263441780,0.0,0.0,300000,300000,0,0,300000,Null,Null,263441780,243107,2
263442880,0.0,0.0,130000,130000,0,0,130000,Null,Null,263442880,111461,20244
263443282,0.0,0.0,19000,19000,0,0,19000,Null,Null,263443282,111461,28576
263443322,0.0,0.0,11960000,5980000,5980000,50,11960000,Null,Null,263443322,111461,15318
263443369,0.0,0.0,280000,280000,0,0,280000,Null,Null,263443369,111461,15250
263443382,0.0,0.0,180000,180000,0,0,180000,Null,Null,263443382,111461,15318
263443459,0.0,0.0,80000,80000,0,0,80000,Null,Null,263443459,25697,28452
263443489,0.0,0.0,436944,436944,0,0,436944,Null,Null,263443489,53269,11857
263443493,0.0,0.0,139000,139000,0,0,139000,Null,Null,263443493,162313,28426
263443602,0.0,0.0,4880000,4880000,0,0,4880000,Null,Null,263443602,7982659,7449
263443619,0.0,0.0,19000,19000,0,0,19000,Null,Null,263443619,111461,28576
263443639,0.0,0.0,4980000,4980000,0,0,4980000,Null,Null,263443639,7982659,7449
263443641,0.0,0.0,327963,327963,0,0,327963,Null,Null,263443641,53269,11857
263443734,0.0,0.0,1199000,1199000,0,0,1199000,Null,Null,263443734,212267,28682
263443831,0.0,0.0,199000,169000,30000,15,199000,Null,Null,263443831,111461,20236
263443878,0.0,0.0,508241,508241,0,0,508241,Null,Null,263443878,53269,11857
263444637,0.0,0.0,201000,201000,0,0,201000,Null,Null,263444637,111461,12918
263444647,0.0,0.0,183000,183000,0,0,183000,Null,Null,263444647,208105,1583
263444683,0.0,0.0,580000,580000,0,0,580000,Null,Null,263444683,3806307,11821
263444691,0.0,0.0,98000,98000,0,0,98000,Null,Null,263444691,111461,12918
263444767,0.0,0.0,119000,69000,50000,42,119000,Null,Null,263444767,302375,1837
263444842,0.0,0.0,350000,350000,0,0,350000,Null,Null,263444842,3806307,11821
263444930,0.0,0.0,150000,90000,60000,40,150000,Null,Null,263444930,408385,11869
263445148,0.0,0.0,19000,19000,0,0,19000,Null,Null,263445148,111461,28576
263445174,0.0,0.0,950000,950000,0,0,950000,Null,Null,263445174,50446,11845
263445261,0.0,0.0,3000000,2389000,611000,20,3000000,Null,Null,263445261,49024,5566
263445288,0.0,0.0,56000,56000,0,0,56000,Null,Null,263445288,148535,12908
263445417,0.0,0.0,60000,36000,24000,40,60000,Null,Null,263445417,408385,11857
263445430,0.0,0.0,300000,199000,101000,34,300000,Null,Null,263445430,578915,12908
263445557,0.0,0.0,380000,380000,0,0,380000,Null,Null,263445557,111461,27230
263445565,0.0,0.0,295000,295000,0,0,295000,Null,Null,263445565,619971,11869
263445724,0.0,0.0,235000,235000,0,0,235000,Null,Null,263445724,619971,11869
263445794,0.0,0.0,950000,950000,0,0,950000,Null,Null,263445794,416127,1583
263445900,0.0,0.0,699000,699000,0,0,699000,Null,Null,263445900,212267,12928
263446016,0.0,0.0,500000,500000,0,0,500000,Null,Null,263446016,416127,53350
263446091,0.0,0.0,63000,63000,0,0,63000,Null,Null,263446091,111461,28458
263446253,0.0,0.0,279000,279000,0,0,279000,Null,Null,263446253,246045,28480
263446269,0.0,0.0,750000,750000,0,0,750000,Null,Null,263446269,212267,12928
263446324,0.0,0.0,99000,99000,0,0,99000,Null,Null,263446324,419129,28574
263446444,0.0,0.0,155000,155000,0,0,155000,Null,Null,263446444,111461,12908
263446530,0.0,0.0,137000,137000,0,0,137000,Null,Null,263446530,111461,12908
263446573,0.0,0.0,129000,129000,0,0,129000,Null,Null,263446573,166419,28574
263446606,0.0,0.0,19000,19000,0,0,19000,Null,Null,263446606,111461,28580
263446697,0.0,0.0,99000,99000,0,0,99000,Null,Null,263446697,111461,2324
263446865,0.0,0.0,129000,129000,0,0,129000,Null,Null,263446865,246045,1815
263447010,0.0,0.0,1068000,1068000,0,0,1068000,Null,Null,263447010,111461,2340
263447032,0.0,0.0,1068000,1068000,0,0,1068000,Null,Null,263447032,111461,2340
263447035,0.0,0.0,79000,79000,0,0,79000,Null,Null,263447035,111461,23184
263447040,0.0,0.0,89000,89000,0,0,89000,Null,Null,263447040,419129,28574
263447387,0.0,0.0,99000,99000,0,0,99000,Null,Null,263447387,419129,28574
263448191,0.0,0.0,123000,123000,0,0,123000,Null,Null,263448191,111461,2
263448217,0.0,0.0,235000,235000,0,0,235000,Null,Null,263448217,111461,2
263448224,0.0,0.0,189000,189000,0,0,189000,Null,Null,263448224,111461,2
263448262,0.0,0.0,455000,455000,0,0,455000,Null,Null,263448262,111461,2
263448271,0.0,0.0,311000,311000,0,0,311000,Null,Null,263448271,111461,2
263448288,0.0,0.0,165000,165000,0,0,165000,Null,Null,263448288,111461,2
263448310,0.0,0.0,675000,675000,0,0,675000,Null,Null,263448310,111461,2
263448313,0.0,0.0,169000,169000,0,0,169000,Null,Null,263448313,111461,2
263448320,0.0,0.0,195000,195000,0,0,195000,Null,Null,263448320,111461,2
263448357,0.0,0.0,500000,500000,0,0,500000,Null,Null,263448357,111461,2
263448413,0.0,0.0,92000,92000,0,0,92000,Null,Null,263448413,111461,2
263448416,0.0,0.0,255000,255000,0,0,255000,Null,Null,263448416,111461,2
263448433,0.0,0.0,39000,39000,0,0,39000,Null,Null,263448433,111461,2
263448478,0.0,0.0,435000,435000,0,0,435000,Null,Null,263448478,111461,2
263448491,0.0,0.0,169000,169000,0,0,169000,Null,Null,263448491,111461,2
263448513,0.0,0.0,179000,179000,0,0,179000,Null,Null,263448513,111461,2
263448547,0.0,0.0,470000,470000,0,0,470000,Null,Null,263448547,111461,2
263448559,0.0,0.0,174000,174000,0,0,174000,Null,Null,263448559,111461,2
263448572,0.0,0.0,160000,160000,0,0,160000,Null,Null,263448572,111461,2
263448574,0.0,0.0,165000,165000,0,0,165000,Null,Null,263448574,111461,2
263448583,0.0,0.0,285000,285000,0,0,285000,Null,Null,263448583,111461,2
263448665,0.0,0.0,259000,259000,0,0,259000,Null,Null,263448665,111461,2
263448672,0.0,0.0,3107000,2390000,717000,23,3107000,Null,Null,263448672,7426417,4381
263448687,0.0,0.0,199000,199000,0,0,199000,Null,Null,263448687,614727,9052
263448701,0.0,0.0,4990000,4990000,0,0,4990000,Null,Null,263448701,25422,1795
263448717,0.0,0.0,79000,79000,0,0,79000,Null,Null,263448717,111461,23184
263448722,0.0,0.0,86000,86000,0,0,86000,Null,Null,263448722,111461,3710
263448762,0.0,0.0,130000,130000,0,0,130000,Null,Null,263448762,111461,23184
263448798,0.0,0.0,69000,69000,0,0,69000,Null,Null,263448798,111461,2337
263448804,0.0,0.0,94000,94000,0,0,94000,Null,Null,263448804,21651,5006
263448817,0.0,0.0,19000,19000,0,0,19000,Null,Null,263448817,111461,28578
263448833,0.0,0.0,2587000,1990000,597000,23,2587000,Null,Null,263448833,7426417,4381
263448889,0.0,0.0,550000,550000,0,0,550000,Null,Null,263448889,111461,2
263448912,0.0,0.0,300000,300000,0,0,300000,Null,Null,263448912,111461,2
263448915,0.0,0.0,170000,170000,0,0,170000,Null,Null,263448915,111461,2
263448921,0.0,0.0,250000,250000,0,0,250000,Null,Null,263448921,111461,2
263448946,0.0,0.0,150000,150000,0,0,150000,Null,Null,263448946,111461,2
263448948,0.0,0.0,480000,480000,0,0,480000,Null,Null,263448948,111461,2
263448967,0.0,0.0,200000,200000,0,0,200000,Null,Null,263448967,111461,2
263448984,0.0,0.0,380000,380000,0,0,380000,Null,Null,263448984,111461,2
263449019,0.0,0.0,160000,160000,0,0,160000,Null,Null,263449019,111461,2
263449020,0.0,0.0,250000,250000,0,0,250000,Null,Null,263449020,111461,2
263449051,0.0,0.0,300000,300000,0,0,300000,Null,Null,263449051,111461,2
263449055,0.0,0.0,250000,250000,0,0,250000,Null,Null,263449055,111461,2
263449056,0.0,0.0,360000,360000,0,0,360000,Null,Null,263449056,111461,2
263449059,0.0,0.0,80000,80000,0,0,80000,Null,Null,263449059,111461,2
263449083,0.0,0.0,250000,250000,0,0,250000,Null,Null,263449083,111461,2
263449088,0.0,0.0,250000,250000,0,0,250000,Null,Null,263449088,111461,2
263449094,0.0,0.0,350000,350000,0,0,350000,Null,Null,263449094,111461,2
263449096,0.0,0.0,110000,110000,0,0,110000,Null,Null,263449096,111461,2
263449101,0.0,0.0,170000,170000,0,0,170000,Null,Null,263449101,111461,2
263449125,0.0,0.0,300000,300000,0,0,300000,Null,Null,263449125,111461,2
263449131,0.0,0.0,150000,150000,0,0,150000,Null,Null,263449131,111461,2
263449138,0.0,0.0,300000,300000,0,0,300000,Null,Null,263449138,111461,2
263449141,0.0,0.0,250000,250000,0,0,250000,Null,Null,263449141,111461,2
263449173,0.0,0.0,45000,45000,0,0,45000,Null,Null,263449173,111461,2
263449174,0.0,0.0,150000,150000,0,0,150000,Null,Null,263449174,111461,2
263449211,0.0,0.0,25000,25000,0,0,25000,Null,Null,263449211,111461,2
263449231,0.0,0.0,350000,350000,0,0,350000,Null,Null,263449231,111461,2
263449233,0.0,0.0,40000,40000,0,0,40000,Null,Null,263449233,111461,2
263449235,0.0,0.0,200000,200000,0,0,200000,Null,Null,263449235,111461,2
263449254,0.0,0.0,1200000,1200000,0,0,1200000,Null,Null,263449254,111461,2
263449259,0.0,0.0,200000,200000,0,0,200000,Null,Null,263449259,111461,2
263449262,0.0,0.0,180000,180000,0,0,180000,Null,Null,263449262,111461,2
263449297,0.0,0.0,550000,550000,0,0,550000,Null,Null,263449297,111461,2
263449421,0.0,0.0,250000,250000,0,0,250000,Null,Null,263449421,111461,2
263449454,0.0,0.0,160000,160000,0,0,160000,Null,Null,263449454,111461,2
263449500,0.0,0.0,200000,200000,0,0,200000,Null,Null,263449500,111461,2
263449529,0.0,0.0,200000,200000,0,0,200000,Null,Null,263449529,111461,2
263449575,0.0,0.0,300000,300000,0,0,300000,Null,Null,263449575,111461,2
263449596,0.0,0.0,250000,250000,0,0,250000,Null,Null,263449596,111461,2
263449599,0.0,0.0,200000,200000,0,0,200000,Null,Null,263449599,111461,2
263449610,0.0,0.0,200000,200000,0,0,200000,Null,Null,263449610,111461,2
263449617,0.0,0.0,1619000,1619000,0,0,1619000,Null,Null,263449617,111461,23706
263449631,0.0,0.0,350000,350000,0,0,350000,Null,Null,263449631,212267,1838
263449648,0.0,0.0,550000,550000,0,0,550000,Null,Null,263449648,111461,2
263449662,0.0,0.0,40000,40000,0,0,40000,Null,Null,263449662,111461,2
263449716,0.0,0.0,120000,120000,0,0,120000,Null,Null,263449716,111461,2
263449756,0.0,0.0,2327000,1790000,537000,23,2327000,Null,Null,263449756,7426417,4381
263449769,0.0,0.0,199000,109000,90000,45,199000,Null,Null,263449769,314675,1838
263449774,0.0,0.0,59000,59000,0,0,59000,Null,Null,263449774,614727,2514
263449796,0.0,0.0,345000,345000,0,0,345000,Null,Null,263449796,111461,2
263449807,0.0,0.0,198000,198000,0,0,198000,Null,Null,263449807,111461,2
263449841,0.0,0.0,530000,530000,0,0,530000,Null,Null,263449841,111461,2340
263449850,0.0,0.0,259000,259000,0,0,259000,Null,Null,263449850,111461,2
263449863,0.0,0.0,192000,192000,0,0,192000,Null,Null,263449863,111461,2
263449875,0.0,0.0,185000,185000,0,0,185000,Null,Null,263449875,111461,2
263449891,0.0,0.0,245000,245000,0,0,245000,Null,Null,263449891,111461,2
263449898,0.0,0.0,345000,345000,0,0,345000,Null,Null,263449898,111461,2
263449919,0.0,0.0,1650000,1650000,0,0,1650000,Null,Null,263449919,143976,23236
263449921,0.0,0.0,2587000,1990000,597000,23,2587000,Null,Null,263449921,7426417,4381
263449926,0.0,0.0,49000,49000,0,0,49000,Null,Null,263449926,614727,2514
263449984,0.0,0.0,60000,60000,0,0,60000,Null,Null,263449984,111461,2
263450218,0.0,0.0,420000,420000,0,0,420000,Null,Null,263450218,111461,2
263450276,0.0,0.0,169000,169000,0,0,169000,Null,Null,263450276,111461,23184
263450358,0.0,0.0,89000,89000,0,0,89000,Null,Null,263450358,614727,2514
263450360,0.0,0.0,2717000,2717000,0,0,2717000,Null,Null,263450360,7426417,4381
263450367,0.0,0.0,1500000,948001,551999,37,1500000,Null,Null,263450367,111461,23112
263450386,0.0,0.0,12000,12000,0,0,12000,Null,Null,263450386,111461,15320
263450411,0.0,0.0,550000,550000,0,0,550000,Null,Null,263450411,111461,2225
263450440,0.0,0.0,119000,119000,0,0,119000,Null,Null,263450440,111461,23010
263450448,0.0,0.0,1937000,1490000,447000,23,1937000,Null,Null,263450448,7426417,4381
263450498,0.0,0.0,119000,119000,0,0,119000,Null,Null,263450498,111461,23184
263450500,0.0,0.0,52900,52900,0,0,52900,Null,Null,263450500,111461,23246
263450509,0.0,0.0,229000,159000,70000,31,229000,Null,Null,263450509,314675,28732
263450513,0.0,0.0,125000,125000,0,0,125000,Null,Null,263450513,614727,2514
263450542,0.0,0.0,49000,49000,0,0,49000,Null,Null,263450542,111461,2016
263450549,0.0,0.0,49000,49000,0,0,49000,Null,Null,263450549,111461,2016
263450551,0.0,0.0,169000,169000,0,0,169000,Null,Null,263450551,111461,23184
263450555,0.0,0.0,6669000,6669000,0,0,6669000,Null,Null,263450555,111461,27196
263450561,0.0,0.0,70000,70000,0,0,70000,Null,Null,263450561,159799,23508
263450598,0.0,0.0,4000000,2648022,1351978,34,4000000,Null,Null,263450598,111461,23112
263450604,0.0,0.0,2717000,2717000,0,0,2717000,Null,Null,263450604,7426417,4381
263450712,0.0,0.0,259000,259000,0,0,259000,Null,Null,263450712,111461,2019
263450808,0.0,0.0,259000,259000,0,0,259000,Null,Null,263450808,111461,2019
263450813,0.0,0.0,1600000,1050000,550000,34,1600000,Null,Null,263450813,46007,53350
263450815,0.0,0.0,3290000,3290000,0,0,3290000,Null,Null,263450815,111461,23600
263450852,0.0,0.0,29000000,29000000,0,0,29000000,Null,Null,263450852,624041,2324
263450854,0.0,0.0,129000,129000,0,0,129000,Null,Null,263450854,111461,2324
263450883,0.0,0.0,4147000,3190000,957000,23,4147000,Null,Null,263450883,7426417,4381
263450896,0.0,0.0,99900,99900,0,0,99900,Null,Null,263450896,111461,2016
263450913,0.0,0.0,99900,99900,0,0,99900,Null,Null,263450913,111461,2016
263450917,0.0,0.0,495000,495000,0,0,495000,Null,Null,263450917,111461,27230
263450946,0.0,0.0,68000,68000,0,0,68000,Null,Null,263450946,4825271,2511
263450948,0.0,0.0,570000,570000,0,0,570000,Null,Null,263450948,111461,2225
263450952,0.0,0.0,1157000,890000,267000,23,1157000,Null,Null,263450952,7426417,4381
263450987,0.0,0.0,6990000,6990000,0,0,6990000,Null,Null,263450987,25422,1795
263450998,0.0,0.0,142000,142000,0,0,142000,Null,Null,263450998,111461,23416
263451002,0.0,0.0,8000,8000,0,0,8000,Null,Null,263451002,111461,3710
263451222,0.0,0.0,3290000,3290000,0,0,3290000,Null,Null,263451222,111461,23600
263451245,0.0,0.0,1079000,830000,249000,23,1079000,Null,Null,263451245,7426417,4381
263451270,0.0,0.0,95000,65000,30000,32,95000,Null,Null,263451270,922779,11859
263451275,0.0,0.0,1950000,1950000,0,0,1950000,Null,Null,263451275,143976,23236
263451292,0.0,0.0,1117000,859000,258000,23,1117000,Null,Null,263451292,7426417,4381
263451303,0.0,0.0,69000,69000,0,0,69000,Null,Null,263451303,111461,2
263451313,0.0,0.0,35000,35000,0,0,35000,Null,Null,263451313,111461,2
263451329,0.0,0.0,35000,35000,0,0,35000,Null,Null,263451329,111461,2
263451332,0.0,0.0,50000,50000,0,0,50000,Null,Null,263451332,111461,2
263451346,0.0,0.0,25000,25000,0,0,25000,Null,Null,263451346,111461,2
263451429,0.0,0.0,14500000,14500000,0,0,14500000,Null,Null,263451429,624041,2324
263451444,0.0,0.0,5998000,5998000,0,0,5998000,Null,Null,263451444,111461,27196
263451452,0.0,0.0,2150000,2150000,0,0,2150000,Null,Null,263451452,143976,23236
263451455,0.0,0.0,69000,69000,0,0,69000,Null,Null,263451455,111461,6305
263451462,0.0,0.0,800000,800000,0,0,800000,Null,Null,263451462,5390495,4428
263451487,0.0,0.0,1417000,1090000,327000,23,1417000,Null,Null,263451487,7426417,4381
263451525,0.0,0.0,1677000,1290000,387000,23,1677000,Null,Null,263451525,7426417,4381
263451528,0.0,0.0,99000,99000,0,0,99000,Null,Null,263451528,111461,23276
263451530,0.0,0.0,14500000,14500000,0,0,14500000,Null,Null,263451530,624041,2324
263451534,0.0,0.0,859000,579000,280000,33,859000,Null,Null,263451534,314675,28454
263451536,0.0,0.0,10000,10000,0,0,10000,Null,Null,263451536,111461,23416
263451578,0.0,0.0,1547000,1190000,357000,23,1547000,Null,Null,263451578,7426417,4381
263451582,0.0,0.0,835000,835000,0,0,835000,Null,Null,263451582,111461,23706
263451597,0.0,0.0,790000,790000,0,0,790000,Null,Null,263451597,111461,2225
263451599,0.0,0.0,1758000,1758000,0,0,1758000,Null,Null,263451599,111461,4381
263451615,0.0,0.0,329000,329000,0,0,329000,Null,Null,263451615,578915,28460
263451630,0.0,0.0,1885000,1450000,435000,23,1885000,Null,Null,263451630,7426417,4381
263451649,0.0,0.0,36000,36000,0,0,36000,Null,Null,263451649,111461,3710
263451775,0.0,0.0,149000,149000,0,0,149000,Null,Null,263451775,7324269,11879
263451783,0.0,0.0,8300000,8300000,0,0,8300000,Null,Null,263451783,624041,2324
263451812,0.0,0.0,59000,59000,0,0,59000,Null,Null,263451812,111461,8167
263451821,0.0,0.0,123000,98000,25000,20,123000,Null,Null,263451821,4825271,23282
263451828,0.0,0.0,5750000,5750000,0,0,5750000,Null,Null,263451828,885749,8512
263451833,0.0,0.0,55000,55000,0,0,55000,Null,Null,263451833,111461,8167
263451853,0.0,0.0,1157000,890000,267000,23,1157000,Null,Null,263451853,7426417,4381
263451863,0.0,0.0,159000,138000,21000,13,159000,Null,Null,263451863,205463,3175
263451865,0.0,0.0,201000,201000,0,0,201000,Null,Null,263451865,111461,12918
263451867,0.0,0.0,99000,99000,0,0,99000,Null,Null,263451867,111461,8167
263451890,0.0,0.0,930000,930000,0,0,930000,Null,Null,263451890,111461,2225
263451893,0.0,0.0,929000,715000,214000,23,929000,Null,Null,263451893,7426417,4381
263451895,0.0,0.0,2000,1000,1000,50,2000,Null,Null,263451895,111461,23112
263451953,0.0,0.0,1368000,1368000,0,0,1368000,Null,Null,263451953,111461,23706
263451955,0.0,0.0,86000,86000,0,0,86000,Null,Null,263451955,111461,3710
263452065,0.0,0.0,430000,399000,31000,7,430000,Null,Null,263452065,922779,11863
263452069,6.0,6.0,250000,250000,0,0,250000,Null,Null,263452069,497893,1883
263452102,0.0,0.0,1417000,1090000,327000,23,1417000,Null,Null,263452102,7426417,4381
263452104,0.0,0.0,650000,650000,0,0,650000,Null,Null,263452104,111461,23276
263452118,0.0,0.0,19000,19000,0,0,19000,Null,Null,263452118,111461,2266
263452130,0.0,0.0,119000,119000,0,0,119000,Null,Null,263452130,21653,12908
263452137,0.0,0.0,225000,195000,30000,13,225000,Null,Null,263452137,205463,3175
263452175,0.0,0.0,1311000,1009000,302000,23,1311000,Null,Null,263452175,7426417,4381
263452186,0.0,0.0,79000,79000,0,0,79000,Null,Null,263452186,7324269,11859
263452197,0.0,0.0,730000,730000,0,0,730000,Null,Null,263452197,111461,2225
263452200,0.0,0.0,1199000,923000,276000,23,1199000,Null,Null,263452200,7426417,4381
263452202,0.0,0.0,65000,65000,0,0,65000,Null,Null,263452202,111461,18888
263452277,0.0,0.0,215000,215000,0,0,215000,Null,Null,263452277,111461,12918
263452639,0.0,0.0,1896000,1459000,437000,23,1896000,Null,Null,263452639,7426417,4381
263452681,0.0,0.0,11000000,11000000,0,0,11000000,Null,Null,263452681,885749,8512
263452683,0.0,0.0,2789000,2789000,0,0,2789000,Null,Null,263452683,111461,27196
263452708,0.0,0.0,141000,141000,0,0,141000,Null,Null,263452708,111461,12918
263452717,0.0,0.0,413000,413000,0,0,413000,Null,Null,263452717,111461,2
263452734,0.0,0.0,1650000,1650000,0,0,1650000,Null,Null,263452734,8194921,11935
263452988,0.0,0.0,209000,209000,0,0,209000,Null,Null,263452988,246045,28482
263452992,0.0,0.0,79000,79000,0,0,79000,Null,Null,263452992,111461,28458
263452997,0.0,0.0,1727000,1329000,398000,23,1727000,Null,Null,263452997,7426417,4381
263453000,0.0,0.0,33000,33000,0,0,33000,Null,Null,263453000,7324269,11873
263453004,0.0,0.0,19000,19000,0,0,19000,Null,Null,263453004,111461,23416
263453028,0.0,0.0,199000,101000,98000,49,199000,Null,Null,263453028,314675,28682
263453055,0.0,0.0,1896000,1459000,437000,23,1896000,Null,Null,263453055,7426417,4381
263453057,0.0,0.0,412000,412000,0,0,412000,Null,Null,263453057,111461,2
263453058,0.0,0.0,312000,312000,0,0,312000,Null,Null,263453058,111461,2
263453060,0.0,0.0,5000000,5000000,0,0,5000000,Null,Null,263453060,152820,11856
263453068,0.0,0.0,350000,350000,0,0,350000,Null,Null,263453068,111461,2
263453077,0.0,0.0,1210000,1210000,0,0,1210000,Null,Null,263453077,111461,23236
263453150,0.0,0.0,58000,58000,0,0,58000,Null,Null,263453150,111461,23416
263453159,0.0,0.0,52000,52000,0,0,52000,Null,Null,263453159,7324269,11873
263453163,0.0,0.0,349000,349000,0,0,349000,Null,Null,263453163,204385,12908
263453166,0.0,0.0,1787000,1375000,412000,23,1787000,Null,Null,263453166,7426417,4381
263453198,0.0,0.0,980000,980000,0,0,980000,Null,Null,263453198,8194921,11935
263453200,0.0,0.0,8000,8000,0,0,8000,Null,Null,263453200,111461,3710
263453327,0.0,0.0,412000,412000,0,0,412000,Null,Null,263453327,111461,2
263453329,0.0,0.0,350000,350000,0,0,350000,Null,Null,263453329,111461,2
263453355,0.0,0.0,285000,285000,0,0,285000,Null,Null,263453355,41010,1583
263453371,0.0,0.0,114500,114500,0,0,114500,Null,Null,263453371,111461,2154
263453381,0.0,0.0,90000,90000,0,0,90000,Null,Null,263453381,285975,11859
263453400,0.0,0.0,999000,999000,0,0,999000,Null,Null,263453400,8194921,11935
263453419,0.0,0.0,280000,280000,0,0,280000,Null,Null,263453419,111461,23058
263453436,0.0,0.0,675000,675000,0,0,675000,Null,Null,263453436,111461,27196
263453475,0.0,0.0,84000,84000,0,0,84000,Null,Null,263453475,111461,23416
263453485,0.0,0.0,92000,92000,0,0,92000,Null,Null,263453485,285975,11869
263453487,0.0,0.0,415000,415000,0,0,415000,Null,Null,263453487,41010,2347
263453489,0.0,0.0,36000,36000,0,0,36000,Null,Null,263453489,111461,3710
263453641,0.0,0.0,99000,99000,0,0,99000,Null,Null,263453641,26675,28452
263453671,0.0,0.0,5579000,5579000,0,0,5579000,Null,Null,263453671,111461,27196
263453673,0.0,0.0,355000,355000,0,0,355000,Null,Null,263453673,41010,53350
263453675,0.0,0.0,65000,65000,0,0,65000,Null,Null,263453675,111461,23036
263453702,0.0,0.0,765600,765600,0,0,765600,Null,Null,263453702,220959,2514
263453704,0.0,0.0,72000,72000,0,0,72000,Null,Null,263453704,285975,11857
263453709,0.0,0.0,395000,248850,146150,37,395000,Null,Null,263453709,111461,23112
263453730,0.0,0.0,95000,95000,0,0,95000,Null,Null,263453730,111461,1934
263453737,0.0,0.0,450000,450000,0,0,450000,Null,Null,263453737,41010,17170
263453752,0.0,0.0,199000,199000,0,0,199000,Null,Null,263453752,111461,1520
263453778,0.0,0.0,189000,189000,0,0,189000,Null,Null,263453778,111461,1520
263453846,0.0,0.0,1005000,1005000,0,0,1005000,Null,Null,263453846,111461,23706
263453848,0.0,0.0,169000,169000,0,0,169000,Null,Null,263453848,26675,28452
263453860,0.0,0.0,119000,119000,0,0,119000,Null,Null,263453860,111461,1634
263453871,0.0,0.0,149000,149000,0,0,149000,Null,Null,263453871,111461,2
263453879,0.0,0.0,1450000,1450000,0,0,1450000,Null,Null,263453879,111461,27196
263453898,0.0,0.0,350000,350000,0,0,350000,Null,Null,263453898,111461,3990
263453900,0.0,0.0,150000,150000,0,0,150000,Null,Null,263453900,111461,27128
263453942,0.0,0.0,18000,18000,0,0,18000,Null,Null,263453942,111461,23134
263453951,0.0,0.0,53000,53000,0,0,53000,Null,Null,263453951,285975,11875
263454027,0.0,0.0,46000,46000,0,0,46000,Null,Null,263454027,111461,1883
263454040,0.0,0.0,86000,86000,0,0,86000,Null,Null,263454040,111461,3710
263454155,0.0,0.0,70000,70000,0,0,70000,Null,Null,263454155,111461,23334
263454157,0.0,0.0,3900000,3900000,0,0,3900000,Null,Null,263454157,111461,3990
263454159,0.0,0.0,70000,38506,31494,45,70000,Null,Null,263454159,111461,23112
263454163,0.0,0.0,89000,89000,0,0,89000,Null,Null,263454163,111461,3877
263454166,0.0,0.0,113000,113000,0,0,113000,Null,Null,263454166,111461,23362
263454187,0.0,0.0,3090000,3090000,0,0,3090000,Null,Null,263454187,25422,1795
263454231,0.0,0.0,96000,96000,0,0,96000,Null,Null,263454231,285975,11869
263454233,0.0,0.0,89000,89000,0,0,89000,Null,Null,263454233,111461,3877
263454235,0.0,0.0,6025000,6025000,0,0,6025000,Null,Null,263454235,111461,27196
263454238,0.0,0.0,960000,960000,0,0,960000,Null,Null,263454238,8196232,11911
263454247,0.0,0.0,1154400,1154400,0,0,1154400,Null,Null,263454247,111461,2
263454248,0.0,0.0,1650000,1650000,0,0,1650000,Null,Null,263454248,111461,2
263454251,0.0,0.0,1600000,1600000,0,0,1600000,Null,Null,263454251,111461,2
263454252,0.0,0.0,1349000,1349000,0,0,1349000,Null,Null,263454252,111461,2
263454259,0.0,0.0,2805000,2805000,0,0,2805000,Null,Null,263454259,111461,2
263454263,0.0,0.0,1500000,1500000,0,0,1500000,Null,Null,263454263,111461,2
263454274,0.0,0.0,699000,699000,0,0,699000,Null,Null,263454274,111461,2
263454278,0.0,0.0,1358400,1358400,0,0,1358400,Null,Null,263454278,111461,2
263454293,0.0,0.0,890000,890000,0,0,890000,Null,Null,263454293,111461,2
263454294,0.0,0.0,1528000,1528000,0,0,1528000,Null,Null,263454294,111461,2
263454307,0.0,0.0,981400,981400,0,0,981400,Null,Null,263454307,111461,2
263454308,0.0,0.0,849000,849000,0,0,849000,Null,Null,263454308,111461,2
263454323,0.0,0.0,106960,106960,0,0,106960,Null,Null,263454323,111461,2
263454336,0.0,0.0,119000,119000,0,0,119000,Null,Null,263454336,111461,2
263454357,0.0,0.0,6900000,6900000,0,0,6900000,Null,Null,263454357,111461,2
263454359,0.0,0.0,198900,198900,0,0,198900,Null,Null,263454359,111461,2
263454366,0.0,0.0,1980000,1980000,0,0,1980000,Null,Null,263454366,111461,2
263454395,0.0,0.0,40000,40000,0,0,40000,Null,Null,263454395,285975,11875
263454458,0.0,0.0,7000,7000,0,0,7000,Null,Null,263454458,111461,23416
263454541,0.0,0.0,3550000,3550000,0,0,3550000,Null,Null,263454541,111461,4381
263454557,0.0,0.0,130000,83300,46700,36,130000,Null,Null,263454557,111461,23112
263454581,0.0,0.0,3900000,3900000,0,0,3900000,Null,Null,263454581,111461,3990
263454631,0.0,0.0,3890000,3890000,0,0,3890000,Null,Null,263454631,111461,23600
263454662,0.0,0.0,55000,55000,0,0,55000,Null,Null,263454662,25697,28452
263454699,0.0,0.0,3900000,3900000,0,0,3900000,Null,Null,263454699,111461,3990
263454746,0.0,0.0,1431596,1431596,0,0,1431596,Null,Null,263454746,223741,53190
263455133,0.0,0.0,160000,160000,0,0,160000,Null,Null,263455133,111461,3990
263455199,0.0,0.0,2900,2900,0,0,2900,Null,Null,263455199,111461,23058
263455201,0.0,0.0,620000,620000,0,0,620000,Null,Null,263455201,111461,2
263455208,0.0,0.0,900000,900000,0,0,900000,Null,Null,263455208,111461,2
263455209,0.0,0.0,900000,900000,0,0,900000,Null,Null,263455209,111461,2
263455215,0.0,0.0,780000,780000,0,0,780000,Null,Null,263455215,111461,2
263455217,0.0,0.0,900000,900000,0,0,900000,Null,Null,263455217,111461,2
263455226,0.0,0.0,690000,690000,0,0,690000,Null,Null,263455226,5207367,2784
263455267,0.0,0.0,380000,288200,91800,24,380000,Null,Null,263455267,111461,23112
263455286,0.0,0.0,85000,85000,0,0,85000,Null,Null,263455286,111461,28722
263455359,0.0,0.0,118000,118000,0,0,118000,Null,Null,263455359,285975,11859
263455439,0.0,0.0,98000,98000,0,0,98000,Null,Null,263455439,285975,11869
263455489,0.0,0.0,98000,98000,0,0,98000,Null,Null,263455489,285975,11861
263455497,0.0,0.0,235000,235000,0,0,235000,Null,Null,263455497,111461,12590
263455502,0.0,0.0,3900000,3900000,0,0,3900000,Null,Null,263455502,111461,3990
263455729,0.0,0.0,93000,93000,0,0,93000,Null,Null,263455729,21651,12294
263455754,0.0,0.0,4255000,3990000,265000,6,4255000,Null,Null,263455754,5347313,8066
263455757,0.0,0.0,390000,390000,0,0,390000,Null,Null,263455757,221187,1613
263455759,0.0,0.0,219000,219000,0,0,219000,Null,Null,263455759,199043,53350
263455783,0.0,0.0,300000,300000,0,0,300000,Null,Null,263455783,221187,1616
263455798,0.0,0.0,520000,520000,0,0,520000,Null,Null,263455798,221187,8223
263455801,0.0,0.0,980000,691011,288989,29,980000,Null,Null,263455801,111461,23112
263455815,0.0,0.0,55000,55000,0,0,55000,Null,Null,263455815,25277,28452
263455830,3.0,3.0,17000,17000,0,0,17000,Null,Null,263455830,111461,1883
263455834,0.0,0.0,23900,23900,0,0,23900,Null,Null,263455834,111461,23022
263455855,0.0,0.0,55000,55000,0,0,55000,Null,Null,263455855,25277,28452
263455912,0.0,0.0,4600000,4600000,0,0,4600000,Null,Null,263455912,111461,3990
263455917,0.0,0.0,55000,55000,0,0,55000,Null,Null,263455917,25697,28452
263455939,0.0,0.0,3590000,3590000,0,0,3590000,Null,Null,263455939,111461,23622
263455958,0.0,0.0,2900000,2900000,0,0,2900000,Null,Null,263455958,111461,3990
263455960,0.0,0.0,55000,55000,0,0,55000,Null,Null,263455960,25697,28452
263455973,0.0,0.0,55000,55000,0,0,55000,Null,Null,263455973,25697,28452
263455982,0.0,0.0,250000,250000,0,0,250000,Null,Null,263455982,221187,13878
263455984,0.0,0.0,460000,460000,0,0,460000,Null,Null,263455984,221187,13878
263455986,0.0,0.0,4600000,4600000,0,0,4600000,Null,Null,263455986,111461,3990
263455988,0.0,0.0,97000,97000,0,0,97000,Null,Null,263455988,111461,53190
263456009,0.0,0.0,4600000,4600000,0,0,4600000,Null,Null,263456009,111461,3990
263456089,0.0,0.0,12900000,12900000,0,0,12900000,Null,Null,263456089,207075,2136
263456134,0.0,0.0,129000,129000,0,0,129000,Null,Null,263456134,111461,23184
263456136,0.0,0.0,58000,58000,0,0,58000,Null,Null,263456136,111461,27214
263456139,0.0,0.0,140000,140000,0,0,140000,Null,Null,263456139,5220265,53350
263456144,0.0,0.0,129000,129000,0,0,129000,Null,Null,263456144,111461,23184
263456152,0.0,0.0,385000,385000,0,0,385000,Null,Null,263456152,48077,1936
263456200,0.0,0.0,10500000,10500000,0,0,10500000,Null,Null,263456200,207075,2136
263456203,0.0,0.0,165000,165000,0,0,165000,Null,Null,263456203,111461,23362
263456227,0.0,0.0,165000,165000,0,0,165000,Null,Null,263456227,111461,23362
263456302,0.0,0.0,165000,165000,0,0,165000,Null,Null,263456302,111461,23362
263456347,0.0,0.0,165000,165000,0,0,165000,Null,Null,263456347,111461,23362
263456373,0.0,0.0,165000,165000,0,0,165000,Null,Null,263456373,111461,23362
263456375,0.0,0.0,340000,340000,0,0,340000,Null,Null,263456375,5220265,53350
263456379,0.0,0.0,199999,199999,0,0,199999,Null,Null,263456379,111461,2
263456434,0.0,0.0,148500,148500,0,0,148500,Null,Null,263456434,111461,2
263456437,0.0,0.0,113850,113850,0,0,113850,Null,Null,263456437,111461,2
263456450,0.0,0.0,82500,82500,0,0,82500,Null,Null,263456450,111461,2
263456488,0.0,0.0,33000,33000,0,0,33000,Null,Null,263456488,111461,2
263456505,0.0,0.0,219000,219000,0,0,219000,Null,Null,263456505,199043,53350
263456509,0.0,0.0,199999,199999,0,0,199999,Null,Null,263456509,111461,2
263456518,0.0,0.0,273900,273900,0,0,273900,Null,Null,263456518,111461,2
263456520,0.0,0.0,14000,14000,0,0,14000,Null,Null,263456520,111461,6948
263456525,0.0,0.0,0,104500,0,0,104500,Null,Null,263456525,111461,0
263456530,0.0,0.0,277508,277508,0,0,277508,Null,Null,263456530,111461,2
263456539,0.0,0.0,42900,42900,0,0,42900,Null,Null,263456539,111461,2
263456550,0.0,0.0,99000,99000,0,0,99000,Null,Null,263456550,111461,2154
263456559,0.0,0.0,85800,85800,0,0,85800,Null,Null,263456559,111461,2
263456568,0.0,0.0,126597,126597,0,0,126597,Null,Null,263456568,111461,2
263456570,0.0,0.0,143000,143000,0,0,143000,Null,Null,263456570,111461,2
263456576,0.0,0.0,346446,346446,0,0,346446,Null,Null,263456576,111461,2
263456583,0.0,0.0,94285,94285,0,0,94285,Null,Null,263456583,111461,2
263456723,0.0,0.0,49500,49500,0,0,49500,Null,Null,263456723,111461,2
263456734,0.0,0.0,93500,93500,0,0,93500,Null,Null,263456734,111461,2
263456736,0.0,0.0,110000,110000,0,0,110000,Null,Null,263456736,111461,2
263456738,0.0,0.0,93500,93500,0,0,93500,Null,Null,263456738,111461,2
263456747,0.0,0.0,41329,41329,0,0,41329,Null,Null,263456747,111461,2
263456770,13.0,13.0,200000,100000,100000,50,200000,Null,Null,263456770,48077,1883
263456784,0.0,0.0,35500,35500,0,0,35500,Null,Null,263456784,111461,28574
263456791,0.0,0.0,890000,890000,0,0,890000,Null,Null,263456791,111461,2225
263456794,0.0,0.0,39000,39000,0,0,39000,Null,Null,263456794,111461,2
263456796,0.0,0.0,115088,115088,0,0,115088,Null,Null,263456796,111461,2
263456798,0.0,0.0,38000,38000,0,0,38000,Null,Null,263456798,111461,2
263456800,0.0,0.0,45000,45000,0,0,45000,Null,Null,263456800,111461,2
263456806,0.0,0.0,100000,100000,0,0,100000,Null,Null,263456806,111461,2
263456808,0.0,0.0,130000,130000,0,0,130000,Null,Null,263456808,111461,2
263456810,0.0,0.0,75000,75000,0,0,75000,Null,Null,263456810,111461,2
263456847,0.0,0.0,139000,139000,0,0,139000,Null,Null,263456847,111461,2
263456855,0.0,0.0,44000,44000,0,0,44000,Null,Null,263456855,111461,2
263456864,0.0,0.0,78000,78000,0,0,78000,Null,Null,263456864,111461,2
263456893,0.0,0.0,0,95000,0,0,95000,Null,Null,263456893,111461,0
263456900,0.0,0.0,130000,130000,0,0,130000,Null,Null,263456900,111461,2
263456909,0.0,0.0,228600,228600,0,0,228600,Null,Null,263456909,111461,2
263456913,0.0,0.0,155000,155000,0,0,155000,Null,Null,263456913,111461,2
263459089,0.0,0.0,40099,40099,0,0,40099,Null,Null,263459089,111461,2
263459096,0.0,0.0,85000,85000,0,0,85000,Null,Null,263459096,111461,2
263459102,0.0,0.0,150000,150000,0,0,150000,Null,Null,263459102,111461,2
263459115,0.0,0.0,70000,70000,0,0,70000,Null,Null,263459115,111461,2
263459134,0.0,0.0,290000,290000,0,0,290000,Null,Null,263459134,111461,2
263459144,0.0,0.0,158000,158000,0,0,158000,Null,Null,263459144,111461,2
263459146,0.0,0.0,0,98000,0,0,98000,Null,Null,263459146,111461,0
263459162,0.0,0.0,90800,90800,0,0,90800,Null,Null,263459162,111461,2
263459164,0.0,0.0,290000,290000,0,0,290000,Null,Null,263459164,111461,2
263459166,0.0,0.0,44800,44800,0,0,44800,Null,Null,263459166,111461,2
263459211,0.0,0.0,399000,399000,0,0,399000,Null,Null,263459211,111461,2266
263459233,0.0,0.0,0,45482,0,0,45482,Null,Null,263459233,111461,0
263459258,0.0,0.0,518000,518000,0,0,518000,Null,Null,263459258,111461,2
263459264,0.0,0.0,50000,50000,0,0,50000,Null,Null,263459264,111461,2
263459266,0.0,0.0,159600,159600,0,0,159600,Null,Null,263459266,111461,2
263459268,0.0,0.0,0,270000,0,0,270000,Null,Null,263459268,111461,0
263459376,0.0,0.0,86700,86700,0,0,86700,Null,Null,263459376,111461,2
263459627,0.0,0.0,12000,12000,0,0,12000,Null,Null,263459627,111461,5450
263460030,0.0,0.0,969781,969781,0,0,969781,Null,Null,263460030,111461,2
263461406,0.0,0.0,980000,980000,0,0,980000,Null,Null,263461406,111461,2
263464028,0.0,0.0,85714,85714,0,0,85714,Null,Null,263464028,111461,2
263465249,0.0,0.0,85000,85000,0,0,85000,Null,Null,263465249,111461,2
263465737,0.0,0.0,37572,37572,0,0,37572,Null,Null,263465737,111461,2
263465940,0.0,0.0,117000,117000,0,0,117000,Null,Null,263465940,111461,2
263465942,0.0,0.0,468000,468000,0,0,468000,Null,Null,263465942,111461,2
263465961,0.0,0.0,78000,78000,0,0,78000,Null,Null,263465961,111461,2
263465963,0.0,0.0,90000,90000,0,0,90000,Null,Null,263465963,111461,2
263465968,0.0,0.0,38400,38400,0,0,38400,Null,Null,263465968,111461,2
263466022,0.0,0.0,59900,59900,0,0,59900,Null,Null,263466022,111461,2
263466041,0.0,0.0,450000,450000,0,0,450000,Null,Null,263466041,111461,2
263466066,0.0,0.0,650000,559000,91000,14,650000,Null,Null,263466066,111461,23660
263466081,0.0,0.0,158000,158000,0,0,158000,Null,Null,263466081,111461,2
263466084,0.0,0.0,63000,63000,0,0,63000,Null,Null,263466084,111461,2
263466090,0.0,0.0,480000,480000,0,0,480000,Null,Null,263466090,111461,2
263466098,0.0,0.0,68310,68310,0,0,68310,Null,Null,263466098,111461,2
263466100,0.0,0.0,18000,18000,0,0,18000,Null,Null,263466100,111461,23042
263466141,0.0,0.0,78000,78000,0,0,78000,Null,Null,263466141,111461,2
263466158,0.0,0.0,216000,216000,0,0,216000,Null,Null,263466158,111461,2
263466164,0.0,0.0,117000,117000,0,0,117000,Null,Null,263466164,111461,2
263466166,0.0,0.0,60000,60000,0,0,60000,Null,Null,263466166,111461,2
263466233,0.0,0.0,90000,90000,0,0,90000,Null,Null,263466233,111461,2
263466237,0.0,0.0,57600,57600,0,0,57600,Null,Null,263466237,111461,2
263466242,0.0,0.0,2500,2500,0,0,2500,Null,Null,263466242,111461,27180
263466266,0.0,0.0,7000,7000,0,0,7000,Null,Null,263466266,111461,2337
263466276,0.0,0.0,40000,40000,0,0,40000,Null,Null,263466276,111461,2
263466278,0.0,0.0,260000,260000,0,0,260000,Null,Null,263466278,111461,2
263466284,0.0,0.0,65000,65000,0,0,65000,Null,Null,263466284,111461,2
263466286,0.0,0.0,50000,50000,0,0,50000,Null,Null,263466286,111461,2
263466288,0.0,0.0,35000,35000,0,0,35000,Null,Null,263466288,111461,2
263466323,0.0,0.0,50000,50000,0,0,50000,Null,Null,263466323,111461,2
263466332,0.0,0.0,65000,65000,0,0,65000,Null,Null,263466332,111461,2
263466334,0.0,0.0,240000,240000,0,0,240000,Null,Null,263466334,111461,2
263466336,0.0,0.0,33000,33000,0,0,33000,Null,Null,263466336,111461,2
263466340,0.0,0.0,65000,65000,0,0,65000,Null,Null,263466340,111461,2
263466368,0.0,0.0,0,39645,0,0,39645,Null,Null,263466368,111461,0
263466408,0.0,0.0,72000,72000,0,0,72000,Null,Null,263466408,111461,2
263466410,0.0,0.0,144000,144000,0,0,144000,Null,Null,263466410,111461,2
263466415,0.0,0.0,76000,76000,0,0,76000,Null,Null,263466415,111461,2
263466418,0.0,0.0,55000,55000,0,0,55000,Null,Null,263466418,111461,2
263466420,0.0,0.0,432000,432000,0,0,432000,Null,Null,263466420,111461,2
263466422,0.0,0.0,279000,279000,0,0,279000,Null,Null,263466422,111461,2
263466425,0.0,0.0,59000,59000,0,0,59000,Null,Null,263466425,111461,2
263466430,0.0,0.0,9000,9000,0,0,9000,Null,Null,263466430,111461,2514
263466440,0.0,0.0,0,270000,0,0,270000,Null,Null,263466440,111461,0
263466447,0.0,0.0,89000,89000,0,0,89000,Null,Null,263466447,111461,2
263466450,0.0,0.0,59400,59400,0,0,59400,Null,Null,263466450,111461,2
263466457,0.0,0.0,120000,120000,0,0,120000,Null,Null,263466457,111461,2
263466459,0.0,0.0,69000,69000,0,0,69000,Null,Null,263466459,111461,2
263466466,0.0,0.0,899000,899000,0,0,899000,Null,Null,263466466,111461,23544
263466553,0.0,0.0,18000,14000,4000,22,18000,Null,Null,263466553,561731,23304
263466566,0.0,0.0,34000,34000,0,0,34000,Null,Null,263466566,111461,23040
263466595,0.0,0.0,34000,34000,0,0,34000,Null,Null,263466595,111461,23010
263474045,0.0,0.0,20000,15000,5000,25,20000,Null,Null,263474045,561731,3178
263479897,0.0,0.0,449000,299000,150000,33,449000,Null,Null,263479897,111461,2225
263479899,0.0,0.0,30000,26000,4000,13,30000,Null,Null,263479899,561731,23340
263480016,0.0,0.0,1490000,1490000,0,0,1490000,Null,Null,263480016,111461,2136
263480205,0.0,0.0,129000,129000,0,0,129000,Null,Null,263480205,111461,23184
263480209,0.0,0.0,129000,129000,0,0,129000,Null,Null,263480209,111461,23184
263480244,0.0,0.0,129000,129000,0,0,129000,Null,Null,263480244,111461,23184
263480376,0.0,0.0,25000,25000,0,0,25000,Null,Null,263480376,111461,23506
263480378,0.0,0.0,129000,129000,0,0,129000,Null,Null,263480378,111461,23184
263480414,0.0,0.0,229000,229000,0,0,229000,Null,Null,263480414,111461,23528
263481776,0.0,0.0,5500000,5500000,0,0,5500000,Null,Null,263481776,5283953,23634
263481793,0.0,0.0,460000,460000,0,0,460000,Null,Null,263481793,111461,3990
263481818,0.0,0.0,490000,490000,0,0,490000,Null,Null,263481818,111461,3990
263481844,0.0,0.0,980000,980000,0,0,980000,Null,Null,263481844,111461,3990
263481863,0.0,0.0,860000,860000,0,0,860000,Null,Null,263481863,111461,3990
263481872,0.0,0.0,560000,560000,0,0,560000,Null,Null,263481872,111461,3990
263481877,0.0,0.0,11960000,5980000,5980000,50,11960000,Null,Null,263481877,111461,15318
263481889,0.0,0.0,680000,680000,0,0,680000,Null,Null,263481889,111461,3990
263481925,0.0,0.0,3150000,3150000,0,0,3150000,Null,Null,263481925,152392,2266
263481937,0.0,0.0,780000,780000,0,0,780000,Null,Null,263481937,111461,3990
263481941,0.0,0.0,380000,380000,0,0,380000,Null,Null,263481941,111461,11885
263482063,0.0,0.0,69000,69000,0,0,69000,Null,Null,263482063,111461,2340
263482084,0.0,0.0,560000,560000,0,0,560000,Null,Null,263482084,111461,3990
263482117,0.0,0.0,700000,700000,0,0,700000,Null,Null,263482117,686797,11897
263482128,0.0,0.0,1256222,1256222,0,0,1256222,Null,Null,263482128,152820,11856
263482170,0.0,0.0,195000,195000,0,0,195000,Null,Null,263482170,111461,8165
263482187,0.0,0.0,3000000,1989060,1010940,34,3000000,Null,Null,263482187,111461,23112
263482195,0.0,0.0,1900000,1900000,0,0,1900000,Null,Null,263482195,111461,23540
263482205,0.0,0.0,1450000,1450000,0,0,1450000,Null,Null,263482205,148818,2266
263482207,0.0,0.0,550000,319000,231000,42,550000,Null,Null,263482207,204385,12908
263482210,84.0,84.0,290000,145000,145000,50,290000,Null,Null,263482210,859997,2
263482242,0.0,0.0,79000,59200,19800,25,79000,Null,Null,263482242,111461,23112
263482316,0.0,0.0,250000,250000,0,0,250000,Null,Null,263482316,111461,2
263482517,0.0,0.0,89000,89000,0,0,89000,Null,Null,263482517,111461,2
263482611,0.0,0.0,220000,220000,0,0,220000,Null,Null,263482611,111461,2
263483055,0.0,0.0,89000,89000,0,0,89000,Null,Null,263483055,111461,2
263483190,0.0,0.0,99000,99000,0,0,99000,Null,Null,263483190,111461,2
263483228,0.0,0.0,829000,829000,0,0,829000,Null,Null,263483228,111461,23236
263483281,0.0,0.0,249000,246001,2999,1,249000,Null,Null,263483281,111461,23112
263483306,0.0,0.0,126000,126000,0,0,126000,Null,Null,263483306,111461,2238
263483375,0.0,0.0,355000,243400,111600,31,355000,Null,Null,263483375,111461,23112
263483415,0.0,0.0,139000,89000,50000,36,139000,Null,Null,263483415,314675,28482
263483428,0.0,0.0,490000,490000,0,0,490000,Null,Null,263483428,230971,23446
263483716,0.0,0.0,138000,138000,0,0,138000,Null,Null,263483716,111461,2238
263483728,0.0,0.0,490000,490000,0,0,490000,Null,Null,263483728,111461,3990
263483828,0.0,0.0,50000,50000,0,0,50000,Null,Null,263483828,111461,6948
263483839,0.0,0.0,480000,298600,181400,38,480000,Null,Null,263483839,111461,23112
263483859,0.0,0.0,1284000,1284000,0,0,1284000,Null,Null,263483859,111461,23678
263483930,0.0,0.0,240000,240000,0,0,240000,Null,Null,263483930,111461,53048
263483947,0.0,0.0,381000,381000,0,0,381000,Null,Null,263483947,111461,27170
263483962,0.0,0.0,450000,450000,0,0,450000,Null,Null,263483962,639127,1637
263483971,0.0,0.0,142000,142000,0,0,142000,Null,Null,263483971,111461,23416
263483974,0.0,0.0,172000,172000,0,0,172000,Null,Null,263483974,111461,23042
263483977,0.0,0.0,225000,225000,0,0,225000,Null,Null,263483977,111461,3990
263483979,0.0,0.0,20000,20000,0,0,20000,Null,Null,263483979,111461,2805
263484015,0.0,0.0,380000,380000,0,0,380000,Null,Null,263484015,111461,9052
263484017,0.0,0.0,381000,381000,0,0,381000,Null,Null,263484017,111461,27172
263484024,0.0,0.0,490000,490000,0,0,490000,Null,Null,263484024,111461,3990
263484043,0.0,0.0,450000,450000,0,0,450000,Null,Null,263484043,639127,1637
263484045,0.0,0.0,58000,58000,0,0,58000,Null,Null,263484045,111461,23416
263484057,0.0,0.0,80000,80000,0,0,80000,Null,Null,263484057,111461,23322
263484195,0.0,0.0,450000,450000,0,0,450000,Null,Null,263484195,639127,1636
263484269,0.0,0.0,155000,155000,0,0,155000,Null,Null,263484269,111461,53054
263484271,0.0,0.0,63000,63000,0,0,63000,Null,Null,263484271,201253,2238
263484281,0.0,0.0,2700000,2700000,0,0,2700000,Null,Null,263484281,111461,4381
263484329,0.0,0.0,23000000,22700000,300000,1,23000000,Null,Null,263484329,18641,2324
263484403,0.0,0.0,69000,69000,0,0,69000,Null,Null,263484403,111461,1605
263484406,0.0,0.0,450000,450000,0,0,450000,Null,Null,263484406,639127,1637
263484409,0.0,0.0,759000,439000,320000,42,759000,Null,Null,263484409,625853,8400
263484433,0.0,0.0,1369000,1369000,0,0,1369000,Null,Null,263484433,111461,23706
263484529,0.0,0.0,34000,34000,0,0,34000,Null,Null,263484529,111461,3177
263484556,0.0,0.0,66000,66000,0,0,66000,Null,Null,263484556,111461,53054
263484567,0.0,0.0,89000,89000,0,0,89000,Null,Null,263484567,111461,2018
263484577,0.0,0.0,2590000,1493300,1096700,42,2590000,Null,Null,263484577,111461,23112
263484584,0.0,0.0,179000,179000,0,0,179000,Null,Null,263484584,111461,23304
263484759,0.0,0.0,399000,386030,12970,3,399000,Null,Null,263484759,111461,23112
263484764,0.0,0.0,138000,138000,0,0,138000,Null,Null,263484764,111461,27256
263484775,0.0,0.0,1195000,1195000,0,0,1195000,Null,Null,263484775,569677,11856
263484780,0.0,0.0,79000,79000,0,0,79000,Null,Null,263484780,111461,23102
263484800,0.0,0.0,55000,55000,0,0,55000,Null,Null,263484800,111461,2340
263484804,0.0,0.0,350000,350000,0,0,350000,Null,Null,263484804,111461,23254
263484865,0.0,0.0,2789000,2789000,0,0,2789000,Null,Null,263484865,111461,27196
263484878,0.0,0.0,830000,830000,0,0,830000,Null,Null,263484878,111461,6511
263484894,0.0,0.0,500000,500000,0,0,500000,Null,Null,263484894,7851327,27214
263484948,0.0,0.0,235000,235000,0,0,235000,Null,Null,263484948,111461,2334
263484950,0.0,0.0,65000,65000,0,0,65000,Null,Null,263484950,111461,53054
263484997,0.0,0.0,319000,319000,0,0,319000,Null,Null,263484997,111461,4429
263485004,0.0,0.0,228000,228000,0,0,228000,Null,Null,263485004,33652,3177
263485007,0.0,0.0,1400000,960000,440000,31,1400000,Null,Null,263485007,51302,2327
263485009,0.0,0.0,690000,690000,0,0,690000,Null,Null,263485009,406243,11875
263485019,0.0,0.0,79000,79000,0,0,79000,Null,Null,263485019,111461,1605
263485067,0.0,0.0,960000,960000,0,0,960000,Null,Null,263485067,111461,6511
263485071,73.0,73.0,449000,449000,0,0,449000,Null,Null,263485071,111461,1520
263485089,0.0,0.0,450000,450000,0,0,450000,Null,Null,263485089,639127,1637
263485094,0.0,0.0,234000,234000,0,0,234000,Null,Null,263485094,33652,3177
263485219,0.0,0.0,2290000,2290000,0,0,2290000,Null,Null,263485219,33652,2136
263485270,0.0,0.0,450000,450000,0,0,450000,Null,Null,263485270,639127,1637
263485303,0.0,0.0,3330000,3330000,0,0,3330000,Null,Null,263485303,33652,2136
263485330,0.0,0.0,50000,45000,5000,10,50000,Null,Null,263485330,114515,11605
263485333,0.0,0.0,900000,900000,0,0,900000,Null,Null,263485333,406243,11875
263485335,0.0,0.0,1100000,609000,491000,45,1100000,Null,Null,263485335,5528055,20492
263485337,0.0,0.0,675000,675000,0,0,675000,Null,Null,263485337,111461,27196
263485361,0.0,0.0,18000,18000,0,0,18000,Null,Null,263485361,111461,28682
263485387,0.0,0.0,299000,299000,0,0,299000,Null,Null,263485387,4414249,23246
263485394,0.0,0.0,450000,450000,0,0,450000,Null,Null,263485394,639127,1637
263485401,0.0,0.0,9430000,9430000,0,0,9430000,Null,Null,263485401,173483,11858
263485404,0.0,0.0,318000,318000,0,0,318000,Null,Null,263485404,111461,2977
263485454,0.0,0.0,1442000,1442000,0,0,1442000,Null,Null,263485454,111461,23322
263485471,0.0,0.0,278000,278000,0,0,278000,Null,Null,263485471,111461,8167
263485482,4.0,4.0,549000,549000,0,0,549000,Null,Null,263485482,111461,1520
263485517,0.0,0.0,2880000,1869033,1010967,35,2880000,Null,Null,263485517,111461,23112
263485680,0.0,0.0,69000,69000,0,0,69000,Null,Null,263485680,25697,28452
263485748,0.0,0.0,5578000,5578000,0,0,5578000,Null,Null,263485748,111461,27196
263485767,0.0,0.0,60000,60000,0,0,60000,Null,Null,263485767,26675,28452
263485780,0.0,0.0,70000,70000,0,0,70000,Null,Null,263485780,111461,1605
263485785,0.0,0.0,15000,15000,0,0,15000,Null,Null,263485785,111461,3178
263485787,0.0,0.0,99000,89000,10000,10,99000,Null,Null,263485787,114515,5905
263485790,0.0,0.0,299000,282050,16950,6,299000,Null,Null,263485790,111461,23112
263485802,0.0,0.0,1099000,839000,260000,24,1099000,Null,Null,263485802,111461,28398
263485823,0.0,0.0,6277000,6277000,0,0,6277000,Null,Null,263485823,111461,27196
263485826,0.0,0.0,132000,132000,0,0,132000,Null,Null,263485826,4414249,23236
263485843,0.0,0.0,60000,60000,0,0,60000,Null,Null,263485843,26675,28452
263485882,0.0,0.0,49000,44000,5000,10,49000,Null,Null,263485882,114515,8194
263485886,0.0,0.0,1180000,946600,233400,20,1180000,Null,Null,263485886,111461,23112
263485892,0.0,0.0,1442000,1442000,0,0,1442000,Null,Null,263485892,111461,23322
263485903,0.0,0.0,1005000,1005000,0,0,1005000,Null,Null,263485903,111461,23706
263485915,0.0,0.0,132000,132000,0,0,132000,Null,Null,263485915,4414249,23236
263485944,0.0,0.0,2680000,2063600,616400,23,2680000,Null,Null,263485944,111461,23112
263485949,0.0,0.0,79000,79000,0,0,79000,Null,Null,263485949,111461,1605
263486031,0.0,0.0,1099000,859000,240000,22,1099000,Null,Null,263486031,111461,28398
263486034,0.0,0.0,104900,104900,0,0,104900,Null,Null,263486034,111461,23304
263486036,0.0,0.0,172000,172000,0,0,172000,Null,Null,263486036,111461,23042
263486038,0.0,0.0,180000,165000,15000,8,180000,Null,Null,263486038,114515,1601
263486045,11.0,11.0,109000,109000,0,0,109000,Null,Null,263486045,111461,8371
263486071,0.0,0.0,370000,370000,0,0,370000,Null,Null,263486071,7798795,11845
263486111,0.0,0.0,1099000,829000,270000,25,1099000,Null,Null,263486111,111461,28398
263486160,8.0,8.0,75000,75000,0,0,75000,Null,Null,263486160,111461,8371
263486168,0.0,0.0,85000,85000,0,0,85000,Null,Null,263486168,111461,1605
263486174,0.0,0.0,3400000,3400000,0,0,3400000,Null,Null,263486174,8194921,11935
263486197,0.0,0.0,60000,60000,0,0,60000,Null,Null,263486197,26675,28452
263486216,0.0,0.0,125000,125000,0,0,125000,Null,Null,263486216,111461,2
263486269,0.0,0.0,169000,169000,0,0,169000,Null,Null,263486269,111461,2
263486275,0.0,0.0,500000,380000,120000,24,500000,Null,Null,263486275,8183419,1936
263486288,0.0,0.0,3800000,3182200,617800,16,3800000,Null,Null,263486288,111461,23112
263486295,0.0,0.0,52000,52000,0,0,52000,Null,Null,263486295,111461,28578
263486345,0.0,0.0,1099000,829000,270000,25,1099000,Null,Null,263486345,111461,28398
263486363,0.0,0.0,399000,399000,0,0,399000,Null,Null,263486363,675211,8602
263486370,0.0,0.0,3200000,1980660,1219340,38,3200000,Null,Null,263486370,111461,23112
263486399,0.0,0.0,79000,79000,0,0,79000,Null,Null,263486399,111461,23102
263486488,0.0,0.0,450000,450000,0,0,450000,Null,Null,263486488,639127,1637
263486490,0.0,0.0,999000,999000,0,0,999000,Null,Null,263486490,7288833,2849
263486502,0.0,0.0,520000,520000,0,0,520000,Null,Null,263486502,111461,28574
263486520,0.0,0.0,59000,59000,0,0,59000,Null,Null,263486520,111461,2
263486562,10.0,10.0,700000,350000,350000,50,700000,Null,Null,263486562,111461,11937
263486572,0.0,0.0,350000,285003,64997,19,350000,Null,Null,263486572,111461,23112
263486614,0.0,0.0,200000,200000,0,0,200000,Null,Null,263486614,111461,23184
263486732,0.0,0.0,3900000,2988033,911967,23,3900000,Null,Null,263486732,111461,23112
263486750,0.0,0.0,15000,15000,0,0,15000,Null,Null,263486750,7368269,2685
263486755,0.0,0.0,159000,159000,0,0,159000,Null,Null,263486755,111461,23238
263486760,0.0,0.0,164000,164000,0,0,164000,Null,Null,263486760,111461,23246
263486777,0.0,0.0,598000,299000,299000,50,598000,Null,Null,263486777,111461,1634
263486789,0.0,0.0,450000,450000,0,0,450000,Null,Null,263486789,639127,1637
263486809,0.0,0.0,52500,52500,0,0,52500,Null,Null,263486809,689369,8224
263486877,4.0,4.0,50000,50000,0,0,50000,Null,Null,263486877,111461,1883
263486890,0.0,0.0,59000,59000,0,0,59000,Null,Null,263486890,111461,2
263486891,0.0,0.0,59000,59000,0,0,59000,Null,Null,263486891,111461,2
263486894,0.0,0.0,59000,59000,0,0,59000,Null,Null,263486894,111461,2
263486896,0.0,0.0,59000,59000,0,0,59000,Null,Null,263486896,111461,2
263486897,0.0,0.0,59000,59000,0,0,59000,Null,Null,263486897,111461,2
263486934,0.0,0.0,450000,450000,0,0,450000,Null,Null,263486934,639127,1637
263486946,0.0,0.0,200000,200000,0,0,200000,Null,Null,263486946,21651,28738
263486956,0.0,0.0,25000,25000,0,0,25000,Null,Null,263486956,111461,8167
263487006,0.0,0.0,60000,60000,0,0,60000,Null,Null,263487006,26675,28452
263487013,0.0,0.0,379000,379000,0,0,379000,Null,Null,263487013,111461,27230
263487053,10.0,10.0,518000,259000,259000,50,518000,Null,Null,263487053,111461,1883
263487079,0.0,0.0,58000,58000,0,0,58000,Null,Null,263487079,111461,1883
263487097,9.0,9.0,1290000,1290000,0,0,1290000,Null,Null,263487097,146479,1811
263487280,0.0,0.0,65000,65000,0,0,65000,Null,Null,263487280,111461,3710
263487383,0.0,0.0,52500,52500,0,0,52500,Null,Null,263487383,689369,8224
263487385,0.0,0.0,150000,150000,0,0,150000,Null,Null,263487385,111461,2
263487416,0.0,0.0,60000,60000,0,0,60000,Null,Null,263487416,111461,2
263487417,0.0,0.0,60000,60000,0,0,60000,Null,Null,263487417,111461,2
263487430,61.0,61.0,50000,50000,0,0,50000,Null,Null,263487430,111461,1883
263487448,0.0,0.0,400000,400000,0,0,400000,Null,Null,263487448,111461,2
263487461,0.0,0.0,65000,65000,0,0,65000,Null,Null,263487461,111461,3710
263487566,0.0,0.0,2700000,2700000,0,0,2700000,Null,Null,263487566,111461,2
263487574,0.0,0.0,75000,75000,0,0,75000,Null,Null,263487574,111461,1605
263487590,0.0,0.0,50000,50000,0,0,50000,Null,Null,263487590,111461,2
263487634,139.0,139.0,50000,50000,0,0,50000,Null,Null,263487634,111461,1883
263487669,0.0,0.0,299000,299000,0,0,299000,Null,Null,263487669,7980991,17170
263487697,0.0,0.0,165000,165000,0,0,165000,Null,Null,263487697,111461,3177
263487762,1.0,1.0,169000,169000,0,0,169000,Null,Null,263487762,8073017,1520
263487766,0.0,0.0,95000,95000,0,0,95000,Null,Null,263487766,111461,1605
263487783,0.0,0.0,195000,195000,0,0,195000,Null,Null,263487783,111461,23042
263487847,0.0,0.0,165000,165000,0,0,165000,Null,Null,263487847,111461,23362
263487849,0.0,0.0,75000,75000,0,0,75000,Null,Null,263487849,111461,18888
263487917,0.0,0.0,98000,98000,0,0,98000,Null,Null,263487917,111461,5566
263487921,0.0,0.0,750000,750000,0,0,750000,Null,Null,263487921,111461,23272
263487925,0.0,0.0,250000,210000,40000,16,250000,Null,Null,263487925,19312,2153
263487930,0.0,0.0,365000,365000,0,0,365000,Null,Null,263487930,111461,8167
263487961,0.0,0.0,250000,210000,40000,16,250000,Null,Null,263487961,19312,2153
263488025,0.0,0.0,14500,14500,0,0,14500,Null,Null,263488025,193677,5450
263488101,0.0,0.0,110000,110000,0,0,110000,Null,Null,263488101,111461,3178
263488105,0.0,0.0,12500,12500,0,0,12500,Null,Null,263488105,193677,5450
263488136,0.0,0.0,319000,319000,0,0,319000,Null,Null,263488136,8196392,3422
263488141,0.0,0.0,3100000,3100000,0,0,3100000,Null,Null,263488141,111461,23658
263488161,0.0,0.0,12500,12500,0,0,12500,Null,Null,263488161,193677,5450
263488197,0.0,0.0,89000,89000,0,0,89000,Null,Null,263488197,111461,2140
263488283,0.0,0.0,163000,163000,0,0,163000,Null,Null,263488283,4414249,23236
263488317,0.0,0.0,14500,14500,0,0,14500,Null,Null,263488317,193677,5450
263488321,50.0,50.0,50000,50000,0,0,50000,Null,Null,263488321,111461,1883
263488342,170.0,170.0,50000,50000,0,0,50000,Null,Null,263488342,111461,1883
263488353,0.0,0.0,268000,268000,0,0,268000,Null,Null,263488353,4414249,23236
263488370,0.0,0.0,89000,89000,0,0,89000,Null,Null,263488370,111461,23184
263488377,0.0,0.0,270000,270000,0,0,270000,Null,Null,263488377,639127,1637
263488383,0.0,0.0,283000,283000,0,0,283000,Null,Null,263488383,4414249,23236
263488389,631.0,631.0,54000,54000,0,0,54000,Null,Null,263488389,111461,1883
263488412,0.0,0.0,520000,520000,0,0,520000,Null,Null,263488412,4414249,23246
263488433,0.0,0.0,520000,520000,0,0,520000,Null,Null,263488433,4414249,23236
263488435,0.0,0.0,290000,290000,0,0,290000,Null,Null,263488435,221187,1623
263488444,0.0,0.0,119000,119000,0,0,119000,Null,Null,263488444,111461,23184
263488446,0.0,0.0,21500,21500,0,0,21500,Null,Null,263488446,193677,5450
263488449,0.0,0.0,270000,270000,0,0,270000,Null,Null,263488449,639127,1637
263488472,274.0,274.0,50000,50000,0,0,50000,Null,Null,263488472,111461,1883
263488485,0.0,0.0,1315000,1315000,0,0,1315000,Null,Null,263488485,4414249,23246
263488498,0.0,0.0,330000,330000,0,0,330000,Null,Null,263488498,4414249,23236
263488516,0.0,0.0,290000,290000,0,0,290000,Null,Null,263488516,221187,1623
263488531,0.0,0.0,130000,130000,0,0,130000,Null,Null,263488531,111461,28598
263488547,0.0,0.0,625000,625000,0,0,625000,Null,Null,263488547,4414249,23246
263488552,0.0,0.0,270000,270000,0,0,270000,Null,Null,263488552,639127,1637
263488579,0.0,0.0,300000,300000,0,0,300000,Null,Null,263488579,111461,2
263488607,0.0,0.0,788000,788000,0,0,788000,Null,Null,263488607,4414249,23236
263488652,0.0,0.0,290000,290000,0,0,290000,Null,Null,263488652,111461,27240
263488660,157.0,157.0,50000,50000,0,0,50000,Null,Null,263488660,111461,1883
263488674,0.0,0.0,58000,58000,0,0,58000,Null,Null,263488674,111461,23340
263488676,0.0,0.0,392000,392000,0,0,392000,Null,Null,263488676,18984,3428
263488678,0.0,0.0,578000,578000,0,0,578000,Null,Null,263488678,4414249,23236
263488683,0.0,0.0,270000,270000,0,0,270000,Null,Null,263488683,639127,1637
263488690,0.0,0.0,89000,89000,0,0,89000,Null,Null,263488690,111461,23184
263488710,0.0,0.0,520000,520000,0,0,520000,Null,Null,263488710,4414249,23246
263488716,0.0,0.0,75000,75000,0,0,75000,Null,Null,263488716,111461,53054
263488764,0.0,0.0,17000,17000,0,0,17000,Null,Null,263488764,111461,9052
263488778,0.0,0.0,377000,377000,0,0,377000,Null,Null,263488778,4414249,23236
263488815,0.0,0.0,150000,150000,0,0,150000,Null,Null,263488815,111461,23288
263488818,87.0,87.0,46000,46000,0,0,46000,Null,Null,263488818,111461,1883
263488833,0.0,0.0,132000,132000,0,0,132000,Null,Null,263488833,4414249,23236
263488835,0.0,0.0,99000,99000,0,0,99000,Null,Null,263488835,111461,23184
263488866,0.0,0.0,19999,19999,0,0,19999,Null,Null,263488866,111461,3990
263488880,0.0,0.0,447000,447000,0,0,447000,Null,Null,263488880,4414249,23236
263488901,0.0,0.0,1500000,1500000,0,0,1500000,Null,Null,263488901,406243,11859
263488917,276.0,276.0,46000,46000,0,0,46000,Null,Null,263488917,111461,1883
263488933,0.0,0.0,158000,158000,0,0,158000,Null,Null,263488933,4414249,23246
263488941,0.0,0.0,9999,9999,0,0,9999,Null,Null,263488941,111461,2511
263488952,0.0,0.0,40000,40000,0,0,40000,Null,Null,263488952,111461,2
263488957,0.0,0.0,218500,218500,0,0,218500,Null,Null,263488957,111461,2
263488960,0.0,0.0,89100,89100,0,0,89100,Null,Null,263488960,111461,2
263488964,0.0,0.0,90000,90000,0,0,90000,Null,Null,263488964,111461,2
263488968,0.0,0.0,1450000,1450000,0,0,1450000,Null,Null,263488968,406243,11881
263488974,78.0,78.0,50000,50000,0,0,50000,Null,Null,263488974,111461,1883
263489003,0.0,0.0,270000,270000,0,0,270000,Null,Null,263489003,639127,1637
263489006,0.0,0.0,379000,379000,0,0,379000,Null,Null,263489006,111461,27230
263489013,0.0,0.0,384000,384000,0,0,384000,Null,Null,263489013,4414249,23246
263489225,0.0,0.0,237000,237000,0,0,237000,Null,Null,263489225,4414249,23236
263489265,12.0,12.0,50000,50000,0,0,50000,Null,Null,263489265,111461,1883
263489319,0.0,0.0,493000,493000,0,0,493000,Null,Null,263489319,4414249,23236
263489369,0.0,0.0,310000,310000,0,0,310000,Null,Null,263489369,4414249,23236
263489371,31.0,31.0,56000,56000,0,0,56000,Null,Null,263489371,111461,1883
263489388,0.0,0.0,255000,255000,0,0,255000,Null,Null,263489388,111461,23706
263489391,0.0,0.0,447900,447900,0,0,447900,Null,Null,263489391,111461,28682
263489407,0.0,0.0,89000,89000,0,0,89000,Null,Null,263489407,50432,8223
263489425,0.0,0.0,149000,149000,0,0,149000,Null,Null,263489425,111461,23184
263489427,0.0,0.0,755000,755000,0,0,755000,Null,Null,263489427,4414249,23246
263489466,0.0,0.0,10000,10000,0,0,10000,Null,Null,263489466,111461,2
263489469,0.0,0.0,4800,4800,0,0,4800,Null,Null,263489469,111461,2
263489482,0.0,0.0,350000,350000,0,0,350000,Null,Null,263489482,513091,23288
263489491,0.0,0.0,3500,3500,0,0,3500,Null,Null,263489491,111461,2
263489493,0.0,0.0,360000,360000,0,0,360000,Null,Null,263489493,111461,2
263489495,0.0,0.0,7000,7000,0,0,7000,Null,Null,263489495,111461,2
263489498,0.0,0.0,1620000,1620000,0,0,1620000,Null,Null,263489498,111461,27196
263489500,0.0,0.0,699000,699000,0,0,699000,Null,Null,263489500,8196232,11911
263489513,0.0,0.0,27000,27000,0,0,27000,Null,Null,263489513,199775,11897
263489546,0.0,0.0,5329000,5329000,0,0,5329000,Null,Null,263489546,111461,27196
263489557,0.0,0.0,4750000,4750000,0,0,4750000,Null,Null,263489557,7982659,7449
263489562,0.0,0.0,35000,35000,0,0,35000,Null,Null,263489562,111461,27214
263489606,0.0,0.0,39900,39900,0,0,39900,Null,Null,263489606,111461,2
263489612,0.0,0.0,1815000,1815000,0,0,1815000,Null,Null,263489612,111461,27196
263489618,0.0,0.0,270000,270000,0,0,270000,Null,Null,263489618,639127,1637
263489627,0.0,0.0,120000,120000,0,0,120000,Null,Null,263489627,111461,23288
263489629,0.0,0.0,310000,310000,0,0,310000,Null,Null,263489629,4414249,23236
263489642,0.0,0.0,50000,50000,0,0,50000,Null,Null,263489642,199775,11875
263489682,0.0,0.0,55000,55000,0,0,55000,Null,Null,263489682,111461,53054
263489755,0.0,0.0,436000,436000,0,0,436000,Null,Null,263489755,4414249,23236
263489762,0.0,0.0,698000,698000,0,0,698000,Null,Null,263489762,4958627,23436
263489798,0.0,0.0,89000,89000,0,0,89000,Null,Null,263489798,111461,28458
263489824,0.0,0.0,4500000,4500000,0,0,4500000,Null,Null,263489824,19788,2657
263489859,0.0,0.0,4490000,4490000,0,0,4490000,Null,Null,263489859,19788,2657
263489907,0.0,0.0,2699000,2699000,0,0,2699000,Null,Null,263489907,19788,2657
263490076,0.0,0.0,5695000,5695000,0,0,5695000,Null,Null,263490076,111461,27196
263490101,0.0,0.0,625000,625000,0,0,625000,Null,Null,263490101,4414249,23236
263490108,0.0,0.0,45000,45000,0,0,45000,Null,Null,263490108,199775,11857
263490112,0.0,0.0,4750000,4750000,0,0,4750000,Null,Null,263490112,7982659,7449
263490156,0.0,0.0,1369000,1369000,0,0,1369000,Null,Null,263490156,111461,23706
263490167,0.0,0.0,105000,105000,0,0,105000,Null,Null,263490167,211343,8309
263490170,0.0,0.0,1290000,1290000,0,0,1290000,Null,Null,263490170,111461,1979
263490172,0.0,0.0,249000,249000,0,0,249000,Null,Null,263490172,111461,27240
263490250,0.0,0.0,177600,177600,0,0,177600,Null,Null,263490250,111461,23416
263490289,0.0,0.0,39999,39999,0,0,39999,Null,Null,263490289,111461,3216
263490294,0.0,0.0,205000,205000,0,0,205000,Null,Null,263490294,4414249,23236
263490320,0.0,0.0,4750000,4750000,0,0,4750000,Null,Null,263490320,7982659,7449
263490322,0.0,0.0,40000,40000,0,0,40000,Null,Null,263490322,111461,53054
263490324,0.0,0.0,220000,220000,0,0,220000,Null,Null,263490324,199775,11857
263490327,0.0,0.0,5440000,5440000,0,0,5440000,Null,Null,263490327,111461,27196
263490335,0.0,0.0,579000,349000,230000,40,579000,Null,Null,263490335,625853,8400
263490346,0.0,0.0,306000,306000,0,0,306000,Null,Null,263490346,21651,12908
263490354,0.0,0.0,129000,129000,0,0,129000,Null,Null,263490354,111461,8188
263490374,0.0,0.0,0,249000,0,0,249000,Null,Null,263490374,111461,0
263490388,0.0,0.0,330000,330000,0,0,330000,Null,Null,263490388,4414249,23236
263491917,0.0,0.0,1290000,1290000,0,0,1290000,Null,Null,263491917,111461,1979
263492416,0.0,0.0,220000,220000,0,0,220000,Null,Null,263492416,199775,11857
263492437,0.0,0.0,520000,520000,0,0,520000,Null,Null,263492437,4414249,23236
263492455,0.0,0.0,490000,490000,0,0,490000,Null,Null,263492455,199775,11845
263492474,0.0,0.0,99000,99000,0,0,99000,Null,Null,263492474,111461,23184
263492479,0.0,0.0,80000,80000,0,0,80000,Null,Null,263492479,513091,23288
263492492,0.0,0.0,5219000,5219000,0,0,5219000,Null,Null,263492492,111461,27196
263492494,0.0,0.0,2468000,2468000,0,0,2468000,Null,Null,263492494,4414249,23236
263492507,0.0,0.0,404900,404900,0,0,404900,Null,Null,263492507,111461,23660
263492658,0.0,0.0,495000,495000,0,0,495000,Null,Null,263492658,111461,23376
263492693,0.0,0.0,227850,227850,0,0,227850,Null,Null,263492693,189983,1609
263492749,0.0,0.0,5077000,5077000,0,0,5077000,Null,Null,263492749,111461,27192
263492759,0.0,0.0,289000,289000,0,0,289000,Null,Null,263492759,111461,28576
263492766,0.0,0.0,1628000,1628000,0,0,1628000,Null,Null,263492766,4414249,23236
263492819,0.0,0.0,15000,15000,0,0,15000,Null,Null,263492819,7324269,11921
263492821,0.0,0.0,406346,406346,0,0,406346,Null,Null,263492821,7873343,15318
263492822,0.0,0.0,600000,600000,0,0,600000,Null,Null,263492822,111461,27240
263492829,0.0,0.0,155000,155000,0,0,155000,Null,Null,263492829,211343,8309
263492831,0.0,0.0,909000,909000,0,0,909000,Null,Null,263492831,4414249,23236
263492836,0.0,0.0,319000,319000,0,0,319000,Null,Null,263492836,8196392,3422
263492859,0.0,0.0,270000,270000,0,0,270000,Null,Null,263492859,639127,1637
263492865,0.0,0.0,62000,62000,0,0,62000,Null,Null,263492865,111461,1605
263492879,0.0,0.0,1733000,1733000,0,0,1733000,Null,Null,263492879,4414249,23236
263492881,0.0,0.0,649000,349000,300000,46,649000,Null,Null,263492881,625853,28454
263492886,0.0,0.0,358000,358000,0,0,358000,Null,Null,263492886,198523,2334
263492895,0.0,0.0,405000,405000,0,0,405000,Null,Null,263492895,111461,1978
263492957,0.0,0.0,2573000,2573000,0,0,2573000,Null,Null,263492957,4414249,23236
263492981,0.0,0.0,1313000,1313000,0,0,1313000,Null,Null,263492981,4414249,23236
263493079,0.0,0.0,125000,125000,0,0,125000,Null,Null,263493079,111461,1605
263493095,0.0,0.0,270000,270000,0,0,270000,Null,Null,263493095,639127,1637
263493112,0.0,0.0,390000,390000,0,0,390000,Null,Null,263493112,199775,11857
263493120,0.0,0.0,755000,755000,0,0,755000,Null,Null,263493120,111461,23706
263493130,0.0,0.0,115000,85000,30000,26,115000,Null,Null,263493130,74676,3449
263493141,0.0,0.0,5350000,5350000,0,0,5350000,Null,Null,263493141,173483,11858
263493194,0.0,0.0,270000,270000,0,0,270000,Null,Null,263493194,639127,1637
263493222,0.0,0.0,5299000,5299000,0,0,5299000,Null,Null,263493222,111461,27196
263493225,0.0,0.0,205000,205000,0,0,205000,Null,Null,263493225,4414249,23246
263493340,0.0,0.0,950000,950000,0,0,950000,Null,Null,263493340,258483,20252
263493443,0.0,0.0,119000,119000,0,0,119000,Null,Null,263493443,111461,3805
263493499,0.0,0.0,5299000,5299000,0,0,5299000,Null,Null,263493499,111461,27196
263493501,0.0,0.0,4370000,4370000,0,0,4370000,Null,Null,263493501,173483,11858
263493506,0.0,0.0,230000,169000,61000,27,230000,Null,Null,263493506,74676,3449
263493508,0.0,0.0,135000,135000,0,0,135000,Null,Null,263493508,111461,1605
263493526,0.0,0.0,6900000,5175000,1725000,25,6900000,Null,Null,263493526,111461,2363
263493533,0.0,0.0,335000,335000,0,0,335000,Null,Null,263493533,4414249,23236
263493569,0.0,0.0,180000,180000,0,0,180000,Null,Null,263493569,221187,8223
263493627,0.0,0.0,214000,150000,64000,30,214000,Null,Null,263493627,74676,3449
263493634,0.0,0.0,1005000,1005000,0,0,1005000,Null,Null,263493634,111461,23706
263493657,0.0,0.0,520000,520000,0,0,520000,Null,Null,263493657,4414249,23236
263493671,0.0,0.0,270000,270000,0,0,270000,Null,Null,263493671,639127,1637
263493712,0.0,0.0,360000,360000,0,0,360000,Null,Null,263493712,199775,11857
263493839,0.0,0.0,260000,260000,0,0,260000,Null,Null,263493839,221187,1623
263493872,0.0,0.0,5350000,5350000,0,0,5350000,Null,Null,263493872,111461,3515
263493876,0.0,0.0,830000,830000,0,0,830000,Null,Null,263493876,4414249,23236
263493881,0.0,0.0,130000,128700,1300,1,130000,Null,Null,263493881,499843,11885
263493891,0.0,0.0,250000,250000,0,0,250000,Null,Null,263493891,111461,27240
263493915,0.0,0.0,280000,280000,0,0,280000,Null,Null,263493915,221187,13878
263493917,0.0,0.0,950000,950000,0,0,950000,Null,Null,263493917,258483,20256
263493927,0.0,0.0,105000,105000,0,0,105000,Null,Null,263493927,111461,23236
263493936,0.0,0.0,762000,762000,0,0,762000,Null,Null,263493936,4414249,23236
263493942,0.0,0.0,6900000,5175000,1725000,25,6900000,Null,Null,263493942,111461,2363
263493972,0.0,0.0,662000,662000,0,0,662000,Null,Null,263493972,4414249,23236
263493991,0.0,0.0,405000,405000,0,0,405000,Null,Null,263493991,111461,1978
263494006,0.0,0.0,1350000,1350000,0,0,1350000,Null,Null,263494006,111461,3515
263494010,0.0,0.0,1313000,1313000,0,0,1313000,Null,Null,263494010,4414249,23236
263494017,0.0,0.0,88000,88000,0,0,88000,Null,Null,263494017,7368269,2513
263494026,0.0,0.0,120000,108000,12000,10,120000,Null,Null,263494026,5220265,2
263494039,0.0,0.0,75000,75000,0,0,75000,Null,Null,263494039,111461,27214
263494044,0.0,0.0,245000,189000,56000,23,245000,Null,Null,263494044,74676,3449
263494059,0.0,0.0,715000,715000,0,0,715000,Null,Null,263494059,4414249,23236
263494195,0.0,0.0,1880000,1880000,0,0,1880000,Null,Null,263494195,40698,2136
263494197,0.0,0.0,440000,268000,172000,39,440000,Null,Null,263494197,8181541,2512
263494227,0.0,0.0,75000,75000,0,0,75000,Null,Null,263494227,111461,27214
263494283,0.0,0.0,1350000,1350000,0,0,1350000,Null,Null,263494283,111461,8170
263494285,0.0,0.0,36900,36900,0,0,36900,Null,Null,263494285,111461,23244
263494290,0.0,0.0,75000,75000,0,0,75000,Null,Null,263494290,111461,27214
263494297,0.0,0.0,79000,79000,0,0,79000,Null,Null,263494297,111461,28736
263494305,0.0,0.0,279000,279000,0,0,279000,Null,Null,263494305,111461,1979
263494359,0.0,0.0,19000,19000,0,0,19000,Null,Null,263494359,111461,11803
263494363,0.0,0.0,75000,75000,0,0,75000,Null,Null,263494363,111461,27214
263494372,0.0,0.0,12000,12000,0,0,12000,Null,Null,263494372,111461,27256
263494504,0.0,0.0,75000,75000,0,0,75000,Null,Null,263494504,111461,27214
263494527,0.0,0.0,8900,8900,0,0,8900,Null,Null,263494527,111461,2
263494542,0.0,0.0,255000,255000,0,0,255000,Null,Null,263494542,282973,17186
263494546,0.0,0.0,199000,199000,0,0,199000,Null,Null,263494546,282973,2
263494547,0.0,0.0,320000,320000,0,0,320000,Null,Null,263494547,282973,2
263494553,0.0,0.0,399000,399000,0,0,399000,Null,Null,263494553,282973,2
263494555,0.0,0.0,389000,389000,0,0,389000,Null,Null,263494555,282973,1752
263494556,0.0,0.0,450000,450000,0,0,450000,Null,Null,263494556,282973,2
263494561,0.0,0.0,799000,799000,0,0,799000,Null,Null,263494561,282973,2
263494563,0.0,0.0,350000,350000,0,0,350000,Null,Null,263494563,282973,2
263494568,0.0,0.0,699000,699000,0,0,699000,Null,Null,263494568,282973,2
263494643,0.0,0.0,8999,8999,0,0,8999,Null,Null,263494643,111461,3216
263494645,0.0,0.0,75000,75000,0,0,75000,Null,Null,263494645,111461,27214
263494683,0.0,0.0,25000,25000,0,0,25000,Null,Null,263494683,111461,2514
263494685,0.0,0.0,9000,9000,0,0,9000,Null,Null,263494685,7368269,23276
263494699,0.0,0.0,2100000,1680000,420000,20,2100000,Null,Null,263494699,499843,11875
263494710,0.0,0.0,99000,99000,0,0,99000,Null,Null,263494710,282973,2
263494720,0.0,0.0,75000,75000,0,0,75000,Null,Null,263494720,111461,27214
263495031,0.0,0.0,189000,189000,0,0,189000,Null,Null,263495031,111461,28458
263495043,0.0,0.0,75000,75000,0,0,75000,Null,Null,263495043,111461,27214
263495051,0.0,0.0,35000,35000,0,0,35000,Null,Null,263495051,111461,8167
263495055,0.0,0.0,450000,450000,0,0,450000,Null,Null,263495055,111461,23660
263495069,0.0,0.0,69000,69000,0,0,69000,Null,Null,263495069,111461,8167
263495080,0.0,0.0,75000,75000,0,0,75000,Null,Null,263495080,111461,27214
263495085,0.0,0.0,25000,25000,0,0,25000,Null,Null,263495085,111461,7064
263495113,0.0,0.0,25000,25000,0,0,25000,Null,Null,263495113,111461,7064
263495138,0.0,0.0,75000,75000,0,0,75000,Null,Null,263495138,111461,27214
263495191,0.0,0.0,79000,79000,0,0,79000,Null,Null,263495191,111461,8167
263495214,0.0,0.0,75000,75000,0,0,75000,Null,Null,263495214,111461,27214
263495232,0.0,0.0,480000,480000,0,0,480000,Null,Null,263495232,111461,27240
263495245,0.0,0.0,79000,79000,0,0,79000,Null,Null,263495245,111461,8167
263495269,0.0,0.0,79000,79000,0,0,79000,Null,Null,263495269,111461,8167
263495276,0.0,0.0,75000,75000,0,0,75000,Null,Null,263495276,111461,27214
263495284,0.0,0.0,290000,290000,0,0,290000,Null,Null,263495284,111461,23082
263495331,0.0,0.0,35000,35000,0,0,35000,Null,Null,263495331,111461,2238
263495337,0.0,0.0,85000,85000,0,0,85000,Null,Null,263495337,111461,8167
263495346,0.0,0.0,75000,75000,0,0,75000,Null,Null,263495346,111461,27214
263495359,0.0,0.0,390000,390000,0,0,390000,Null,Null,263495359,111461,23082
263495368,0.0,0.0,21000,21000,0,0,21000,Null,Null,263495368,111461,15320
263495374,0.0,0.0,75000,75000,0,0,75000,Null,Null,263495374,111461,27214
263495379,0.0,0.0,85000,85000,0,0,85000,Null,Null,263495379,111461,8167
263495395,0.0,0.0,85000,85000,0,0,85000,Null,Null,263495395,111461,23322
263495403,0.0,0.0,565000,565000,0,0,565000,Null,Null,263495403,33203,20252
263495408,0.0,0.0,25000,25000,0,0,25000,Null,Null,263495408,7368269,6305
263495411,0.0,0.0,75000,75000,0,0,75000,Null,Null,263495411,111461,27214
263495426,0.0,0.0,1339000,1339000,0,0,1339000,Null,Null,263495426,152820,2
263495430,0.0,0.0,530000,530000,0,0,530000,Null,Null,263495430,111461,23082
263495447,0.0,0.0,45000,45000,0,0,45000,Null,Null,263495447,111461,2337
263495457,0.0,0.0,75000,75000,0,0,75000,Null,Null,263495457,111461,27214
263495513,0.0,0.0,150000,150000,0,0,150000,Null,Null,263495513,111461,23210
263495535,0.0,0.0,75000,75000,0,0,75000,Null,Null,263495535,111461,27214
263495548,0.0,0.0,1312000,1312000,0,0,1312000,Null,Null,263495548,111461,23112
263495568,0.0,0.0,75000,75000,0,0,75000,Null,Null,263495568,111461,27214
263495575,0.0,0.0,120000,120000,0,0,120000,Null,Null,263495575,111461,23334
263495577,0.0,0.0,25000,25000,0,0,25000,Null,Null,263495577,111461,3178
263495582,0.0,0.0,75000,75000,0,0,75000,Null,Null,263495582,111461,27214
263495589,0.0,0.0,99000,99000,0,0,99000,Null,Null,263495589,21653,12908
263495608,0.0,0.0,125000,125000,0,0,125000,Null,Null,263495608,111461,3178
263495620,0.0,0.0,1390000,1390000,0,0,1390000,Null,Null,263495620,111461,6511
263495634,0.0,0.0,245000,245000,0,0,245000,Null,Null,263495634,111461,3178
263495661,0.0,0.0,119000,119000,0,0,119000,Null,Null,263495661,111461,28644
263495913,0.0,0.0,399000,399000,0,0,399000,Null,Null,263495913,929187,2020
263495917,0.0,0.0,69000,69000,0,0,69000,Null,Null,263495917,7368269,3178
263495922,38.0,38.0,100000,100000,0,0,100000,Null,Null,263495922,178551,1520
263495927,0.0,0.0,69800,69800,0,0,69800,Null,Null,263495927,111461,1831
263495936,0.0,0.0,285000,285000,0,0,285000,Null,Null,263495936,111461,3515
263495940,0.0,0.0,582000,582000,0,0,582000,Null,Null,263495940,33652,3178
263495958,0.0,0.0,1590000,1590000,0,0,1590000,Null,Null,263495958,111461,6511
263496059,0.0,0.0,17000,17000,0,0,17000,Null,Null,263496059,111461,15250
263496233,0.0,0.0,3650000,3650000,0,0,3650000,Null,Null,263496233,4701461,8198
263496281,0.0,0.0,525000,525000,0,0,525000,Null,Null,263496281,19107,3428
263496338,0.0,0.0,899000,899000,0,0,899000,Null,Null,263496338,111461,23112
263496342,0.0,0.0,624000,624000,0,0,624000,Null,Null,263496342,33652,3178
263496467,0.0,0.0,139000,139000,0,0,139000,Null,Null,263496467,162313,28426
263496478,0.0,0.0,589000,589000,0,0,589000,Null,Null,263496478,111461,2
263496480,0.0,0.0,184300,184300,0,0,184300,Null,Null,263496480,111461,2
263496482,0.0,0.0,142500,142500,0,0,142500,Null,Null,263496482,111461,2
263496485,0.0,0.0,73150,73150,0,0,73150,Null,Null,263496485,111461,2
263496488,0.0,0.0,23750,23750,0,0,23750,Null,Null,263496488,111461,2
263496493,0.0,0.0,76950,76950,0,0,76950,Null,Null,263496493,111461,2
263496494,0.0,0.0,79800,79800,0,0,79800,Null,Null,263496494,111461,2
263496507,0.0,0.0,23750,23750,0,0,23750,Null,Null,263496507,111461,2
263496508,0.0,0.0,47500,47500,0,0,47500,Null,Null,263496508,111461,2
263496514,0.0,0.0,60800,60800,0,0,60800,Null,Null,263496514,111461,2
263496518,0.0,0.0,48450,48450,0,0,48450,Null,Null,263496518,111461,2
263496523,0.0,0.0,28500,28500,0,0,28500,Null,Null,263496523,111461,2
263496527,0.0,0.0,39900,39900,0,0,39900,Null,Null,263496527,111461,2
263496532,0.0,0.0,168150,168150,0,0,168150,Null,Null,263496532,111461,2
263496536,0.0,0.0,76000,76000,0,0,76000,Null,Null,263496536,111461,2
263496537,0.0,0.0,256500,256500,0,0,256500,Null,Null,263496537,111461,2
263496542,0.0,0.0,51300,51300,0,0,51300,Null,Null,263496542,111461,2
263496545,0.0,0.0,111150,111150,0,0,111150,Null,Null,263496545,111461,2
263496547,0.0,0.0,23750,23750,0,0,23750,Null,Null,263496547,111461,2
263496549,0.0,0.0,185250,185250,0,0,185250,Null,Null,263496549,111461,2
263496552,0.0,0.0,589000,589000,0,0,589000,Null,Null,263496552,111461,2
263496556,0.0,0.0,17100,17100,0,0,17100,Null,Null,263496556,111461,2
263496558,0.0,0.0,665000,665000,0,0,665000,Null,Null,263496558,111461,2
263496560,0.0,0.0,142500,142500,0,0,142500,Null,Null,263496560,111461,2
263496561,0.0,0.0,43700,43700,0,0,43700,Null,Null,263496561,111461,2
263496564,0.0,0.0,11400,11400,0,0,11400,Null,Null,263496564,111461,2
263496568,0.0,0.0,57000,57000,0,0,57000,Null,Null,263496568,111461,2
263496570,0.0,0.0,48450,48450,0,0,48450,Null,Null,263496570,111461,2
263496572,0.0,0.0,58900,58900,0,0,58900,Null,Null,263496572,111461,2
263496584,0.0,0.0,28500,28500,0,0,28500,Null,Null,263496584,111461,2
263496587,0.0,0.0,214000,214000,0,0,214000,Null,Null,263496587,111461,2
263496592,0.0,0.0,11400,11400,0,0,11400,Null,Null,263496592,111461,2
263496596,0.0,0.0,145350,145350,0,0,145350,Null,Null,263496596,111461,2
263496604,0.0,0.0,39900,39900,0,0,39900,Null,Null,263496604,111461,2
263496612,0.0,0.0,23750,23750,0,0,23750,Null,Null,263496612,111461,2
263496616,0.0,0.0,11400,11400,0,0,11400,Null,Null,263496616,111461,2
263496619,0.0,0.0,122550,122550,0,0,122550,Null,Null,263496619,111461,2
263496620,0.0,0.0,17100,17100,0,0,17100,Null,Null,263496620,111461,2
263496626,0.0,0.0,14250,14250,0,0,14250,Null,Null,263496626,111461,2
263496627,0.0,0.0,84550,84550,0,0,84550,Null,Null,263496627,111461,2
263496628,0.0,0.0,56050,56050,0,0,56050,Null,Null,263496628,111461,2
263496629,0.0,0.0,28500,28500,0,0,28500,Null,Null,263496629,111461,2
263496636,0.0,0.0,165000,165000,0,0,165000,Null,Null,263496636,111461,2
263496638,0.0,0.0,71250,71250,0,0,71250,Null,Null,263496638,111461,2
263496642,0.0,0.0,56050,56050,0,0,56050,Null,Null,263496642,111461,2
263496645,0.0,0.0,69350,69350,0,0,69350,Null,Null,263496645,111461,2
263496651,0.0,0.0,31350,31350,0,0,31350,Null,Null,263496651,111461,2
263496657,0.0,0.0,128250,128250,0,0,128250,Null,Null,263496657,111461,2
263496668,0.0,0.0,42750,42750,0,0,42750,Null,Null,263496668,111461,2
263496675,0.0,0.0,43700,43700,0,0,43700,Null,Null,263496675,111461,2
263496679,0.0,0.0,110200,110200,0,0,110200,Null,Null,263496679,111461,2
263496690,0.0,0.0,99750,99750,0,0,99750,Null,Null,263496690,111461,2
263496691,0.0,0.0,461700,461700,0,0,461700,Null,Null,263496691,111461,2
263496701,0.0,0.0,92150,92150,0,0,92150,Null,Null,263496701,111461,2
263496702,0.0,0.0,26600,26600,0,0,26600,Null,Null,263496702,111461,2
263496704,0.0,0.0,10450,10450,0,0,10450,Null,Null,263496704,111461,2
263496706,0.0,0.0,152000,152000,0,0,152000,Null,Null,263496706,111461,2
263496711,0.0,0.0,278350,278350,0,0,278350,Null,Null,263496711,111461,2
263496716,0.0,0.0,42750,42750,0,0,42750,Null,Null,263496716,111461,2
263496725,0.0,0.0,25650,25650,0,0,25650,Null,Null,263496725,111461,2
263496726,0.0,0.0,52250,52250,0,0,52250,Null,Null,263496726,111461,2
263496727,0.0,0.0,15200,15200,0,0,15200,Null,Null,263496727,111461,2
263496729,0.0,0.0,110200,110200,0,0,110200,Null,Null,263496729,111461,2
263496733,0.0,0.0,185250,185250,0,0,185250,Null,Null,263496733,111461,2
263496737,0.0,0.0,95000,95000,0,0,95000,Null,Null,263496737,111461,2
263496762,0.0,0.0,311000,311000,0,0,311000,Null,Null,263496762,111461,2
263496763,0.0,0.0,57950,57950,0,0,57950,Null,Null,263496763,111461,2
263496765,0.0,0.0,61750,61750,0,0,61750,Null,Null,263496765,111461,2
263496776,0.0,0.0,57000,57000,0,0,57000,Null,Null,263496776,111461,2
263496777,0.0,0.0,26600,26600,0,0,26600,Null,Null,263496777,111461,2
263496778,0.0,0.0,93100,93100,0,0,93100,Null,Null,263496778,111461,2
263496779,0.0,0.0,90250,90250,0,0,90250,Null,Null,263496779,111461,2
263496785,0.0,0.0,175750,175750,0,0,175750,Null,Null,263496785,111461,2
263496788,0.0,0.0,202350,202350,0,0,202350,Null,Null,263496788,111461,2
263496796,0.0,0.0,172900,172900,0,0,172900,Null,Null,263496796,111461,2
263496798,0.0,0.0,5700,5700,0,0,5700,Null,Null,263496798,111461,2
263496801,0.0,0.0,52250,52250,0,0,52250,Null,Null,263496801,111461,2
263496803,0.0,0.0,47500,47500,0,0,47500,Null,Null,263496803,111461,2
263496805,0.0,0.0,37050,37050,0,0,37050,Null,Null,263496805,111461,2
263496808,0.0,0.0,94050,94050,0,0,94050,Null,Null,263496808,111461,2
263496810,0.0,0.0,139650,139650,0,0,139650,Null,Null,263496810,111461,2
263496827,0.0,0.0,23750,23750,0,0,23750,Null,Null,263496827,111461,2
263496829,0.0,0.0,19000,19000,0,0,19000,Null,Null,263496829,111461,2
263496831,0.0,0.0,76000,76000,0,0,76000,Null,Null,263496831,111461,2
263496832,0.0,0.0,90000,90000,0,0,90000,Null,Null,263496832,111461,2
263496834,0.0,0.0,54150,54150,0,0,54150,Null,Null,263496834,111461,2
263496842,0.0,0.0,802750,802750,0,0,802750,Null,Null,263496842,111461,2
263496845,0.0,0.0,74100,74100,0,0,74100,Null,Null,263496845,111461,2
263496854,0.0,0.0,41800,41800,0,0,41800,Null,Null,263496854,111461,2
263496855,0.0,0.0,80750,80750,0,0,80750,Null,Null,263496855,111461,2
263496856,0.0,0.0,611800,611800,0,0,611800,Null,Null,263496856,111461,2
263496857,0.0,0.0,49400,49400,0,0,49400,Null,Null,263496857,111461,2
263496858,0.0,0.0,47500,47500,0,0,47500,Null,Null,263496858,111461,2
263496872,0.0,0.0,51300,51300,0,0,51300,Null,Null,263496872,111461,2
263496884,0.0,0.0,48450,48450,0,0,48450,Null,Null,263496884,111461,2
263496886,0.0,0.0,245000,245000,0,0,245000,Null,Null,263496886,111461,2
263496895,0.0,0.0,38000,38000,0,0,38000,Null,Null,263496895,111461,2
263496896,0.0,0.0,11400,11400,0,0,11400,Null,Null,263496896,111461,2
263496900,0.0,0.0,122000,122000,0,0,122000,Null,Null,263496900,111461,2
263496901,0.0,0.0,11400,11400,0,0,11400,Null,Null,263496901,111461,2
263496905,0.0,0.0,15200,15200,0,0,15200,Null,Null,263496905,111461,2
263496907,0.0,0.0,332500,332500,0,0,332500,Null,Null,263496907,111461,2
263496910,0.0,0.0,11400,11400,0,0,11400,Null,Null,263496910,111461,2
263496920,0.0,0.0,104500,104500,0,0,104500,Null,Null,263496920,111461,2
263496923,0.0,0.0,99750,99750,0,0,99750,Null,Null,263496923,111461,2
263496927,0.0,0.0,32300,32300,0,0,32300,Null,Null,263496927,111461,2
263496930,0.0,0.0,273600,273600,0,0,273600,Null,Null,263496930,111461,2
263496932,0.0,0.0,36100,36100,0,0,36100,Null,Null,263496932,111461,2
263496936,0.0,0.0,88350,88350,0,0,88350,Null,Null,263496936,111461,2
263496937,0.0,0.0,46550,46550,0,0,46550,Null,Null,263496937,111461,2
263496939,0.0,0.0,47500,47500,0,0,47500,Null,Null,263496939,111461,2
263496947,0.0,0.0,41800,41800,0,0,41800,Null,Null,263496947,111461,2
263496948,0.0,0.0,204250,204250,0,0,204250,Null,Null,263496948,111461,2
263496949,0.0,0.0,9500,9500,0,0,9500,Null,Null,263496949,111461,2
263496950,0.0,0.0,52250,52250,0,0,52250,Null,Null,263496950,111461,2
263496955,0.0,0.0,23750,23750,0,0,23750,Null,Null,263496955,111461,2
263496957,0.0,0.0,55100,55100,0,0,55100,Null,Null,263496957,111461,2
263496962,0.0,0.0,84550,84550,0,0,84550,Null,Null,263496962,111461,2
263496964,0.0,0.0,16150,16150,0,0,16150,Null,Null,263496964,111461,2
263496965,0.0,0.0,27550,27550,0,0,27550,Null,Null,263496965,111461,2
263496968,0.0,0.0,41800,41800,0,0,41800,Null,Null,263496968,111461,2
263496970,0.0,0.0,528200,528200,0,0,528200,Null,Null,263496970,111461,2
263496975,0.0,0.0,92150,92150,0,0,92150,Null,Null,263496975,111461,2
263496976,0.0,0.0,43700,43700,0,0,43700,Null,Null,263496976,111461,2
263496977,0.0,0.0,20900,20900,0,0,20900,Null,Null,263496977,111461,2
263496978,0.0,0.0,104500,104500,0,0,104500,Null,Null,263496978,111461,2
263496985,0.0,0.0,72200,72200,0,0,72200,Null,Null,263496985,111461,2
263496989,0.0,0.0,22800,22800,0,0,22800,Null,Null,263496989,111461,2
263496993,0.0,0.0,45600,45600,0,0,45600,Null,Null,263496993,111461,2
263496998,0.0,0.0,99750,99750,0,0,99750,Null,Null,263496998,111461,2
263497001,0.0,0.0,8550,8550,0,0,8550,Null,Null,263497001,111461,2
263497002,0.0,0.0,190000,190000,0,0,190000,Null,Null,263497002,111461,2
263497005,0.0,0.0,63650,63650,0,0,63650,Null,Null,263497005,111461,2
263497008,0.0,0.0,41800,41800,0,0,41800,Null,Null,263497008,111461,2
263497014,0.0,0.0,133000,133000,0,0,133000,Null,Null,263497014,111461,2
263497016,0.0,0.0,64600,64600,0,0,64600,Null,Null,263497016,111461,2
263497026,0.0,0.0,32300,32300,0,0,32300,Null,Null,263497026,111461,2
263497036,0.0,0.0,22800,22800,0,0,22800,Null,Null,263497036,111461,2
263497039,0.0,0.0,123500,123500,0,0,123500,Null,Null,263497039,111461,2
263497050,0.0,0.0,167200,167200,0,0,167200,Null,Null,263497050,111461,2
263497051,0.0,0.0,52250,52250,0,0,52250,Null,Null,263497051,111461,2
263497054,0.0,0.0,38950,38950,0,0,38950,Null,Null,263497054,111461,2
263497063,0.0,0.0,195700,195700,0,0,195700,Null,Null,263497063,111461,2
263497064,0.0,0.0,26600,26600,0,0,26600,Null,Null,263497064,111461,2
263497065,0.0,0.0,185250,185250,0,0,185250,Null,Null,263497065,111461,2
263497067,0.0,0.0,204250,204250,0,0,204250,Null,Null,263497067,111461,2
263497068,0.0,0.0,280250,280250,0,0,280250,Null,Null,263497068,111461,2
263497070,0.0,0.0,167200,167200,0,0,167200,Null,Null,263497070,111461,2
263497075,0.0,0.0,39900,39900,0,0,39900,Null,Null,263497075,111461,2
263497079,0.0,0.0,102600,102600,0,0,102600,Null,Null,263497079,111461,2
263497083,0.0,0.0,214000,214000,0,0,214000,Null,Null,263497083,111461,2
263497103,0.0,0.0,76000,76000,0,0,76000,Null,Null,263497103,111461,2
263497105,0.0,0.0,94050,94050,0,0,94050,Null,Null,263497105,111461,2
263497107,0.0,0.0,228950,228950,0,0,228950,Null,Null,263497107,111461,2
263497115,0.0,0.0,94050,94050,0,0,94050,Null,Null,263497115,111461,2
263497132,0.0,0.0,152000,152000,0,0,152000,Null,Null,263497132,111461,2
263497136,0.0,0.0,60800,60800,0,0,60800,Null,Null,263497136,111461,2
263497143,0.0,0.0,495900,495900,0,0,495900,Null,Null,263497143,111461,2
263497145,0.0,0.0,81700,81700,0,0,81700,Null,Null,263497145,111461,2
263497146,0.0,0.0,80750,80750,0,0,80750,Null,Null,263497146,111461,2
263497147,0.0,0.0,104500,104500,0,0,104500,Null,Null,263497147,111461,2
263497148,0.0,0.0,26600,26600,0,0,26600,Null,Null,263497148,111461,2
263497156,0.0,0.0,52250,52250,0,0,52250,Null,Null,263497156,111461,2
263497157,0.0,0.0,389500,389500,0,0,389500,Null,Null,263497157,111461,2
263497159,0.0,0.0,93100,93100,0,0,93100,Null,Null,263497159,111461,2
263497163,0.0,0.0,9500,9500,0,0,9500,Null,Null,263497163,111461,2
263497168,0.0,0.0,56050,56050,0,0,56050,Null,Null,263497168,111461,2
263497170,0.0,0.0,589000,589000,0,0,589000,Null,Null,263497170,111461,2
263497175,0.0,0.0,731500,731500,0,0,731500,Null,Null,263497175,111461,2
263497179,0.0,0.0,134900,134900,0,0,134900,Null,Null,263497179,111461,2
263497188,0.0,0.0,36100,36100,0,0,36100,Null,Null,263497188,111461,2
263497189,0.0,0.0,271700,271700,0,0,271700,Null,Null,263497189,111461,2
263497190,0.0,0.0,190000,190000,0,0,190000,Null,Null,263497190,111461,2
263497196,0.0,0.0,11400,11400,0,0,11400,Null,Null,263497196,111461,2
263497200,0.0,0.0,36100,36100,0,0,36100,Null,Null,263497200,111461,2
263497201,0.0,0.0,90000,90000,0,0,90000,Null,Null,263497201,111461,2
263497207,0.0,0.0,47500,47500,0,0,47500,Null,Null,263497207,111461,2
263497209,0.0,0.0,142500,142500,0,0,142500,Null,Null,263497209,111461,2
263497213,0.0,0.0,278350,278350,0,0,278350,Null,Null,263497213,111461,2
263497214,0.0,0.0,42750,42750,0,0,42750,Null,Null,263497214,111461,2
263497225,0.0,0.0,184300,184300,0,0,184300,Null,Null,263497225,111461,2
263497229,0.0,0.0,85500,85500,0,0,85500,Null,Null,263497229,111461,2
263497237,0.0,0.0,940500,940500,0,0,940500,Null,Null,263497237,111461,2
263497239,0.0,0.0,41800,41800,0,0,41800,Null,Null,263497239,111461,2
263497241,0.0,0.0,13300,13300,0,0,13300,Null,Null,263497241,111461,2
263497252,0.0,0.0,168150,168150,0,0,168150,Null,Null,263497252,111461,2
263497254,0.0,0.0,495900,495900,0,0,495900,Null,Null,263497254,111461,2
263497257,0.0,0.0,142500,142500,0,0,142500,Null,Null,263497257,111461,2
263497259,0.0,0.0,99750,99750,0,0,99750,Null,Null,263497259,111461,2
263497262,0.0,0.0,52250,52250,0,0,52250,Null,Null,263497262,111461,2
263497267,0.0,0.0,41800,41800,0,0,41800,Null,Null,263497267,111461,2
263497271,0.0,0.0,23750,23750,0,0,23750,Null,Null,263497271,111461,2
263497275,0.0,0.0,11400,11400,0,0,11400,Null,Null,263497275,111461,2
263497277,0.0,0.0,118750,118750,0,0,118750,Null,Null,263497277,111461,2
263497281,0.0,0.0,271700,271700,0,0,271700,Null,Null,263497281,111461,2
263497286,0.0,0.0,95000,95000,0,0,95000,Null,Null,263497286,111461,2
263497288,0.0,0.0,68400,68400,0,0,68400,Null,Null,263497288,111461,2
263497290,0.0,0.0,11400,11400,0,0,11400,Null,Null,263497290,111461,2
263497298,0.0,0.0,81700,81700,0,0,81700,Null,Null,263497298,111461,2
263497300,0.0,0.0,11400,11400,0,0,11400,Null,Null,263497300,111461,2
263497306,0.0,0.0,95000,95000,0,0,95000,Null,Null,263497306,111461,2
263497310,0.0,0.0,142500,142500,0,0,142500,Null,Null,263497310,111461,2
263497311,0.0,0.0,104500,104500,0,0,104500,Null,Null,263497311,111461,2
263497314,0.0,0.0,104500,104500,0,0,104500,Null,Null,263497314,111461,2
263497315,0.0,0.0,24700,24700,0,0,24700,Null,Null,263497315,111461,2
263497320,0.0,0.0,51000,51000,0,0,51000,Null,Null,263497320,111461,2
263497332,0.0,0.0,52250,52250,0,0,52250,Null,Null,263497332,111461,2
263497340,0.0,0.0,48450,48450,0,0,48450,Null,Null,263497340,111461,2
263497347,0.0,0.0,389500,389500,0,0,389500,Null,Null,263497347,111461,2
263497352,0.0,0.0,49400,49400,0,0,49400,Null,Null,263497352,111461,2
263497354,0.0,0.0,38950,38950,0,0,38950,Null,Null,263497354,111461,2
263497365,0.0,0.0,28500,28500,0,0,28500,Null,Null,263497365,111461,2
263497366,0.0,0.0,54150,54150,0,0,54150,Null,Null,263497366,111461,2
263497369,0.0,0.0,76950,76950,0,0,76950,Null,Null,263497369,111461,2
263497371,0.0,0.0,15200,15200,0,0,15200,Null,Null,263497371,111461,2
263497374,0.0,0.0,185250,185250,0,0,185250,Null,Null,263497374,111461,2
263497375,0.0,0.0,261250,261250,0,0,261250,Null,Null,263497375,111461,2
263497376,0.0,0.0,69350,69350,0,0,69350,Null,Null,263497376,111461,2
263497378,0.0,0.0,16150,16150,0,0,16150,Null,Null,263497378,111461,2
263497382,0.0,0.0,47500,47500,0,0,47500,Null,Null,263497382,111461,2
263497383,0.0,0.0,41800,41800,0,0,41800,Null,Null,263497383,111461,2
263497384,0.0,0.0,71250,71250,0,0,71250,Null,Null,263497384,111461,2
263497386,0.0,0.0,99750,99750,0,0,99750,Null,Null,263497386,111461,2
263497390,0.0,0.0,22800,22800,0,0,22800,Null,Null,263497390,111461,2
263497393,0.0,0.0,94050,94050,0,0,94050,Null,Null,263497393,111461,2
263497395,0.0,0.0,38000,38000,0,0,38000,Null,Null,263497395,111461,2
263497401,0.0,0.0,123500,123500,0,0,123500,Null,Null,263497401,111461,2
263497407,0.0,0.0,142500,142500,0,0,142500,Null,Null,263497407,111461,2
263497408,0.0,0.0,32300,32300,0,0,32300,Null,Null,263497408,111461,2
263497412,0.0,0.0,48450,48450,0,0,48450,Null,Null,263497412,111461,2
263497413,0.0,0.0,81700,81700,0,0,81700,Null,Null,263497413,111461,2
263497415,0.0,0.0,35150,35150,0,0,35150,Null,Null,263497415,111461,2
263497417,0.0,0.0,32300,32300,0,0,32300,Null,Null,263497417,111461,2
263497419,0.0,0.0,228950,228950,0,0,228950,Null,Null,263497419,111461,2
263497422,0.0,0.0,91200,91200,0,0,91200,Null,Null,263497422,111461,2
263497430,0.0,0.0,94050,94050,0,0,94050,Null,Null,263497430,111461,2
263497432,0.0,0.0,68400,68400,0,0,68400,Null,Null,263497432,111461,2
263497439,0.0,0.0,43700,43700,0,0,43700,Null,Null,263497439,111461,2
263497442,0.0,0.0,81700,81700,0,0,81700,Null,Null,263497442,111461,2
263497446,0.0,0.0,96900,96900,0,0,96900,Null,Null,263497446,111461,2
263497447,0.0,0.0,56050,56050,0,0,56050,Null,Null,263497447,111461,2
263497452,0.0,0.0,206150,206150,0,0,206150,Null,Null,263497452,111461,2
263497454,0.0,0.0,222300,222300,0,0,222300,Null,Null,263497454,111461,2
263497456,0.0,0.0,24700,24700,0,0,24700,Null,Null,263497456,111461,2
263497458,0.0,0.0,36100,36100,0,0,36100,Null,Null,263497458,111461,2
263497459,0.0,0.0,19000,19000,0,0,19000,Null,Null,263497459,111461,2
263497460,0.0,0.0,28500,28500,0,0,28500,Null,Null,263497460,111461,2
263497463,0.0,0.0,34200,34200,0,0,34200,Null,Null,263497463,111461,2
263497464,0.0,0.0,528200,528200,0,0,528200,Null,Null,263497464,111461,2
263497468,0.0,0.0,31350,31350,0,0,31350,Null,Null,263497468,111461,2
263497480,0.0,0.0,11400,11400,0,0,11400,Null,Null,263497480,111461,2
263497482,0.0,0.0,63650,63650,0,0,63650,Null,Null,263497482,111461,2
263497485,0.0,0.0,46550,46550,0,0,46550,Null,Null,263497485,111461,2
263497495,0.0,0.0,96900,96900,0,0,96900,Null,Null,263497495,111461,2
263497498,0.0,0.0,23750,23750,0,0,23750,Null,Null,263497498,111461,2
263497500,0.0,0.0,90250,90250,0,0,90250,Null,Null,263497500,111461,2
263497501,0.0,0.0,111150,111150,0,0,111150,Null,Null,263497501,111461,2
263497506,0.0,0.0,940500,940500,0,0,940500,Null,Null,263497506,111461,2
263497511,0.0,0.0,15200,15200,0,0,15200,Null,Null,263497511,111461,2
263497514,0.0,0.0,185250,185250,0,0,185250,Null,Null,263497514,111461,2
263497519,0.0,0.0,28500,28500,0,0,28500,Null,Null,263497519,111461,2
263497521,0.0,0.0,12350,12350,0,0,12350,Null,Null,263497521,111461,2
263497524,0.0,0.0,43700,43700,0,0,43700,Null,Null,263497524,111461,2
263497527,0.0,0.0,36100,36100,0,0,36100,Null,Null,263497527,111461,2
263497541,0.0,0.0,99750,99750,0,0,99750,Null,Null,263497541,111461,2
263497542,0.0,0.0,71250,71250,0,0,71250,Null,Null,263497542,111461,2
263497543,0.0,0.0,57000,57000,0,0,57000,Null,Null,263497543,111461,2
263497549,0.0,0.0,23750,23750,0,0,23750,Null,Null,263497549,111461,2
263497551,0.0,0.0,88350,88350,0,0,88350,Null,Null,263497551,111461,2
263497553,0.0,0.0,322000,322000,0,0,322000,Null,Null,263497553,111461,2
263497554,0.0,0.0,37050,37050,0,0,37050,Null,Null,263497554,111461,2
263497558,0.0,0.0,14250,14250,0,0,14250,Null,Null,263497558,111461,2
263497559,0.0,0.0,25650,25650,0,0,25650,Null,Null,263497559,111461,2
263497561,0.0,0.0,204250,204250,0,0,204250,Null,Null,263497561,111461,2
263497564,0.0,0.0,64600,64600,0,0,64600,Null,Null,263497564,111461,2
263497566,0.0,0.0,104500,104500,0,0,104500,Null,Null,263497566,111461,2
263497569,0.0,0.0,34200,34200,0,0,34200,Null,Null,263497569,111461,2
263497573,0.0,0.0,611800,611800,0,0,611800,Null,Null,263497573,111461,2
263497575,0.0,0.0,104500,104500,0,0,104500,Null,Null,263497575,111461,2
263497578,0.0,0.0,11400,11400,0,0,11400,Null,Null,263497578,111461,2
263497581,0.0,0.0,142500,142500,0,0,142500,Null,Null,263497581,111461,2
263497601,0.0,0.0,11400,11400,0,0,11400,Null,Null,263497601,111461,2
263497607,0.0,0.0,175750,175750,0,0,175750,Null,Null,263497607,111461,2
263497613,0.0,0.0,149150,149150,0,0,149150,Null,Null,263497613,111461,2
263497614,0.0,0.0,35150,35150,0,0,35150,Null,Null,263497614,111461,2
263497617,0.0,0.0,149150,149150,0,0,149150,Null,Null,263497617,111461,2
263497624,0.0,0.0,11400,11400,0,0,11400,Null,Null,263497624,111461,2
263497628,0.0,0.0,8550,8550,0,0,8550,Null,Null,263497628,111461,2
263497629,0.0,0.0,94050,94050,0,0,94050,Null,Null,263497629,111461,2
263497630,0.0,0.0,104500,104500,0,0,104500,Null,Null,263497630,111461,2
263497632,0.0,0.0,73150,73150,0,0,73150,Null,Null,263497632,111461,2
263497637,0.0,0.0,13300,13300,0,0,13300,Null,Null,263497637,111461,2
263497641,0.0,0.0,33250,33250,0,0,33250,Null,Null,263497641,111461,2
263497646,0.0,0.0,20900,20900,0,0,20900,Null,Null,263497646,111461,2
263497648,0.0,0.0,461700,461700,0,0,461700,Null,Null,263497648,111461,2
263497659,0.0,0.0,52250,52250,0,0,52250,Null,Null,263497659,111461,2
263497662,0.0,0.0,133000,133000,0,0,133000,Null,Null,263497662,111461,2
263497678,0.0,0.0,204250,204250,0,0,204250,Null,Null,263497678,111461,2
263497680,0.0,0.0,145350,145350,0,0,145350,Null,Null,263497680,111461,2
263497681,0.0,0.0,31350,31350,0,0,31350,Null,Null,263497681,111461,2
263497684,0.0,0.0,88350,88350,0,0,88350,Null,Null,263497684,111461,2
263497694,0.0,0.0,11400,11400,0,0,11400,Null,Null,263497694,111461,2
263497697,0.0,0.0,36100,36100,0,0,36100,Null,Null,263497697,111461,2
263497701,0.0,0.0,42750,42750,0,0,42750,Null,Null,263497701,111461,2
263497702,0.0,0.0,10450,10450,0,0,10450,Null,Null,263497702,111461,2
263497707,0.0,0.0,110200,110200,0,0,110200,Null,Null,263497707,111461,2
263497708,0.0,0.0,17100,17100,0,0,17100,Null,Null,263497708,111461,2
263497712,0.0,0.0,52250,52250,0,0,52250,Null,Null,263497712,111461,2
263497719,0.0,0.0,14250,14250,0,0,14250,Null,Null,263497719,111461,2
263497721,0.0,0.0,139650,139650,0,0,139650,Null,Null,263497721,111461,2
263497723,0.0,0.0,47500,47500,0,0,47500,Null,Null,263497723,111461,2
263497725,0.0,0.0,94050,94050,0,0,94050,Null,Null,263497725,111461,2
263497731,0.0,0.0,14250,14250,0,0,14250,Null,Null,263497731,111461,2
263497732,0.0,0.0,202350,202350,0,0,202350,Null,Null,263497732,111461,2
263497751,0.0,0.0,31350,31350,0,0,31350,Null,Null,263497751,111461,2
263497754,0.0,0.0,51300,51300,0,0,51300,Null,Null,263497754,111461,2
263497758,0.0,0.0,204250,204250,0,0,204250,Null,Null,263497758,111461,2
263497762,0.0,0.0,122550,122550,0,0,122550,Null,Null,263497762,111461,2
263497763,0.0,0.0,79800,79800,0,0,79800,Null,Null,263497763,111461,2
263497765,0.0,0.0,28500,28500,0,0,28500,Null,Null,263497765,111461,2
263497766,0.0,0.0,185250,185250,0,0,185250,Null,Null,263497766,111461,2
263497769,0.0,0.0,185250,185250,0,0,185250,Null,Null,263497769,111461,2
263497770,0.0,0.0,11400,11400,0,0,11400,Null,Null,263497770,111461,2
263497771,0.0,0.0,80750,80750,0,0,80750,Null,Null,263497771,111461,2
263497782,0.0,0.0,185250,185250,0,0,185250,Null,Null,263497782,111461,2
263497784,0.0,0.0,665000,665000,0,0,665000,Null,Null,263497784,111461,2
263497785,0.0,0.0,56050,56050,0,0,56050,Null,Null,263497785,111461,2
263497792,0.0,0.0,332500,332500,0,0,332500,Null,Null,263497792,111461,2
263497793,0.0,0.0,85500,85500,0,0,85500,Null,Null,263497793,111461,2
263497796,0.0,0.0,39900,39900,0,0,39900,Null,Null,263497796,111461,2
263497804,0.0,0.0,104500,104500,0,0,104500,Null,Null,263497804,111461,2
263497806,0.0,0.0,280250,280250,0,0,280250,Null,Null,263497806,111461,2
263497807,0.0,0.0,91200,91200,0,0,91200,Null,Null,263497807,111461,2
263497808,0.0,0.0,273600,273600,0,0,273600,Null,Null,263497808,111461,2
263497814,0.0,0.0,12350,12350,0,0,12350,Null,Null,263497814,111461,2
263497818,0.0,0.0,52250,52250,0,0,52250,Null,Null,263497818,111461,2
263497822,0.0,0.0,28500,28500,0,0,28500,Null,Null,263497822,111461,2
263497827,0.0,0.0,102600,102600,0,0,102600,Null,Null,263497827,111461,2
263497837,0.0,0.0,63650,63650,0,0,63650,Null,Null,263497837,111461,2
263497844,0.0,0.0,142500,142500,0,0,142500,Null,Null,263497844,111461,2
263497845,0.0,0.0,39900,39900,0,0,39900,Null,Null,263497845,111461,2
263497849,0.0,0.0,20900,20900,0,0,20900,Null,Null,263497849,111461,2
263497850,0.0,0.0,74100,74100,0,0,74100,Null,Null,263497850,111461,2
263497851,0.0,0.0,5700,5700,0,0,5700,Null,Null,263497851,111461,2
263497856,0.0,0.0,152000,152000,0,0,152000,Null,Null,263497856,111461,2
263497857,0.0,0.0,611800,611800,0,0,611800,Null,Null,263497857,111461,2
263497860,0.0,0.0,118750,118750,0,0,118750,Null,Null,263497860,111461,2
263497889,0.0,0.0,528200,528200,0,0,528200,Null,Null,263497889,111461,2
263497890,0.0,0.0,110200,110200,0,0,110200,Null,Null,263497890,111461,2
263497891,0.0,0.0,123500,123500,0,0,123500,Null,Null,263497891,111461,2
263497900,0.0,0.0,93100,93100,0,0,93100,Null,Null,263497900,111461,2
263497911,0.0,0.0,41800,41800,0,0,41800,Null,Null,263497911,111461,2
263497921,0.0,0.0,665000,665000,0,0,665000,Null,Null,263497921,111461,2
263497922,0.0,0.0,41800,41800,0,0,41800,Null,Null,263497922,111461,2
263497925,0.0,0.0,122000,122000,0,0,122000,Null,Null,263497925,111461,2
263497930,0.0,0.0,731500,731500,0,0,731500,Null,Null,263497930,111461,2
263497933,0.0,0.0,57000,57000,0,0,57000,Null,Null,263497933,111461,2
263497934,0.0,0.0,31350,31350,0,0,31350,Null,Null,263497934,111461,2
263497935,0.0,0.0,731500,731500,0,0,731500,Null,Null,263497935,111461,2
263497936,0.0,0.0,110200,110200,0,0,110200,Null,Null,263497936,111461,2
263497946,0.0,0.0,17100,17100,0,0,17100,Null,Null,263497946,111461,2
263497949,0.0,0.0,206150,206150,0,0,206150,Null,Null,263497949,111461,2
263497950,0.0,0.0,461700,461700,0,0,461700,Null,Null,263497950,111461,2
263497951,0.0,0.0,152000,152000,0,0,152000,Null,Null,263497951,111461,2
263497953,0.0,0.0,122000,122000,0,0,122000,Null,Null,263497953,111461,2
263497964,0.0,0.0,142500,142500,0,0,142500,Null,Null,263497964,111461,2
263497968,0.0,0.0,56050,56050,0,0,56050,Null,Null,263497968,111461,2
263497971,0.0,0.0,102600,102600,0,0,102600,Null,Null,263497971,111461,2
263497972,0.0,0.0,51300,51300,0,0,51300,Null,Null,263497972,111461,2
263497977,0.0,0.0,52250,52250,0,0,52250,Null,Null,263497977,111461,2
263497992,0.0,0.0,43700,43700,0,0,43700,Null,Null,263497992,111461,2
263498003,0.0,0.0,52250,52250,0,0,52250,Null,Null,263498003,111461,2
263498004,0.0,0.0,104500,104500,0,0,104500,Null,Null,263498004,111461,2
263498016,0.0,0.0,76950,76950,0,0,76950,Null,Null,263498016,111461,2
263498017,0.0,0.0,48450,48450,0,0,48450,Null,Null,263498017,111461,2
263498021,0.0,0.0,589000,589000,0,0,589000,Null,Null,263498021,111461,2
263498023,0.0,0.0,222300,222300,0,0,222300,Null,Null,263498023,111461,2
263498028,0.0,0.0,15200,15200,0,0,15200,Null,Null,263498028,111461,2
263498029,0.0,0.0,61750,61750,0,0,61750,Null,Null,263498029,111461,2
263498032,0.0,0.0,92150,92150,0,0,92150,Null,Null,263498032,111461,2
263498039,0.0,0.0,37050,37050,0,0,37050,Null,Null,263498039,111461,2
263498042,0.0,0.0,133000,133000,0,0,133000,Null,Null,263498042,111461,2
263498047,0.0,0.0,245000,245000,0,0,245000,Null,Null,263498047,111461,2
263498049,0.0,0.0,11400,11400,0,0,11400,Null,Null,263498049,111461,2
263498055,0.0,0.0,47500,47500,0,0,47500,Null,Null,263498055,111461,2
263498056,0.0,0.0,172900,172900,0,0,172900,Null,Null,263498056,111461,2
263498060,0.0,0.0,46550,46550,0,0,46550,Null,Null,263498060,111461,2
263498062,0.0,0.0,10450,10450,0,0,10450,Null,Null,263498062,111461,2
263498066,0.0,0.0,9500,9500,0,0,9500,Null,Null,263498066,111461,2
263498068,0.0,0.0,802750,802750,0,0,802750,Null,Null,263498068,111461,2
263498070,0.0,0.0,165000,165000,0,0,165000,Null,Null,263498070,111461,2
263498072,0.0,0.0,184300,184300,0,0,184300,Null,Null,263498072,111461,2
263498073,0.0,0.0,22800,22800,0,0,22800,Null,Null,263498073,111461,2
263498074,0.0,0.0,185250,185250,0,0,185250,Null,Null,263498074,111461,2
263498080,0.0,0.0,95000,95000,0,0,95000,Null,Null,263498080,111461,2
263498083,0.0,0.0,202350,202350,0,0,202350,Null,Null,263498083,111461,2
263498094,0.0,0.0,31350,31350,0,0,31350,Null,Null,263498094,111461,2
263498096,0.0,0.0,16150,16150,0,0,16150,Null,Null,263498096,111461,2
263498097,0.0,0.0,11400,11400,0,0,11400,Null,Null,263498097,111461,2
263498103,0.0,0.0,73150,73150,0,0,73150,Null,Null,263498103,111461,2
263498109,0.0,0.0,28500,28500,0,0,28500,Null,Null,263498109,111461,2
263498118,0.0,0.0,28500,28500,0,0,28500,Null,Null,263498118,111461,2
263498121,0.0,0.0,54150,54150,0,0,54150,Null,Null,263498121,111461,2
263498122,0.0,0.0,589000,589000,0,0,589000,Null,Null,263498122,111461,2
263498129,0.0,0.0,104500,104500,0,0,104500,Null,Null,263498129,111461,2
263498137,0.0,0.0,195700,195700,0,0,195700,Null,Null,263498137,111461,2
263498143,0.0,0.0,72200,72200,0,0,72200,Null,Null,263498143,111461,2
263498144,0.0,0.0,19000,19000,0,0,19000,Null,Null,263498144,111461,2
263498147,0.0,0.0,55100,55100,0,0,55100,Null,Null,263498147,111461,2
263498148,0.0,0.0,167200,167200,0,0,167200,Null,Null,263498148,111461,2
263498149,0.0,0.0,11400,11400,0,0,11400,Null,Null,263498149,111461,2
263498150,0.0,0.0,11400,11400,0,0,11400,Null,Null,263498150,111461,2
263498153,0.0,0.0,23750,23750,0,0,23750,Null,Null,263498153,111461,2
263498155,0.0,0.0,55100,55100,0,0,55100,Null,Null,263498155,111461,2
263498162,0.0,0.0,228950,228950,0,0,228950,Null,Null,263498162,111461,2
263498166,0.0,0.0,14250,14250,0,0,14250,Null,Null,263498166,111461,2
263498168,0.0,0.0,19000,19000,0,0,19000,Null,Null,263498168,111461,2
263498173,0.0,0.0,93100,93100,0,0,93100,Null,Null,263498173,111461,2
263498180,0.0,0.0,11400,11400,0,0,11400,Null,Null,263498180,111461,2
263498192,0.0,0.0,9500,9500,0,0,9500,Null,Null,263498192,111461,2
263498195,0.0,0.0,280250,280250,0,0,280250,Null,Null,263498195,111461,2
263498200,0.0,0.0,185250,185250,0,0,185250,Null,Null,263498200,111461,2
263498204,0.0,0.0,122550,122550,0,0,122550,Null,Null,263498204,111461,2
263498206,0.0,0.0,175750,175750,0,0,175750,Null,Null,263498206,111461,2
263498207,0.0,0.0,72200,72200,0,0,72200,Null,Null,263498207,111461,2
263498211,0.0,0.0,60800,60800,0,0,60800,Null,Null,263498211,111461,2
263498219,0.0,0.0,11400,11400,0,0,11400,Null,Null,263498219,111461,2
263498220,0.0,0.0,43700,43700,0,0,43700,Null,Null,263498220,111461,2
263498221,0.0,0.0,39900,39900,0,0,39900,Null,Null,263498221,111461,2
263498231,0.0,0.0,142500,142500,0,0,142500,Null,Null,263498231,111461,2
263498237,0.0,0.0,118750,118750,0,0,118750,Null,Null,263498237,111461,2
263498238,0.0,0.0,63650,63650,0,0,63650,Null,Null,263498238,111461,2
263498240,0.0,0.0,204250,204250,0,0,204250,Null,Null,263498240,111461,2
263498246,0.0,0.0,261250,261250,0,0,261250,Null,Null,263498246,111461,2
263498249,0.0,0.0,24700,24700,0,0,24700,Null,Null,263498249,111461,2
263498251,0.0,0.0,85500,85500,0,0,85500,Null,Null,263498251,111461,2
263498253,0.0,0.0,94050,94050,0,0,94050,Null,Null,263498253,111461,2
263498255,0.0,0.0,52250,52250,0,0,52250,Null,Null,263498255,111461,2
263498257,0.0,0.0,309000,309000,0,0,309000,Null,Null,263498257,111461,2
263498259,0.0,0.0,278350,278350,0,0,278350,Null,Null,263498259,111461,2
263498265,0.0,0.0,38000,38000,0,0,38000,Null,Null,263498265,111461,2
263498277,0.0,0.0,142500,142500,0,0,142500,Null,Null,263498277,111461,2
263498279,0.0,0.0,91200,91200,0,0,91200,Null,Null,263498279,111461,2
263498283,0.0,0.0,128250,128250,0,0,128250,Null,Null,263498283,111461,2
263498286,0.0,0.0,16150,16150,0,0,16150,Null,Null,263498286,111461,2
263498298,0.0,0.0,168150,168150,0,0,168150,Null,Null,263498298,111461,2
263498306,0.0,0.0,110200,110200,0,0,110200,Null,Null,263498306,111461,2
263498319,0.0,0.0,22800,22800,0,0,22800,Null,Null,263498319,111461,2
263498322,0.0,0.0,190000,190000,0,0,190000,Null,Null,263498322,111461,2
263498326,0.0,0.0,84550,84550,0,0,84550,Null,Null,263498326,111461,2
263498327,0.0,0.0,39900,39900,0,0,39900,Null,Null,263498327,111461,2
263498335,0.0,0.0,142500,142500,0,0,142500,Null,Null,263498335,111461,2
263498336,0.0,0.0,56050,56050,0,0,56050,Null,Null,263498336,111461,2
263498337,0.0,0.0,63650,63650,0,0,63650,Null,Null,263498337,111461,2
263498342,0.0,0.0,16150,16150,0,0,16150,Null,Null,263498342,111461,2
263498345,0.0,0.0,71250,71250,0,0,71250,Null,Null,263498345,111461,2
263498349,0.0,0.0,68400,68400,0,0,68400,Null,Null,263498349,111461,2
263498357,0.0,0.0,43700,43700,0,0,43700,Null,Null,263498357,111461,2
263498358,0.0,0.0,36100,36100,0,0,36100,Null,Null,263498358,111461,2
263498360,0.0,0.0,111150,111150,0,0,111150,Null,Null,263498360,111461,2
263498364,0.0,0.0,206150,206150,0,0,206150,Null,Null,263498364,111461,2
263498365,0.0,0.0,145350,145350,0,0,145350,Null,Null,263498365,111461,2
263498371,0.0,0.0,9500,9500,0,0,9500,Null,Null,263498371,111461,2
263498374,0.0,0.0,134900,134900,0,0,134900,Null,Null,263498374,111461,2
263498375,0.0,0.0,48450,48450,0,0,48450,Null,Null,263498375,111461,2
263498376,0.0,0.0,104500,104500,0,0,104500,Null,Null,263498376,111461,2
263498379,0.0,0.0,23750,23750,0,0,23750,Null,Null,263498379,111461,2
263498389,0.0,0.0,41800,41800,0,0,41800,Null,Null,263498389,111461,2
263498401,0.0,0.0,81700,81700,0,0,81700,Null,Null,263498401,111461,2
263498414,0.0,0.0,23750,23750,0,0,23750,Null,Null,263498414,111461,2
263498415,0.0,0.0,32300,32300,0,0,32300,Null,Null,263498415,111461,2
263498416,0.0,0.0,16150,16150,0,0,16150,Null,Null,263498416,111461,2
263498417,0.0,0.0,149150,149150,0,0,149150,Null,Null,263498417,111461,2
263498431,0.0,0.0,27550,27550,0,0,27550,Null,Null,263498431,111461,2
263498436,0.0,0.0,128250,128250,0,0,128250,Null,Null,263498436,111461,2
263498447,0.0,0.0,39900,39900,0,0,39900,Null,Null,263498447,111461,2
263498454,0.0,0.0,152000,152000,0,0,152000,Null,Null,263498454,111461,2
263498457,0.0,0.0,389500,389500,0,0,389500,Null,Null,263498457,111461,2
263498458,0.0,0.0,589000,589000,0,0,589000,Null,Null,263498458,111461,2
263498459,0.0,0.0,71250,71250,0,0,71250,Null,Null,263498459,111461,2
263498462,0.0,0.0,52250,52250,0,0,52250,Null,Null,263498462,111461,2
263498463,0.0,0.0,71250,71250,0,0,71250,Null,Null,263498463,111461,2
263498486,0.0,0.0,99750,99750,0,0,99750,Null,Null,263498486,111461,2
263498492,0.0,0.0,47500,47500,0,0,47500,Null,Null,263498492,111461,2
263498493,0.0,0.0,51300,51300,0,0,51300,Null,Null,263498493,111461,2
263498496,0.0,0.0,13300,13300,0,0,13300,Null,Null,263498496,111461,2
263498498,0.0,0.0,94050,94050,0,0,94050,Null,Null,263498498,111461,2
263498500,0.0,0.0,93100,93100,0,0,93100,Null,Null,263498500,111461,2
263498510,0.0,0.0,26600,26600,0,0,26600,Null,Null,263498510,111461,2
263498515,0.0,0.0,23750,23750,0,0,23750,Null,Null,263498515,111461,2
263498516,0.0,0.0,261250,261250,0,0,261250,Null,Null,263498516,111461,2
263498517,0.0,0.0,185250,185250,0,0,185250,Null,Null,263498517,111461,2
263498521,0.0,0.0,142500,142500,0,0,142500,Null,Null,263498521,111461,2
263498522,0.0,0.0,57000,57000,0,0,57000,Null,Null,263498522,111461,2
263498526,0.0,0.0,99750,99750,0,0,99750,Null,Null,263498526,111461,2
263498529,0.0,0.0,76000,76000,0,0,76000,Null,Null,263498529,111461,2
263498531,0.0,0.0,11400,11400,0,0,11400,Null,Null,263498531,111461,2
263498533,0.0,0.0,142500,142500,0,0,142500,Null,Null,263498533,111461,2
263498535,0.0,0.0,172900,172900,0,0,172900,Null,Null,263498535,111461,2
263498539,0.0,0.0,93100,93100,0,0,93100,Null,Null,263498539,111461,2
263498541,0.0,0.0,17100,17100,0,0,17100,Null,Null,263498541,111461,2
263498544,0.0,0.0,90250,90250,0,0,90250,Null,Null,263498544,111461,2
263498548,0.0,0.0,332500,332500,0,0,332500,Null,Null,263498548,111461,2
263498549,0.0,0.0,23750,23750,0,0,23750,Null,Null,263498549,111461,2
263498552,0.0,0.0,12350,12350,0,0,12350,Null,Null,263498552,111461,2
263498554,0.0,0.0,48450,48450,0,0,48450,Null,Null,263498554,111461,2
263498566,0.0,0.0,104500,104500,0,0,104500,Null,Null,263498566,111461,2
263498567,0.0,0.0,11400,11400,0,0,11400,Null,Null,263498567,111461,2
263498571,0.0,0.0,256500,256500,0,0,256500,Null,Null,263498571,111461,2
263498580,0.0,0.0,41800,41800,0,0,41800,Null,Null,263498580,111461,2
263498581,0.0,0.0,49400,49400,0,0,49400,Null,Null,263498581,111461,2
263498582,0.0,0.0,41800,41800,0,0,41800,Null,Null,263498582,111461,2
263498592,0.0,0.0,142500,142500,0,0,142500,Null,Null,263498592,111461,2
263498594,0.0,0.0,9500,9500,0,0,9500,Null,Null,263498594,111461,2
263498599,0.0,0.0,57950,57950,0,0,57950,Null,Null,263498599,111461,2
263498608,0.0,0.0,51300,51300,0,0,51300,Null,Null,263498608,111461,2
263498609,0.0,0.0,23750,23750,0,0,23750,Null,Null,263498609,111461,2
263498610,0.0,0.0,42750,42750,0,0,42750,Null,Null,263498610,111461,2
263498611,0.0,0.0,33250,33250,0,0,33250,Null,Null,263498611,111461,2
263498622,0.0,0.0,222300,222300,0,0,222300,Null,Null,263498622,111461,2
263498626,0.0,0.0,940500,940500,0,0,940500,Null,Null,263498626,111461,2
263498631,0.0,0.0,23750,23750,0,0,23750,Null,Null,263498631,111461,2
263498632,0.0,0.0,8550,8550,0,0,8550,Null,Null,263498632,111461,2
263498635,0.0,0.0,23750,23750,0,0,23750,Null,Null,263498635,111461,2
263498637,0.0,0.0,39900,39900,0,0,39900,Null,Null,263498637,111461,2
263498638,0.0,0.0,81700,81700,0,0,81700,Null,Null,263498638,111461,2
263498646,0.0,0.0,152000,152000,0,0,152000,Null,Null,263498646,111461,2
263498647,0.0,0.0,25650,25650,0,0,25650,Null,Null,263498647,111461,2
263498654,0.0,0.0,36100,36100,0,0,36100,Null,Null,263498654,111461,2
263498656,0.0,0.0,58900,58900,0,0,58900,Null,Null,263498656,111461,2
263498659,0.0,0.0,22800,22800,0,0,22800,Null,Null,263498659,111461,2
263498666,0.0,0.0,134900,134900,0,0,134900,Null,Null,263498666,111461,2
263498667,0.0,0.0,42750,42750,0,0,42750,Null,Null,263498667,111461,2
263498669,0.0,0.0,271700,271700,0,0,271700,Null,Null,263498669,111461,2
263498676,0.0,0.0,23750,23750,0,0,23750,Null,Null,263498676,111461,2
263498680,0.0,0.0,57000,57000,0,0,57000,Null,Null,263498680,111461,2
263498682,0.0,0.0,802750,802750,0,0,802750,Null,Null,263498682,111461,2
263498684,0.0,0.0,28500,28500,0,0,28500,Null,Null,263498684,111461,2
263498685,0.0,0.0,11400,11400,0,0,11400,Null,Null,263498685,111461,2
263498690,0.0,0.0,56050,56050,0,0,56050,Null,Null,263498690,111461,2
263498692,0.0,0.0,74100,74100,0,0,74100,Null,Null,263498692,111461,2
263498693,0.0,0.0,35150,35150,0,0,35150,Null,Null,263498693,111461,2
263498694,0.0,0.0,26600,26600,0,0,26600,Null,Null,263498694,111461,2
263498696,0.0,0.0,28500,28500,0,0,28500,Null,Null,263498696,111461,2
263498697,0.0,0.0,495900,495900,0,0,495900,Null,Null,263498697,111461,2
263498708,0.0,0.0,47500,47500,0,0,47500,Null,Null,263498708,111461,2
263498709,0.0,0.0,5700,5700,0,0,5700,Null,Null,263498709,111461,2
263498710,0.0,0.0,45600,45600,0,0,45600,Null,Null,263498710,111461,2
263498711,0.0,0.0,256500,256500,0,0,256500,Null,Null,263498711,111461,2
263498712,0.0,0.0,33250,33250,0,0,33250,Null,Null,263498712,111461,2
263498716,0.0,0.0,38950,38950,0,0,38950,Null,Null,263498716,111461,2
263498724,0.0,0.0,69350,69350,0,0,69350,Null,Null,263498724,111461,2
263498726,0.0,0.0,64600,64600,0,0,64600,Null,Null,263498726,111461,2
263498732,0.0,0.0,245000,245000,0,0,245000,Null,Null,263498732,111461,2
263498739,0.0,0.0,17100,17100,0,0,17100,Null,Null,263498739,111461,2
263498746,0.0,0.0,90000,90000,0,0,90000,Null,Null,263498746,111461,2
263498751,0.0,0.0,14250,14250,0,0,14250,Null,Null,263498751,111461,2
263498753,0.0,0.0,56050,56050,0,0,56050,Null,Null,263498753,111461,2
263498758,0.0,0.0,47500,47500,0,0,47500,Null,Null,263498758,111461,2
263498759,0.0,0.0,96900,96900,0,0,96900,Null,Null,263498759,111461,2
263498780,0.0,0.0,15200,15200,0,0,15200,Null,Null,263498780,111461,2
263498783,0.0,0.0,76000,76000,0,0,76000,Null,Null,263498783,111461,2
263498786,0.0,0.0,11400,11400,0,0,11400,Null,Null,263498786,111461,2
263498787,0.0,0.0,34200,34200,0,0,34200,Null,Null,263498787,111461,2
263498792,0.0,0.0,36100,36100,0,0,36100,Null,Null,263498792,111461,2
263498800,0.0,0.0,52250,52250,0,0,52250,Null,Null,263498800,111461,2
263498802,0.0,0.0,139650,139650,0,0,139650,Null,Null,263498802,111461,2
263498807,0.0,0.0,57950,57950,0,0,57950,Null,Null,263498807,111461,2
263498809,0.0,0.0,63650,63650,0,0,63650,Null,Null,263498809,111461,2
263498812,0.0,0.0,195700,195700,0,0,195700,Null,Null,263498812,111461,2
263498819,0.0,0.0,95000,95000,0,0,95000,Null,Null,263498819,111461,2
263498820,0.0,0.0,45600,45600,0,0,45600,Null,Null,263498820,111461,2
263498822,0.0,0.0,61750,61750,0,0,61750,Null,Null,263498822,111461,2
263498831,0.0,0.0,47500,47500,0,0,47500,Null,Null,263498831,111461,2
263498834,0.0,0.0,76000,76000,0,0,76000,Null,Null,263498834,111461,2
263498850,0.0,0.0,273600,273600,0,0,273600,Null,Null,263498850,111461,2
263498851,0.0,0.0,99750,99750,0,0,99750,Null,Null,263498851,111461,2
263498857,0.0,0.0,19000,19000,0,0,19000,Null,Null,263498857,111461,2
263498860,0.0,0.0,79800,79800,0,0,79800,Null,Null,263498860,111461,2
263498861,0.0,0.0,32300,32300,0,0,32300,Null,Null,263498861,111461,2
263498863,0.0,0.0,165000,165000,0,0,165000,Null,Null,263498863,111461,2
263498880,0.0,0.0,19000,19000,0,0,19000,Null,Null,263498880,111461,2
263498884,0.0,0.0,58900,58900,0,0,58900,Null,Null,263498884,111461,2
263498885,0.0,0.0,43700,43700,0,0,43700,Null,Null,263498885,111461,2
263498888,0.0,0.0,27550,27550,0,0,27550,Null,Null,263498888,111461,2
263498890,0.0,0.0,185250,185250,0,0,185250,Null,Null,263498890,111461,2
263498895,0.0,0.0,51000,51000,0,0,51000,Null,Null,263498895,111461,2
263498923,0.0,0.0,51000,51000,0,0,51000,Null,Null,263498923,111461,2
263498941,0.0,0.0,214000,214000,0,0,214000,Null,Null,263498941,111461,2
263498943,0.0,0.0,6800000,6800000,0,0,6800000,Null,Null,263498943,111461,23072
263498999,0.0,0.0,279000,279000,0,0,279000,Null,Null,263498999,111461,1979
263499014,0.0,0.0,48450,48450,0,0,48450,Null,Null,263499014,111461,2
263499041,0.0,0.0,1050000,786000,264000,25,1050000,Null,Null,263499041,8181541,2340
263499068,0.0,0.0,244200,244200,0,0,244200,Null,Null,263499068,111461,2324
263499073,0.0,0.0,23800,23800,0,0,23800,Null,Null,263499073,111461,1831
263499081,0.0,0.0,15000,15000,0,0,15000,Null,Null,263499081,111461,2
263499092,0.0,0.0,3590000,3590000,0,0,3590000,Null,Null,263499092,4701461,23276
263499099,0.0,0.0,79000,79000,0,0,79000,Null,Null,263499099,111461,23168
263499110,0.0,0.0,25000,25000,0,0,25000,Null,Null,263499110,111461,2
263499112,0.0,0.0,70000,70000,0,0,70000,Null,Null,263499112,111461,28486
263499130,0.0,0.0,1369000,1369000,0,0,1369000,Null,Null,263499130,111461,23706
263499157,0.0,0.0,848000,848000,0,0,848000,Null,Null,263499157,303001,1883
263499161,0.0,0.0,1380000,1380000,0,0,1380000,Null,Null,263499161,111461,6511
263499179,0.0,0.0,259000,239000,20000,8,259000,Null,Null,263499179,243693,1819
263499181,0.0,0.0,7000000,7000000,0,0,7000000,Null,Null,263499181,111461,23072
263499543,0.0,0.0,185000,185000,0,0,185000,Null,Null,263499543,111461,1979
263499551,0.0,0.0,37800,37800,0,0,37800,Null,Null,263499551,5160827,2
263499553,0.0,0.0,36000,36000,0,0,36000,Null,Null,263499553,5160827,2
263499555,0.0,0.0,459000,459000,0,0,459000,Null,Null,263499555,5160827,2
263499557,0.0,0.0,46000,46000,0,0,46000,Null,Null,263499557,5160827,2
263499558,0.0,0.0,50150,50150,0,0,50150,Null,Null,263499558,5160827,2
263499561,0.0,0.0,339000,339000,0,0,339000,Null,Null,263499561,5160827,2
263499563,0.0,0.0,350000,350000,0,0,350000,Null,Null,263499563,5160827,2
263499565,0.0,0.0,103500,103500,0,0,103500,Null,Null,263499565,5160827,2
263499567,0.0,0.0,131000,131000,0,0,131000,Null,Null,263499567,5160827,2
263499569,0.0,0.0,230000,230000,0,0,230000,Null,Null,263499569,5160827,2
263499571,0.0,0.0,20800,20800,0,0,20800,Null,Null,263499571,5160827,2
263499576,0.0,0.0,339000,339000,0,0,339000,Null,Null,263499576,5160827,2
263499580,0.0,0.0,243500,243500,0,0,243500,Null,Null,263499580,5160827,2
263499582,0.0,0.0,229000,229000,0,0,229000,Null,Null,263499582,5160827,2
263499586,0.0,0.0,230000,230000,0,0,230000,Null,Null,263499586,5160827,2
263499589,0.0,0.0,449100,449100,0,0,449100,Null,Null,263499589,5160827,2
263499599,0.0,0.0,339000,339000,0,0,339000,Null,Null,263499599,5160827,2
263499600,0.0,0.0,225000,225000,0,0,225000,Null,Null,263499600,5160827,2
263499603,0.0,0.0,0,235000,0,0,235000,Null,Null,263499603,5160827,0
263499604,0.0,0.0,129000,129000,0,0,129000,Null,Null,263499604,5160827,2
263499607,0.0,0.0,260000,260000,0,0,260000,Null,Null,263499607,5160827,2
263499609,0.0,0.0,33000,33000,0,0,33000,Null,Null,263499609,5160827,2
263499611,0.0,0.0,575000,575000,0,0,575000,Null,Null,263499611,5160827,2
263499613,0.0,0.0,55800,55800,0,0,55800,Null,Null,263499613,5160827,2
263499614,0.0,0.0,75000,75000,0,0,75000,Null,Null,263499614,5160827,2
263499622,0.0,0.0,26100,26100,0,0,26100,Null,Null,263499622,5160827,2
263499623,0.0,0.0,322050,322050,0,0,322050,Null,Null,263499623,5160827,2
263499631,0.0,0.0,32000,32000,0,0,32000,Null,Null,263499631,5160827,2
263499633,0.0,0.0,320000,320000,0,0,320000,Null,Null,263499633,5160827,2
263499634,0.0,0.0,100000,100000,0,0,100000,Null,Null,263499634,5160827,2
263499648,0.0,0.0,20500,20500,0,0,20500,Null,Null,263499648,5160827,2
263499650,0.0,0.0,33000,33000,0,0,33000,Null,Null,263499650,5160827,2
263499652,0.0,0.0,156700,156700,0,0,156700,Null,Null,263499652,5160827,2
263499654,0.0,0.0,23920,23920,0,0,23920,Null,Null,263499654,5160827,2
263499659,0.0,0.0,339000,339000,0,0,339000,Null,Null,263499659,5160827,2
263499660,0.0,0.0,58650,58650,0,0,58650,Null,Null,263499660,5160827,2
263499661,0.0,0.0,156500,156500,0,0,156500,Null,Null,263499661,5160827,2
263499665,0.0,0.0,75000,75000,0,0,75000,Null,Null,263499665,5160827,2
263499667,0.0,0.0,131000,131000,0,0,131000,Null,Null,263499667,5160827,2
263499669,0.0,0.0,349000,349000,0,0,349000,Null,Null,263499669,5160827,2
263499671,0.0,0.0,39000,39000,0,0,39000,Null,Null,263499671,5160827,2
263499672,0.0,0.0,64500,64500,0,0,64500,Null,Null,263499672,5160827,2
263499686,0.0,0.0,369000,369000,0,0,369000,Null,Null,263499686,5160827,2
263499690,0.0,0.0,319000,319000,0,0,319000,Null,Null,263499690,5160827,2
263499691,0.0,0.0,230000,230000,0,0,230000,Null,Null,263499691,5160827,2
263499693,0.0,0.0,42500,42500,0,0,42500,Null,Null,263499693,5160827,2
263499694,0.0,0.0,42500,42500,0,0,42500,Null,Null,263499694,5160827,2
263499698,0.0,0.0,0,169500,0,0,169500,Null,Null,263499698,5160827,0
263499699,0.0,0.0,155000,155000,0,0,155000,Null,Null,263499699,5160827,2
263499702,0.0,0.0,119000,119000,0,0,119000,Null,Null,263499702,5160827,2
263499704,0.0,0.0,105000,105000,0,0,105000,Null,Null,263499704,5160827,2
263499706,0.0,0.0,189000,189000,0,0,189000,Null,Null,263499706,5160827,2
263499708,0.0,0.0,310000,310000,0,0,310000,Null,Null,263499708,5160827,2
263499710,0.0,0.0,40000,40000,0,0,40000,Null,Null,263499710,5160827,2
263499713,0.0,0.0,17500,17500,0,0,17500,Null,Null,263499713,5160827,2
263499717,0.0,0.0,430000,430000,0,0,430000,Null,Null,263499717,5160827,2
263499719,0.0,0.0,42500,42500,0,0,42500,Null,Null,263499719,5160827,2
263499721,0.0,0.0,103500,103500,0,0,103500,Null,Null,263499721,5160827,2
263499723,0.0,0.0,34000,34000,0,0,34000,Null,Null,263499723,5160827,2
263499725,0.0,0.0,45000,45000,0,0,45000,Null,Null,263499725,5160827,2
263499727,0.0,0.0,129000,129000,0,0,129000,Null,Null,263499727,5160827,2
263499734,0.0,0.0,399000,399000,0,0,399000,Null,Null,263499734,5160827,2
263499735,0.0,0.0,319000,319000,0,0,319000,Null,Null,263499735,5160827,2
263499738,0.0,0.0,36000,36000,0,0,36000,Null,Null,263499738,5160827,2
263499739,0.0,0.0,75000,75000,0,0,75000,Null,Null,263499739,5160827,2
263499751,0.0,0.0,319000,319000,0,0,319000,Null,Null,263499751,5160827,2
263499753,0.0,0.0,1160000,1160000,0,0,1160000,Null,Null,263499753,5160827,2
263499755,0.0,0.0,12000,12000,0,0,12000,Null,Null,263499755,5160827,2
263499757,0.0,0.0,349000,349000,0,0,349000,Null,Null,263499757,5160827,2
263499759,0.0,0.0,45000,45000,0,0,45000,Null,Null,263499759,5160827,2
263499760,0.0,0.0,313600,313600,0,0,313600,Null,Null,263499760,5160827,2
263499763,0.0,0.0,79000,79000,0,0,79000,Null,Null,263499763,5160827,2
263499764,0.0,0.0,220000,220000,0,0,220000,Null,Null,263499764,5160827,2
263499767,0.0,0.0,62500,62500,0,0,62500,Null,Null,263499767,5160827,2
263499769,0.0,0.0,24000,24000,0,0,24000,Null,Null,263499769,5160827,2
263499774,0.0,0.0,156500,156500,0,0,156500,Null,Null,263499774,5160827,2
263499778,0.0,0.0,109250,109250,0,0,109250,Null,Null,263499778,5160827,2
263499779,0.0,0.0,40000,40000,0,0,40000,Null,Null,263499779,5160827,2
263499785,0.0,0.0,45000,45000,0,0,45000,Null,Null,263499785,5160827,2
263499786,0.0,0.0,67500,67500,0,0,67500,Null,Null,263499786,5160827,2
263499790,0.0,0.0,229000,229000,0,0,229000,Null,Null,263499790,5160827,2
263499792,0.0,0.0,20000,20000,0,0,20000,Null,Null,263499792,5160827,2
263499810,0.0,0.0,139000,139000,0,0,139000,Null,Null,263499810,5160827,2
263499812,0.0,0.0,350000,350000,0,0,350000,Null,Null,263499812,5160827,2
263499815,0.0,0.0,33600,33600,0,0,33600,Null,Null,263499815,5160827,2
263499820,0.0,0.0,379000,379000,0,0,379000,Null,Null,263499820,5160827,2
263499839,0.0,0.0,239000,239000,0,0,239000,Null,Null,263499839,5160827,2
263499841,0.0,0.0,350000,350000,0,0,350000,Null,Null,263499841,5160827,2
263499842,0.0,0.0,67000,67000,0,0,67000,Null,Null,263499842,5160827,2
263499845,0.0,0.0,210000,210000,0,0,210000,Null,Null,263499845,5160827,2
263499847,0.0,0.0,240000,240000,0,0,240000,Null,Null,263499847,5160827,2
263499849,0.0,0.0,650000,650000,0,0,650000,Null,Null,263499849,5160827,2
263499851,0.0,0.0,95000,95000,0,0,95000,Null,Null,263499851,5160827,2
263499933,0.0,0.0,600000,600000,0,0,600000,Null,Null,263499933,5160827,11941
263500012,0.0,0.0,149000,149000,0,0,149000,Null,Null,263500012,111461,28644
263500043,0.0,0.0,6500000,6500000,0,0,6500000,Null,Null,263500043,111461,23072
263500066,0.0,0.0,225000,225000,0,0,225000,Null,Null,263500066,111461,23112
263500083,0.0,0.0,550000,299000,251000,46,550000,Null,Null,263500083,111461,4380
263500194,0.0,0.0,230000,230000,0,0,230000,Null,Null,263500194,111461,23112
263500218,0.0,0.0,95000,95000,0,0,95000,Null,Null,263500218,111461,28594
263500245,0.0,0.0,230000,230000,0,0,230000,Null,Null,263500245,111461,1978
263500389,0.0,0.0,225000,225000,0,0,225000,Null,Null,263500389,111461,23112
263500438,0.0,0.0,1350000,1350000,0,0,1350000,Null,Null,263500438,111461,53074
263500443,0.0,0.0,230000,230000,0,0,230000,Null,Null,263500443,111461,1978
263500792,0.0,0.0,170000,170000,0,0,170000,Null,Null,263500792,111461,15318
263500847,0.0,0.0,175000,175000,0,0,175000,Null,Null,263500847,111461,6511
263501026,0.0,0.0,2799000,2799000,0,0,2799000,Null,Null,263501026,4650749,5264
263501367,0.0,0.0,45000,45000,0,0,45000,Null,Null,263501367,111461,2
263501446,0.0,0.0,120000,120000,0,0,120000,Null,Null,263501446,111461,2
263501488,0.0,0.0,125000,125000,0,0,125000,Null,Null,263501488,111461,2
263501537,0.0,0.0,45000,45000,0,0,45000,Null,Null,263501537,111461,2
263501538,0.0,0.0,95000,95000,0,0,95000,Null,Null,263501538,111461,2
263501548,0.0,0.0,195000,195000,0,0,195000,Null,Null,263501548,111461,2
263501593,0.0,0.0,45000,45000,0,0,45000,Null,Null,263501593,111461,2
263501629,0.0,0.0,60000,60000,0,0,60000,Null,Null,263501629,111461,2
263501634,0.0,0.0,125000,125000,0,0,125000,Null,Null,263501634,111461,2
263501661,0.0,0.0,195000,195000,0,0,195000,Null,Null,263501661,111461,2
263501708,0.0,0.0,95000,95000,0,0,95000,Null,Null,263501708,111461,2
263501713,0.0,0.0,245000,245000,0,0,245000,Null,Null,263501713,111461,2
263501723,0.0,0.0,155000,155000,0,0,155000,Null,Null,263501723,111461,2
263501736,0.0,0.0,245000,245000,0,0,245000,Null,Null,263501736,111461,2
263501745,0.0,0.0,120000,120000,0,0,120000,Null,Null,263501745,111461,2
263501829,0.0,0.0,125000,125000,0,0,125000,Null,Null,263501829,111461,2
263501841,0.0,0.0,125000,125000,0,0,125000,Null,Null,263501841,111461,2
263501845,0.0,0.0,195000,195000,0,0,195000,Null,Null,263501845,111461,2
263501865,0.0,0.0,155000,155000,0,0,155000,Null,Null,263501865,111461,2
263502095,0.0,0.0,195000,195000,0,0,195000,Null,Null,263502095,111461,2
263502111,0.0,0.0,90000,90000,0,0,90000,Null,Null,263502111,111461,2
263502132,0.0,0.0,180000,180000,0,0,180000,Null,Null,263502132,111461,2
263502169,0.0,0.0,190000,190000,0,0,190000,Null,Null,263502169,111461,2
263502249,0.0,0.0,345000,345000,0,0,345000,Null,Null,263502249,111461,2
263502306,0.0,0.0,350000,350000,0,0,350000,Null,Null,263502306,111461,23112
263502550,0.0,0.0,6350000,6350000,0,0,6350000,Null,Null,263502550,111461,23270
263502575,0.0,0.0,2799000,2799000,0,0,2799000,Null,Null,263502575,4650749,5267
263502688,0.0,0.0,1699000,1699000,0,0,1699000,Null,Null,263502688,111461,1979
263503580,0.0,0.0,1699000,1699000,0,0,1699000,Null,Null,263503580,111461,1979
263504688,0.0,0.0,479000,479000,0,0,479000,Null,Null,263504688,111461,27240
263504749,0.0,0.0,18000,18000,0,0,18000,Null,Null,263504749,111461,2
263504863,0.0,0.0,180000,180000,0,0,180000,Null,Null,263504863,5220265,53350
263504979,0.0,0.0,330000,330000,0,0,330000,Null,Null,263504979,5220265,53350
263505003,0.0,0.0,1580000,1264000,316000,20,1580000,Null,Null,263505003,111461,23102
263505438,0.0,0.0,1500000,1500000,0,0,1500000,Null,Null,263505438,4202899,4381
263505451,0.0,0.0,540000,540000,0,0,540000,Null,Null,263505451,5220265,53350
263505509,0.0,0.0,260000,260000,0,0,260000,Null,Null,263505509,111461,23708
263505548,0.0,0.0,260000,260000,0,0,260000,Null,Null,263505548,111461,23708
263505589,0.0,0.0,2250000,1912500,337500,15,2250000,Null,Null,263505589,111461,23102
263506090,0.0,0.0,7000000,7000000,0,0,7000000,Null,Null,263506090,111461,23072
263506199,0.0,0.0,215000,215000,0,0,215000,Null,Null,263506199,362757,4428
263506205,0.0,0.0,294000,294000,0,0,294000,Null,Null,263506205,111461,27230
263506222,0.0,0.0,6800000,6800000,0,0,6800000,Null,Null,263506222,111461,23072
263506247,0.0,0.0,7000000,7000000,0,0,7000000,Null,Null,263506247,111461,23072
263506269,0.0,0.0,850000,795000,55000,6,850000,Null,Null,263506269,111461,23102
263506271,0.0,0.0,180000,180000,0,0,180000,Null,Null,263506271,111461,1979
263506273,0.0,0.0,99000,99000,0,0,99000,Null,Null,263506273,111461,23184
263506278,0.0,0.0,180000,180000,0,0,180000,Null,Null,263506278,111461,1979
263506372,0.0,0.0,494000,494000,0,0,494000,Null,Null,263506372,111461,2784
263506405,0.0,0.0,40000,40000,0,0,40000,Null,Null,263506405,111461,5995
263506407,0.0,0.0,1800000,1800000,0,0,1800000,Null,Null,263506407,111461,1978
263506436,0.0,0.0,1800000,1800000,0,0,1800000,Null,Null,263506436,111461,1978
263506453,0.0,0.0,99000,99000,0,0,99000,Null,Null,263506453,111461,23184
263506468,0.0,0.0,249000,249000,0,0,249000,Null,Null,263506468,111461,27240
263506485,0.0,0.0,509000,509000,0,0,509000,Null,Null,263506485,111461,23708
263506512,0.0,0.0,2950000,2950000,0,0,2950000,Null,Null,263506512,3795327,2511
263506526,0.0,0.0,509000,509000,0,0,509000,Null,Null,263506526,111461,23708
263506528,0.0,0.0,280000,250000,30000,11,280000,Null,Null,263506528,4269821,23288
263506538,0.0,0.0,2799000,2799000,0,0,2799000,Null,Null,263506538,514405,5267
263506593,0.0,0.0,2500000,2500000,0,0,2500000,Null,Null,263506593,4202899,4381
263509945,0.0,0.0,300000,270000,30000,10,300000,Null,Null,263509945,4269821,23288
263509948,0.0,0.0,680000,610000,70000,10,680000,Null,Null,263509948,4269821,23288
263509951,0.0,0.0,680000,610000,70000,10,680000,Null,Null,263509951,4269821,23288
263509954,0.0,0.0,360000,320000,40000,11,360000,Null,Null,263509954,4269821,23288
263509957,0.0,0.0,320000,280000,40000,13,320000,Null,Null,263509957,4269821,23288
263509960,0.0,0.0,320000,280000,40000,13,320000,Null,Null,263509960,4269821,23288
263510078,0.0,0.0,499000,499000,0,0,499000,Null,Null,263510078,8196398,3422
263510080,0.0,0.0,4490000,4490000,0,0,4490000,Null,Null,263510080,3795327,2511
263510213,0.0,0.0,99000,99000,0,0,99000,Null,Null,263510213,111461,23184
263510278,0.0,0.0,99000,99000,0,0,99000,Null,Null,263510278,111461,23184
263510299,0.0,0.0,99000,99000,0,0,99000,Null,Null,263510299,111461,23184
263510310,0.0,0.0,99000,99000,0,0,99000,Null,Null,263510310,111461,23184
263510455,0.0,0.0,99000,99000,0,0,99000,Null,Null,263510455,111461,23184
263510756,0.0,0.0,285000,285000,0,0,285000,Null,Null,263510756,111461,8167
263510934,0.0,0.0,70000,70000,0,0,70000,Null,Null,263510934,111461,2
263511143,0.0,0.0,690000,690000,0,0,690000,Null,Null,263511143,189445,28596
263511189,0.0,0.0,2750000,2750000,0,0,2750000,Null,Null,263511189,636191,23450
263511198,0.0,0.0,5290000,5290000,0,0,5290000,Null,Null,263511198,636191,23450
263511203,0.0,0.0,1200000,1200000,0,0,1200000,Null,Null,263511203,111461,2
263511227,0.0,0.0,1800000,1800000,0,0,1800000,Null,Null,263511227,111461,2
263511234,0.0,0.0,3000000,3000000,0,0,3000000,Null,Null,263511234,111461,2
263511236,0.0,0.0,2200000,2200000,0,0,2200000,Null,Null,263511236,111461,2
263511246,0.0,0.0,1500000,1500000,0,0,1500000,Null,Null,263511246,111461,23156
263511248,0.0,0.0,1500000,1500000,0,0,1500000,Null,Null,263511248,111461,2514
263511255,0.0,0.0,1200000,1200000,0,0,1200000,Null,Null,263511255,111461,2
263511265,0.0,0.0,560000,560000,0,0,560000,Null,Null,263511265,111461,2
263511275,0.0,0.0,1700000,1700000,0,0,1700000,Null,Null,263511275,111461,2513
263511277,0.0,0.0,1800000,1800000,0,0,1800000,Null,Null,263511277,111461,2
263511279,0.0,0.0,2500000,2500000,0,0,2500000,Null,Null,263511279,111461,2
263511290,0.0,0.0,2200000,2200000,0,0,2200000,Null,Null,263511290,111461,2513
263511315,0.0,0.0,2000000,2000000,0,0,2000000,Null,Null,263511315,111461,2
263511335,0.0,0.0,1560000,1560000,0,0,1560000,Null,Null,263511335,111461,2
263511874,0.0,0.0,2800000,2800000,0,0,2800000,Null,Null,263511874,636191,23450
263512387,0.0,0.0,2990000,2990000,0,0,2990000,Null,Null,263512387,636191,23450
263512396,0.0,0.0,2450000,2450000,0,0,2450000,Null,Null,263512396,636191,23450
263512498,0.0,0.0,95000,95000,0,0,95000,Null,Null,263512498,111461,23040
263512513,0.0,0.0,45000,45000,0,0,45000,Null,Null,263512513,111461,23156
263512527,0.0,0.0,149000,149000,0,0,149000,Null,Null,263512527,111461,27214
263512552,0.0,0.0,135000,135000,0,0,135000,Null,Null,263512552,111461,23126
263512557,0.0,0.0,15000,15000,0,0,15000,Null,Null,263512557,111461,5450
263512582,0.0,0.0,29000,29000,0,0,29000,Null,Null,263512582,111461,5450
263512586,0.0,0.0,45000,45000,0,0,45000,Null,Null,263512586,111461,5450
263512591,0.0,0.0,60000,60000,0,0,60000,Null,Null,263512591,111461,5450
263512603,0.0,0.0,75000,75000,0,0,75000,Null,Null,263512603,111461,5450
263512612,0.0,0.0,2490000,2490000,0,0,2490000,Null,Null,263512612,111461,23622
263512615,0.0,0.0,75000000,75000000,0,0,75000000,Null,Null,263512615,7982755,23544
263512617,0.0,0.0,1950000,1950000,0,0,1950000,Null,Null,263512617,111461,23652
263512622,0.0,0.0,3090000,3090000,0,0,3090000,Null,Null,263512622,111461,23622
263512637,0.0,0.0,3090000,3090000,0,0,3090000,Null,Null,263512637,111461,23622
263512767,0.0,0.0,55000000,55000000,0,0,55000000,Null,Null,263512767,7982755,23544
263512817,0.0,0.0,69000,69000,0,0,69000,Null,Null,263512817,8189829,20236
263512945,0.0,0.0,0,995000,0,0,995000,Null,Null,263512945,111461,0
263512962,0.0,0.0,195000,195000,0,0,195000,Null,Null,263512962,4414249,23246
263512997,0.0,0.0,184000,184000,0,0,184000,Null,Null,263512997,4414249,23246
263513016,0.0,0.0,12000,12000,0,0,12000,Null,Null,263513016,111461,2238
263513037,0.0,0.0,209000,209000,0,0,209000,Null,Null,263513037,4414249,23246
263513048,0.0,0.0,210000,210000,0,0,210000,Null,Null,263513048,111461,23258
263513058,0.0,0.0,35000,35000,0,0,35000,Null,Null,263513058,111461,3710
263513122,0.0,0.0,250000,250000,0,0,250000,Null,Null,263513122,111461,20244
263513128,0.0,0.0,250000,250000,0,0,250000,Null,Null,263513128,111461,20244
263513130,0.0,0.0,14000,14000,0,0,14000,Null,Null,263513130,111461,2514
263513133,0.0,0.0,184000,184000,0,0,184000,Null,Null,263513133,4414249,23246
263513195,0.0,0.0,199000,199000,0,0,199000,Null,Null,263513195,4414249,23246
263513226,0.0,0.0,58000,58000,0,0,58000,Null,Null,263513226,111461,3710
263513261,0.0,0.0,200000,139000,61000,31,200000,Null,Null,263513261,520061,18876
263513292,0.0,0.0,89000,89000,0,0,89000,Null,Null,263513292,111461,3877
263513300,0.0,0.0,79000,79000,0,0,79000,Null,Null,263513300,8189829,20244
263513306,0.0,0.0,14000,14000,0,0,14000,Null,Null,263513306,111461,53074
263513424,0.0,0.0,179000,179000,0,0,179000,Null,Null,263513424,111461,18888
263513461,0.0,0.0,58000,58000,0,0,58000,Null,Null,263513461,111461,3710
263513547,0.0,0.0,1470000,1470000,0,0,1470000,Null,Null,263513547,111461,23304
263513561,0.0,0.0,550000,550000,0,0,550000,Null,Null,263513561,111461,3877
263513694,0.0,0.0,550000,550000,0,0,550000,Null,Null,263513694,111461,3877
263513712,0.0,0.0,373000,373000,0,0,373000,Null,Null,263513712,4414249,23238
263513861,0.0,0.0,290000,290000,0,0,290000,Null,Null,263513861,111461,20244
263514047,0.0,0.0,650000,650000,0,0,650000,Null,Null,263514047,111461,27214
263514115,0.0,0.0,149000,149000,0,0,149000,Null,Null,263514115,111461,28464
263514132,0.0,0.0,80000,80000,0,0,80000,Null,Null,263514132,8173019,3426
263514143,0.0,0.0,149000,149000,0,0,149000,Null,Null,263514143,111461,28464
263514185,0.0,0.0,185000,185000,0,0,185000,Null,Null,263514185,111461,2340
263514191,0.0,0.0,650000,650000,0,0,650000,Null,Null,263514191,111461,27214
263514209,0.0,0.0,247000,247000,0,0,247000,Null,Null,263514209,4414249,23238
263514234,0.0,0.0,33800,33800,0,0,33800,Null,Null,263514234,111461,23246
263514291,0.0,0.0,160000,160000,0,0,160000,Null,Null,263514291,8173019,3426
263514330,0.0,0.0,450000,450000,0,0,450000,Null,Null,263514330,111461,20244
263514367,0.0,0.0,250000,250000,0,0,250000,Null,Null,263514367,111461,27240
263514376,0.0,0.0,19300000,19300000,0,0,19300000,Null,Null,263514376,213855,23544
263514410,0.0,0.0,84000,84000,0,0,84000,Null,Null,263514410,4414249,23238
263514448,0.0,0.0,14000,14000,0,0,14000,Null,Null,263514448,111461,23304
263514520,0.0,0.0,650000,650000,0,0,650000,Null,Null,263514520,111461,27214
263514537,0.0,0.0,195000,195000,0,0,195000,Null,Null,263514537,4414249,23238
263514539,0.0,0.0,10800,10800,0,0,10800,Null,Null,263514539,111461,27240
263514573,0.0,0.0,650000,650000,0,0,650000,Null,Null,263514573,111461,27214
263514612,0.0,0.0,650000,650000,0,0,650000,Null,Null,263514612,111461,27214
263514627,0.0,0.0,952000,952000,0,0,952000,Null,Null,263514627,4414249,23238
263514634,0.0,0.0,199000,199000,0,0,199000,Null,Null,263514634,111461,9052
263514674,0.0,0.0,58000,58000,0,0,58000,Null,Null,263514674,111461,3710
263514746,0.0,0.0,52500,52500,0,0,52500,Null,Null,263514746,689369,8224
263514787,0.0,0.0,25000,25000,0,0,25000,Null,Null,263514787,111461,7064
263514789,21.0,21.0,639000,389000,250000,39,639000,Null,Null,263514789,625853,1811
263514888,0.0,0.0,25000,25000,0,0,25000,Null,Null,263514888,111461,7064
263514945,0.0,0.0,120000,120000,0,0,120000,Null,Null,263514945,111461,23660
263514969,0.0,0.0,79000,79000,0,0,79000,Null,Null,263514969,5272071,3177
263514980,0.0,0.0,578000,578000,0,0,578000,Null,Null,263514980,4414249,23238
263514987,0.0,0.0,20000,20000,0,0,20000,Null,Null,263514987,111461,2154
263514998,0.0,0.0,85000,85000,0,0,85000,Null,Null,263514998,111461,8167
263515005,0.0,0.0,4990000,4990000,0,0,4990000,Null,Null,263515005,111461,7449
263515018,0.0,0.0,58000,58000,0,0,58000,Null,Null,263515018,111461,3710
263515056,0.0,0.0,79000,79000,0,0,79000,Null,Null,263515056,111461,8167
263515067,0.0,0.0,19000000,19000000,0,0,19000000,Null,Null,263515067,111461,23392
263515074,0.0,0.0,79000,79000,0,0,79000,Null,Null,263515074,111461,8167
263515084,0.0,0.0,180000,180000,0,0,180000,Null,Null,263515084,111461,1979
263515105,0.0,0.0,94000,94000,0,0,94000,Null,Null,263515105,4414249,23238
263515213,0.0,0.0,85000,85000,0,0,85000,Null,Null,263515213,111461,8167
263515272,0.0,0.0,7999000,7999000,0,0,7999000,Null,Null,263515272,111461,7449
263515277,0.0,0.0,3999000,3999000,0,0,3999000,Null,Null,263515277,111461,20492
263515296,0.0,0.0,9799000,9799000,0,0,9799000,Null,Null,263515296,111461,7449
263515321,0.0,0.0,79000,79000,0,0,79000,Null,Null,263515321,111461,8167
263515335,1.0,1.0,467000,467000,0,0,467000,Null,Null,263515335,304627,1883
263515344,0.0,0.0,69000,69000,0,0,69000,Null,Null,263515344,111461,8167
263515369,0.0,0.0,3190000,3190000,0,0,3190000,Null,Null,263515369,111461,23622
263515373,0.0,0.0,35000,35000,0,0,35000,Null,Null,263515373,111461,28574
263515401,0.0,0.0,380000,380000,0,0,380000,Null,Null,263515401,111461,49724
263515476,0.0,0.0,58000,58000,0,0,58000,Null,Null,263515476,111461,3710
263515531,0.0,0.0,12500,12500,0,0,12500,Null,Null,263515531,111461,27214
263515607,0.0,0.0,330000,330000,0,0,330000,Null,Null,263515607,4414249,23238
263515610,0.0,0.0,149000,149000,0,0,149000,Null,Null,263515610,111461,27230
263515632,0.0,0.0,79000,79000,0,0,79000,Null,Null,263515632,5272071,1936
263515641,0.0,0.0,80000,49000,31000,39,80000,Null,Null,263515641,520061,18876
263515684,0.0,0.0,40000,22000,18000,45,40000,Null,Null,263515684,182863,1630
263515697,0.0,0.0,149000,149000,0,0,149000,Null,Null,263515697,111461,2
263515817,0.0,0.0,950000,950000,0,0,950000,Null,Null,263515817,111461,49724
263515824,0.0,0.0,14000000,14000000,0,0,14000000,Null,Null,263515824,111461,23392
263515936,0.0,0.0,120900,120900,0,0,120900,Null,Null,263515936,111461,2513
263516075,0.0,0.0,1350000,1350000,0,0,1350000,Null,Null,263516075,111461,49724
263516088,0.0,0.0,79000,79000,0,0,79000,Null,Null,263516088,5272071,3177
263516218,0.0,0.0,2290000,2290000,0,0,2290000,Null,Null,263516218,421431,2136
263516228,0.0,0.0,366000,366000,0,0,366000,Null,Null,263516228,111461,23112
263516240,0.0,0.0,149000,149000,0,0,149000,Null,Null,263516240,111461,28464
263516279,0.0,0.0,58000,58000,0,0,58000,Null,Null,263516279,111461,3710
263516325,0.0,0.0,115000,115000,0,0,115000,Null,Null,263516325,21653,12908
263516427,0.0,0.0,79000,79000,0,0,79000,Null,Null,263516427,21651,28574
263516430,0.0,0.0,149000,149000,0,0,149000,Null,Null,263516430,111461,28464
263516504,0.0,0.0,149000,149000,0,0,149000,Null,Null,263516504,111461,28464
263516593,0.0,0.0,16000000,8000000,8000000,50,16000000,Null,Null,263516593,111461,23392
263516619,0.0,0.0,149000,149000,0,0,149000,Null,Null,263516619,111461,28464
263516627,0.0,0.0,250000,250000,0,0,250000,Null,Null,263516627,111461,27240
263516829,0.0,0.0,119000,119000,0,0,119000,Null,Null,263516829,21653,12908
263516898,0.0,0.0,6549000,6549000,0,0,6549000,Null,Null,263516898,111461,53074
263516925,0.0,0.0,980000,617400,362600,37,980000,Null,Null,263516925,243693,12908
263516950,0.0,0.0,5750000,5750000,0,0,5750000,Null,Null,263516950,7393659,4381
263516969,0.0,0.0,79000,79000,0,0,79000,Null,Null,263516969,5272071,1936
263516984,0.0,0.0,249000,249000,0,0,249000,Null,Null,263516984,111461,2971
263516993,0.0,0.0,180000,180000,0,0,180000,Null,Null,263516993,111461,1979
263517030,0.0,0.0,450000,450000,0,0,450000,Null,Null,263517030,111461,23154
263517083,0.0,0.0,73000,73000,0,0,73000,Null,Null,263517083,111461,23778
263517208,0.0,0.0,90000,90000,0,0,90000,Null,Null,263517208,252399,23370
263517212,0.0,0.0,100000,100000,0,0,100000,Null,Null,263517212,111461,28480
263517241,0.0,0.0,450000,450000,0,0,450000,Null,Null,263517241,111461,15250
263517357,0.0,0.0,350000,339500,10500,3,350000,Null,Null,263517357,875757,2
263517366,0.0,0.0,2880000,2880000,0,0,2880000,Null,Null,263517366,411003,20492
263517371,0.0,0.0,28000,28000,0,0,28000,Null,Null,263517371,111461,4342
263517378,0.0,0.0,125000,125000,0,0,125000,Null,Null,263517378,111461,3177
263517392,0.0,0.0,285000,285000,0,0,285000,Null,Null,263517392,111461,2971
263517394,0.0,0.0,250000,250000,0,0,250000,Null,Null,263517394,111461,27240
263517485,0.0,0.0,180000,180000,0,0,180000,Null,Null,263517485,111461,15318
263518789,0.0,0.0,490000,475300,14700,3,490000,Null,Null,263518789,875757,2
263521805,0.0,0.0,939000,939000,0,0,939000,Null,Null,263521805,111461,2266
263528567,0.0,0.0,59500,59500,0,0,59500,Null,Null,263528567,111461,28458
263532861,0.0,0.0,280000,280000,0,0,280000,Null,Null,263532861,111461,53048
263539058,0.0,0.0,370000,358900,11100,3,370000,Null,Null,263539058,875757,2
263555160,0.0,0.0,200000,200000,0,0,200000,Null,Null,263555160,111461,1934
263557212,0.0,0.0,58200,58200,0,0,58200,Null,Null,263557212,111461,3179
263557221,0.0,0.0,330000,320100,9900,3,330000,Null,Null,263557221,199801,1520
263557301,0.0,0.0,59600,59600,0,0,59600,Null,Null,263557301,111461,28458
263557313,0.0,0.0,85000,85000,0,0,85000,Null,Null,263557313,111461,28578
263557328,0.0,0.0,295000,295000,0,0,295000,Null,Null,263557328,111461,23446
263557330,0.0,0.0,10000,10000,0,0,10000,Null,Null,263557330,111461,2363
263557337,0.0,0.0,340000,340000,0,0,340000,Null,Null,263557337,111461,23254
263557344,0.0,0.0,590000,379000,211000,36,590000,Null,Null,263557344,111461,3428
263557350,0.0,0.0,66000,54000,12000,18,66000,Null,Null,263557350,79682,11835
263557361,0.0,0.0,60000,60000,0,0,60000,Null,Null,263557361,111461,20254
263557394,0.0,0.0,240000,240000,0,0,240000,Null,Null,263557394,111461,23236
263557398,0.0,0.0,130000,128700,1300,1,130000,Null,Null,263557398,499843,11885
263557432,0.0,0.0,1090000,1090000,0,0,1090000,Null,Null,263557432,7289199,23236
263557479,0.0,0.0,126500,126500,0,0,126500,Null,Null,263557479,838371,23238
263557500,0.0,0.0,308000,308000,0,0,308000,Null,Null,263557500,111461,6948
263557535,0.0,0.0,340000,289000,51000,15,340000,Null,Null,263557535,148559,1936
263557552,0.0,0.0,335000,335000,0,0,335000,Null,Null,263557552,111461,1634
263557559,0.0,0.0,1650000,1650000,0,0,1650000,Null,Null,263557559,7289199,23236
263557746,0.0,0.0,1290000,1090000,200000,16,1290000,Null,Null,263557746,5347313,8066
263557857,0.0,0.0,121000,121000,0,0,121000,Null,Null,263557857,111461,23006
263557868,0.0,0.0,19000000,9500000,9500000,50,19000000,Null,Null,263557868,111461,23392
263557874,0.0,0.0,499000,499000,0,0,499000,Null,Null,263557874,26855,13878
263557877,0.0,0.0,429000,429000,0,0,429000,Null,Null,263557877,4691869,23246
263558107,0.0,0.0,270000,270000,0,0,270000,Null,Null,263558107,111461,23622
263558150,0.0,0.0,98000,98000,0,0,98000,Null,Null,263558150,111461,27256
263558264,0.0,0.0,650000,650000,0,0,650000,Null,Null,263558264,111461,27214
263558318,0.0,0.0,870000,843900,26100,3,870000,Null,Null,263558318,875757,2
263558322,0.0,0.0,1950000,1950000,0,0,1950000,Null,Null,263558322,7289199,23236
263558369,0.0,0.0,750000,750000,0,0,750000,Null,Null,263558369,111461,23832
263558405,0.0,0.0,85000,85000,0,0,85000,Null,Null,263558405,111461,28574
263558441,0.0,0.0,1050000,1018500,31500,3,1050000,Null,Null,263558441,199801,1520
263558447,0.0,0.0,650000,650000,0,0,650000,Null,Null,263558447,111461,27214
263558452,0.0,0.0,320000,320000,0,0,320000,Null,Null,263558452,111461,15250
263558454,0.0,0.0,95000,95000,0,0,95000,Null,Null,263558454,111461,23244
263558468,0.0,0.0,26000,26000,0,0,26000,Null,Null,263558468,111461,3990
263558486,0.0,0.0,158000,158000,0,0,158000,Null,Null,263558486,7516279,8229
263558505,0.0,0.0,650000,650000,0,0,650000,Null,Null,263558505,111461,27214
263558556,0.0,0.0,650000,650000,0,0,650000,Null,Null,263558556,111461,27214
263558590,0.0,0.0,255000,255000,0,0,255000,Null,Null,263558590,111461,2511
263558658,0.0,0.0,18000,18000,0,0,18000,Null,Null,263558658,111461,23832
263558661,0.0,0.0,650000,650000,0,0,650000,Null,Null,263558661,111461,27214
263558775,0.0,0.0,650000,650000,0,0,650000,Null,Null,263558775,111461,27214
263558780,0.0,0.0,422000,422000,0,0,422000,Null,Null,263558780,111461,6305
263558781,0.0,0.0,217000,210490,6510,3,217000,Null,Null,263558781,875757,2
263558865,0.0,0.0,150000,150000,0,0,150000,Null,Null,263558865,111461,18888
263558868,0.0,0.0,134000,134000,0,0,134000,Null,Null,263558868,689369,8224
263558907,0.0,0.0,65000,65000,0,0,65000,Null,Null,263558907,111461,18888
263558932,0.0,0.0,188000,188000,0,0,188000,Null,Null,263558932,111461,3990
263558934,0.0,0.0,130000,130000,0,0,130000,Null,Null,263558934,111461,18888
263558936,0.0,0.0,98000,98000,0,0,98000,Null,Null,263558936,212267,3805
263558944,0.0,0.0,39000,39000,0,0,39000,Null,Null,263558944,111461,18888
263558946,0.0,0.0,250000,250000,0,0,250000,Null,Null,263558946,212267,28460
263558957,0.0,0.0,79000,79000,0,0,79000,Null,Null,263558957,111461,18888
263558987,0.0,0.0,199000,199000,0,0,199000,Null,Null,263558987,212267,12908
263559030,0.0,0.0,49000,49000,0,0,49000,Null,Null,263559030,111461,18888
263559032,0.0,0.0,89000,89000,0,0,89000,Null,Null,263559032,111461,18888
263559095,0.0,0.0,450000,450000,0,0,450000,Null,Null,263559095,212267,12908
263559097,0.0,0.0,99000,99000,0,0,99000,Null,Null,263559097,111461,23184
263559104,0.0,0.0,69000,69000,0,0,69000,Null,Null,263559104,111461,18888
263559114,0.0,0.0,129000,129000,0,0,129000,Null,Null,263559114,111461,18888
263559116,0.0,0.0,330000,330000,0,0,330000,Null,Null,263559116,212267,12908
263559133,0.0,0.0,49000,49000,0,0,49000,Null,Null,263559133,111461,18888
263559136,0.0,0.0,99000,99000,0,0,99000,Null,Null,263559136,111461,23184
263559151,0.0,0.0,89000,89000,0,0,89000,Null,Null,263559151,111461,18888
263559154,0.0,0.0,1167000,1167000,0,0,1167000,Null,Null,263559154,26150,8513
263559156,0.0,0.0,138800,138800,0,0,138800,Null,Null,263559156,111461,3178
263559207,23.0,23.0,99000,99000,0,0,99000,Null,Null,263559207,111461,1883
263559238,0.0,0.0,60000,60000,0,0,60000,Null,Null,263559238,111461,3990
263559253,0.0,0.0,3160000,1580000,1580000,50,3160000,Null,Null,263559253,111461,15250
263559368,0.0,0.0,109000,109000,0,0,109000,Null,Null,263559368,111461,2
263559370,0.0,0.0,79000,79000,0,0,79000,Null,Null,263559370,111461,2
263559372,0.0,0.0,99000,99000,0,0,99000,Null,Null,263559372,111461,2
263559438,0.0,0.0,99000,99000,0,0,99000,Null,Null,263559438,111461,23184
263559458,0.0,0.0,200000,200000,0,0,200000,Null,Null,263559458,252399,23352
263559471,0.0,0.0,60000,60000,0,0,60000,Null,Null,263559471,26675,28452
263559486,0.0,0.0,10000,10000,0,0,10000,Null,Null,263559486,111461,23416
263559488,0.0,0.0,10000,10000,0,0,10000,Null,Null,263559488,111461,23416
263559490,0.0,0.0,11000,11000,0,0,11000,Null,Null,263559490,732689,3178
263559492,0.0,0.0,650000,650000,0,0,650000,Null,Null,263559492,111461,27214
263559656,0.0,0.0,650000,650000,0,0,650000,Null,Null,263559656,111461,27214
263559698,0.0,0.0,449000,449000,0,0,449000,Null,Null,263559698,212267,1838
263559712,0.0,0.0,2850000,2850000,0,0,2850000,Null,Null,263559712,47424,2342
263559714,0.0,0.0,18000,18000,0,0,18000,Null,Null,263559714,4414249,23246
263559716,0.0,0.0,89000,89000,0,0,89000,Null,Null,263559716,111461,3877
263559721,0.0,0.0,99000,99000,0,0,99000,Null,Null,263559721,111461,23184
263559753,0.0,0.0,310000,310000,0,0,310000,Null,Null,263559753,4414249,23238
263559781,0.0,0.0,99000,99000,0,0,99000,Null,Null,263559781,111461,23184
263559789,0.0,0.0,150000,135000,15000,10,150000,Null,Null,263559789,5220265,17170
263559812,0.0,0.0,520000,520000,0,0,520000,Null,Null,263559812,4414249,23238
263559832,0.0,0.0,99000,99000,0,0,99000,Null,Null,263559832,111461,23184
263559866,0.0,0.0,120000,120000,0,0,120000,Null,Null,263559866,111461,2
263559917,0.0,0.0,32000,32000,0,0,32000,Null,Null,263559917,4414249,23238
263559924,0.0,0.0,255000,255000,0,0,255000,Null,Null,263559924,111461,23162
263559937,0.0,0.0,99000,99000,0,0,99000,Null,Null,263559937,111461,23184
263559985,0.0,0.0,447000,447000,0,0,447000,Null,Null,263559985,4414249,23238
263559992,0.0,0.0,99000,99000,0,0,99000,Null,Null,263559992,111461,23184
263560005,0.0,0.0,99000,99000,0,0,99000,Null,Null,263560005,111461,23184
263560025,0.0,0.0,808000,808000,0,0,808000,Null,Null,263560025,189513,1520
263560062,0.0,0.0,157100,157100,0,0,157100,Null,Null,263560062,234951,23238
263560157,0.0,0.0,250000,225000,25000,10,250000,Null,Null,263560157,5220265,17170
263560182,0.0,0.0,180000,180000,0,0,180000,Null,Null,263560182,111461,23416
263560188,0.0,0.0,419000,419000,0,0,419000,Null,Null,263560188,111461,1979
263560198,0.0,0.0,419000,419000,0,0,419000,Null,Null,263560198,111461,1979
263560200,0.0,0.0,69000,69000,0,0,69000,Null,Null,263560200,4414249,23238
263560234,0.0,0.0,175000,175000,0,0,175000,Null,Null,263560234,111461,23352
263560255,0.0,0.0,1399000,1399000,0,0,1399000,Null,Null,263560255,111461,12984
263560283,0.0,0.0,395000,395000,0,0,395000,Null,Null,263560283,111461,9052
263560292,0.0,0.0,129000,129000,0,0,129000,Null,Null,263560292,111461,3990
263560324,0.0,0.0,785000,785000,0,0,785000,Null,Null,263560324,111461,23706
263560329,0.0,0.0,119000,119000,0,0,119000,Null,Null,263560329,111461,23184
263560336,0.0,0.0,7890000,5500000,2390000,30,7890000,Null,Null,263560336,47424,2342
263560344,0.0,0.0,237000,237000,0,0,237000,Null,Null,263560344,4414249,23238
263560369,0.0,0.0,1720000,1720000,0,0,1720000,Null,Null,263560369,111461,23010
263560414,0.0,0.0,176000,176000,0,0,176000,Null,Null,263560414,234951,23238
263560418,0.0,0.0,1788000,1788000,0,0,1788000,Null,Null,263560418,111461,2234
263560479,0.0,0.0,1199000,1199000,0,0,1199000,Null,Null,263560479,111461,27196
263560482,0.0,0.0,58000,58000,0,0,58000,Null,Null,263560482,111461,1883
263560503,0.0,0.0,349000,349000,0,0,349000,Null,Null,263560503,111461,1883
263560513,0.0,0.0,2315000,2315000,0,0,2315000,Null,Null,263560513,111461,27196
263560594,0.0,0.0,163000,163000,0,0,163000,Null,Null,263560594,4414249,23238
263560623,0.0,0.0,299000,299000,0,0,299000,Null,Null,263560623,111461,1883
263560629,0.0,0.0,189000,189000,0,0,189000,Null,Null,263560629,4691869,10413
263560635,0.0,0.0,6350000,6350000,0,0,6350000,Null,Null,263560635,111461,2363
263560649,0.0,0.0,5135000,5135000,0,0,5135000,Null,Null,263560649,111461,27196
263560739,0.0,0.0,6400000,6400000,0,0,6400000,Null,Null,263560739,3795327,2136
263560741,0.0,0.0,1490000,1490000,0,0,1490000,Null,Null,263560741,111461,23678
263560743,0.0,0.0,2115000,2115000,0,0,2115000,Null,Null,263560743,111461,23706
263560758,0.0,0.0,389000,389000,0,0,389000,Null,Null,263560758,111461,1979
263560760,0.0,0.0,552000,552000,0,0,552000,Null,Null,263560760,4414249,23238
263560787,0.0,0.0,2199000,1249000,950000,43,2199000,Null,Null,263560787,314675,2324
263560801,0.0,0.0,389000,389000,0,0,389000,Null,Null,263560801,111461,1979
263560938,0.0,0.0,250000,250000,0,0,250000,Null,Null,263560938,111461,27230
263560951,0.0,0.0,169000,169000,0,0,169000,Null,Null,263560951,111461,2
263560981,0.0,0.0,895000,895000,0,0,895000,Null,Null,263560981,111461,23706
263561012,0.0,0.0,69000,69000,0,0,69000,Null,Null,263561012,4414249,23238
263561043,0.0,0.0,3090000,3090000,0,0,3090000,Null,Null,263561043,111461,23622
263561062,0.0,0.0,310000,310000,0,0,310000,Null,Null,263561062,4414249,23238
263561143,0.0,0.0,10000,10000,0,0,10000,Null,Null,263561143,4414249,23246
263561209,0.0,0.0,1478000,1478000,0,0,1478000,Null,Null,263561209,111461,27196
263561274,0.0,0.0,25000,25000,0,0,25000,Null,Null,263561274,4414249,23238
263561396,0.0,0.0,315000,315000,0,0,315000,Null,Null,263561396,4414249,23246
263561409,0.0,0.0,6000000,6000000,0,0,6000000,Null,Null,263561409,111461,3515
263561455,0.0,0.0,670000,670000,0,0,670000,Null,Null,263561455,111461,23706
263561472,0.0,0.0,247000,247000,0,0,247000,Null,Null,263561472,4414249,23238
263561567,0.0,0.0,185000,185000,0,0,185000,Null,Null,263561567,111461,5566
263561571,0.0,0.0,205000,205000,0,0,205000,Null,Null,263561571,4414249,23238
263561624,0.0,0.0,1175000,1175000,0,0,1175000,Null,Null,263561624,111461,23030
263561739,0.0,0.0,3490000,3490000,0,0,3490000,Null,Null,263561739,3795327,2136
263561784,0.0,0.0,205000,205000,0,0,205000,Null,Null,263561784,4414249,23238
263561793,0.0,0.0,155000,155000,0,0,155000,Null,Null,263561793,203917,1613
263561809,0.0,0.0,9350000,9350000,0,0,9350000,Null,Null,263561809,173483,11858
263561841,0.0,0.0,849000,849000,0,0,849000,Null,Null,263561841,4691869,5267
263561878,0.0,0.0,19000,19000,0,0,19000,Null,Null,263561878,111461,7064
263561899,0.0,0.0,3300000,3300000,0,0,3300000,Null,Null,263561899,4202899,4381
263561929,0.0,0.0,268000,268000,0,0,268000,Null,Null,263561929,4414249,23238
263561975,0.0,0.0,598000,299000,299000,50,598000,Null,Null,263561975,199239,28696
263561988,0.0,0.0,1175000,1175000,0,0,1175000,Null,Null,263561988,111461,23030
263562003,0.0,0.0,18050,18050,0,0,18050,Null,Null,263562003,209871,2488
263562032,0.0,0.0,75500,75500,0,0,75500,Null,Null,263562032,111461,23246
263562043,0.0,0.0,132000,132000,0,0,132000,Null,Null,263562043,4414249,23238
263562050,0.0,0.0,88000,88000,0,0,88000,Null,Null,263562050,111461,2
263562079,0.0,0.0,4200000,4200000,0,0,4200000,Null,Null,263562079,173483,11858
263562186,0.0,0.0,237000,237000,0,0,237000,Null,Null,263562186,4414249,23238
263562237,0.0,0.0,4300000,4300000,0,0,4300000,Null,Null,263562237,173483,11858
263562308,0.0,0.0,230000,184000,46000,20,230000,Null,Null,263562308,203893,8308
263562312,0.0,0.0,95000,95000,0,0,95000,Null,Null,263562312,111461,5566
263562350,0.0,0.0,6000000,6000000,0,0,6000000,Null,Null,263562350,111461,3515
263562352,0.0,0.0,15000,15000,0,0,15000,Null,Null,263562352,111461,8205
263562359,0.0,0.0,142000,142000,0,0,142000,Null,Null,263562359,4414249,23238
263562385,0.0,0.0,169000,169000,0,0,169000,Null,Null,263562385,111461,28644
263562392,0.0,0.0,395000,395000,0,0,395000,Null,Null,263562392,111461,27240
263562479,0.0,0.0,52000000,52000000,0,0,52000000,Null,Null,263562479,111461,23544
263562492,0.0,0.0,339000,339000,0,0,339000,Null,Null,263562492,536863,1984
263562501,0.0,0.0,195000,195000,0,0,195000,Null,Null,263562501,111461,2659
263562529,0.0,0.0,9110000,9110000,0,0,9110000,Null,Null,263562529,173483,11858
263562531,0.0,0.0,6000000,6000000,0,0,6000000,Null,Null,263562531,111461,3515
263562537,0.0,0.0,85000,85000,0,0,85000,Null,Null,263562537,111461,18888
263562591,0.0,0.0,230000,184000,46000,20,230000,Null,Null,263562591,203893,8308
263562598,0.0,0.0,119000,61000,58000,49,119000,Null,Null,263562598,625853,3805
263562605,0.0,0.0,8000000,4000000,4000000,50,8000000,Null,Null,263562605,111461,23392
263562612,0.0,0.0,5600000,5600000,0,0,5600000,Null,Null,263562612,173483,11858
263562614,0.0,0.0,730000,730000,0,0,730000,Null,Null,263562614,4414249,23238
263562659,0.0,0.0,839000,839000,0,0,839000,Null,Null,263562659,111461,23246
263562681,0.0,0.0,180500,180500,0,0,180500,Null,Null,263562681,111461,5566
263562700,0.0,0.0,205000,205000,0,0,205000,Null,Null,263562700,4414249,23238
263562714,0.0,0.0,525000,509250,15750,3,525000,Null,Null,263562714,875757,2
263562718,0.0,0.0,230000,184000,46000,20,230000,Null,Null,263562718,203893,8308
263562755,0.0,0.0,29999,29999,0,0,29999,Null,Null,263562755,111461,3216
263562785,0.0,0.0,599000,599000,0,0,599000,Null,Null,263562785,4414249,23238
263562794,0.0,0.0,1800000,1800000,0,0,1800000,Null,Null,263562794,111461,23576
263562821,0.0,0.0,17000000,17000000,0,0,17000000,Null,Null,263562821,173483,11858
263562823,0.0,0.0,230000,184000,46000,20,230000,Null,Null,263562823,203893,8308
263562841,0.0,0.0,130000,100000,30000,23,130000,Null,Null,263562841,296157,23658
263562879,0.0,0.0,1475000,1475000,0,0,1475000,Null,Null,263562879,111461,27196
263562886,0.0,0.0,115000,115000,0,0,115000,Null,Null,263562886,4414249,23238
263562917,0.0,0.0,1606795,819465,787330,49,1606795,Null,Null,263562917,8191825,2
263562924,0.0,0.0,1606795,819465,787330,49,1606795,Null,Null,263562924,8191825,2
263562931,0.0,0.0,1606795,819465,787330,49,1606795,Null,Null,263562931,8191825,2
263562938,0.0,0.0,1606795,819465,787330,49,1606795,Null,Null,263562938,8191825,2
263562945,0.0,0.0,1606795,819465,787330,49,1606795,Null,Null,263562945,8191825,2
263562952,0.0,0.0,1405946,717032,688914,49,1405946,Null,Null,263562952,8191825,2
263562957,0.0,0.0,1606795,819465,787330,49,1606795,Null,Null,263562957,8191825,2
263562964,0.0,0.0,1405946,717032,688914,49,1405946,Null,Null,263562964,8191825,2
263562969,0.0,0.0,1606795,819465,787330,49,1606795,Null,Null,263562969,8191825,2
263562976,0.0,0.0,1405946,717032,688914,49,1405946,Null,Null,263562976,8191825,2
263562981,0.0,0.0,1606795,819465,787330,49,1606795,Null,Null,263562981,8191825,2
263562982,0.0,0.0,1606795,819465,787330,49,1606795,Null,Null,263562982,8191825,2
263562995,0.0,0.0,1606795,819465,787330,49,1606795,Null,Null,263562995,8191825,2
263563002,0.0,0.0,1606795,819465,787330,49,1606795,Null,Null,263563002,8191825,2
263563009,0.0,0.0,1606795,819465,787330,49,1606795,Null,Null,263563009,8191825,2
263563010,0.0,0.0,1606795,819465,787330,49,1606795,Null,Null,263563010,8191825,2
263563023,0.0,0.0,1606795,819465,787330,49,1606795,Null,Null,263563023,8191825,2
263563029,0.0,0.0,1606795,819465,787330,49,1606795,Null,Null,263563029,8191825,2
263563039,0.0,0.0,1606795,819465,787330,49,1606795,Null,Null,263563039,8191825,2
263563046,0.0,0.0,1857857,947507,910350,49,1857857,Null,Null,263563046,8191825,23678
263563051,0.0,0.0,1606795,819465,787330,49,1606795,Null,Null,263563051,8191825,2
263563056,0.0,0.0,1606795,819465,787330,49,1606795,Null,Null,263563056,8191825,2
263563067,0.0,0.0,1606795,819465,787330,49,1606795,Null,Null,263563067,8191825,2
263563074,0.0,0.0,1606795,819465,787330,49,1606795,Null,Null,263563074,8191825,2
263563081,0.0,0.0,1606795,819465,787330,49,1606795,Null,Null,263563081,8191825,2
263563088,0.0,0.0,1606795,819465,787330,49,1606795,Null,Null,263563088,8191825,2
263563095,0.0,0.0,195000,195000,0,0,195000,Null,Null,263563095,111461,28622
263563106,0.0,0.0,230000,184000,46000,20,230000,Null,Null,263563106,203893,8308
263563126,0.0,0.0,205000,205000,0,0,205000,Null,Null,263563126,111461,27196
263563130,0.0,0.0,2990000,2990000,0,0,2990000,Null,Null,263563130,18802,2657
263563289,0.0,0.0,12000,12000,0,0,12000,Null,Null,263563289,111461,53190
263563305,0.0,0.0,55000,55000,0,0,55000,Null,Null,263563305,25697,28452
263563374,0.0,0.0,99000,99000,0,0,99000,Null,Null,263563374,8196432,17170
263563405,0.0,0.0,160000,160000,0,0,160000,Null,Null,263563405,111461,2659
263563450,0.0,0.0,6200000,6200000,0,0,6200000,Null,Null,263563450,173483,11858
263563460,0.0,0.0,19000,19000,0,0,19000,Null,Null,263563460,5160827,2
263563610,0.0,0.0,43000,43000,0,0,43000,Null,Null,263563610,4414249,1883
263563634,0.0,0.0,95000,95000,0,0,95000,Null,Null,263563634,111461,5566
263563639,0.0,0.0,561500,561500,0,0,561500,Null,Null,263563639,111461,20236
263563659,0.0,0.0,1061000,1061000,0,0,1061000,Null,Null,263563659,111461,23706
263563712,0.0,0.0,3210000,3210000,0,0,3210000,Null,Null,263563712,173483,11858
263563721,0.0,0.0,186000,186000,0,0,186000,Null,Null,263563721,111461,2153
263563734,0.0,0.0,299000,299000,0,0,299000,Null,Null,263563734,201253,5893
263563754,0.0,0.0,4909000,4909000,0,0,4909000,Null,Null,263563754,111461,27196
263563765,0.0,0.0,185000,185000,0,0,185000,Null,Null,263563765,236637,2136
263563778,7.0,7.0,250000,170000,80000,32,250000,Null,Null,263563778,41048,1883
263563787,0.0,0.0,62000,62000,0,0,62000,Null,Null,263563787,4414249,23238
263563841,0.0,0.0,4770000,4770000,0,0,4770000,Null,Null,263563841,173483,11858
263563846,0.0,0.0,599000,599000,0,0,599000,Null,Null,263563846,111461,27240
263563859,0.0,0.0,2490000,2490000,0,0,2490000,Null,Null,263563859,111461,23622
263563871,0.0,0.0,1788000,1788000,0,0,1788000,Null,Null,263563871,111461,2234
263563882,0.0,0.0,99000,99000,0,0,99000,Null,Null,263563882,8196645,4413
263563893,0.0,0.0,10000,10000,0,0,10000,Null,Null,263563893,4414249,23238
263563902,0.0,0.0,1490000,1490000,0,0,1490000,Null,Null,263563902,111461,2511
263563912,0.0,0.0,149000,79000,70000,47,149000,Null,Null,263563912,314675,28480
263563957,0.0,0.0,20000000,12000000,8000000,40,20000000,Null,Null,263563957,111461,23392
263563959,0.0,0.0,2490000,2490000,0,0,2490000,Null,Null,263563959,111461,23622
263563962,0.0,0.0,55000,55000,0,0,55000,Null,Null,263563962,111461,23446
263564017,0.0,0.0,30000,30000,0,0,30000,Null,Null,263564017,111461,2154
263564023,0.0,0.0,95000,95000,0,0,95000,Null,Null,263564023,111461,28574
263564089,0.0,0.0,192500,192500,0,0,192500,Null,Null,263564089,111461,28638
263564151,0.0,0.0,979999,979999,0,0,979999,Null,Null,263564151,111461,53350
263564155,0.0,0.0,94000,94000,0,0,94000,Null,Null,263564155,4414249,23238
263564180,0.0,0.0,1129500,1129500,0,0,1129500,Null,Null,263564180,111461,2971
263564295,0.0,0.0,99000,99000,0,0,99000,Null,Null,263564295,111461,5566
263564297,0.0,0.0,179000,179000,0,0,179000,Null,Null,263564297,111461,28644
263564299,0.0,0.0,1478000,1478000,0,0,1478000,Null,Null,263564299,111461,27196
263564323,0.0,0.0,14000,14000,0,0,14000,Null,Null,263564323,5160827,2
263564327,0.0,0.0,1540000,1540000,0,0,1540000,Null,Null,263564327,111461,23346
263564336,0.0,0.0,950000,950000,0,0,950000,Null,Null,263564336,111461,2016
263564340,0.0,0.0,54000,54000,0,0,54000,Null,Null,263564340,111461,20254
263564373,0.0,0.0,4465000,4465000,0,0,4465000,Null,Null,263564373,111461,27192
263564375,0.0,0.0,90000,90000,0,0,90000,Null,Null,263564375,4414249,23238
263564422,0.0,0.0,20000000,14000000,6000000,30,20000000,Null,Null,263564422,111461,23392
263564496,0.0,0.0,590000,590000,0,0,590000,Null,Null,263564496,111461,12590
263564499,0.0,0.0,1890000,1890000,0,0,1890000,Null,Null,263564499,111461,6511
263564526,0.0,0.0,99000,99000,0,0,99000,Null,Null,263564526,111461,5566
263564702,0.0,0.0,2200000,2200000,0,0,2200000,Null,Null,263564702,111461,6511
263564733,0.0,0.0,4465000,4465000,0,0,4465000,Null,Null,263564733,111461,27196
263564808,0.0,0.0,25000,25000,0,0,25000,Null,Null,263564808,4414249,23238
263564872,0.0,0.0,1200000,1200000,0,0,1200000,Null,Null,263564872,111461,53350
263564901,0.0,0.0,395800,395800,0,0,395800,Null,Null,263564901,111461,5267
263564903,0.0,0.0,350000,350000,0,0,350000,Null,Null,263564903,111461,23588
263565043,0.0,0.0,300000,300000,0,0,300000,Null,Null,263565043,111461,2657
263565076,0.0,0.0,450000,450000,0,0,450000,Null,Null,263565076,111461,2324
263565165,0.0,0.0,4465000,4465000,0,0,4465000,Null,Null,263565165,111461,27196
263566671,0.0,0.0,125000,125000,0,0,125000,Null,Null,263566671,111461,27240
263566819,0.0,0.0,120000,120000,0,0,120000,Null,Null,263566819,111461,23660
263566844,0.0,0.0,299000,299000,0,0,299000,Null,Null,263566844,471783,1601
263566950,0.0,0.0,180000,180000,0,0,180000,Null,Null,263566950,111461,23660
263567063,0.0,0.0,105000,105000,0,0,105000,Null,Null,263567063,5262001,3179
263567076,14.0,14.0,299000,299000,0,0,299000,Null,Null,263567076,550967,1520
263567103,0.0,0.0,29000,29000,0,0,29000,Null,Null,263567103,111461,15320
263567105,0.0,0.0,1540000,1540000,0,0,1540000,Null,Null,263567105,111461,23346
263567127,0.0,0.0,160000,160000,0,0,160000,Null,Null,263567127,111461,28582
263567167,0.0,0.0,41400,41400,0,0,41400,Null,Null,263567167,111461,2234
263567218,0.0,0.0,199000,199000,0,0,199000,Null,Null,263567218,111461,5566
263567255,0.0,0.0,18000,18000,0,0,18000,Null,Null,263567255,111461,20254
263567262,0.0,0.0,42000,42000,0,0,42000,Null,Null,263567262,5160827,2
263567272,0.0,0.0,850000,850000,0,0,850000,Null,Null,263567272,111461,2
263567287,0.0,0.0,199000,199000,0,0,199000,Null,Null,263567287,111461,2
263567304,0.0,0.0,180000,180000,0,0,180000,Null,Null,263567304,111461,2
263567352,0.0,0.0,3545000,3545000,0,0,3545000,Null,Null,263567352,111461,27192
263567395,0.0,0.0,230000,230000,0,0,230000,Null,Null,263567395,111461,15318
263567428,0.0,0.0,250000,250000,0,0,250000,Null,Null,263567428,111461,23660
263567440,0.0,0.0,450000,450000,0,0,450000,Null,Null,263567440,111461,15250
263567462,0.0,0.0,2009000,2009000,0,0,2009000,Null,Null,263567462,111461,27196
263567483,0.0,0.0,690000,690000,0,0,690000,Null,Null,263567483,111461,23056
263567486,0.0,0.0,230000,230000,0,0,230000,Null,Null,263567486,111461,15318
263567502,0.0,0.0,790000,790000,0,0,790000,Null,Null,263567502,111461,23056
263567526,0.0,0.0,230000,230000,0,0,230000,Null,Null,263567526,111461,15318
263567570,0.0,0.0,269000,269000,0,0,269000,Null,Null,263567570,111461,1979
263567620,0.0,0.0,269000,269000,0,0,269000,Null,Null,263567620,111461,1979
263567623,0.0,0.0,274900,274900,0,0,274900,Null,Null,263567623,111461,5531
263567635,0.0,0.0,250000,250000,0,0,250000,Null,Null,263567635,111461,23236
263567676,0.0,0.0,150000,150000,0,0,150000,Null,Null,263567676,111461,28592
263567685,0.0,0.0,280000,280000,0,0,280000,Null,Null,263567685,111461,15250
263567689,0.0,0.0,180000,180000,0,0,180000,Null,Null,263567689,111461,15318
263567704,0.0,0.0,32000,32000,0,0,32000,Null,Null,263567704,111461,4428
263567815,0.0,0.0,8000,8000,0,0,8000,Null,Null,263567815,111461,5566
263567846,0.0,0.0,165000,165000,0,0,165000,Null,Null,263567846,111461,2392
263567850,0.0,0.0,165000,165000,0,0,165000,Null,Null,263567850,111461,2392
263567903,0.0,0.0,135000,135000,0,0,135000,Null,Null,263567903,111461,28592
263567970,0.0,0.0,90000,90000,0,0,90000,Null,Null,263567970,111461,3990
263567989,0.0,0.0,5990000,4990000,1000000,17,5990000,Null,Null,263567989,18802,1794
263568019,0.0,0.0,120000,120000,0,0,120000,Null,Null,263568019,111461,15318
263568082,0.0,0.0,390000,390000,0,0,390000,Null,Null,263568082,111461,5566
263568085,0.0,0.0,169000,169000,0,0,169000,Null,Null,263568085,111461,3990
263568115,0.0,0.0,749000,749000,0,0,749000,Null,Null,263568115,111461,5566
263568135,0.0,0.0,249900,249900,0,0,249900,Null,Null,263568135,111461,23832
263568137,0.0,0.0,70000,70000,0,0,70000,Null,Null,263568137,111461,23346
263568250,0.0,0.0,389000,389000,0,0,389000,Null,Null,263568250,111461,5566
263568276,0.0,0.0,142000,142000,0,0,142000,Null,Null,263568276,111461,5566
263568325,0.0,0.0,55200000,55200000,0,0,55200000,Null,Null,263568325,111461,23540
263568327,0.0,0.0,1540000,1540000,0,0,1540000,Null,Null,263568327,111461,23346
263568344,0.0,0.0,55200000,55200000,0,0,55200000,Null,Null,263568344,111461,23540
263568355,0.0,0.0,55000,55000,0,0,55000,Null,Null,263568355,111461,5566
263568967,0.0,0.0,219000,219000,0,0,219000,Null,Null,263568967,111461,3990
263569404,0.0,0.0,152000,152000,0,0,152000,Null,Null,263569404,111461,2
263569415,0.0,0.0,39000,39000,0,0,39000,Null,Null,263569415,111461,28682
263569488,0.0,0.0,68000,68000,0,0,68000,Null,Null,263569488,111461,23346
263569593,0.0,0.0,999000,999000,0,0,999000,Null,Null,263569593,212267,12908
263569633,0.0,0.0,145000,145000,0,0,145000,Null,Null,263569633,111461,23246
263569746,0.0,0.0,245000,245000,0,0,245000,Null,Null,263569746,415523,1613
263569748,0.0,0.0,145000,145000,0,0,145000,Null,Null,263569748,111461,23346
263569906,0.0,0.0,120000,120000,0,0,120000,Null,Null,263569906,5220265,8206
263569931,0.0,0.0,178000,178000,0,0,178000,Null,Null,263569931,111461,3515
263569994,0.0,0.0,270000,270000,0,0,270000,Null,Null,263569994,111461,2340
263570052,0.0,0.0,250000,250000,0,0,250000,Null,Null,263570052,5220265,8206
263570083,0.0,0.0,650000,650000,0,0,650000,Null,Null,263570083,111461,8167
263570123,0.0,0.0,245000,245000,0,0,245000,Null,Null,263570123,111461,8167
263570257,0.0,0.0,2499000,2499000,0,0,2499000,Null,Null,263570257,4650749,5264
263570376,0.0,0.0,69000,69000,0,0,69000,Null,Null,263570376,21407,2348
263570428,0.0,0.0,210000,210000,0,0,210000,Null,Null,263570428,5220265,2347
263570440,0.0,0.0,99000,99000,0,0,99000,Null,Null,263570440,111461,15318
263570488,0.0,0.0,139000,139000,0,0,139000,Null,Null,263570488,111461,2
263570502,0.0,0.0,175100,175100,0,0,175100,Null,Null,263570502,41391,2
263570503,0.0,0.0,110800,110800,0,0,110800,Null,Null,263570503,41391,2
263570505,0.0,0.0,232200,232200,0,0,232200,Null,Null,263570505,41391,2
263570507,0.0,0.0,175100,175100,0,0,175100,Null,Null,263570507,41391,2
263570516,0.0,0.0,295400,295400,0,0,295400,Null,Null,263570516,41391,2
263570517,0.0,0.0,64428,64428,0,0,64428,Null,Null,263570517,41391,2
263570518,0.0,0.0,42700,42700,0,0,42700,Null,Null,263570518,41391,2
263570525,0.0,0.0,175100,175100,0,0,175100,Null,Null,263570525,41391,2
263570531,0.0,0.0,75500,75500,0,0,75500,Null,Null,263570531,41391,2
263570539,0.0,0.0,10800,10800,0,0,10800,Null,Null,263570539,41391,2
263570540,0.0,0.0,131359,131359,0,0,131359,Null,Null,263570540,41391,2
263570541,0.0,0.0,23300,23300,0,0,23300,Null,Null,263570541,41391,2
263570546,0.0,0.0,64200,64200,0,0,64200,Null,Null,263570546,41391,2
263570549,0.0,0.0,72000,72000,0,0,72000,Null,Null,263570549,41391,2
263570550,0.0,0.0,336326,336326,0,0,336326,Null,Null,263570550,41391,2
263570552,0.0,0.0,256100,256100,0,0,256100,Null,Null,263570552,41391,2
263570553,0.0,0.0,414700,414700,0,0,414700,Null,Null,263570553,41391,2
263570554,0.0,0.0,182662,182662,0,0,182662,Null,Null,263570554,41391,2
263570566,0.0,0.0,279000,279000,0,0,279000,Null,Null,263570566,41391,2
263570569,0.0,0.0,290910,290910,0,0,290910,Null,Null,263570569,41391,2
263570571,0.0,0.0,49100,49100,0,0,49100,Null,Null,263570571,41391,2
263570574,0.0,0.0,732300,732300,0,0,732300,Null,Null,263570574,41391,2
263570582,0.0,0.0,495039,495039,0,0,495039,Null,Null,263570582,41391,2
263570585,0.0,0.0,692600,692600,0,0,692600,Null,Null,263570585,41391,2
263570586,0.0,0.0,79000,79000,0,0,79000,Null,Null,263570586,41391,2
263570587,0.0,0.0,271200,271200,0,0,271200,Null,Null,263570587,41391,2
263570588,0.0,0.0,116800,116800,0,0,116800,Null,Null,263570588,41391,2
263570591,0.0,0.0,116000,116000,0,0,116000,Null,Null,263570591,41391,2
263570599,0.0,0.0,67300,67300,0,0,67300,Null,Null,263570599,41391,2
263570604,0.0,0.0,64428,64428,0,0,64428,Null,Null,263570604,41391,2
263570611,0.0,0.0,147822,147822,0,0,147822,Null,Null,263570611,41391,2
263570613,0.0,0.0,82603,82603,0,0,82603,Null,Null,263570613,41391,2
263570614,0.0,0.0,144700,144700,0,0,144700,Null,Null,263570614,41391,2
263570617,0.0,0.0,72419,72419,0,0,72419,Null,Null,263570617,41391,2
263570635,0.0,0.0,60390,60390,0,0,60390,Null,Null,263570635,41391,2
263570638,0.0,0.0,210065,210065,0,0,210065,Null,Null,263570638,41391,2
263570640,0.0,0.0,115100,115100,0,0,115100,Null,Null,263570640,41391,2
263570647,0.0,0.0,1078400,1078400,0,0,1078400,Null,Null,263570647,41391,2
263570652,0.0,0.0,100350,100350,0,0,100350,Null,Null,263570652,41391,2
263570659,0.0,0.0,125100,125100,0,0,125100,Null,Null,263570659,41391,2
263570661,0.0,0.0,138870,138870,0,0,138870,Null,Null,263570661,41391,2
263570662,0.0,0.0,124600,124600,0,0,124600,Null,Null,263570662,41391,2
263570664,0.0,0.0,33400,33400,0,0,33400,Null,Null,263570664,41391,2
263570669,0.0,0.0,171750,171750,0,0,171750,Null,Null,263570669,41391,2
263570670,0.0,0.0,192000,192000,0,0,192000,Null,Null,263570670,41391,2
263570671,0.0,0.0,24000,24000,0,0,24000,Null,Null,263570671,41391,2
263570698,0.0,0.0,65400,65400,0,0,65400,Null,Null,263570698,41391,2
263570702,0.0,0.0,225700,225700,0,0,225700,Null,Null,263570702,41391,2
263570705,0.0,0.0,262400,262400,0,0,262400,Null,Null,263570705,41391,2
263570707,0.0,0.0,131400,131400,0,0,131400,Null,Null,263570707,41391,2
263570716,0.0,0.0,46800,46800,0,0,46800,Null,Null,263570716,41391,2
263570718,0.0,0.0,399400,399400,0,0,399400,Null,Null,263570718,41391,2
263570719,0.0,0.0,263530,263530,0,0,263530,Null,Null,263570719,41391,2
263570728,0.0,0.0,60700,60700,0,0,60700,Null,Null,263570728,41391,2
263570729,0.0,0.0,229100,229100,0,0,229100,Null,Null,263570729,41391,2
263570732,0.0,0.0,214800,214800,0,0,214800,Null,Null,263570732,41391,2
263570737,0.0,0.0,183300,183300,0,0,183300,Null,Null,263570737,41391,2
263570738,0.0,0.0,239700,239700,0,0,239700,Null,Null,263570738,41391,2
263570753,0.0,0.0,19700,19700,0,0,19700,Null,Null,263570753,41391,2
263570758,0.0,0.0,23004,23004,0,0,23004,Null,Null,263570758,41391,2
263570764,0.0,0.0,112817,112817,0,0,112817,Null,Null,263570764,41391,2
263570765,0.0,0.0,241038,241038,0,0,241038,Null,Null,263570765,41391,2
263570766,0.0,0.0,82200,82200,0,0,82200,Null,Null,263570766,41391,2
263570767,0.0,0.0,178300,178300,0,0,178300,Null,Null,263570767,41391,2
263570769,0.0,0.0,329900,329900,0,0,329900,Null,Null,263570769,41391,2
263570772,0.0,0.0,97685,97685,0,0,97685,Null,Null,263570772,41391,2
263570774,0.0,0.0,136300,136300,0,0,136300,Null,Null,263570774,41391,2
263570779,0.0,0.0,228800,228800,0,0,228800,Null,Null,263570779,41391,2
263570787,0.0,0.0,103100,103100,0,0,103100,Null,Null,263570787,41391,2
263570788,0.0,0.0,175100,175100,0,0,175100,Null,Null,263570788,41391,2
263570789,0.0,0.0,21400,21400,0,0,21400,Null,Null,263570789,41391,2
263570800,0.0,0.0,254900,254900,0,0,254900,Null,Null,263570800,41391,2
263570801,0.0,0.0,152500,152500,0,0,152500,Null,Null,263570801,41391,2
263570812,0.0,0.0,38700,38700,0,0,38700,Null,Null,263570812,41391,2
263570813,0.0,0.0,203405,203405,0,0,203405,Null,Null,263570813,41391,2
263570815,0.0,0.0,226600,226600,0,0,226600,Null,Null,263570815,41391,2
263570817,0.0,0.0,798100,798100,0,0,798100,Null,Null,263570817,41391,2
263570821,0.0,0.0,17718,17718,0,0,17718,Null,Null,263570821,41391,2
263570826,0.0,0.0,209200,209200,0,0,209200,Null,Null,263570826,41391,2
263570832,0.0,0.0,100500,100500,0,0,100500,Null,Null,263570832,41391,2
263570836,0.0,0.0,707400,707400,0,0,707400,Null,Null,263570836,41391,2
263570844,0.0,0.0,241038,241038,0,0,241038,Null,Null,263570844,41391,2
263570846,0.0,0.0,100367,100367,0,0,100367,Null,Null,263570846,41391,2
263570847,0.0,0.0,668100,668100,0,0,668100,Null,Null,263570847,41391,2
263570853,0.0,0.0,124100,124100,0,0,124100,Null,Null,263570853,41391,2
263570859,0.0,0.0,12355,12355,0,0,12355,Null,Null,263570859,41391,2
263570861,0.0,0.0,102293,102293,0,0,102293,Null,Null,263570861,41391,2
263570862,0.0,0.0,88200,88200,0,0,88200,Null,Null,263570862,41391,2
263570869,0.0,0.0,179258,179258,0,0,179258,Null,Null,263570869,41391,2
263570871,0.0,0.0,160300,160300,0,0,160300,Null,Null,263570871,41391,2
263570874,0.0,0.0,94240,94240,0,0,94240,Null,Null,263570874,41391,2
263570875,0.0,0.0,160500,160500,0,0,160500,Null,Null,263570875,41391,2
263570883,0.0,0.0,42978,42978,0,0,42978,Null,Null,263570883,41391,2
263570891,0.0,0.0,31465,31465,0,0,31465,Null,Null,263570891,41391,2
263570893,0.0,0.0,167675,167675,0,0,167675,Null,Null,263570893,41391,2
263570895,0.0,0.0,92100,92100,0,0,92100,Null,Null,263570895,41391,2
263570897,0.0,0.0,192000,192000,0,0,192000,Null,Null,263570897,41391,2
263570898,0.0,0.0,135520,135520,0,0,135520,Null,Null,263570898,41391,2
263570902,0.0,0.0,115152,115152,0,0,115152,Null,Null,263570902,41391,2
263570923,0.0,0.0,203405,203405,0,0,203405,Null,Null,263570923,41391,2
263570936,0.0,0.0,24000,24000,0,0,24000,Null,Null,263570936,41391,2
263570938,0.0,0.0,40325,40325,0,0,40325,Null,Null,263570938,41391,2
263570947,0.0,0.0,33500,33500,0,0,33500,Null,Null,263570947,41391,2
263570949,0.0,0.0,153400,153400,0,0,153400,Null,Null,263570949,41391,2
263570958,0.0,0.0,174400,174400,0,0,174400,Null,Null,263570958,41391,2
263570963,0.0,0.0,144069,144069,0,0,144069,Null,Null,263570963,41391,2
263570965,0.0,0.0,118258,118258,0,0,118258,Null,Null,263570965,41391,2
263570972,0.0,0.0,172996,172996,0,0,172996,Null,Null,263570972,41391,2
263570986,0.0,0.0,2499000,2499000,0,0,2499000,Null,Null,263570986,514405,5267
263570987,0.0,0.0,620000,620000,0,0,620000,Null,Null,263570987,111461,23276
263571045,0.0,0.0,3400000,3400000,0,0,3400000,Null,Null,263571045,111461,53186
263571056,0.0,0.0,70000,38000,32000,46,70000,Null,Null,263571056,111461,23778
263571064,0.0,0.0,6900000,6900000,0,0,6900000,Null,Null,263571064,111461,53186
263571104,0.0,0.0,2060000,2060000,0,0,2060000,Null,Null,263571104,111461,53186
263571106,0.0,0.0,99000,99000,0,0,99000,Null,Null,263571106,111461,3177
263571123,0.0,0.0,180000,180000,0,0,180000,Null,Null,263571123,111461,23622
263571181,0.0,0.0,120000,120000,0,0,120000,Null,Null,263571181,111461,23258
263571190,0.0,0.0,680000,680000,0,0,680000,Null,Null,263571190,111461,23276
263571227,0.0,0.0,2990000,2990000,0,0,2990000,Null,Null,263571227,5188707,1883
263571293,0.0,0.0,65000,65000,0,0,65000,Null,Null,263571293,111461,2
263571376,0.0,0.0,479000,479000,0,0,479000,Null,Null,263571376,8196398,3422
263571382,0.0,0.0,500000,295000,205000,41,500000,Null,Null,263571382,7377629,23622
263571441,0.0,0.0,64000,64000,0,0,64000,Null,Null,263571441,111461,12984
263571454,0.0,0.0,55000,55000,0,0,55000,Null,Null,263571454,111461,2
263571497,0.0,0.0,2390000,2390000,0,0,2390000,Null,Null,263571497,5188707,1883
263571530,0.0,0.0,286000,286000,0,0,286000,Null,Null,263571530,111461,12984
263571556,0.0,0.0,155000,155000,0,0,155000,Null,Null,263571556,111461,15320
263571567,0.0,0.0,40000,40000,0,0,40000,Null,Null,263571567,111461,2
263571662,0.0,0.0,2590000,2590000,0,0,2590000,Null,Null,263571662,5188707,1883
263572049,0.0,0.0,2290000,2290000,0,0,2290000,Null,Null,263572049,5188707,1883
263572360,0.0,0.0,39000,39000,0,0,39000,Null,Null,263572360,111461,2
263572365,0.0,0.0,35000,35000,0,0,35000,Null,Null,263572365,111461,2
263572368,0.0,0.0,55000,55000,0,0,55000,Null,Null,263572368,111461,2
263572371,0.0,0.0,15000,15000,0,0,15000,Null,Null,263572371,111461,2
263572375,0.0,0.0,25000,25000,0,0,25000,Null,Null,263572375,111461,2
263572382,0.0,0.0,15000,15000,0,0,15000,Null,Null,263572382,111461,2
263572387,0.0,0.0,25000,25000,0,0,25000,Null,Null,263572387,111461,2
263572388,0.0,0.0,55000,55000,0,0,55000,Null,Null,263572388,111461,2
263572394,0.0,0.0,35000,35000,0,0,35000,Null,Null,263572394,111461,2
263572399,0.0,0.0,15000,15000,0,0,15000,Null,Null,263572399,111461,2
263572438,0.0,0.0,2990000,2990000,0,0,2990000,Null,Null,263572438,5188707,1883
263572501,0.0,0.0,2690000,2690000,0,0,2690000,Null,Null,263572501,5188707,1883
263572563,0.0,0.0,1990000,1990000,0,0,1990000,Null,Null,263572563,5188707,1883
263572625,0.0,0.0,1590000,1590000,0,0,1590000,Null,Null,263572625,5188707,1883
263573345,0.0,0.0,1750000,1750000,0,0,1750000,Null,Null,263573345,5188707,1883
263574275,0.0,0.0,18000,18000,0,0,18000,Null,Null,263574275,111461,23416
263574549,0.0,0.0,340000,340000,0,0,340000,Null,Null,263574549,111461,15318
263574551,0.0,0.0,340000,340000,0,0,340000,Null,Null,263574551,111461,15318
263574553,0.0,0.0,340000,340000,0,0,340000,Null,Null,263574553,111461,15318
263574555,0.0,0.0,340000,340000,0,0,340000,Null,Null,263574555,111461,15318
263574557,0.0,0.0,340000,340000,0,0,340000,Null,Null,263574557,111461,15318
263574559,0.0,0.0,340000,340000,0,0,340000,Null,Null,263574559,111461,15318
263574561,0.0,0.0,340000,340000,0,0,340000,Null,Null,263574561,111461,15318
263574563,0.0,0.0,340000,340000,0,0,340000,Null,Null,263574563,111461,15318
263574565,0.0,0.0,340000,340000,0,0,340000,Null,Null,263574565,111461,15318
263574567,0.0,0.0,340000,340000,0,0,340000,Null,Null,263574567,111461,15318
263574569,0.0,0.0,420000,420000,0,0,420000,Null,Null,263574569,111461,15318
263574571,0.0,0.0,340000,340000,0,0,340000,Null,Null,263574571,111461,15318
263574573,0.0,0.0,340000,340000,0,0,340000,Null,Null,263574573,111461,15318
263574575,0.0,0.0,340000,340000,0,0,340000,Null,Null,263574575,111461,15318
263574577,0.0,0.0,340000,340000,0,0,340000,Null,Null,263574577,111461,15318
263574579,0.0,0.0,340000,340000,0,0,340000,Null,Null,263574579,111461,15318
263574581,0.0,0.0,340000,340000,0,0,340000,Null,Null,263574581,111461,15318
263574583,0.0,0.0,340000,340000,0,0,340000,Null,Null,263574583,111461,15318
263574585,0.0,0.0,200000,200000,0,0,200000,Null,Null,263574585,111461,15318
263574587,0.0,0.0,360000,360000,0,0,360000,Null,Null,263574587,111461,15318
263574589,0.0,0.0,340000,340000,0,0,340000,Null,Null,263574589,111461,15318
263574591,0.0,0.0,340000,340000,0,0,340000,Null,Null,263574591,111461,15318
263574593,0.0,0.0,340000,340000,0,0,340000,Null,Null,263574593,111461,15318
263574595,0.0,0.0,340000,340000,0,0,340000,Null,Null,263574595,111461,15318
263574597,0.0,0.0,340000,340000,0,0,340000,Null,Null,263574597,111461,15318
263574599,0.0,0.0,340000,340000,0,0,340000,Null,Null,263574599,111461,15318
263574601,0.0,0.0,340000,340000,0,0,340000,Null,Null,263574601,111461,15318
263574603,0.0,0.0,340000,340000,0,0,340000,Null,Null,263574603,111461,15318
263574605,0.0,0.0,340000,340000,0,0,340000,Null,Null,263574605,111461,15318
263574607,0.0,0.0,340000,340000,0,0,340000,Null,Null,263574607,111461,15318
263574609,0.0,0.0,25000,25000,0,0,25000,Null,Null,263574609,152820,11856
263574620,0.0,0.0,549000,549000,0,0,549000,Null,Null,263574620,111461,2
263574621,0.0,0.0,669000,669000,0,0,669000,Null,Null,263574621,111461,2
263574624,0.0,0.0,329000,329000,0,0,329000,Null,Null,263574624,111461,2
263574625,0.0,0.0,759000,759000,0,0,759000,Null,Null,263574625,111461,2
263574631,0.0,0.0,1199000,1199000,0,0,1199000,Null,Null,263574631,111461,2
263574632,0.0,0.0,680000,680000,0,0,680000,Null,Null,263574632,111461,2
263574633,0.0,0.0,999000,999000,0,0,999000,Null,Null,263574633,111461,2
263574637,0.0,0.0,750000,750000,0,0,750000,Null,Null,263574637,111461,2
263574642,0.0,0.0,33000,33000,0,0,33000,Null,Null,263574642,111461,2
263574643,0.0,0.0,299000,299000,0,0,299000,Null,Null,263574643,111461,2
263574646,0.0,0.0,339000,339000,0,0,339000,Null,Null,263574646,111461,2
263574648,0.0,0.0,139000,139000,0,0,139000,Null,Null,263574648,111461,2
263574650,0.0,0.0,839000,839000,0,0,839000,Null,Null,263574650,111461,2
263574652,0.0,0.0,239000,239000,0,0,239000,Null,Null,263574652,111461,2
263574654,0.0,0.0,336000,336000,0,0,336000,Null,Null,263574654,111461,2
263574655,0.0,0.0,1090000,1090000,0,0,1090000,Null,Null,263574655,111461,2
263574658,0.0,0.0,550000,550000,0,0,550000,Null,Null,263574658,111461,2
263574660,0.0,0.0,499000,499000,0,0,499000,Null,Null,263574660,111461,2
263574665,0.0,0.0,550000,550000,0,0,550000,Null,Null,263574665,111461,2
263574667,0.0,0.0,199000,199000,0,0,199000,Null,Null,263574667,111461,2
263574669,0.0,0.0,739000,739000,0,0,739000,Null,Null,263574669,111461,2
263574671,0.0,0.0,299000,299000,0,0,299000,Null,Null,263574671,111461,2
263574673,0.0,0.0,399000,399000,0,0,399000,Null,Null,263574673,111461,2
263574675,0.0,0.0,699000,699000,0,0,699000,Null,Null,263574675,111461,2
263574682,0.0,0.0,239000,239000,0,0,239000,Null,Null,263574682,111461,2
263574700,0.0,0.0,590000,590000,0,0,590000,Null,Null,263574700,111461,2
263574702,0.0,0.0,399000,399000,0,0,399000,Null,Null,263574702,111461,2
263574713,0.0,0.0,839000,839000,0,0,839000,Null,Null,263574713,111461,2
263574721,0.0,0.0,199000,199000,0,0,199000,Null,Null,263574721,111461,2
263574726,0.0,0.0,668000,668000,0,0,668000,Null,Null,263574726,111461,2
263574732,0.0,0.0,668000,668000,0,0,668000,Null,Null,263574732,111461,2
263574734,0.0,0.0,299000,299000,0,0,299000,Null,Null,263574734,111461,2
263574749,0.0,0.0,259000,259000,0,0,259000,Null,Null,263574749,111461,2
263574756,0.0,0.0,59000,59000,0,0,59000,Null,Null,263574756,111461,2
263574763,0.0,0.0,99000,99000,0,0,99000,Null,Null,263574763,111461,2
263574765,0.0,0.0,189000,189000,0,0,189000,Null,Null,263574765,111461,2
263574776,0.0,0.0,550000,550000,0,0,550000,Null,Null,263574776,111461,2
263574782,0.0,0.0,359000,359000,0,0,359000,Null,Null,263574782,111461,2
263574783,0.0,0.0,1639000,1639000,0,0,1639000,Null,Null,263574783,111461,2
263574786,0.0,0.0,639000,639000,0,0,639000,Null,Null,263574786,111461,2
263574788,0.0,0.0,839000,839000,0,0,839000,Null,Null,263574788,111461,2
263574790,0.0,0.0,89000,89000,0,0,89000,Null,Null,263574790,111461,2
263574792,0.0,0.0,650000,650000,0,0,650000,Null,Null,263574792,111461,2
263574794,0.0,0.0,459000,459000,0,0,459000,Null,Null,263574794,111461,2
263574796,0.0,0.0,400000,400000,0,0,400000,Null,Null,263574796,111461,2
263574801,0.0,0.0,586000,586000,0,0,586000,Null,Null,263574801,111461,2
263574802,0.0,0.0,250000,250000,0,0,250000,Null,Null,263574802,111461,2
263574806,0.0,0.0,1300000,1300000,0,0,1300000,Null,Null,263574806,111461,2
263574808,0.0,0.0,1050000,1050000,0,0,1050000,Null,Null,263574808,111461,2
263574810,0.0,0.0,1200000,1200000,0,0,1200000,Null,Null,263574810,111461,2
263574812,0.0,0.0,899000,899000,0,0,899000,Null,Null,263574812,111461,2
263574813,0.0,0.0,239000,239000,0,0,239000,Null,Null,263574813,111461,2
263574814,0.0,0.0,399000,399000,0,0,399000,Null,Null,263574814,111461,2
263574821,0.0,0.0,550000,550000,0,0,550000,Null,Null,263574821,111461,2
263574823,0.0,0.0,250000,250000,0,0,250000,Null,Null,263574823,111461,2
263574825,0.0,0.0,199000,199000,0,0,199000,Null,Null,263574825,111461,2
263574827,0.0,0.0,4500000,4500000,0,0,4500000,Null,Null,263574827,111461,2
263574829,0.0,0.0,550000,550000,0,0,550000,Null,Null,263574829,111461,2
263574831,0.0,0.0,208000,208000,0,0,208000,Null,Null,263574831,4414249,23238
263574834,0.0,0.0,594000,594000,0,0,594000,Null,Null,263574834,4414249,23246
263574841,0.0,0.0,174000,174000,0,0,174000,Null,Null,263574841,4414249,23238
263574874,0.0,0.0,1898000,1898000,0,0,1898000,Null,Null,263574874,48497,23030
263574884,0.0,0.0,1999000,1999000,0,0,1999000,Null,Null,263574884,48497,23030
263574892,0.0,0.0,175000,175000,0,0,175000,Null,Null,263574892,4414249,23246
263574894,0.0,0.0,99000,99000,0,0,99000,Null,Null,263574894,111461,28484
263574906,0.0,0.0,163000,163000,0,0,163000,Null,Null,263574906,4414249,23246
263574915,0.0,0.0,71900,71900,0,0,71900,Null,Null,263574915,111461,4429
263574917,0.0,0.0,130000,130000,0,0,130000,Null,Null,263574917,111461,2
263574926,0.0,0.0,750000,750000,0,0,750000,Null,Null,263574926,111461,2
263574930,0.0,0.0,230000,230000,0,0,230000,Null,Null,263574930,111461,2
263574932,0.0,0.0,120000,120000,0,0,120000,Null,Null,263574932,4414249,23246
263574941,0.0,0.0,599000,599000,0,0,599000,Null,Null,263574941,606305,23102
263574943,0.0,0.0,320000,320000,0,0,320000,Null,Null,263574943,111461,2
263574947,0.0,0.0,120000,120000,0,0,120000,Null,Null,263574947,4414249,23246
263574955,0.0,0.0,65000,65000,0,0,65000,Null,Null,263574955,111461,2
263574957,0.0,0.0,120000,120000,0,0,120000,Null,Null,263574957,4414249,23246
263574966,0.0,0.0,330000,330000,0,0,330000,Null,Null,263574966,111461,2
263574973,0.0,0.0,250000,250000,0,0,250000,Null,Null,263574973,111461,2
263574979,0.0,0.0,250000,250000,0,0,250000,Null,Null,263574979,111461,2
263574981,0.0,0.0,120000,120000,0,0,120000,Null,Null,263574981,4414249,23246
263574989,0.0,0.0,258000,258000,0,0,258000,Null,Null,263574989,4414249,2019
263574996,0.0,0.0,195000,195000,0,0,195000,Null,Null,263574996,4414249,23246
263575007,0.0,0.0,2500000,2500000,0,0,2500000,Null,Null,263575007,111461,23634
263575009,0.0,0.0,247000,247000,0,0,247000,Null,Null,263575009,4414249,23246
263575011,0.0,0.0,15000,15000,0,0,15000,Null,Null,263575011,5307993,27172
263575074,0.0,0.0,165000,165000,0,0,165000,Null,Null,263575074,4414249,23246
263575081,0.0,0.0,89000,89000,0,0,89000,Null,Null,263575081,111461,2340
263575101,0.0,0.0,173000,173000,0,0,173000,Null,Null,263575101,111461,23778
263575137,0.0,0.0,66000,66000,0,0,66000,Null,Null,263575137,111461,1883
263575149,0.0,0.0,15000,15000,0,0,15000,Null,Null,263575149,5307993,27172
263575169,0.0,0.0,125000,125000,0,0,125000,Null,Null,263575169,4414249,23246
263575177,0.0,0.0,360000,360000,0,0,360000,Null,Null,263575177,111461,1979
263575207,0.0,0.0,247000,247000,0,0,247000,Null,Null,263575207,4414249,2019
263575222,0.0,0.0,360000,360000,0,0,360000,Null,Null,263575222,111461,1979
263575224,0.0,0.0,10000,10000,0,0,10000,Null,Null,263575224,5307993,27172
263575260,0.0,0.0,557000,557000,0,0,557000,Null,Null,263575260,4414249,23246
263575267,0.0,0.0,134000,134000,0,0,134000,Null,Null,263575267,689369,23800
263575306,0.0,0.0,147900,147900,0,0,147900,Null,Null,263575306,111461,23622
263575316,0.0,0.0,15000,15000,0,0,15000,Null,Null,263575316,5307993,27172
263575388,0.0,0.0,122000,122000,0,0,122000,Null,Null,263575388,4414249,23246
263575411,0.0,0.0,18000,18000,0,0,18000,Null,Null,263575411,111461,23220
263575421,0.0,0.0,175000,175000,0,0,175000,Null,Null,263575421,4414249,23246
263575427,0.0,0.0,2990000,2990000,0,0,2990000,Null,Null,263575427,111461,23652
263575452,0.0,0.0,195000,195000,0,0,195000,Null,Null,263575452,4414249,23246
263575607,0.0,0.0,205000,205000,0,0,205000,Null,Null,263575607,4414249,2019
263575620,0.0,0.0,1950000,1950000,0,0,1950000,Null,Null,263575620,111461,23622
263575634,0.0,0.0,10000,10000,0,0,10000,Null,Null,263575634,111461,23254
263575642,0.0,0.0,352000,352000,0,0,352000,Null,Null,263575642,4414249,23246
263575689,0.0,0.0,134000,134000,0,0,134000,Null,Null,263575689,689369,23800
263575695,0.0,0.0,1390000,1390000,0,0,1390000,Null,Null,263575695,111461,2511
263575716,0.0,0.0,578000,578000,0,0,578000,Null,Null,263575716,4414249,23246
263575787,0.0,0.0,122000,122000,0,0,122000,Null,Null,263575787,111461,23340
263575800,0.0,0.0,142000,142000,0,0,142000,Null,Null,263575800,4414249,2019
263575850,0.0,0.0,2600000,2600000,0,0,2600000,Null,Null,263575850,111461,23660
263575854,0.0,0.0,9000,9000,0,0,9000,Null,Null,263575854,111461,23276
263575864,0.0,0.0,259000,259000,0,0,259000,Null,Null,263575864,111461,1883
263575894,0.0,0.0,2399000,2399000,0,0,2399000,Null,Null,263575894,111461,4381
263575915,0.0,0.0,146000,146000,0,0,146000,Null,Null,263575915,4414249,23246
263575920,0.0,0.0,950000,950000,0,0,950000,Null,Null,263575920,111461,23078
263575924,0.0,0.0,28000,28000,0,0,28000,Null,Null,263575924,111461,23036
263575946,0.0,0.0,94000,94000,0,0,94000,Null,Null,263575946,111461,1836
263575963,0.0,0.0,320000,320000,0,0,320000,Null,Null,263575963,111461,23236
263575965,0.0,0.0,405000,405000,0,0,405000,Null,Null,263575965,4414249,2019
263576026,0.0,0.0,100000,100000,0,0,100000,Null,Null,263576026,111461,23154
263576060,0.0,0.0,195000,195000,0,0,195000,Null,Null,263576060,4414249,23246
263576062,0.0,0.0,1599000,1599000,0,0,1599000,Null,Null,263576062,111461,4381
263576146,0.0,0.0,174000,174000,0,0,174000,Null,Null,263576146,4414249,2019
263576188,0.0,0.0,515000,515000,0,0,515000,Null,Null,263576188,4414249,23246
263576191,0.0,0.0,70000,35000,35000,50,70000,Null,Null,263576191,111461,23778
263576227,0.0,0.0,1299000,1299000,0,0,1299000,Null,Null,263576227,111461,4381
263576256,0.0,0.0,588000,588000,0,0,588000,Null,Null,263576256,4414249,23246
263576269,0.0,0.0,21000,21000,0,0,21000,Null,Null,263576269,111461,3179
263577077,0.0,0.0,46000,46000,0,0,46000,Null,Null,263577077,111461,23706
263577084,0.0,0.0,69000,69000,0,0,69000,Null,Null,263577084,111461,17162
263577098,0.0,0.0,160000,160000,0,0,160000,Null,Null,263577098,4414249,2019
263577118,0.0,0.0,1567000,1567000,0,0,1567000,Null,Null,263577118,7426417,4381
263577194,0.0,0.0,70000,35000,35000,50,70000,Null,Null,263577194,111461,23778
263577210,0.0,0.0,7900,7900,0,0,7900,Null,Null,263577210,154455,53054
263577215,0.0,0.0,174000,174000,0,0,174000,Null,Null,263577215,4414249,2019
263577231,0.0,0.0,135000,135000,0,0,135000,Null,Null,263577231,111461,2
263577240,0.0,0.0,130000,130000,0,0,130000,Null,Null,263577240,111461,2
263577248,0.0,0.0,35000,35000,0,0,35000,Null,Null,263577248,111461,2
263577255,0.0,0.0,169000,169000,0,0,169000,Null,Null,263577255,111461,2
263577258,0.0,0.0,80000,80000,0,0,80000,Null,Null,263577258,111461,2
263577269,0.0,0.0,125000,125000,0,0,125000,Null,Null,263577269,111461,2
263577270,0.0,0.0,35000,35000,0,0,35000,Null,Null,263577270,111461,2
263577298,0.0,0.0,17000,17000,0,0,17000,Null,Null,263577298,111461,2
263577304,0.0,0.0,45000,45000,0,0,45000,Null,Null,263577304,111461,2
263577320,0.0,0.0,190000,190000,0,0,190000,Null,Null,263577320,111461,2
263577322,0.0,0.0,175000,175000,0,0,175000,Null,Null,263577322,111461,2
263577328,0.0,0.0,260000,260000,0,0,260000,Null,Null,263577328,111461,2
263577383,0.0,0.0,135000,135000,0,0,135000,Null,Null,263577383,4414249,23246
263577389,0.0,0.0,125000,125000,0,0,125000,Null,Null,263577389,111461,2
263577391,0.0,0.0,175000,175000,0,0,175000,Null,Null,263577391,111461,2
263577403,0.0,0.0,70000,70000,0,0,70000,Null,Null,263577403,111461,2
263577416,0.0,0.0,30000,30000,0,0,30000,Null,Null,263577416,111461,2
263577449,0.0,0.0,788000,788000,0,0,788000,Null,Null,263577449,4414249,23246
263577464,0.0,0.0,58000,58000,0,0,58000,Null,Null,263577464,111461,15318
263577473,0.0,0.0,1684000,1684000,0,0,1684000,Null,Null,263577473,7426417,4381
263577515,0.0,0.0,1540000,1540000,0,0,1540000,Null,Null,263577515,111461,23346
263577540,0.0,0.0,319139,319139,0,0,319139,Null,Null,263577540,7873343,15318
263577541,0.0,0.0,419896,419896,0,0,419896,Null,Null,263577541,7873343,15318
263577542,0.0,0.0,218759,218759,0,0,218759,Null,Null,263577542,7873343,15318
263577580,0.0,0.0,289000,289000,0,0,289000,Null,Null,263577580,4414249,2019
263577587,0.0,0.0,48000,48000,0,0,48000,Null,Null,263577587,154455,53054
263579425,0.0,0.0,1640000,1640000,0,0,1640000,Null,Null,263579425,7426417,4381
263579464,0.0,0.0,109000,89000,20000,18,109000,Null,Null,263579464,150215,2347
263579549,0.0,0.0,2400000,2400000,0,0,2400000,Null,Null,263579549,111461,23576
263579566,0.0,0.0,25000,25000,0,0,25000,Null,Null,263579566,111461,23024
263579685,0.0,0.0,120000,120000,0,0,120000,Null,Null,263579685,5160827,2
263579746,0.0,0.0,109000,89000,20000,18,109000,Null,Null,263579746,150215,1752
263579772,0.0,0.0,485000,485000,0,0,485000,Null,Null,263579772,111461,53350
263579792,0.0,0.0,8000,8000,0,0,8000,Null,Null,263579792,111461,28434
263579866,0.0,0.0,1300000,950000,350000,27,1300000,Null,Null,263579866,5166975,6305
263579877,0.0,0.0,49000,49000,0,0,49000,Null,Null,263579877,111461,8167
263579897,0.0,0.0,55000,55000,0,0,55000,Null,Null,263579897,111461,8167
263579942,0.0,0.0,1540000,1540000,0,0,1540000,Null,Null,263579942,111461,23346
263580024,0.0,0.0,55000,55000,0,0,55000,Null,Null,263580024,111461,8167
263580071,0.0,0.0,55000,55000,0,0,55000,Null,Null,263580071,111461,8167
263580112,0.0,0.0,480000,480000,0,0,480000,Null,Null,263580112,111461,53350
263580156,0.0,0.0,55000,55000,0,0,55000,Null,Null,263580156,111461,8167
263580305,0.0,0.0,1540000,1540000,0,0,1540000,Null,Null,263580305,111461,23346
263580318,0.0,0.0,78000,78000,0,0,78000,Null,Null,263580318,111461,53190
263580332,0.0,0.0,1376000,1376000,0,0,1376000,Null,Null,263580332,7426417,4381
263580339,0.0,0.0,168000,168000,0,0,168000,Null,Null,263580339,111461,3990
263580379,0.0,0.0,550000,550000,0,0,550000,Null,Null,263580379,708725,2512
263580461,0.0,0.0,91900,91900,0,0,91900,Null,Null,263580461,111461,28482
263580530,0.0,0.0,0,69000,0,0,69000,Null,Null,263580530,111461,0
263580561,0.0,0.0,890000,890000,0,0,890000,Null,Null,263580561,111461,53350
263580582,0.0,0.0,1540000,1540000,0,0,1540000,Null,Null,263580582,111461,23346
263580591,0.0,0.0,1990000,1990000,0,0,1990000,Null,Null,263580591,5188707,1883
263580778,0.0,0.0,45000,29900,15100,34,45000,Null,Null,263580778,111461,1883
263580784,0.0,0.0,1690000,1690000,0,0,1690000,Null,Null,263580784,5188707,1883
263580807,0.0,0.0,1890000,1890000,0,0,1890000,Null,Null,263580807,7426417,4381
263580854,0.0,0.0,30000,30000,0,0,30000,Null,Null,263580854,5160827,2
263580867,0.0,0.0,1990000,1990000,0,0,1990000,Null,Null,263580867,5188707,1883
263580925,0.0,0.0,1540000,1540000,0,0,1540000,Null,Null,263580925,111461,23346
263580961,0.0,0.0,1990000,1990000,0,0,1990000,Null,Null,263580961,5188707,1883
263580971,0.0,0.0,5000,5000,0,0,5000,Null,Null,263580971,111461,53190
263580998,0.0,0.0,44000,44000,0,0,44000,Null,Null,263580998,111461,2238
263581005,0.0,0.0,119000,119000,0,0,119000,Null,Null,263581005,21651,5006
263581025,0.0,0.0,1190000,1190000,0,0,1190000,Null,Null,263581025,5188707,1883
263581083,0.0,0.0,1540000,1540000,0,0,1540000,Null,Null,263581083,111461,23346
263581130,0.0,0.0,298000,298000,0,0,298000,Null,Null,263581130,111461,23304
263581144,0.0,0.0,145000,93000,52000,36,145000,Null,Null,263581144,8181541,5263
263581153,0.0,0.0,990000,990000,0,0,990000,Null,Null,263581153,5188707,1883
263581161,0.0,0.0,550000,550000,0,0,550000,Null,Null,263581161,111461,23288
263581180,0.0,0.0,6000,6000,0,0,6000,Null,Null,263581180,111461,53190
263581191,0.0,0.0,389000,389000,0,0,389000,Null,Null,263581191,111461,1979
263581208,0.0,0.0,460000,460000,0,0,460000,Null,Null,263581208,111461,53350
263581215,0.0,0.0,50000,50000,0,0,50000,Null,Null,263581215,111461,2340
263581241,0.0,0.0,389000,389000,0,0,389000,Null,Null,263581241,111461,1979
263581249,6.0,6.0,20000,20000,0,0,20000,Null,Null,263581249,111461,1883
263581256,0.0,0.0,99000,99000,0,0,99000,Null,Null,263581256,111461,2
263581278,0.0,0.0,99000,99000,0,0,99000,Null,Null,263581278,111461,2
263581338,0.0,0.0,99000,99000,0,0,99000,Null,Null,263581338,111461,2
263581347,0.0,0.0,916000,916000,0,0,916000,Null,Null,263581347,7426417,4381
263581367,0.0,0.0,1540000,1540000,0,0,1540000,Null,Null,263581367,111461,23346
263581680,0.0,0.0,80000,80000,0,0,80000,Null,Null,263581680,111461,2
263581682,0.0,0.0,99000,99000,0,0,99000,Null,Null,263581682,111461,2
263581779,0.0,0.0,170000,170000,0,0,170000,Null,Null,263581779,111461,15320
263581786,0.0,0.0,85000,85000,0,0,85000,Null,Null,263581786,111461,2
263581806,0.0,0.0,1090000,1090000,0,0,1090000,Null,Null,263581806,5188707,1883
263581892,0.0,0.0,59000,59000,0,0,59000,Null,Null,263581892,111461,12988
263581894,0.0,0.0,1064000,1064000,0,0,1064000,Null,Null,263581894,7426417,4381
263581936,0.0,0.0,85000,85000,0,0,85000,Null,Null,263581936,111461,2
263582084,0.0,0.0,79000,79000,0,0,79000,Null,Null,263582084,111461,18888
263582090,0.0,0.0,85000,85000,0,0,85000,Null,Null,263582090,111461,2
263582122,0.0,0.0,1540000,1540000,0,0,1540000,Null,Null,263582122,111461,23346
263582177,0.0,0.0,12000,12000,0,0,12000,Null,Null,263582177,111461,53190
263582183,0.0,0.0,17170000,17170000,0,0,17170000,Null,Null,263582183,488701,2340
263582186,0.0,0.0,99000,99000,0,0,99000,Null,Null,263582186,111461,28484
263582189,0.0,0.0,2100000,2100000,0,0,2100000,Null,Null,263582189,467599,1984
263582226,0.0,0.0,787000,787000,0,0,787000,Null,Null,263582226,7426417,4381
263582266,0.0,0.0,8000,8000,0,0,8000,Null,Null,263582266,111461,23244
263582282,0.0,0.0,60800,60800,0,0,60800,Null,Null,263582282,689369,8224
263582336,0.0,0.0,2022000,2022000,0,0,2022000,Null,Null,263582336,7426417,4381
263582341,0.0,0.0,79000,79000,0,0,79000,Null,Null,263582341,623837,2948
263582509,0.0,0.0,130000,130000,0,0,130000,Null,Null,263582509,111461,28644
